,"Type","Date","Num","Adj","Name","Memo","Account Type","Account","Clr","Split","Debit","Credit","Balance"
"Ordinary Income/Expense",,,,,,,,,,,,,""
"Income",,,,,,,,,,,,,""
"Sales",,,,,,,,,,,,,""
"Stickering",,,,,,,,,,,,,""
,"Invoice","12-09-2024","MC06146",,"Aurora Ventures Limited","Stickering 16128 pcs of Product","Income","Stickering",,"Accounts Receivable","",20160.00,20160.00
,"Invoice","28-10-2024","MC06307",,"Sleek Kenya Ltd","KEBS SM correction stickering labour 4800 Pcs","Income","Stickering",,"Accounts Receivable","",4800.00,24960.00
,"Invoice","22-11-2024","MC06400",,"Sleek Kenya Ltd","KEBS SM correction stickering labour 17000 Pcs","Income","Stickering",,"Accounts Receivable","",17000.00,41960.00
,"Invoice","09-12-2024","MC06455",,"Sleek Kenya Ltd","KEBS SM correction stickering labour 15840 Pcs","Income","Stickering",,"Accounts Receivable","",15840.00,57800.00
"Total Stickering",,,,,,,,,,,0.00,57800.00,57800.00
"Zelia",,,,,,,,,,,,,""
"Zelia Machine Wash",,,,,,,,,,,,,""
,"Sales Receipt","06-11-2024","3402",,"Cash Sales","Zelia Machine Wash 16x750ML","Income","Zelia Machine Wash",,"Undeposited Funds","",154.00,154.00
,"Sales Receipt","12-11-2024","3431",,"Cash Sales","-MULTIPLE-","Income","Zelia Machine Wash",,"Undeposited Funds","",5700.00,5854.00
,"Sales Receipt","18-11-2024","3473",,"Cash Sales","Zelia Machine Wash 16x750ML","Income","Zelia Machine Wash",,"Undeposited Funds",0.00,"",5854.00
,"Sales Receipt","22-11-2024","3499",,"Cash Sales","Zelia Machine Wash 16x750ML","Income","Zelia Machine Wash",,"Undeposited Funds","",1000.00,6854.00
,"Sales Receipt","28-11-2024","3750",,"Cash Sales","Zelia Machine Wash 4x5L","Income","Zelia Machine Wash",,"Undeposited Funds","",1500.00,8354.00
,"Sales Receipt","28-11-2024","3751",,"Cash Sales","Zelia Machine Wash 4x5L","Income","Zelia Machine Wash",,"Undeposited Funds","",1500.00,9854.00
,"Sales Receipt","30-11-2024","AT203",,"Cash Sales","-MULTIPLE-","Income","Zelia Machine Wash",,"Undeposited Funds","",8650.00,18504.00
,"Sales Receipt","02-12-2024","3767",,"Cash Sales","Zelia Machine Wash 9x1.5L","Income","Zelia Machine Wash",,"Undeposited Funds","",600.00,19104.00
,"Sales Receipt","09-12-2024","3318",,"Cash Sales","Zelia Machine Wash 16x750ML","Income","Zelia Machine Wash",,"Undeposited Funds","",300.00,19404.00
,"Sales Receipt","16-12-2024","3348",,"Cash Sales","Zelia Machine Wash 4x5L","Income","Zelia Machine Wash",,"Undeposited Funds","",1500.00,20904.00
,"Sales Receipt","17-12-2024","3355",,"Cash Sales","Zelia Machine Wash 4x5L","Income","Zelia Machine Wash",,"Undeposited Funds","",3000.00,23904.00
,"Sales Receipt","19-12-2024","3373",,"Cash Sales","Zelia Machine Wash 4x5L","Income","Zelia Machine Wash",,"Undeposited Funds",0.00,"",23904.00
"Total Zelia Machine Wash",,,,,,,,,,,0.00,23904.00,23904.00
"Fuel Gel",,,,,,,,,,,,,""
,"Sales Receipt","23-07-2024","2581",,"Cash Sales","Flem Fuel Gel 200ML","Income","Fuel Gel",,"Undeposited Funds",0.00,"",0.00
,"Sales Receipt","29-07-2024","2602",,"Cash Sales","Flem Fuel Gel 200ML","Income","Fuel Gel",,"Undeposited Funds",0.00,"",0.00
,"Sales Receipt","29-07-2024","2603",,"Cash Sales","Flem Fuel Gel 200ML","Income","Fuel Gel",,"Undeposited Funds",0.00,"",0.00
,"Sales Receipt","01-08-2024","2636",,"Cash Sales","Flem Fuel Gel 200ML","Income","Fuel Gel",,"Undeposited Funds",0.00,"",0.00
,"Sales Receipt","02-08-2024","2651",,"Cash Sales","-MULTIPLE-","Income","Fuel Gel",,"Undeposited Funds","",220.00,220.00
,"Sales Receipt","06-08-2024","2662",,"Cash Sales","Flem Fuel Gel 200ML","Income","Fuel Gel",,"Undeposited Funds",0.00,"",220.00
,"Sales Receipt","08-08-2024","2685",,"Cash Sales","Flem Fuel Gel 500ML","Income","Fuel Gel",,"Undeposited Funds",0.00,"",220.00
,"Sales Receipt","09-08-2024","2696",,"Cash Sales","Flem Fuel Gel 200ML","Income","Fuel Gel",,"Undeposited Funds","",180.00,400.00
,"Invoice","14-08-2024","MC06036",,"Entumoto Safari Camp Ltd","-MULTIPLE-","Income","Fuel Gel",,"Accounts Receivable","",9310.34,9710.34
,"Sales Receipt","16-08-2024","2903",,"Cash Sales","Flem Fuel Gel 200ML","Income","Fuel Gel",,"Undeposited Funds","",144.00,9854.34
,"Sales Receipt","19-08-2024","2838",,"Cash Sales","Flem Fuel Gel 200ML","Income","Fuel Gel",,"Undeposited Funds",0.00,"",9854.34
,"Sales Receipt","19-08-2024","2839",,"Cash Sales","Flem Fuel Gel 200ML","Income","Fuel Gel",,"Undeposited Funds",0.00,"",9854.34
,"Invoice","21-08-2024","MC06061",,"Muhaya & Rukundo Holdings Ltd","-MULTIPLE-","Income","Fuel Gel",,"Accounts Receivable","",25800.00,35654.34
,"Sales Receipt","03-09-2024","2922",,"Cash Sales","Flem Fuel Gel 48X200ML","Income","Fuel Gel",,"Undeposited Funds",0.00,"",35654.34
,"Sales Receipt","05-09-2024","2952",,"Cash Sales","Flem Fuel Gel 48X200ML","Income","Fuel Gel",,"Undeposited Funds",0.00,"",35654.34
,"Invoice","11-09-2024","MC06137",,"MUTHU SILVER SPRINGS MANAGEMENT LIMITED","Flem Fuel Gel 48X200ML","Income","Fuel Gel",,"Accounts Receivable","",3744.00,39398.34
,"Invoice","11-10-2024","MC06251",,"HOPEMART SELF SERVICES LTD","Flem Fuel Gel 48X200ML  6 Pieces @96.28","Income","Fuel Gel",,"Accounts Receivable","",498.00,39896.34
,"Invoice","07-11-2024","MC06337",,"HOTEL MONARCH LIMITED","Flem Fuel Gel 5L","Income","Fuel Gel",,"Accounts Receivable","",4040.00,43936.34
,"Invoice","11-11-2024","MC06351",,"HOTEL MONARCH LIMITED","Flem Fuel Gel 5L","Income","Fuel Gel",,"Accounts Receivable","",5050.00,48986.34
,"Sales Receipt","14-11-2024","3727",,"Cash Sales","Flem Fuel Gel 48X200ML","Income","Fuel Gel",,"Undeposited Funds","",188.00,49174.34
,"Sales Receipt","18-11-2024","3455",,"Cash Sales","Flem Fuel Gel 500ML","Income","Fuel Gel",,"Undeposited Funds","",130.00,49304.34
,"Invoice","19-11-2024","MC06380",,"HOTEL MONARCH LIMITED","Flem Fuel Gel 5L","Income","Fuel Gel",,"Accounts Receivable","",5050.00,54354.34
,"Credit Note","19-11-2024","CN01074",,"HOTEL MONARCH LIMITED","Flem Fuel Gel 5L","Income","Fuel Gel",,"Accounts Receivable",5050.00,"",49304.34
,"Sales Receipt","19-11-2024","3471",,"Kedulle Enterprises","Flem Fuel Gel 48X200ML","Income","Fuel Gel",,"Undeposited Funds","",2952.00,52256.34
,"Sales Receipt","19-11-2024","3749",,"Kedulle Enterprises","Flem Fuel Gel 500ML","Income","Fuel Gel",,"Undeposited Funds","",2460.00,54716.34
,"Sales Receipt","20-11-2024","3477",,"Cash Sales","Flem Fuel Gel 48X200ML","Income","Fuel Gel",,"Undeposited Funds",0.00,"",54716.34
,"Sales Receipt","22-11-2024","3485",,"Cash Sales","Flem Fuel Gel 500ML","Income","Fuel Gel",,"Undeposited Funds","",650.00,55366.34
,"Sales Receipt","22-11-2024","3487",,"Cash Sales","Flem Fuel Gel 500ML","Income","Fuel Gel",,"Undeposited Funds","",130.00,55496.34
,"Sales Receipt","10-12-2024","3322",,"Cash Sales","Flem Fuel Gel 5L Label","Income","Fuel Gel",,"Undeposited Funds","",1500.00,56996.34
"Total Fuel Gel",,,,,,,,,,,5050.00,62046.34,56996.34
"Carneli Shower Gel",,,,,,,,,,,,,""
,"Sales Receipt","03-01-2024","1598",,"Cash Sales","-MULTIPLE-","Income","Carneli Shower Gel",,"Undeposited Funds","",700.00,700.00
,"Sales Receipt","11-01-2024","1723",,"Cash Sales","Carneli Sweet Vanilla Shower Gel 400ML","Income","Carneli Shower Gel",,"Undeposited Funds",0.00,"",700.00
,"Sales Receipt","12-01-2024","1727",,"Cash Sales","Carneli Sweet Vanilla Shower Gel 400ML","Income","Carneli Shower Gel",,"Undeposited Funds","",350.00,1050.00
,"Sales Receipt","19-01-2024","1744",,"Cash Sales","Carneli Normal Shower Gel 400ML","Income","Carneli Shower Gel",,"Undeposited Funds","",600.00,1650.00
,"Sales Receipt","30-01-2024","1767",,"Cash Sales","Carneli Normal Shower Gel 400ML","Income","Carneli Shower Gel",,"Undeposited Funds",0.00,"",1650.00
,"Sales Receipt","31-01-2024","1773",,"Cash Sales","Carneli Normal Shower Gel 400ML","Income","Carneli Shower Gel",,"Undeposited Funds",0.00,"",1650.00
,"Sales Receipt","02-02-2024","1782",,"Cash Sales","Carneli Normal Shower Gel 400ML","Income","Carneli Shower Gel",,"Undeposited Funds","",350.00,2000.00
,"Sales Receipt","19-02-2024",,,"Joyce Body wash","-MULTIPLE-","Income","Carneli Shower Gel",,"Undeposited Funds",0.00,"",2000.00
,"Sales Receipt","22-02-2024","1866",,"Cash Sales","Carneli Sweet Vanilla Shower Gel 400ML","Income","Carneli Shower Gel",,"Undeposited Funds","",350.00,2350.00
,"Sales Receipt","22-02-2024","1868",,"Cash Sales","Carneli Sweet Vanilla Shower Gel 400ML","Income","Carneli Shower Gel",,"Undeposited Funds","",350.00,2700.00
,"Sales Receipt","29-02-2024","1890",,"Cash Sales","Carneli Normal Shower Gel 400ML","Income","Carneli Shower Gel",,"Undeposited Funds","",600.00,3300.00
,"Sales Receipt","04-03-2024","1895",,"Cash Sales","Carneli Normal Shower Gel 400ML","Income","Carneli Shower Gel",,"Undeposited Funds","",300.00,3600.00
,"Sales Receipt","07-03-2024","2029",,"Cash Sales","Carneli Normal Shower Gel 400ML","Income","Carneli Shower Gel",,"Undeposited Funds","",295.00,3895.00
,"Sales Receipt","12-03-2024","2057",,"Cash Sales","-MULTIPLE-","Income","Carneli Shower Gel",,"Undeposited Funds",0.00,"",3895.00
,"Sales Receipt","23-03-2024","2100",,,"Carneli Intense Clean Body Wash 400ML","Income","Carneli Shower Gel",,"Undeposited Funds","",300.00,4195.00
,"Sales Receipt","28-03-2024","2130",,"Cash Sales","Carneli Sweet Vanilla Body Wash 400ML","Income","Carneli Shower Gel",,"Undeposited Funds","",300.00,4495.00
,"Sales Receipt","03-04-2024","2144",,"Cash Sales","Carneli Intense Clean Body Wash 400ML","Income","Carneli Shower Gel",,"Undeposited Funds","",300.00,4795.00
,"Sales Receipt","03-04-2024","2145",,"Cash Sales","Carneli Intense Clean Body Wash 400ML","Income","Carneli Shower Gel",,"Undeposited Funds","",300.00,5095.00
,"Sales Receipt","08-04-2024","2164",,"Kangundo Briolly Bookshop","Carneli Intense Clean Body Wash 400ML","Income","Carneli Shower Gel",,"Undeposited Funds","",300.00,5395.00
,"Sales Receipt","19-04-2024","2231",,"Cash Sales","Carneli Intense Clean Body Wash 400ML","Income","Carneli Shower Gel",,"Undeposited Funds","",300.00,5695.00
,"Sales Receipt","02-05-2024","2287",,"5pm Hotel","Carneli Intense Clean Body Wash 400ML","Income","Carneli Shower Gel",,"Undeposited Funds","",526.32,6221.32
,"Sales Receipt","03-05-2024","2300",,"Cash Sales","Carneli Intense Clean Body Wash 400ML","Income","Carneli Shower Gel",,"Undeposited Funds",0.00,"",6221.32
,"Sales Receipt","03-05-2024","2304",,"Cash Sales","Carneli Sweet Vanilla Body Wash 400ML","Income","Carneli Shower Gel",,"Undeposited Funds","",300.00,6521.32
,"Sales Receipt","13-05-2024","2351",,"Aymat Wholesalers","-MULTIPLE-","Income","Carneli Shower Gel",,"Undeposited Funds","",4560.00,11081.32
,"Sales Receipt","13-05-2024","02916",,"Joyce Body wash","-MULTIPLE-","Income","Carneli Shower Gel",,"Undeposited Funds",0.00,"",11081.32
,"Sales Receipt","14-05-2024","1925",,"Cash Sales","Carneli Sweet Vanilla Body Wash 400ML","Income","Carneli Shower Gel",,"Undeposited Funds","",300.00,11381.32
,"Sales Receipt","15-05-2024","2361",,"Lango Supermarket","-MULTIPLE-","Income","Carneli Shower Gel",,"Undeposited Funds","",4200.00,15581.32
,"Sales Receipt","15-05-2024","2362",,"Cash Sales","Carneli Sweet Vanilla Body Wash 400ML","Income","Carneli Shower Gel",,"Undeposited Funds",0.00,"",15581.32
,"Sales Receipt","27-05-2024","2386",,"Joyce Body wash","-MULTIPLE-","Income","Carneli Shower Gel",,"Undeposited Funds",0.00,"",15581.32
,"Sales Receipt","07-06-2024","1994",,"Cash Sales","Carneli Intense Clean Body Wash 400ML","Income","Carneli Shower Gel",,"Undeposited Funds","",350.00,15931.32
,"Sales Receipt","07-06-2024","1995",,"Cash Sales","Carneli Intense Clean Body Wash 400ML","Income","Carneli Shower Gel",,"Undeposited Funds","",350.00,16281.32
,"Sales Receipt","12-06-2024","10274",,"Joyce Body wash","-MULTIPLE-","Income","Carneli Shower Gel",,"Undeposited Funds",0.00,"",16281.32
,"Sales Receipt","01-07-2024","2756",,"Cash Sales","-MULTIPLE-","Income","Carneli Shower Gel",,"Undeposited Funds","",600.00,16881.32
,"Sales Receipt","03-07-2024","2761",,"Cash Sales","-MULTIPLE-","Income","Carneli Shower Gel",,"Undeposited Funds",0.00,"",16881.32
,"Sales Receipt","05-07-2024","2792",,"Cash Sales","Carneli Sweet Vanilla Body Wash 400ML","Income","Carneli Shower Gel",,"Undeposited Funds","",300.00,17181.32
,"Sales Receipt","12-07-2024","2537",,"Cash Sales","Carneli Sweet Vanilla Body Wash 400ML","Income","Carneli Shower Gel",,"Undeposited Funds","",350.00,17531.32
,"Sales Receipt","15-07-2024","2542",,"Cash Sales","-MULTIPLE-","Income","Carneli Shower Gel",,"Undeposited Funds","",700.00,18231.32
,"Sales Receipt","23-07-2024","2585",,"Cash Sales","Carneli Intense Clean Body Wash 400ML","Income","Carneli Shower Gel",,"Undeposited Funds","",350.00,18581.32
,"Sales Receipt","14-08-2024","2822",,"Cash Sales","Carneli Intense Clean Body Wash 400ML","Income","Carneli Shower Gel",,"Undeposited Funds","",350.00,18931.32
,"Sales Receipt","19-08-2024","2837",,"Cash Sales","Carneli Intense Clean Body Wash 400ML","Income","Carneli Shower Gel",,"Undeposited Funds","",350.00,19281.32
,"Invoice","22-08-2024","MC06066",,"Cash Sales","Carneli Intense Clean Body Wash 400ML","Income","Carneli Shower Gel",,"Accounts Receivable","",301.72,19583.04
,"Credit Note","22-08-2024","CN01065",,"Cash Sales","Carneli Intense Clean Body Wash 400ML","Income","Carneli Shower Gel",,"Accounts Receivable",301.72,"",19281.32
,"Sales Receipt","23-08-2024","2880",,"Cash Sales","Carneli Intense Clean Body Wash 400ML","Income","Carneli Shower Gel",,"Undeposited Funds","",350.00,19631.32
,"Sales Receipt","26-08-2024","2885",,"Cash Sales","Carneli Intense Clean Body Wash 400ML","Income","Carneli Shower Gel",,"Undeposited Funds","",1050.00,20681.32
,"Sales Receipt","10-09-2024","2978",,"Cash Sales","Carneli Intense Clean Body Wash 400ML","Income","Carneli Shower Gel",,"Undeposited Funds","",350.00,21031.32
,"Sales Receipt","12-09-2024","2987",,"Cash Sales","Carneli Intense Clean Body Wash 400ML","Income","Carneli Shower Gel",,"Undeposited Funds",0.00,"",21031.32
,"Sales Receipt","17-09-2024","3051",,"Cash Sales","Carneli Intense Clean Body Wash 400ML","Income","Carneli Shower Gel",,"Undeposited Funds","",2100.00,23131.32
,"Sales Receipt","26-09-2024","3209",,"Cash Sales","Carneli Intense Clean Body Wash 400ML","Income","Carneli Shower Gel",,"Undeposited Funds",0.00,"",23131.32
,"Sales Receipt","04-10-2024","3251",,"Cash Sales","Carneli Intense Clean Body Wash 400ML","Income","Carneli Shower Gel",,"Undeposited Funds","",1050.00,24181.32
,"Sales Receipt","04-10-2024","AT200",,"Cash Sales","Carneli Intense Clean Body Wash 400ML","Income","Carneli Shower Gel",,"Undeposited Funds","",1500.00,25681.32
,"Sales Receipt","07-10-2024","3256",,"Cash Sales","Carneli Intense Clean Body Wash 400ML","Income","Carneli Shower Gel",,"Undeposited Funds","",350.00,26031.32
,"Sales Receipt","24-10-2024","3148",,"Cash Sales","Carneli Sweet Vanilla Body Wash 400ML","Income","Carneli Shower Gel",,"Undeposited Funds","",820.00,26851.32
,"Sales Receipt","12-11-2024","3431",,"Cash Sales","Carneli Intense Clean Body Wash 400ML","Income","Carneli Shower Gel",,"Undeposited Funds","",12600.00,39451.32
,"Sales Receipt","13-11-2024","3434",,"Cash Sales","Carneli Intense Clean Body Wash 5L","Income","Carneli Shower Gel",,"Undeposited Funds","",4020.00,43471.32
,"Sales Receipt","13-11-2024","3435",,"Cash Sales","Carneli Sweet Vanilla Body Wash 400ML","Income","Carneli Shower Gel",,"Undeposited Funds","",1050.00,44521.32
,"Sales Receipt","22-11-2024","3484",,"Cash Sales","Carneli Sweet Vanilla Body Wash 400ML","Income","Carneli Shower Gel",,"Undeposited Funds","",400.00,44921.32
,"Invoice","25-11-2024","MC06411",,"Solucom Enterprises Limited","Perfume Spiritz 2130420","Income","Carneli Shower Gel",,"Accounts Receivable","",9900.00,54821.32
,"Sales Receipt","02-12-2024","3767",,"Cash Sales","Carneli Intense Clean Body Wash 400ML","Income","Carneli Shower Gel",,"Undeposited Funds","",350.00,55171.32
,"Sales Receipt","02-12-2024","3779",,"Cash Sales","Carneli Intense Clean Body Wash 400ML","Income","Carneli Shower Gel",,"Undeposited Funds","",700.00,55871.32
,"Sales Receipt","11-12-2024","3336",,"Cash Sales","Carneli Intense Clean Body Wash 400ML","Income","Carneli Shower Gel",,"Undeposited Funds","",350.00,56221.32
,"Sales Receipt","16-12-2024","3344",,"Cash Sales","Carneli Intense Clean Body Wash 400ML","Income","Carneli Shower Gel",,"Undeposited Funds","",800.00,57021.32
"Total Carneli Shower Gel",,,,,,,,,,,301.72,57323.04,57021.32
"Zelia Surface Cleaner",,,,,,,,,,,,,""
,"Invoice","04-01-2024","MC05269",,"OFFSHORE GLOBAL LOGISTICS LIMITED","Zelia Surface Cleaner 750ML","Income","Zelia Surface Cleaner",,"Accounts Receivable","",1358.62,1358.62
,"Sales Receipt","12-01-2024","1727",,"Cash Sales","Zelia Surface Cleaner 750ML","Income","Zelia Surface Cleaner",,"Undeposited Funds","",350.00,1708.62
,"Sales Receipt","25-01-2024","1758",,"Cash Sales","Zelia Surface Cleaner 750ML","Income","Zelia Surface Cleaner",,"Undeposited Funds","",660.00,2368.62
,"Sales Receipt","30-01-2024","1766",,"Cash Sales","Zelia Surface Cleaner 750ML","Income","Zelia Surface Cleaner",,"Undeposited Funds","",900.00,3268.62
,"Sales Receipt","31-01-2024","1773",,"Cash Sales","Zelia Surface Cleaner 750ML","Income","Zelia Surface Cleaner",,"Undeposited Funds",0.00,"",3268.62
,"Sales Receipt","10-02-2024","1821",,"Alma Mart","Zelia Surface Cleaner 750ML","Income","Zelia Surface Cleaner",,"Undeposited Funds","",652.00,3920.62
,"Sales Receipt","28-03-2024","2129",,"Cash Sales","Zelia Surface Cleaner 750ML","Income","Zelia Surface Cleaner",,"Undeposited Funds","",300.00,4220.62
,"Sales Receipt","12-04-2024","2175",,"Tekonstruct LTD","Zelia Surface Cleaner 750ML","Income","Zelia Surface Cleaner",,"Undeposited Funds","",1388.00,5608.62
,"Sales Receipt","08-05-2024","2321",,"Cash Sales","Zelia Surface Cleaner 750ML","Income","Zelia Surface Cleaner",,"Undeposited Funds","",320.00,5928.62
,"Sales Receipt","10-05-2024","1918",,"Cash Sales","Zelia Surface Cleaner 750ML","Income","Zelia Surface Cleaner",,"Undeposited Funds","",1580.00,7508.62
,"Sales Receipt","13-05-2024","2356",,"The Hub Minimart","Zelia Surface Cleaner 750ML","Income","Zelia Surface Cleaner",,"Undeposited Funds","",326.00,7834.62
,"Sales Receipt","31-05-2024","1937",,"Island Gift Shop","Zelia Surface Cleaner 750ML","Income","Zelia Surface Cleaner",,"Undeposited Funds","",694.00,8528.62
,"Sales Receipt","22-07-2024","2571",,"Fahma Qali","Zelia Surface Cleaner 750ML","Income","Zelia Surface Cleaner",,"Undeposited Funds","",1200.00,9728.62
,"Sales Receipt","03-09-2024","3226",,"Soft Landing","Zelia Surface Cleaner 750ML","Income","Zelia Surface Cleaner",,"Undeposited Funds","",714.00,10442.62
,"Sales Receipt","03-09-2024","2922",,"Cash Sales","Zelia Surface Cleaner 750ML","Income","Zelia Surface Cleaner",,"Undeposited Funds",0.00,"",10442.62
,"Sales Receipt","10-09-2024","2973",,"Cash Sales","Zelia Surface Cleaner 750ML","Income","Zelia Surface Cleaner",,"Undeposited Funds","",410.00,10852.62
,"Sales Receipt","16-09-2024","3044",,"Afro Drip LTD","Zelia Surface Cleaner 750ML","Income","Zelia Surface Cleaner",,"Undeposited Funds","",300.00,11152.62
,"Sales Receipt","16-09-2024","3045",,"Afro Drip LTD Reception","Zelia Surface Cleaner 750ML","Income","Zelia Surface Cleaner",,"Undeposited Funds","",300.00,11452.62
,"Sales Receipt","25-09-2024","3095",,"Cash Sales","Zelia Surface Cleaner 750ML","Income","Zelia Surface Cleaner",,"Undeposited Funds","",300.00,11752.62
,"Sales Receipt","27-09-2024","3216",,"Cash Sales","Zelia Surface Cleaner 750ML","Income","Zelia Surface Cleaner",,"Undeposited Funds","",600.00,12352.62
,"Sales Receipt","16-10-2024","3109",,"Cash Sales","Zelia Surface Cleaner 750ML","Income","Zelia Surface Cleaner",,"Undeposited Funds","",300.00,12652.62
,"Sales Receipt","08-11-2024","3458",,"Mama Sam Shop","Zelia Surface Cleaner 750ML","Income","Zelia Surface Cleaner",,"Undeposited Funds","",2142.00,14794.62
,"Sales Receipt","11-11-2024","3420",,"Cash Sales","Zelia Surface Cleaner 750ML","Income","Zelia Surface Cleaner",,"Undeposited Funds","",350.00,15144.62
,"Sales Receipt","26-11-2024","3740",,"Afrodrip JKIA","Zelia Surface Cleaner 750ML","Income","Zelia Surface Cleaner",,"Undeposited Funds","",300.00,15444.62
,"Sales Receipt","28-11-2024","3750",,"Cash Sales","Zelia Surface Cleaner 750ML","Income","Zelia Surface Cleaner",,"Undeposited Funds","",300.00,15744.62
,"Sales Receipt","16-12-2024","3346",,"Cash Sales","Zelia Surface Cleaner 750ML","Income","Zelia Surface Cleaner",,"Undeposited Funds","",1200.00,16944.62
,"Sales Receipt","17-12-2024","3355",,"Cash Sales","Zelia Surface Cleaner 750ML","Income","Zelia Surface Cleaner",,"Undeposited Funds","",600.00,17544.62
"Total Zelia Surface Cleaner",,,,,,,,,,,0.00,17544.62,17544.62
"Zelia Bleach",,,,,,,,,,,,,""
,"Sales Receipt","03-01-2024","1592",,"Cash Sales","Zelia Bleach 500ML","Income","Zelia Bleach",,"Undeposited Funds","",100.00,100.00
,"Invoice","04-01-2024","MC05269",,"OFFSHORE GLOBAL LOGISTICS LIMITED","Zelia Bleach 5L","Income","Zelia Bleach",,"Accounts Receivable","",1491.38,1591.38
,"Sales Receipt","04-01-2024","1707",,"Mama Amina","Zelia Bleach 500ML","Income","Zelia Bleach",,"Undeposited Funds","",606.00,2197.38
,"Sales Receipt","04-01-2024","1708",,"Cash Sales","Zelia Bleach 5L","Income","Zelia Bleach",,"Undeposited Funds","",850.00,3047.38
,"Invoice","05-01-2024","MC05272",,"Mumsha Supamat","-MULTIPLE-","Income","Zelia Bleach",,"Accounts Receivable","",1453.44,4500.82
,"Sales Receipt","05-01-2024","1600",,"Cash Sales","Zelia Bleach 5L","Income","Zelia Bleach",,"Undeposited Funds","",800.00,5300.82
,"Sales Receipt","05-01-2024","1711",,"Summer Outlets","Zelia Bleach 500ML","Income","Zelia Bleach",,"Undeposited Funds","",606.00,5906.82
,"Invoice","12-01-2024","MC05300",,"MUHINDI MWEUSI SUPERMARKET LIMITED","-MULTIPLE-","Income","Zelia Bleach",,"Accounts Receivable","",2296.55,8203.37
,"Invoice","12-01-2024","MC05302",,"MUHINDI MWEUSI SUPERMARKET LIMITED","Zelia Bleach 500ML","Income","Zelia Bleach",,"Accounts Receivable","",610.34,8813.71
,"Sales Receipt","12-01-2024","1727",,"Cash Sales","Zelia Bleach 750ML","Income","Zelia Bleach",,"Undeposited Funds",0.00,"",8813.71
,"Invoice","15-01-2024","MC05309",,"MUHINDI MWEUSI SUPERMARKET LIMITED","Zelia Bleach 750ML","Income","Zelia Bleach",,"Accounts Receivable","",1686.21,10499.92
,"Invoice","15-01-2024","MC05311",,"Seasons lane Mart","-MULTIPLE-","Income","Zelia Bleach",,"Accounts Receivable","",1453.45,11953.37
,"Invoice","15-01-2024","MC05315",,"MUHINDI MWEUSI SUPERMARKET LIMITED","Zelia Bleach 500ML","Income","Zelia Bleach",,"Accounts Receivable","",2441.38,14394.75
,"Sales Receipt","18-01-2024","1738",,"Cash Sales","Zelia Bleach 750ML","Income","Zelia Bleach",,"Undeposited Funds","",125.00,14519.75
,"Sales Receipt","19-01-2024","1739",,"Cash Sales","Zelia Bleach 500ML","Income","Zelia Bleach",,"Undeposited Funds",0.00,"",14519.75
,"Sales Receipt","19-01-2024","1744",,"Cash Sales","-MULTIPLE-","Income","Zelia Bleach",,"Undeposited Funds","",3210.00,17729.75
,"Invoice","23-01-2024","MC05343",,"MUHINDI MWEUSI SUPERMARKET LIMITED","Zelia Bleach 500ML","Income","Zelia Bleach",,"Accounts Receivable","",1220.69,18950.44
,"Invoice","24-01-2024","MC05346",,"Qways Supermarket","-MULTIPLE-","Income","Zelia Bleach",,"Accounts Receivable","",2063.79,21014.23
,"Sales Receipt","24-01-2024","1754",,"Cash Sales","Zelia Bleach 5L","Income","Zelia Bleach",,"Undeposited Funds","",800.00,21814.23
,"Sales Receipt","24-01-2024","1755",,"Alma Mart","-MULTIPLE-","Income","Zelia Bleach",,"Undeposited Funds","",2904.00,24718.23
,"Sales Receipt","24-01-2024","1757",,"Cash Sales","Zelia Bleach 750ML","Income","Zelia Bleach",,"Undeposited Funds","",125.00,24843.23
,"Sales Receipt","29-01-2024","1761",,"Cash Sales","Zelia Bleach 500ML","Income","Zelia Bleach",,"Undeposited Funds","",303.00,25146.23
,"Sales Receipt","29-01-2024","1769",,"Cash Sales","-MULTIPLE-","Income","Zelia Bleach",,"Undeposited Funds",0.00,"",25146.23
,"Sales Receipt","30-01-2024","1765",,"Cash Sales","Zelia Bleach 5L","Income","Zelia Bleach",,"Undeposited Funds","",800.00,25946.23
,"Sales Receipt","30-01-2024","1766",,"Cash Sales","Zelia Bleach 5L","Income","Zelia Bleach",,"Undeposited Funds","",800.00,26746.23
,"Sales Receipt","30-01-2024","1767",,"Cash Sales","Zelia Bleach 750ML","Income","Zelia Bleach",,"Undeposited Funds","",180.00,26926.23
,"Sales Receipt","31-01-2024","1773",,"Cash Sales","Zelia Bleach 500ML","Income","Zelia Bleach",,"Undeposited Funds",0.00,"",26926.23
,"Sales Receipt","01-02-2024","1776",,"FARMERS BEST GROCERY","-MULTIPLE-","Income","Zelia Bleach",,"Undeposited Funds","",2248.00,29174.23
,"Invoice","02-02-2024","MC05379",,"HOPEMART SELF SERVICES LTD","Zelia Bleach 500ML","Income","Zelia Bleach",,"Accounts Receivable","",610.34,29784.57
,"Sales Receipt","02-02-2024","1783",,"Cheche Minimart","-MULTIPLE-","Income","Zelia Bleach",,"Undeposited Funds","",1029.00,30813.57
,"Sales Receipt","03-02-2024","1792",,"Soimo Minimart","Zelia Bleach 500ML","Income","Zelia Bleach",,"Undeposited Funds","",303.00,31116.57
,"Invoice","05-02-2024","MC05385",,"TAWALA SUPERMARKET LIMITED","-MULTIPLE-","Income","Zelia Bleach",,"Accounts Receivable","",2906.90,34023.47
,"Sales Receipt","05-02-2024","1787",,"Cash Sales","Zelia Bleach 500ML","Income","Zelia Bleach",,"Undeposited Funds",0.00,"",34023.47
,"Sales Receipt","05-02-2024","1788",,"Cash Sales","Zelia Bleach 750ML","Income","Zelia Bleach",,"Undeposited Funds","",125.00,34148.47
,"Sales Receipt","05-02-2024","1791",,"The Hub Minimart","Zelia Bleach 500ML","Income","Zelia Bleach",,"Undeposited Funds","",606.00,34754.47
,"Sales Receipt","06-02-2024","1798",,"Cash Sales","Zelia Bleach 750ML","Income","Zelia Bleach",,"Undeposited Funds","",118.00,34872.47
,"Sales Receipt","06-02-2024","1799",,"Cash Sales","Zelia Bleach 5L","Income","Zelia Bleach",,"Undeposited Funds","",800.00,35672.47
,"Sales Receipt","06-02-2024","1800",,"Mama Amina","Zelia Bleach 500ML","Income","Zelia Bleach",,"Undeposited Funds","",606.00,36278.47
,"Sales Receipt","06-02-2024","1808",,"Cash Sales","Zelia Bleach 750ML","Income","Zelia Bleach",,"Undeposited Funds","",105.00,36383.47
,"Sales Receipt","07-02-2024","1809",,"Cash Sales","Zelia Bleach 5L","Income","Zelia Bleach",,"Undeposited Funds","",800.00,37183.47
,"Sales Receipt","08-02-2024","1814",,"Cash Sales","Zelia Bleach 500ML","Income","Zelia Bleach",,"Undeposited Funds",0.00,"",37183.47
,"Sales Receipt","08-02-2024","1815",,"Cash Sales","Zelia Bleach 500ML","Income","Zelia Bleach",,"Undeposited Funds",0.00,"",37183.47
,"Invoice","12-02-2024","MC05396",,"OFFSHORE GLOBAL LOGISTICS LIMITED","Zelia Bleach 5L","Income","Zelia Bleach",,"Accounts Receivable","",1491.38,38674.85
,"Invoice","12-02-2024","MC05400",,"KASAMAT INVESTMENTS LTD","Zelia Bleach 500ML","Income","Zelia Bleach",,"Accounts Receivable","",610.34,39285.19
,"Sales Receipt","12-02-2024","1824",,"Cash Sales","Zelia Bleach 750ML","Income","Zelia Bleach",,"Undeposited Funds",0.00,"",39285.19
,"Sales Receipt","13-02-2024","1834",,"Cash Sales","Zelia Bleach 750ML","Income","Zelia Bleach",,"Undeposited Funds","",236.00,39521.19
,"Invoice","14-02-2024","MC05405",,"MUHINDI MWEUSI SUPERMARKET LIMITED","Zelia Bleach 500ML","Income","Zelia Bleach",,"Accounts Receivable","",610.35,40131.54
,"Invoice","14-02-2024","MC05406",,"MUHINDI MWEUSI SUPERMARKET LIMITED","Zelia Bleach 500ML","Income","Zelia Bleach",,"Accounts Receivable","",1220.69,41352.23
,"Sales Receipt","14-02-2024","1838",,"Cash Sales","Zelia Bleach 750ML","Income","Zelia Bleach",,"Undeposited Funds",0.00,"",41352.23
,"Sales Receipt","15-02-2024","1839",,"Cash Sales","Zelia Bleach 750ML","Income","Zelia Bleach",,"Undeposited Funds","",118.00,41470.23
,"Sales Receipt","16-02-2024","1847",,"Gidesh Supermarket","-MULTIPLE-","Income","Zelia Bleach",,"Undeposited Funds","",1266.00,42736.23
,"Sales Receipt","16-02-2024","1848",,"Cash Sales","Zelia Bleach 500ML","Income","Zelia Bleach",,"Undeposited Funds","",150.00,42886.23
,"Sales Receipt","16-02-2024","1849",,"Cash Sales","Zelia Bleach 500ML","Income","Zelia Bleach",,"Undeposited Funds","",312.00,43198.23
,"Sales Receipt","16-02-2024","1852",,"Nuclear Supermarket","-MULTIPLE-","Income","Zelia Bleach",,"Undeposited Funds","",1266.00,44464.23
,"Sales Receipt","17-02-2024","1851",,"MumsCereal and General Stores","-MULTIPLE-","Income","Zelia Bleach",,"Undeposited Funds","",633.00,45097.23
,"Sales Receipt","19-02-2024","1853",,"Restoration Traders","-MULTIPLE-","Income","Zelia Bleach",,"Undeposited Funds","",3588.00,48685.23
,"Sales Receipt","21-02-2024","1855",,"Cash Sales","Zelia Bleach 750ML","Income","Zelia Bleach",,"Undeposited Funds","",135.00,48820.23
,"Sales Receipt","21-02-2024","1856",,"Cash Sales","Zelia Bleach 750ML","Income","Zelia Bleach",,"Undeposited Funds","",235.00,49055.23
,"Sales Receipt","21-02-2024","1861",,"Cash Sales","Zelia Bleach 750ML","Income","Zelia Bleach",,"Undeposited Funds","",405.00,49460.23
,"Invoice","23-02-2024","MC05443",,"DAILY CHAMPIONS MINI SUPERMARKET LIMITED","Zelia Bleach 500ML","Income","Zelia Bleach",,"Accounts Receivable","",527.59,49987.82
,"Sales Receipt","26-02-2024","1873",,"mamkon minimart","Zelia Bleach 500ML","Income","Zelia Bleach",,"Undeposited Funds","",202.00,50189.82
,"Sales Receipt","26-02-2024","1877",,"Cash Sales","Zelia Bleach 750ML","Income","Zelia Bleach",,"Undeposited Funds","",118.00,50307.82
,"Sales Receipt","27-02-2024","1879",,"Cash Sales","Zelia Bleach 5L","Income","Zelia Bleach",,"Undeposited Funds","",700.00,51007.82
,"Sales Receipt","27-02-2024","1880",,"Cash Sales","Zelia Bleach 5L","Income","Zelia Bleach",,"Undeposited Funds","",700.00,51707.82
,"Sales Receipt","27-02-2024","1881",,"Gure Yare Shop Nasra","Zelia Bleach 750ML","Income","Zelia Bleach",,"Undeposited Funds","",1476.00,53183.82
,"Sales Receipt","29-02-2024","1890",,"Cash Sales","-MULTIPLE-","Income","Zelia Bleach",,"Undeposited Funds","",1530.00,54713.82
,"Sales Receipt","29-02-2024","AT185",,"Cash Sales","Zelia Bleach 500ML","Income","Zelia Bleach",,"Undeposited Funds","",2847.36,57561.18
,"Sales Receipt","04-03-2024","2003",,"Cash Sales","Zelia Bleach 500ML","Income","Zelia Bleach",,"Undeposited Funds","",79.00,57640.18
,"Invoice","05-03-2024","MC05471",,"PRICE CHOPPER STORES LIMITED","-MULTIPLE-","Income","Zelia Bleach",,"Accounts Receivable","",1267.25,58907.43
,"Sales Receipt","06-03-2024","2026",,"Mama Amina","-MULTIPLE-","Income","Zelia Bleach",,"Undeposited Funds","",1266.00,60173.43
,"Sales Receipt","06-03-2024","2027",,"Khalifa Shop","Zelia Bleach 500ML","Income","Zelia Bleach",,"Undeposited Funds","",1056.00,61229.43
,"Invoice","07-03-2024","MC05477",,"OFFSHORE GLOBAL LOGISTICS LIMITED","Zelia Bleach 5L","Income","Zelia Bleach",,"Accounts Receivable","",2237.07,63466.50
,"Sales Receipt","07-03-2024","2029",,"Cash Sales","Zelia Bleach 750ML","Income","Zelia Bleach",,"Undeposited Funds","",110.00,63576.50
,"Sales Receipt","07-03-2024","2033",,"Cash Sales","Zelia Bleach 750ML","Income","Zelia Bleach",,"Undeposited Funds","",110.00,63686.50
,"Sales Receipt","07-03-2024","2037",,"Cash Sales","Zelia Bleach 750ML","Income","Zelia Bleach",,"Undeposited Funds","",110.00,63796.50
,"Sales Receipt","08-03-2024","2041",,"Cash Sales","Zelia Bleach 750ML","Income","Zelia Bleach",,"Undeposited Funds","",220.00,64016.50
,"Sales Receipt","08-03-2024","2046",,"Cash Sales","Zelia Bleach 750ML","Income","Zelia Bleach",,"Undeposited Funds","",110.00,64126.50
,"Sales Receipt","08-03-2024","2047",,"Cash Sales","Zelia Bleach 750ML","Income","Zelia Bleach",,"Undeposited Funds","",118.00,64244.50
,"Sales Receipt","11-03-2024","2049",,"MWASPART AIRWAYS","-MULTIPLE-","Income","Zelia Bleach",,"Undeposited Funds","",1266.00,65510.50
,"Sales Receipt","11-03-2024","2052",,"Cash Sales","Zelia Bleach 500ML","Income","Zelia Bleach",,"Undeposited Funds",0.00,"",65510.50
,"Sales Receipt","11-03-2024","2053",,"Cash Sales","Zelia Bleach 5L","Income","Zelia Bleach",,"Undeposited Funds","",750.00,66260.50
,"Sales Receipt","11-03-2024","2055",,"Beta Traders","-MULTIPLE-","Income","Zelia Bleach",,"Undeposited Funds","",1266.00,67526.50
,"Sales Receipt","11-03-2024","2056",,"Nasib Wholesallers","Zelia Bleach 500ML","Income","Zelia Bleach",,"Undeposited Funds","",2112.00,69638.50
,"Sales Receipt","13-03-2024","2058",,"Cash Sales","Zelia Bleach 750ML","Income","Zelia Bleach",,"Undeposited Funds","",110.00,69748.50
,"Sales Receipt","13-03-2024","2059",,"Cash Sales","Zelia Bleach 750ML","Income","Zelia Bleach",,"Undeposited Funds","",135.00,69883.50
,"Sales Receipt","14-03-2024","2063",,"Cash Sales","Zelia Bleach 750ML","Income","Zelia Bleach",,"Undeposited Funds","",135.00,70018.50
,"Sales Receipt","14-03-2024","2065",,"Cash Sales","Zelia Bleach 750ML","Income","Zelia Bleach",,"Undeposited Funds","",118.00,70136.50
,"Sales Receipt","14-03-2024","2067",,"Nzurimart wholesale","Zelia Bleach 750ML","Income","Zelia Bleach",,"Undeposited Funds","",123.00,70259.50
,"Sales Receipt","18-03-2024","2074",,"Cash Sales","Zelia Bleach 5L","Income","Zelia Bleach",,"Undeposited Funds","",700.00,70959.50
,"Invoice","19-03-2024","MC05502",,"Tupo Mart Limited","Zelia Bleach 500ML","Income","Zelia Bleach",,"Accounts Receivable","",527.59,71487.09
,"Invoice","20-03-2024","MC05507",,"DAILY CHAMPIONS MINI SUPERMARKET LIMITED","Zelia Bleach 500ML","Income","Zelia Bleach",,"Accounts Receivable","",527.59,72014.68
,"Sales Receipt","20-03-2024","2083",,"Cash Sales","Zelia Bleach 5L","Income","Zelia Bleach",,"Undeposited Funds","",800.00,72814.68
,"Sales Receipt","20-03-2024","2087",,"Pambazuka Mart (K) Limited","-MULTIPLE-","Income","Zelia Bleach",,"Undeposited Funds","",3588.00,76402.68
,"Sales Receipt","20-03-2024","2093",,"Cash Sales","Zelia Bleach 750ML","Income","Zelia Bleach",,"Undeposited Funds","",193.00,76595.68
,"Sales Receipt","21-03-2024","2092",,"Norham Groceries","Zelia Bleach 500ML","Income","Zelia Bleach",,"Undeposited Funds","",528.00,77123.68
,"Sales Receipt","21-03-2024","2101",,"Raymart Minimart","Zelia Bleach 500ML","Income","Zelia Bleach",,"Undeposited Funds","",264.00,77387.68
,"Sales Receipt","25-03-2024","2099",,"Cash Sales","Zelia Bleach 750ML","Income","Zelia Bleach",,"Undeposited Funds",0.00,"",77387.68
,"Sales Receipt","26-03-2024","2108",,"Cash Sales","Zelia Bleach 5L","Income","Zelia Bleach",,"Undeposited Funds","",700.00,78087.68
,"Sales Receipt","28-03-2024","2118",,"Cash Sales","Zelia Bleach 750ML","Income","Zelia Bleach",,"Undeposited Funds","",150.00,78237.68
,"Sales Receipt","28-03-2024","2127",,"Cash Sales","Zelia Bleach 500ML","Income","Zelia Bleach",,"Undeposited Funds",0.00,"",78237.68
,"Sales Receipt","28-03-2024","2129",,"Cash Sales","Zelia Bleach 5L","Income","Zelia Bleach",,"Undeposited Funds","",550.00,78787.68
,"Sales Receipt","02-04-2024","2132",,"Cash Sales","Zelia Bleach 5L","Income","Zelia Bleach",,"Undeposited Funds","",615.00,79402.68
,"Invoice","04-04-2024","MC05564",,"Azaavi Collections Limited","Zelia Bleach 750ML","Income","Zelia Bleach",,"Accounts Receivable","",120.69,79523.37
,"Sales Receipt","04-04-2024","2149",,"Cash Sales","Zelia Bleach 5L","Income","Zelia Bleach",,"Undeposited Funds","",550.00,80073.37
,"Sales Receipt","05-04-2024","2157",,"Cash Sales","Zelia Bleach 500ML","Income","Zelia Bleach",,"Undeposited Funds","",200.00,80273.37
,"Sales Receipt","05-04-2024","2161",,"Cash Sales","Zelia Bleach 500ML","Income","Zelia Bleach",,"Undeposited Funds","",110.00,80383.37
,"Sales Receipt","05-04-2024","AT 193",,"JUDY USENGE","Zelia Bleach 500ML","Income","Zelia Bleach",,"Undeposited Funds","",8448.00,88831.37
,"Sales Receipt","08-04-2024","2164",,"Kangundo Briolly Bookshop","Zelia Bleach 500ML","Income","Zelia Bleach",,"Undeposited Funds","",88.00,88919.37
,"Sales Receipt","08-04-2024","2165",,"Cash Sales","Zelia Bleach 5L","Income","Zelia Bleach",,"Undeposited Funds","",700.00,89619.37
,"Sales Receipt","08-04-2024","2166",,"Cash Sales","Zelia Bleach 750ML","Income","Zelia Bleach",,"Undeposited Funds","",118.00,89737.37
,"Sales Receipt","11-04-2024","2173",,"Cash Sales","Zelia Bleach 5L","Income","Zelia Bleach",,"Undeposited Funds","",700.00,90437.37
,"Sales Receipt","11-04-2024","2205",,"Gure Yare Shop Nasra","-MULTIPLE-","Income","Zelia Bleach",,"Undeposited Funds","",3588.00,94025.37
,"Sales Receipt","12-04-2024","2175",,"Tekonstruct LTD","Zelia Bleach 5L","Income","Zelia Bleach",,"Undeposited Funds","",615.00,94640.37
,"Sales Receipt","12-04-2024","2176",,"Cash Sales","Zelia Bleach 5L","Income","Zelia Bleach",,"Undeposited Funds","",1230.00,95870.37
,"Sales Receipt","12-04-2024","2185",,"Mamken Minimart","-MULTIPLE-","Income","Zelia Bleach",,"Undeposited Funds","",1266.00,97136.37
,"Sales Receipt","12-04-2024","2186",,"Kandara minimart","-MULTIPLE-","Income","Zelia Bleach",,"Undeposited Funds","",1266.00,98402.37
,"Sales Receipt","15-04-2024","2189",,"Deep Store","Zelia Bleach 500ML","Income","Zelia Bleach",,"Undeposited Funds","",1056.00,99458.37
,"Sales Receipt","15-04-2024","2190",,"Cash Sales","Zelia Bleach 500ML","Income","Zelia Bleach",,"Undeposited Funds","",150.00,99608.37
,"Sales Receipt","15-04-2024","2191",,"Cash Sales","Zelia Bleach 5L","Income","Zelia Bleach",,"Undeposited Funds","",700.00,100308.37
,"Sales Receipt","15-04-2024","2193",,"Diaspora Diaries","Zelia Bleach 750ML","Income","Zelia Bleach",,"Undeposited Funds","",246.00,100554.37
,"Sales Receipt","15-04-2024","2200",,"Cash Sales","Zelia Bleach 500ML","Income","Zelia Bleach",,"Undeposited Funds","",110.00,100664.37
,"Sales Receipt","17-04-2024","2215",,"Best Ratino Stores","Zelia Bleach 5L","Income","Zelia Bleach",,"Undeposited Funds","",2460.00,103124.37
,"Sales Receipt","17-04-2024","2218",,"Maida Minimart","Zelia Bleach 500ML","Income","Zelia Bleach",,"Undeposited Funds","",264.00,103388.37
,"Invoice","19-04-2024","MC05610",,"DISII TRADERS LTD","Zelia Bleach 500ML","Income","Zelia Bleach",,"Accounts Receivable","",1055.17,104443.54
,"Sales Receipt","19-04-2024","2231",,"Cash Sales","Zelia Bleach 500ML","Income","Zelia Bleach",,"Undeposited Funds","",158.00,104601.54
,"Sales Receipt","19-04-2024","2236",,"Restoration Traders","-MULTIPLE-","Income","Zelia Bleach",,"Undeposited Funds","",2532.00,107133.54
,"Invoice","22-04-2024","MC05622",,"KASAMAT INVESTMENTS LTD","Zelia Bleach 500ML","Income","Zelia Bleach",,"Accounts Receivable","",351.73,107485.27
,"Sales Receipt","23-04-2024","2251",,"Cash Sales","Zelia Bleach 500ML","Income","Zelia Bleach",,"Undeposited Funds","",100.00,107585.27
,"Invoice","24-04-2024","MC05630",,"Mumsha Supamat","Zelia Bleach 500ML","Income","Zelia Bleach",,"Accounts Receivable","",522.41,108107.68
,"Invoice","24-04-2024","MC05636",,"Maji Asili Limited","-MULTIPLE-","Income","Zelia Bleach",,"Accounts Receivable","",3589.66,111697.34
,"Sales Receipt","24-04-2024","2259",,"Muleshe Wholesallers","Zelia Bleach 500ML","Income","Zelia Bleach",,"Undeposited Funds","",1056.00,112753.34
,"Sales Receipt","25-04-2024","2268",,"Mama Amina","Zelia Bleach 750ML","Income","Zelia Bleach",,"Undeposited Funds","",738.00,113491.34
,"Sales Receipt","26-04-2024","2270",,"Cash Sales","Zelia Bleach 5L","Income","Zelia Bleach",,"Undeposited Funds","",700.00,114191.34
,"Sales Receipt","29-04-2024","2273",,"Blessed Shop","Zelia Bleach 750ML","Income","Zelia Bleach",,"Undeposited Funds","",123.00,114314.34
,"Sales Receipt","29-04-2024","2275",,"Cash Sales","Zelia Bleach 750ML","Income","Zelia Bleach",,"Undeposited Funds","",118.00,114432.34
,"Credit Note","29-04-2024","CN01059",,"TAWALA SUPERMARKET LIMITED","Zelia Bleach 750ML","Income","Zelia Bleach",,"Accounts Receivable",1686.21,"",112746.13
,"Sales Receipt","29-04-2024","2280",,"Cash Sales","Zelia Bleach 750ML","Income","Zelia Bleach",,"Undeposited Funds","",110.00,112856.13
,"Invoice","30-04-2024","MC05652",,"OFFSHORE GLOBAL LOGISTICS LIMITED","Zelia Bleach 5L","Income","Zelia Bleach",,"Accounts Receivable","",2237.07,115093.20
,"Sales Receipt","30-04-2024","2283",,"Cash Sales","Zelia Bleach 750ML","Income","Zelia Bleach",,"Undeposited Funds","",110.00,115203.20
,"Sales Receipt","02-05-2024","2287",,"5pm Hotel","Zelia Bleach 500ML","Income","Zelia Bleach",,"Undeposited Funds","",77.19,115280.39
,"Sales Receipt","02-05-2024","2290",,"Mama Amina","Zelia Bleach 500ML","Income","Zelia Bleach",,"Undeposited Funds","",528.00,115808.39
,"Sales Receipt","02-05-2024","2296",,"Tawakal Wholesale Eastleigh","Zelia Bleach 500ML","Income","Zelia Bleach",,"Undeposited Funds","",2112.00,117920.39
,"Sales Receipt","03-05-2024","2303",,"Cash Sales","Zelia Bleach 750ML","Income","Zelia Bleach",,"Undeposited Funds","",110.00,118030.39
,"Sales Receipt","05-05-2024","2308",,"Cash Sales","Zelia Bleach 750ML","Income","Zelia Bleach",,"Undeposited Funds","",150.00,118180.39
,"Sales Receipt","07-05-2024","2316",,"Cash Sales","Zelia Bleach 750ML","Income","Zelia Bleach",,"Undeposited Funds","",948.00,119128.39
,"Sales Receipt","08-05-2024","2321",,"Cash Sales","Zelia Bleach 500ML","Income","Zelia Bleach",,"Undeposited Funds","",100.00,119228.39
,"Sales Receipt","08-05-2024","2323",,"Cash Sales","Zelia Bleach 5L","Income","Zelia Bleach",,"Undeposited Funds","",750.00,119978.39
,"Sales Receipt","10-05-2024","1918",,"Cash Sales","Zelia Bleach 750ML","Income","Zelia Bleach",,"Undeposited Funds","",280.00,120258.39
,"Sales Receipt","13-05-2024","2344",,"Cash Sales","Zelia Bleach 500ML","Income","Zelia Bleach",,"Undeposited Funds","",1056.00,121314.39
,"Sales Receipt","13-05-2024","2346",,"Garumo Wholesallers","Zelia Bleach 500ML","Income","Zelia Bleach",,"Undeposited Funds","",2112.00,123426.39
,"Sales Receipt","13-05-2024","2356",,"The Hub Minimart","-MULTIPLE-","Income","Zelia Bleach",,"Undeposited Funds","",1794.00,125220.39
,"Sales Receipt","13-05-2024","1920",,"Cash Sales","Zelia Bleach 750ML","Income","Zelia Bleach",,"Undeposited Funds","",110.00,125330.39
,"Sales Receipt","13-05-2024","1924",,"Cash Sales","Zelia Bleach 750ML","Income","Zelia Bleach",,"Undeposited Funds","",110.00,125440.39
,"Sales Receipt","14-05-2024","2355",,"Beraccah Wholesallers","Zelia Bleach 500ML","Income","Zelia Bleach",,"Undeposited Funds","",1056.00,126496.39
,"Sales Receipt","16-05-2024","2370",,"Imani General Store","Zelia Bleach 500ML","Income","Zelia Bleach",,"Undeposited Funds","",528.00,127024.39
,"Sales Receipt","16-05-2024","1930",,"Cash Sales","Zelia Bleach 5L","Income","Zelia Bleach",,"Undeposited Funds","",700.00,127724.39
,"Sales Receipt","17-05-2024","1934",,"Cash Sales","Zelia Bleach 750ML","Income","Zelia Bleach",,"Undeposited Funds","",110.00,127834.39
,"Sales Receipt","20-05-2024","1939",,"Nuclear Supermarket","Zelia Bleach 500ML","Income","Zelia Bleach",,"Undeposited Funds","",528.00,128362.39
,"Sales Receipt","22-05-2024","1952",,"Cash Sales","Zelia Bleach 5L","Income","Zelia Bleach",,"Undeposited Funds","",700.00,129062.39
,"Sales Receipt","23-05-2024","1955",,"Cash Sales","Zelia Bleach 750ML","Income","Zelia Bleach",,"Undeposited Funds","",110.00,129172.39
,"Sales Receipt","23-05-2024","1963",,"Safa Shop","Zelia Bleach 500ML","Income","Zelia Bleach",,"Undeposited Funds","",1056.00,130228.39
,"Sales Receipt","24-05-2024","2381",,"Cash Sales","Zelia Bleach 5L","Income","Zelia Bleach",,"Undeposited Funds","",700.00,130928.39
,"Invoice","28-05-2024","MC05765",,"TAWALA SUPERMARKET LIMITED","Zelia Bleach 500ML","Income","Zelia Bleach",,"Accounts Receivable","",1055.17,131983.56
,"Sales Receipt","28-05-2024","2389",,"Restoration Traders","-MULTIPLE-","Income","Zelia Bleach",,"Undeposited Funds","",3588.00,135571.56
,"Sales Receipt","29-05-2024","2390",,"Cash Sales","Zelia Bleach 750ML","Income","Zelia Bleach",,"Undeposited Funds","",220.00,135791.56
,"Sales Receipt","29-05-2024","1971",,"Freshfinds Wholesale","-MULTIPLE-","Income","Zelia Bleach",,"Undeposited Funds","",1266.00,137057.56
,"Invoice","30-05-2024","MC05776",,"OFFSHORE GLOBAL LOGISTICS LIMITED","Zelia Bleach 5L","Income","Zelia Bleach",,"Accounts Receivable","",1491.38,138548.94
,"Sales Receipt","31-05-2024","1975",,"Cash Sales","Zelia Bleach 750ML","Income","Zelia Bleach",,"Undeposited Funds","",118.00,138666.94
,"Sales Receipt","31-05-2024","1976",,"Cash Sales","Zelia Bleach 750ML","Income","Zelia Bleach",,"Undeposited Funds",0.00,"",138666.94
,"Sales Receipt","03-06-2024","2399",,"Cash Sales","Zelia Bleach 750ML","Income","Zelia Bleach",,"Undeposited Funds","",109.00,138775.94
,"Sales Receipt","03-06-2024","1975",,"Cash Sales","Zelia Bleach 750ML","Income","Zelia Bleach",,"Undeposited Funds","",118.00,138893.94
,"Sales Receipt","03-06-2024","1983",,"Marris Mini mart","Zelia Bleach 500ML","Income","Zelia Bleach",,"Undeposited Funds","",528.00,139421.94
,"Sales Receipt","04-06-2024","1985",,"Cash Sales","Zelia Bleach 5L","Income","Zelia Bleach",,"Undeposited Funds","",800.00,140221.94
,"Sales Receipt","04-06-2024","2742",,"Arwa Wholesale","-MULTIPLE-","Income","Zelia Bleach",,"Undeposited Funds","",1794.00,142015.94
,"Sales Receipt","05-06-2024","1989",,"Cash Sales","Zelia Bleach 750ML","Income","Zelia Bleach",,"Undeposited Funds","",110.00,142125.94
,"Sales Receipt","07-06-2024","1996",,"Cash Sales","Zelia Bleach 500ML","Income","Zelia Bleach",,"Undeposited Funds","",312.00,142437.94
,"Sales Receipt","07-06-2024","2426",,"Cash Sales","Zelia Bleach 5L","Income","Zelia Bleach",,"Undeposited Funds","",750.00,143187.94
,"Sales Receipt","10-06-2024","1997",,"Cash Sales","Zelia Bleach 750ML","Income","Zelia Bleach",,"Undeposited Funds","",110.00,143297.94
,"Sales Receipt","10-06-2024","2434",,"Cash Sales","Zelia Bleach 5L","Income","Zelia Bleach",,"Undeposited Funds","",700.00,143997.94
,"Invoice","11-06-2024","MC05815",,"MADINA SUPERMARKET LIMITED","Zelia Bleach 500ML","Income","Zelia Bleach",,"Accounts Receivable","",579.31,144577.25
,"Sales Receipt","11-06-2024","2440",,"Cash Sales","Zelia Bleach 750ML","Income","Zelia Bleach",,"Undeposited Funds","",150.00,144727.25
,"Sales Receipt","11-06-2024","2442",,"Cash Sales","Zelia Bleach 5L","Income","Zelia Bleach",,"Undeposited Funds","",700.00,145427.25
,"Sales Receipt","12-06-2024","2451",,"Cash Sales","Zelia Bleach 5L","Income","Zelia Bleach",,"Undeposited Funds","",800.00,146227.25
,"Sales Receipt","12-06-2024","2453",,"Cash Sales","-MULTIPLE-","Income","Zelia Bleach",,"Undeposited Funds","",4600.00,150827.25
,"Sales Receipt","12-06-2024","2461",,"Cash Sales","Zelia Bleach 750ML","Income","Zelia Bleach",,"Undeposited Funds","",110.00,150937.25
,"Sales Receipt","12-06-2024","2462",,"Mama Amina","Zelia Bleach 500ML","Income","Zelia Bleach",,"Undeposited Funds","",1056.00,151993.25
,"Sales Receipt","13-06-2024","2471",,"Cash Sales","Zelia Bleach 5L","Income","Zelia Bleach",,"Undeposited Funds","",1230.00,153223.25
,"Sales Receipt","13-06-2024","2472",,"Cash Sales","Zelia Bleach 750ML","Income","Zelia Bleach",,"Undeposited Funds","",110.00,153333.25
,"Sales Receipt","13-06-2024","2473",,"Horn of Africa","Zelia Bleach 500ML","Income","Zelia Bleach",,"Undeposited Funds","",1056.00,154389.25
,"Sales Receipt","14-06-2024","2476",,"Cash Sales","Zelia Bleach 500ML","Income","Zelia Bleach",,"Undeposited Funds","",90.00,154479.25
,"Sales Receipt","14-06-2024","2477",,"Cash Sales","Zelia Bleach 750ML","Income","Zelia Bleach",,"Undeposited Funds","",440.00,154919.25
,"Sales Receipt","14-06-2024","2481",,"Cash Sales","Zelia Bleach 500ML","Income","Zelia Bleach",,"Undeposited Funds","",100.00,155019.25
,"Sales Receipt","19-06-2024","2484",,"Cash Sales","Zelia Bleach 750ML","Income","Zelia Bleach",,"Undeposited Funds","",300.00,155319.25
,"Invoice","20-06-2024","MC05842",,"HOPEMART SELF SERVICES LTD","Zelia Bleach 500ML","Income","Zelia Bleach",,"Accounts Receivable","",1055.17,156374.42
,"Sales Receipt","20-06-2024","2493",,"Cash Sales","Zelia Bleach 500ML","Income","Zelia Bleach",,"Undeposited Funds",0.00,"",156374.42
,"Sales Receipt","20-06-2024","AT197",,"Cash Sales","Zelia Bleach 500ML","Income","Zelia Bleach",,"Undeposited Funds","",1423.68,157798.10
,"Sales Receipt","20-06-2024","AT198",,"Cash Sales","Zelia Bleach 750ML","Income","Zelia Bleach",,"Undeposited Funds","",1830.48,159628.58
,"Sales Receipt","20-06-2024","2498",,"Mamken Minimart","-MULTIPLE-","Income","Zelia Bleach",,"Undeposited Funds","",3588.00,163216.58
,"Sales Receipt","21-06-2024","2716",,"Cash Sales","Zelia Bleach 5L","Income","Zelia Bleach",,"Undeposited Funds","",700.00,163916.58
,"Sales Receipt","21-06-2024","2722",,"Kika Mart","Zelia Bleach 500ML","Income","Zelia Bleach",,"Undeposited Funds","",1056.00,164972.58
,"Sales Receipt","22-06-2024","2131",,"Ekai moke wholesale","-MULTIPLE-","Income","Zelia Bleach",,"Undeposited Funds","",1266.00,166238.58
,"Sales Receipt","24-06-2024","8960",,"Pambazuka Mart (K) Limited","Zelia Bleach 750ML","Income","Zelia Bleach",,"Undeposited Funds","",1416.00,167654.58
,"Invoice","26-06-2024","MC05863",,"Tupo Mart Limited","Zelia Bleach 500ML","Income","Zelia Bleach",,"Accounts Receivable","",527.59,168182.17
,"Invoice","26-06-2024","MC05865",,"KASAMAT INVESTMENTS LTD","Zelia Bleach 500ML","Income","Zelia Bleach",,"Accounts Receivable","",527.59,168709.76
,"Sales Receipt","26-06-2024","2732",,"Instanbul Shop","Zelia Bleach 500ML","Income","Zelia Bleach",,"Undeposited Funds","",528.00,169237.76
,"Sales Receipt","01-07-2024","2750",,"Adurus Wholesallers","Zelia Bleach 750ML","Income","Zelia Bleach",,"Undeposited Funds","",738.00,169975.76
,"Sales Receipt","02-07-2024","2758",,"Cash Sales","Zelia Bleach 5L","Income","Zelia Bleach",,"Undeposited Funds","",700.00,170675.76
,"Sales Receipt","02-07-2024","2760",,"Cash Sales","Zelia Bleach 750ML","Income","Zelia Bleach",,"Undeposited Funds","",110.00,170785.76
,"Sales Receipt","02-07-2024","2762",,"Maida Minimart","Zelia Bleach 500ML","Income","Zelia Bleach",,"Undeposited Funds","",528.00,171313.76
,"Sales Receipt","03-07-2024","2763",,"Cash Sales","Zelia Bleach 5L","Income","Zelia Bleach",,"Undeposited Funds","",2800.00,174113.76
,"Sales Receipt","03-07-2024","2767",,"Cash Sales","Zelia Bleach 750ML","Income","Zelia Bleach",,"Undeposited Funds","",110.00,174223.76
,"Sales Receipt","03-07-2024","2773",,"Muleshe Wholesallers","Zelia Bleach 5L","Income","Zelia Bleach",,"Undeposited Funds","",3690.00,177913.76
,"Sales Receipt","04-07-2024","2784",,"Cash Sales","Zelia Bleach 750ML","Income","Zelia Bleach",,"Undeposited Funds","",110.00,178023.76
,"Sales Receipt","04-07-2024","2785",,"Cash Sales","Zelia Bleach 5L","Income","Zelia Bleach",,"Undeposited Funds","",700.00,178723.76
,"Sales Receipt","04-07-2024","2786",,"Cash Sales","Zelia Bleach 5L","Income","Zelia Bleach",,"Undeposited Funds","",700.00,179423.76
,"Sales Receipt","04-07-2024","2787",,"Cash Sales","Zelia Bleach 750ML","Income","Zelia Bleach",,"Undeposited Funds",0.00,"",179423.76
,"Sales Receipt","04-07-2024","2788",,"Cash Sales","Zelia Bleach 750ML","Income","Zelia Bleach",,"Undeposited Funds","",110.00,179533.76
,"Sales Receipt","05-07-2024","2791",,"Cash Sales","Zelia Bleach 5L","Income","Zelia Bleach",,"Undeposited Funds","",800.00,180333.76
,"Sales Receipt","05-07-2024","2797",,"Afro Drip LTD","Zelia Bleach 5L","Income","Zelia Bleach",,"Undeposited Funds","",615.00,180948.76
,"Sales Receipt","06-07-2024","2502",,"Cash Sales","Zelia Bleach 5L","Income","Zelia Bleach",,"Undeposited Funds","",700.00,181648.76
,"Sales Receipt","08-07-2024","2504",,"Cash Sales","Zelia Bleach 5L","Income","Zelia Bleach",,"Undeposited Funds","",700.00,182348.76
,"Sales Receipt","08-07-2024","2520",,"Brightfood Nasra","Zelia Bleach 500ML","Income","Zelia Bleach",,"Undeposited Funds","",264.00,182612.76
,"Sales Receipt","09-07-2024","2508",,"Cash Sales","Zelia Bleach 5L","Income","Zelia Bleach",,"Undeposited Funds","",700.00,183312.76
,"Sales Receipt","09-07-2024","2509",,"Cash Sales","Zelia Bleach 5L","Income","Zelia Bleach",,"Undeposited Funds","",700.00,184012.76
,"Sales Receipt","09-07-2024","2510",,"Cash Sales","Zelia Bleach 750ML","Income","Zelia Bleach",,"Undeposited Funds","",160.00,184172.76
,"Sales Receipt","09-07-2024","2523",,"Mama Amina","Zelia Bleach 500ML","Income","Zelia Bleach",,"Undeposited Funds","",1056.00,185228.76
,"Sales Receipt","12-07-2024","2537",,"Cash Sales","Zelia Bleach 500ML","Income","Zelia Bleach",,"Undeposited Funds","",348.00,185576.76
,"Sales Receipt","12-07-2024","2547",,"Farmwell Enterprises","Zelia Bleach 500ML","Income","Zelia Bleach",,"Undeposited Funds","",528.00,186104.76
,"Sales Receipt","13-07-2024","2654",,"Damim Mart","Zelia Bleach 500ML","Income","Zelia Bleach",,"Undeposited Funds","",528.00,186632.76
,"Invoice","15-07-2024","MC05924",,"Azaavi Collections Limited","Zelia Bleach 750ML","Income","Zelia Bleach",,"Accounts Receivable","",118.00,186750.76
,"Sales Receipt","15-07-2024","2543",,"Cash Sales","Zelia Bleach 750ML","Income","Zelia Bleach",,"Undeposited Funds","",220.00,186970.76
,"Sales Receipt","16-07-2024","2550",,"Summer Outlets","Zelia Bleach 500ML","Income","Zelia Bleach",,"Undeposited Funds","",528.00,187498.76
,"Sales Receipt","17-07-2024","2562",,"Fresh Finds Mart","Zelia Bleach 750ML","Income","Zelia Bleach",,"Undeposited Funds","",738.00,188236.76
,"Sales Receipt","20-07-2024","2578",,"Horn of Africa","-MULTIPLE-","Income","Zelia Bleach",,"Undeposited Funds","",2532.00,190768.76
,"Sales Receipt","23-07-2024","2582",,"Cash Sales","Zelia Bleach 500ML","Income","Zelia Bleach",,"Undeposited Funds","",79.00,190847.76
,"Sales Receipt","23-07-2024","2591",,"Cash Sales","Zelia Bleach 5L","Income","Zelia Bleach",,"Undeposited Funds","",800.00,191647.76
,"Sales Receipt","23-07-2024","2581",,"Cash Sales","Zelia Bleach 500ML","Income","Zelia Bleach",,"Undeposited Funds",0.00,"",191647.76
,"Sales Receipt","24-07-2024","2587",,"Cash Sales","Zelia Bleach 750ML","Income","Zelia Bleach",,"Undeposited Funds",0.00,"",191647.76
,"Sales Receipt","24-07-2024","2608",,"Capital Halal","Zelia Bleach 500ML","Income","Zelia Bleach",,"Undeposited Funds","",528.00,192175.76
,"Sales Receipt","25-07-2024","2592",,"Cash Sales","Zelia Bleach 5L","Income","Zelia Bleach",,"Undeposited Funds","",700.00,192875.76
,"Sales Receipt","25-07-2024","2594",,"Cash Sales","Zelia Bleach 750ML","Income","Zelia Bleach",,"Undeposited Funds","",110.00,192985.76
,"Sales Receipt","26-07-2024","2690",,"Amani Store","Zelia Bleach 500ML","Income","Zelia Bleach",,"Undeposited Funds","",1056.00,194041.76
,"Invoice","29-07-2024","MC05984",,"Mumsha Supamat","Zelia Bleach 750ML","Income","Zelia Bleach",,"Accounts Receivable","",739.66,194781.42
,"Sales Receipt","29-07-2024","2602",,"Cash Sales","Zelia Bleach 500ML","Income","Zelia Bleach",,"Undeposited Funds",0.00,"",194781.42
,"Sales Receipt","30-07-2024","2619",,"Cash Sales","Zelia Bleach 750ML","Income","Zelia Bleach",,"Undeposited Funds","",118.00,194899.42
,"Sales Receipt","30-07-2024","2620",,"Cash Sales","Zelia Bleach 750ML","Income","Zelia Bleach",,"Undeposited Funds","",236.00,195135.42
,"Sales Receipt","30-07-2024","2623",,"Smart Choice","-MULTIPLE-","Income","Zelia Bleach",,"Undeposited Funds","",2004.00,197139.42
,"Sales Receipt","30-07-2024","2627",,"Elliane Wholesalers","Zelia Bleach 500ML","Income","Zelia Bleach",,"Undeposited Funds","",528.00,197667.42
,"Sales Receipt","30-07-2024","2626",,"Nzuri Supermarket","Zelia Bleach 500ML","Income","Zelia Bleach",,"Undeposited Funds","",264.00,197931.42
,"Sales Receipt","30-07-2024","2689",,"Mt Kenya  mart","Zelia Bleach 500ML","Income","Zelia Bleach",,"Undeposited Funds","",528.00,198459.42
,"Sales Receipt","02-08-2024","2644",,"Cash Sales","Zelia Bleach 750ML","Income","Zelia Bleach",,"Undeposited Funds","",118.00,198577.42
,"Sales Receipt","02-08-2024","2647",,"Cash Sales","Zelia Bleach 500ML","Income","Zelia Bleach",,"Undeposited Funds","",78.00,198655.42
,"Sales Receipt","02-08-2024","2648",,"Cash Sales","Zelia Bleach 500ML","Income","Zelia Bleach",,"Undeposited Funds","",78.00,198733.42
,"Sales Receipt","02-08-2024","2650",,"Cash Sales","Zelia Bleach 500ML","Income","Zelia Bleach",,"Undeposited Funds","",234.00,198967.42
,"Sales Receipt","02-08-2024","2666",,"Mama Amina","-MULTIPLE-","Income","Zelia Bleach",,"Undeposited Funds","",2532.00,201499.42
,"Sales Receipt","03-08-2024","2669",,"Kilimanjaro Store","Zelia Bleach 500ML","Income","Zelia Bleach",,"Undeposited Funds","",2112.00,203611.42
,"Sales Receipt","06-08-2024","2659",,"Cash Sales","Zelia Bleach 5L","Income","Zelia Bleach",,"Undeposited Funds","",800.00,204411.42
,"Sales Receipt","06-08-2024","2680",,"Juja Minimart","-MULTIPLE-","Income","Zelia Bleach",,"Undeposited Funds","",3588.00,207999.42
,"Sales Receipt","07-08-2024","828",,"B-Shop","-MULTIPLE-","Income","Zelia Bleach",,"Undeposited Funds","",7176.00,215175.42
,"Invoice","08-08-2024","MC06018",,"OFFSHORE GLOBAL LOGISTICS LIMITED","Zelia Bleach 5L","Income","Zelia Bleach",,"Accounts Receivable","",700.00,215875.42
,"Sales Receipt","09-08-2024","2699",,"Cash Sales","Zelia Bleach 500ML","Income","Zelia Bleach",,"Undeposited Funds","",75.00,215950.42
,"Invoice","12-08-2024","MC06031",,"KAVYA SUPERMARKET LIMITED","Zelia Bleach 750ML","Income","Zelia Bleach",,"Accounts Receivable","",1531.03,217481.45
,"Sales Receipt","12-08-2024","2807",,"Cash Sales","Zelia Bleach 5L","Income","Zelia Bleach",,"Undeposited Funds","",750.00,218231.45
,"Sales Receipt","12-08-2024","2813",,"Mamken Minimart","Zelia Bleach 500ML","Income","Zelia Bleach",,"Undeposited Funds","",528.00,218759.45
,"Sales Receipt","12-08-2024","2815",,"Kibibi Wasai Store","Zelia Bleach 500ML","Income","Zelia Bleach",,"Undeposited Funds","",2112.00,220871.45
,"Sales Receipt","13-08-2024","2820",,"Cash Sales","Zelia Bleach 5L","Income","Zelia Bleach",,"Undeposited Funds","",569.00,221440.45
,"Sales Receipt","14-08-2024","2821",,"Cash Sales","Zelia Bleach 5L","Income","Zelia Bleach",,"Undeposited Funds","",1500.00,222940.45
,"Sales Receipt","14-08-2024","2823",,"Cash Sales","Zelia Bleach 500ML","Income","Zelia Bleach",,"Undeposited Funds","",231.00,223171.45
,"Sales Receipt","14-08-2024","2847",,"Memos Supermarket","-MULTIPLE-","Income","Zelia Bleach",,"Undeposited Funds","",3588.00,226759.45
,"Sales Receipt","15-08-2024","2824",,"Cash Sales","Zelia Bleach 5L","Income","Zelia Bleach",,"Undeposited Funds","",1136.00,227895.45
,"Sales Receipt","16-08-2024","2901",,"Cash Sales","Zelia Bleach 750ML","Income","Zelia Bleach",,"Undeposited Funds","",106.00,228001.45
,"Sales Receipt","16-08-2024","2850",,"Hawkers Paradise","Zelia Bleach 5L","Income","Zelia Bleach",,"Undeposited Funds","",615.00,228616.45
,"Sales Receipt","16-08-2024","2851",,"Tahila Enterprises","-MULTIPLE-","Income","Zelia Bleach",,"Undeposited Funds","",422.00,229038.45
,"Sales Receipt","17-08-2024","2843",,"Horn of Africa","-MULTIPLE-","Income","Zelia Bleach",,"Undeposited Funds","",2532.00,231570.45
,"Invoice","19-08-2024","MC06050",,"Azaavi Collections Limited","Zelia Bleach 750ML","Income","Zelia Bleach",,"Accounts Receivable","",118.00,231688.45
,"Sales Receipt","19-08-2024","2836",,"Cash Sales","Zelia Bleach 750ML","Income","Zelia Bleach",,"Undeposited Funds","",118.00,231806.45
,"Sales Receipt","20-08-2024","2857",,"Nuclear Supermarket","-MULTIPLE-","Income","Zelia Bleach",,"Undeposited Funds","",1266.00,233072.45
,"Sales Receipt","20-08-2024","2869",,"Soft Landing","Zelia Bleach 750ML","Income","Zelia Bleach",,"Undeposited Funds","",266.00,233338.45
,"Invoice","22-08-2024","MC06069",,"Mumsha Supamat","Zelia Bleach 500ML","Income","Zelia Bleach",,"Accounts Receivable","",543.10,233881.55
,"Sales Receipt","23-08-2024","2876",,"Cash Sales","Zelia Bleach 750ML","Income","Zelia Bleach",,"Undeposited Funds","",107.00,233988.55
,"Sales Receipt","23-08-2024","2877",,"Cash Sales","Zelia Bleach 750ML","Income","Zelia Bleach",,"Undeposited Funds","",110.00,234098.55
,"Sales Receipt","23-08-2024","2878",,"Cash Sales","Zelia Bleach 750ML","Income","Zelia Bleach",,"Undeposited Funds","",107.00,234205.55
,"Sales Receipt","26-08-2024","2883",,"Cash Sales","Zelia Bleach 750ML","Income","Zelia Bleach",,"Undeposited Funds","",300.00,234505.55
,"Sales Receipt","26-08-2024","2886",,"Cash Sales","Zelia Bleach 5L","Income","Zelia Bleach",,"Undeposited Funds","",1500.00,236005.55
,"Sales Receipt","26-08-2024","1207",,"Kemera Discount","Zelia Bleach 5L","Income","Zelia Bleach",,"Undeposited Funds","",615.00,236620.55
,"Sales Receipt","27-08-2024","2909",,"Horn of Africa","Zelia Bleach 500ML","Income","Zelia Bleach",,"Undeposited Funds","",2160.00,238780.55
,"Sales Receipt","02-09-2024","2916",,"Anne","Zelia Bleach 24X500ML","Income","Zelia Bleach",,"Undeposited Funds","",270.00,239050.55
,"Sales Receipt","02-09-2024","2923",,"Blossom Beauty","Zelia Bleach 24X500ML","Income","Zelia Bleach",,"Undeposited Funds","",540.00,239590.55
,"Sales Receipt","02-09-2024","2972",,"Muleshe Wholesallers","Zelia Bleach 4X5L","Income","Zelia Bleach",,"Undeposited Funds","",4920.00,244510.55
,"Sales Receipt","02-09-2024","3002",,"Cash Sales","Zelia Bleach 12X750ML","Income","Zelia Bleach",,"Undeposited Funds",0.00,"",244510.55
,"Sales Receipt","02-09-2024","3005",,"Cash Sales","Zelia Bleach 4X5L","Income","Zelia Bleach",,"Undeposited Funds","",750.00,245260.55
,"Sales Receipt","02-09-2024","3008",,"Cash Sales","Zelia Bleach 12X750ML","Income","Zelia Bleach",,"Undeposited Funds","",106.00,245366.55
,"Sales Receipt","02-09-2024","3010",,"Cash Sales","Zelia Bleach 24X500ML","Income","Zelia Bleach",,"Undeposited Funds","",77.01,245443.56
,"Sales Receipt","02-09-2024","3012",,"Cash Sales","Zelia Bleach 12X750ML","Income","Zelia Bleach",,"Undeposited Funds","",212.00,245655.56
,"Sales Receipt","02-09-2024","2921",,"Cash Sales","Zelia Bleach 12X750ML","Income","Zelia Bleach",,"Undeposited Funds","",110.00,245765.56
,"Invoice","04-09-2024","MC06108",,"PRICE CHOPPER STORES LIMITED","-MULTIPLE-","Income","Zelia Bleach",,"Accounts Receivable","",1282.75,247048.31
,"Sales Receipt","04-09-2024","2937",,"Restoration Traders","-MULTIPLE-","Income","Zelia Bleach",,"Undeposited Funds","",3636.00,250684.31
,"Sales Receipt","04-09-2024","2932",,"Cash Sales","Zelia Bleach 4X5L","Income","Zelia Bleach",,"Undeposited Funds","",750.00,251434.31
,"Sales Receipt","04-09-2024","2935",,"Cash Sales","Zelia Bleach 12X750ML","Income","Zelia Bleach",,"Undeposited Funds","",110.00,251544.31
,"Sales Receipt","05-09-2024","2950",,"Cash Sales","Zelia Bleach 24X500ML","Income","Zelia Bleach",,"Undeposited Funds","",234.00,251778.31
,"Sales Receipt","05-09-2024","2951",,"Cash Sales","Zelia Bleach 24X500ML","Income","Zelia Bleach",,"Undeposited Funds","",77.01,251855.32
,"Sales Receipt","06-09-2024","2957",,"Cash Sales","Zelia Bleach 12X750ML","Income","Zelia Bleach",,"Undeposited Funds","",106.00,251961.32
,"Sales Receipt","06-09-2024","2958",,"Cash Sales","Zelia Bleach 12X750ML","Income","Zelia Bleach",,"Undeposited Funds","",106.00,252067.32
,"Sales Receipt","09-09-2024","2964",,"Cash Sales","Zelia Bleach 12X750ML","Income","Zelia Bleach",,"Undeposited Funds","",107.00,252174.32
,"Sales Receipt","09-09-2024","2965",,"Cash Sales","Zelia Bleach 4X5L","Income","Zelia Bleach",,"Undeposited Funds","",750.00,252924.32
,"Sales Receipt","09-09-2024","2970",,"Cash Sales","Zelia Bleach 12X750ML","Income","Zelia Bleach",,"Undeposited Funds","",107.00,253031.32
,"Sales Receipt","10-09-2024","2983",,"Summer Outlets","Zelia Bleach 12X750ML","Income","Zelia Bleach",,"Undeposited Funds","",738.00,253769.32
,"Sales Receipt","10-09-2024","2990",,"Maida Minimart","-MULTIPLE-","Income","Zelia Bleach",,"Undeposited Funds","",1278.00,255047.32
,"Sales Receipt","10-09-2024","2973",,"Cash Sales","Zelia Bleach 12X750ML","Income","Zelia Bleach",,"Undeposited Funds","",149.99,255197.31
,"Sales Receipt","10-09-2024","2975",,"Cash Sales","Zelia Bleach 24X500ML","Income","Zelia Bleach",,"Undeposited Funds","",340.01,255537.32
,"Sales Receipt","10-09-2024","3015",,"Cash Sales","Zelia Bleach 12X750ML","Income","Zelia Bleach",,"Undeposited Funds","",139.99,255677.31
,"Sales Receipt","10-09-2024","3016",,"Cash Sales","Zelia Bleach 4X5L","Income","Zelia Bleach",,"Undeposited Funds","",750.00,256427.31
,"Sales Receipt","10-09-2024","3237",,"Cash Sales","Zelia Bleach 24X500ML","Income","Zelia Bleach",,"Undeposited Funds",0.00,"",256427.31
,"Sales Receipt","12-09-2024","2987",,"Cash Sales","Zelia Bleach 12X750ML","Income","Zelia Bleach",,"Undeposited Funds","",300.01,256727.32
,"Sales Receipt","13-09-2024","3101",,"Cash Sales","Zelia Bleach 12X750ML","Income","Zelia Bleach",,"Undeposited Funds","",107.00,256834.32
,"Sales Receipt","16-09-2024","3044",,"Afro Drip LTD","Zelia Bleach 4X5L","Income","Zelia Bleach",,"Undeposited Funds","",1230.00,258064.32
,"Sales Receipt","16-09-2024","3045",,"Afro Drip LTD Reception","Zelia Bleach 12X750ML","Income","Zelia Bleach",,"Undeposited Funds","",123.00,258187.32
,"Sales Receipt","18-09-2024","3060",,"Faisel Wholesalers","Zelia Bleach 4X5L","Income","Zelia Bleach",,"Undeposited Funds","",4920.00,263107.32
,"Sales Receipt","18-09-2024","3053",,"Cash Sales","Zelia Bleach 12X750ML","Income","Zelia Bleach",,"Undeposited Funds","",107.00,263214.32
,"Sales Receipt","18-09-2024","3056",,"Cash Sales","Zelia Bleach 12X750ML","Income","Zelia Bleach",,"Undeposited Funds","",149.99,263364.31
,"Invoice","20-09-2024","MC06179",,"OFFSHORE GLOBAL LOGISTICS LIMITED","Zelia Bleach 4X5L","Income","Zelia Bleach",,"Accounts Receivable","",1500.00,264864.31
,"Sales Receipt","20-09-2024","3068",,"Cash Sales","Zelia Bleach 12X750ML","Income","Zelia Bleach",,"Undeposited Funds","",105.00,264969.31
,"Sales Receipt","23-09-2024","3073",,"Cash Sales","Zelia Bleach 12X750ML","Income","Zelia Bleach",,"Undeposited Funds","",106.00,265075.31
,"Invoice","24-09-2024","MC06196",,"KASAMAT INVESTMENTS LTD","Zelia Bleach 24X500ML","Income","Zelia Bleach",,"Accounts Receivable","",543.10,265618.41
,"Sales Receipt","24-09-2024","3090",,"Elliane Wholesalers","Zelia Bleach 24X500ML","Income","Zelia Bleach",,"Undeposited Funds","",540.00,266158.41
,"Sales Receipt","24-09-2024","3078",,"Cash Sales","Zelia Bleach 4X5L","Income","Zelia Bleach",,"Undeposited Funds","",569.00,266727.41
,"Sales Receipt","24-09-2024","3079",,"Cash Sales","Zelia Bleach 4X5L","Income","Zelia Bleach",,"Undeposited Funds","",2276.00,269003.41
,"Sales Receipt","24-09-2024","3088",,"Cash Sales","Zelia Bleach 12X750ML","Income","Zelia Bleach",,"Undeposited Funds","",105.00,269108.41
,"Sales Receipt","24-09-2024","3089",,"Cash Sales","Zelia Bleach 24X500ML","Income","Zelia Bleach",,"Undeposited Funds","",80.01,269188.42
,"Sales Receipt","24-09-2024","3091",,"Cash Sales","Zelia Bleach 12X750ML","Income","Zelia Bleach",,"Undeposited Funds","",105.00,269293.42
,"Sales Receipt","25-09-2024","3202",,"Cash Sales","Zelia Bleach 12X750ML","Income","Zelia Bleach",,"Undeposited Funds","",105.00,269398.42
,"Invoice","26-09-2024","MC06205",,"OFFSHORE GLOBAL LOGISTICS LIMITED","Zelia Bleach 4X5L","Income","Zelia Bleach",,"Accounts Receivable","",1500.00,270898.42
,"Invoice","27-09-2024","MC06216",,"QUALITYMART SUPERMARKET LIMITED","-MULTIPLE-","Income","Zelia Bleach",,"Accounts Receivable","",1282.76,272181.18
,"Invoice","27-09-2024","MC06217",,"Mumsha Supamat","-MULTIPLE-","Income","Zelia Bleach",,"Accounts Receivable","",1282.76,273463.94
,"Sales Receipt","27-09-2024","3216",,"Cash Sales","Zelia Bleach 4X5L","Income","Zelia Bleach",,"Undeposited Funds","",1500.00,274963.94
,"Sales Receipt","01-10-2024","3217",,"Cash Sales","Zelia Bleach 4X5L","Income","Zelia Bleach",,"Undeposited Funds","",750.00,275713.94
,"Sales Receipt","02-10-2024","3232",,"Manzil Wholesalers","-MULTIPLE-","Income","Zelia Bleach",,"Undeposited Funds","",3636.00,279349.94
,"Sales Receipt","02-10-2024","3244",,"B-Shop","Zelia Bleach 24X500ML","Income","Zelia Bleach",,"Undeposited Funds","",7176.00,286525.94
,"Sales Receipt","03-10-2024","3240",,"Cash Sales","Zelia Bleach 4X5L","Income","Zelia Bleach",,"Undeposited Funds","",750.00,287275.94
,"Sales Receipt","03-10-2024","3243",,"Cash Sales","Zelia Bleach 12X750ML","Income","Zelia Bleach",,"Undeposited Funds","",110.00,287385.94
,"Sales Receipt","04-10-2024","3253",,"Cash Sales","Zelia Bleach 24X500ML","Income","Zelia Bleach",,"Undeposited Funds","",234.00,287619.94
,"Sales Receipt","07-10-2024","3288",,"Adurus Wholesallers","-MULTIPLE-","Income","Zelia Bleach",,"Undeposited Funds","",2556.00,290175.94
,"Sales Receipt","08-10-2024","3262",,"Cash Sales","Zelia Bleach 4X5L","Income","Zelia Bleach",,"Undeposited Funds","",1500.00,291675.94
,"Sales Receipt","08-10-2024","3264",,"Cash Sales","Zelia Bleach 4X5L","Income","Zelia Bleach",,"Undeposited Funds","",750.00,292425.94
,"Sales Receipt","08-10-2024","3268",,"Cash Sales","Zelia Bleach 4X5L","Income","Zelia Bleach",,"Undeposited Funds","",660.00,293085.94
,"Sales Receipt","09-10-2024","3275",,"Cash Sales","Zelia Bleach 4X5L","Income","Zelia Bleach",,"Undeposited Funds","",750.00,293835.94
,"Sales Receipt","09-10-2024","3276",,"Cash Sales","Zelia Bleach 24X500ML","Income","Zelia Bleach",,"Undeposited Funds",0.00,"",293835.94
,"Sales Receipt","09-10-2024","3279",,"Cash Sales","Zelia Bleach 12X750ML","Income","Zelia Bleach",,"Undeposited Funds","",120.00,293955.94
,"Sales Receipt","09-10-2024","3281",,"Cash Sales","Zelia Bleach 4X5L","Income","Zelia Bleach",,"Undeposited Funds","",750.00,294705.94
,"Sales Receipt","09-10-2024","3287",,"Baba Ali Shop","Zelia Bleach 24X500ML","Income","Zelia Bleach",,"Undeposited Funds","",1080.00,295785.94
,"Invoice","11-10-2024","MC06251",,"HOPEMART SELF SERVICES LTD","-MULTIPLE-","Income","Zelia Bleach",,"Accounts Receivable","",1818.00,297603.94
,"Sales Receipt","11-10-2024","3289",,"Cash Sales","Zelia Bleach 4X5L","Income","Zelia Bleach",,"Undeposited Funds","",750.00,298353.94
,"Sales Receipt","11-10-2024","3291",,"Cash Sales","Zelia Bleach 24X500ML","Income","Zelia Bleach",,"Undeposited Funds","",234.00,298587.94
,"Sales Receipt","11-10-2024","3296",,"Restoration Traders","Zelia Bleach 12X750ML","Income","Zelia Bleach",,"Undeposited Funds","",2952.00,301539.94
,"Sales Receipt","16-10-2024","3108",,"Cash Sales","Zelia Bleach 12X750ML","Income","Zelia Bleach",,"Undeposited Funds","",110.00,301649.94
,"Sales Receipt","16-10-2024","3109",,"Cash Sales","Zelia Bleach 12X750ML","Income","Zelia Bleach",,"Undeposited Funds","",300.01,301949.95
,"Invoice","17-10-2024","MC06269",,"MUHINDI MWEUSI SUPERMARKET LIMITED","-MULTIPLE-","Income","Zelia Bleach",,"Accounts Receivable","",2556.00,304505.95
,"Sales Receipt","18-10-2024","3123",,"Cash Sales","Zelia Bleach 24X500ML","Income","Zelia Bleach",,"Undeposited Funds","",78.01,304583.96
,"Sales Receipt","22-10-2024","3132",,"Hidika Shop","Zelia Bleach 24X500ML","Income","Zelia Bleach",,"Undeposited Funds","",1080.00,305663.96
,"Sales Receipt","23-10-2024","3137",,"Cash Sales","Zelia Bleach 4X5L","Income","Zelia Bleach",,"Undeposited Funds","",1600.00,307263.96
,"Sales Receipt","23-10-2024","3138",,"Cash Sales","Zelia Bleach 4X5L","Income","Zelia Bleach",,"Undeposited Funds","",750.00,308013.96
,"Sales Receipt","23-10-2024","3142",,"Cash Sales","Zelia Bleach 12X750ML","Income","Zelia Bleach",,"Undeposited Funds","",129.99,308143.95
,"Sales Receipt","23-10-2024","3144",,"Cash Sales","Zelia Bleach 4X5L","Income","Zelia Bleach",,"Undeposited Funds","",569.00,308712.95
,"Sales Receipt","23-10-2024","3141",,"Kibibi Wasai Store","-MULTIPLE-","Income","Zelia Bleach",,"Undeposited Funds","",8652.00,317364.95
,"Sales Receipt","24-10-2024","3147",,"Cash Sales","Zelia Bleach 12X750ML","Income","Zelia Bleach",,"Undeposited Funds","",300.01,317664.96
,"Invoice","25-10-2024","MC06300",,"HAPPY VIEW SUPERMARKET LIMITED","Zelia Bleach 24X500ML  6Pcs@105","Income","Zelia Bleach",,"Accounts Receivable","",543.10,318208.06
,"Sales Receipt","25-10-2024","3159",,"Marris Mini mart","Zelia Bleach 24X500ML","Income","Zelia Bleach",,"Undeposited Funds","",540.00,318748.06
,"Sales Receipt","25-10-2024","3157",,"Mamken Minimart","-MULTIPLE-","Income","Zelia Bleach",,"Undeposited Funds","",3588.00,322336.06
,"Sales Receipt","26-10-2024","3161",,"Cash Sales","Zelia Bleach 12X750ML","Income","Zelia Bleach",,"Undeposited Funds","",300.01,322636.07
,"Sales Receipt","26-10-2024","3162",,"Muleshe Wholesallers","-MULTIPLE-","Income","Zelia Bleach",,"Undeposited Funds","",9984.00,332620.07
,"Sales Receipt","29-10-2024","3169",,"Cash Sales","Zelia Bleach 12X750ML","Income","Zelia Bleach",,"Undeposited Funds","",107.00,332727.07
,"Invoice","30-10-2024","MC06322",,"OFFSHORE GLOBAL LOGISTICS LIMITED","Zelia Bleach 4X5L","Income","Zelia Bleach",,"Accounts Receivable","",700.00,333427.07
,"Sales Receipt","30-10-2024","3171",,"Cash Sales","Zelia Bleach 4X5L","Income","Zelia Bleach",,"Undeposited Funds","",750.00,334177.07
,"Sales Receipt","04-11-2024","3430",,"Mabini Minimart","Zelia Bleach 12X750ML","Income","Zelia Bleach",,"Undeposited Funds","",738.00,334915.07
,"Sales Receipt","04-11-2024","3708",,"Gure Yare Shop","-MULTIPLE-","Income","Zelia Bleach",,"Undeposited Funds","",5112.00,340027.07
,"Invoice","06-11-2024","MC06335",,"Guard Mart Supermarket Limited","-MULTIPLE-","Income","Zelia Bleach",,"Accounts Receivable","",225.00,340252.07
,"Sales Receipt","06-11-2024","3401",,"Cash Sales","Zelia Bleach 4X5L","Income","Zelia Bleach",,"Undeposited Funds","",1500.00,341752.07
,"Sales Receipt","06-11-2024","3402",,"Cash Sales","Zelia Bleach 24X500ML","Income","Zelia Bleach",,"Undeposited Funds","",90.01,341842.08
,"Sales Receipt","07-11-2024","3405",,"Cash Sales","Zelia Bleach 4X5L","Income","Zelia Bleach",,"Undeposited Funds","",750.00,342592.08
,"Sales Receipt","07-11-2024","3239",,"Cash Sales","Zelia Bleach 12X750ML","Income","Zelia Bleach",,"Undeposited Funds",0.00,"",342592.08
,"Sales Receipt","08-11-2024","3408",,"Cash Sales","Zelia Bleach 12X750ML","Income","Zelia Bleach",,"Undeposited Funds","",106.00,342698.08
,"Sales Receipt","08-11-2024","3411",,"Cash Sales","Zelia Bleach 12X750ML","Income","Zelia Bleach",,"Undeposited Funds","",106.00,342804.08
,"Sales Receipt","11-11-2024","3415",,"Cash Sales","Zelia Bleach 4X5L","Income","Zelia Bleach",,"Undeposited Funds","",1138.00,343942.08
,"Sales Receipt","11-11-2024","3456",,"RichMind Property","Zelia Bleach 4X5L","Income","Zelia Bleach",,"Undeposited Funds","",658.00,344600.08
,"Sales Receipt","12-11-2024","3431",,"Cash Sales","-MULTIPLE-","Income","Zelia Bleach",,"Undeposited Funds","",15600.00,360200.08
,"Sales Receipt","12-11-2024","3437",,"Jombs wholesalers","Zelia Bleach 12X750ML","Income","Zelia Bleach",,"Undeposited Funds","",369.00,360569.08
,"Invoice","13-11-2024","MC06356",,"Mumsha Supamat","Zelia Bleach 12X750ML  6Pieces@143","Income","Zelia Bleach",,"Accounts Receivable","",739.66,361308.74
,"Sales Receipt","13-11-2024","3434",,"Cash Sales","Zelia Bleach 4X5L","Income","Zelia Bleach",,"Undeposited Funds","",750.00,362058.74
,"Sales Receipt","15-11-2024","3448",,"Cash Sales","Zelia Bleach 4X5L","Income","Zelia Bleach",,"Undeposited Funds","",750.00,362808.74
,"Invoice","18-11-2024","MC06372",,"Guard Mart Supermarket Limited","-MULTIPLE-","Income","Zelia Bleach",,"Accounts Receivable","",3852.00,366660.74
,"Credit Note","18-11-2024","CN01073",,"Guard Mart Supermarket Limited","-MULTIPLE-","Income","Zelia Bleach",,"Accounts Receivable",225.00,"",366435.74
,"Sales Receipt","18-11-2024","3469",,"Cash Sales","Zelia Bleach 12X750ML","Income","Zelia Bleach",,"Undeposited Funds","",110.00,366545.74
,"Sales Receipt","18-11-2024","3473",,"Cash Sales","Zelia Bleach 24X500ML","Income","Zelia Bleach",,"Undeposited Funds",0.00,"",366545.74
,"Sales Receipt","20-11-2024","3476",,"Cash Sales","Zelia Bleach 24X500ML","Income","Zelia Bleach",,"Undeposited Funds",0.00,"",366545.74
,"Sales Receipt","22-11-2024","3484",,"Cash Sales","Zelia Bleach 4X5L","Income","Zelia Bleach",,"Undeposited Funds","",750.00,367295.74
,"Sales Receipt","22-11-2024","3489",,"Cash Sales","Zelia Bleach 4X5L","Income","Zelia Bleach",,"Undeposited Funds","",1500.00,368795.74
,"Sales Receipt","22-11-2024","3303",,"Cash Sales","Zelia Bleach 12X750ML","Income","Zelia Bleach",,"Undeposited Funds","",107.00,368902.74
,"Sales Receipt","26-11-2024","3740",,"Afrodrip JKIA","Zelia Bleach 4X5L","Income","Zelia Bleach",,"Undeposited Funds","",1316.00,370218.74
,"Sales Receipt","28-11-2024","3750",,"Cash Sales","Zelia Bleach 4X5L","Income","Zelia Bleach",,"Undeposited Funds","",1500.00,371718.74
,"Sales Receipt","28-11-2024","3751",,"Cash Sales","Zelia Bleach 4X5L","Income","Zelia Bleach",,"Undeposited Funds","",750.00,372468.74
,"Sales Receipt","29-11-2024","3754",,"Cash Sales","Zelia Bleach 12X750ML","Income","Zelia Bleach",,"Undeposited Funds","",135.00,372603.74
,"Sales Receipt","29-11-2024","3757",,"Cash Sales","Zelia Bleach 4X5L","Income","Zelia Bleach",,"Undeposited Funds","",570.00,373173.74
,"Sales Receipt","29-11-2024","3789",,"Ubwete Shop","-MULTIPLE-","Income","Zelia Bleach",,"Undeposited Funds","",2556.00,375729.74
,"Sales Receipt","02-12-2024","3772",,"Cash Sales","Zelia Bleach 24X500ML","Income","Zelia Bleach",,"Undeposited Funds","",86.00,375815.74
,"Sales Receipt","02-12-2024","3778",,"Cash Sales","Zelia Bleach 12X750ML","Income","Zelia Bleach",,"Undeposited Funds","",110.00,375925.74
,"Invoice","09-12-2024","MC06452",,"DISII TRADERS LTD","Zelia Bleach 24X500ML  6Pcs@104","Income","Zelia Bleach",,"Accounts Receivable","",537.93,376463.67
,"Sales Receipt","09-12-2024","3318",,"Cash Sales","Zelia Bleach 4X5L","Income","Zelia Bleach",,"Undeposited Funds","",672.00,377135.67
,"Sales Receipt","09-12-2024","3320",,"Cash Sales","Zelia Bleach 24X500ML","Income","Zelia Bleach",,"Undeposited Funds","",86.00,377221.67
,"Sales Receipt","11-12-2024","3333",,"Cash Sales","Zelia Bleach 12X750ML","Income","Zelia Bleach",,"Undeposited Funds","",214.00,377435.67
,"Sales Receipt","11-12-2024","3334",,"Cash Sales","Zelia Bleach 4X5L","Income","Zelia Bleach",,"Undeposited Funds","",750.00,378185.67
,"Sales Receipt","11-12-2024","3335",,"Cash Sales","Zelia Bleach 4X5L","Income","Zelia Bleach",,"Undeposited Funds","",569.00,378754.67
,"Sales Receipt","13-12-2024","3340",,"Cash Sales","Zelia Bleach 4X5L","Income","Zelia Bleach",,"Undeposited Funds","",800.00,379554.67
,"Sales Receipt","16-12-2024","3346",,"Cash Sales","Zelia Bleach 4X5L","Income","Zelia Bleach",,"Undeposited Funds","",3000.00,382554.67
,"Sales Receipt","16-12-2024","3348",,"Cash Sales","Zelia Bleach 4X5L","Income","Zelia Bleach",,"Undeposited Funds","",750.00,383304.67
,"Sales Receipt","16-12-2024","3353",,"Cash Sales","Zelia Bleach 4X5L","Income","Zelia Bleach",,"Undeposited Funds","",569.00,383873.67
,"Invoice","17-12-2024","MC06477",,"OFFSHORE GLOBAL LOGISTICS LIMITED","Zelia Bleach 4X5L","Income","Zelia Bleach",,"Accounts Receivable","",1400.00,385273.67
,"Sales Receipt","19-12-2024","3375",,"Cash Sales","Zelia Bleach 4X5L","Income","Zelia Bleach",,"Undeposited Funds","",1500.00,386773.67
,"Sales Receipt","20-12-2024","3376",,"Cash Sales","Zelia Bleach 4X5L","Income","Zelia Bleach",,"Undeposited Funds","",1500.00,388273.67
"Total Zelia Bleach",,,,,,,,,,,1911.21,390184.88,388273.67
"Zelia Carpet Cleaner",,,,,,,,,,,,,""
,"Sales Receipt","03-01-2024","1596",,"Cash Sales","Zelia Carpet Cleaner 5L","Income","Zelia Carpet Cleaner",,"Undeposited Funds",0.00,"",0.00
,"Sales Receipt","11-01-2024","1723",,"Cash Sales","Zelia Machine Wash 5L","Income","Zelia Carpet Cleaner",,"Undeposited Funds","",1500.00,1500.00
,"Sales Receipt","12-01-2024","1727",,"Cash Sales","Zelia Machine Wash 5L","Income","Zelia Carpet Cleaner",,"Undeposited Funds","",1500.00,3000.00
,"Sales Receipt","19-01-2024","1744",,"Cash Sales","Zelia Carpet Cleaner 1L","Income","Zelia Carpet Cleaner",,"Undeposited Funds","",2200.00,5200.00
,"Sales Receipt","31-01-2024","1773",,"Cash Sales","Zelia Carpet Cleaner 1L","Income","Zelia Carpet Cleaner",,"Undeposited Funds",0.00,"",5200.00
,"Sales Receipt","01-02-2024","1776",,"FARMERS BEST GROCERY","Zelia Machine Wash 1L","Income","Zelia Carpet Cleaner",,"Undeposited Funds","",808.00,6008.00
,"Sales Receipt","07-02-2024","1811",,"Cash Sales","Zelia Carpet Cleaner 1L","Income","Zelia Carpet Cleaner",,"Undeposited Funds",0.00,"",6008.00
,"Sales Receipt","12-02-2024","1831",,"Cash Sales","Zelia Carpet Cleaner 5L","Income","Zelia Carpet Cleaner",,"Undeposited Funds","",750.00,6758.00
,"Sales Receipt","21-02-2024","1856",,"Cash Sales","Zelia Carpet Cleaner 1L","Income","Zelia Carpet Cleaner",,"Undeposited Funds","",200.00,6958.00
,"Sales Receipt","21-02-2024","1862",,"Ebenezer  Minimart","Zelia Machine Wash 5L","Income","Zelia Carpet Cleaner",,"Undeposited Funds","",702.00,7660.00
,"Sales Receipt","21-02-2024","1864",,"Cash Sales","Zelia Carpet Cleaner 20L","Income","Zelia Carpet Cleaner",,"Undeposited Funds","",2334.00,9994.00
,"Sales Receipt","04-03-2024","2006",,"Cash Sales","Zelia Machine Wash 5L","Income","Zelia Carpet Cleaner",,"Undeposited Funds","",750.00,10744.00
,"Sales Receipt","05-03-2024","2009",,"Cash Sales","Zelia Machine Wash 5L","Income","Zelia Carpet Cleaner",,"Undeposited Funds","",3300.00,14044.00
,"Sales Receipt","18-03-2024","2072",,"Cash Sales","Zelia Machine Wash 5L","Income","Zelia Carpet Cleaner",,"Undeposited Funds",0.00,"",14044.00
,"Sales Receipt","02-04-2024","2132",,"Cash Sales","Zelia Machine Wash 5L","Income","Zelia Carpet Cleaner",,"Undeposited Funds","",1404.00,15448.00
,"Sales Receipt","05-04-2024","AT 193",,"JUDY USENGE","Zelia Machine Wash 5L","Income","Zelia Carpet Cleaner",,"Undeposited Funds","",8424.00,23872.00
,"Sales Receipt","15-04-2024","2196",,"Ebenezer  Minimart","Zelia Machine Wash 5L","Income","Zelia Carpet Cleaner",,"Undeposited Funds","",702.00,24574.00
,"Sales Receipt","03-05-2024","2302",,"Cash Sales","Zelia Machine Wash 5L","Income","Zelia Carpet Cleaner",,"Undeposited Funds","",1200.00,25774.00
,"Sales Receipt","08-05-2024","2322",,"Cash Sales","Zelia Carpet Cleaner 5L","Income","Zelia Carpet Cleaner",,"Undeposited Funds","",750.00,26524.00
,"Sales Receipt","13-05-2024","2356",,"The Hub Minimart","Zelia Carpet Cleaner 1L","Income","Zelia Carpet Cleaner",,"Undeposited Funds","",176.00,26700.00
,"Sales Receipt","13-05-2024","1922",,"Cash Sales","Zelia Machine Wash 5L","Income","Zelia Carpet Cleaner",,"Undeposited Funds","",1300.00,28000.00
,"Sales Receipt","15-05-2024","2362",,"Cash Sales","Zelia Carpet Cleaner 5L","Income","Zelia Carpet Cleaner",,"Undeposited Funds","",800.00,28800.00
,"Sales Receipt","23-05-2024","2379",,"Cash Sales","Zelia Machine Wash 5L","Income","Zelia Carpet Cleaner",,"Undeposited Funds",0.00,"",28800.00
,"Sales Receipt","24-05-2024","2380",,"Cash Sales","Zelia Carpet Cleaner 5L","Income","Zelia Carpet Cleaner",,"Undeposited Funds","",850.00,29650.00
,"Sales Receipt","28-05-2024","2388",,"Cash Sales","Zelia Machine Wash 5L","Income","Zelia Carpet Cleaner",,"Undeposited Funds","",1180.00,30830.00
,"Sales Receipt","31-05-2024","1937",,"Island Gift Shop","Zelia Carpet Cleaner 1L","Income","Zelia Carpet Cleaner",,"Undeposited Funds","",352.00,31182.00
,"Sales Receipt","07-06-2024","2426",,"Cash Sales","Zelia Carpet Cleaner 5L","Income","Zelia Carpet Cleaner",,"Undeposited Funds","",800.00,31982.00
,"Sales Receipt","10-06-2024","2433",,"Cash Sales","Zelia Machine Wash 1L","Income","Zelia Carpet Cleaner",,"Undeposited Funds","",160.00,32142.00
,"Sales Receipt","12-06-2024","2449",,"Cash Sales","Zelia Carpet Cleaner 1L","Income","Zelia Carpet Cleaner",,"Undeposited Funds","",200.00,32342.00
,"Sales Receipt","13-06-2024","2470",,"Cash Sales","Zelia Machine Wash 5L","Income","Zelia Carpet Cleaner",,"Undeposited Funds","",702.00,33044.00
,"Sales Receipt","28-06-2024","2745",,"Cash Sales","Zelia Carpet Cleaner 5L","Income","Zelia Carpet Cleaner",,"Undeposited Funds","",702.00,33746.00
,"Sales Receipt","03-07-2024","2773",,"Muleshe Wholesallers","Zelia Machine Wash 5L","Income","Zelia Carpet Cleaner",,"Undeposited Funds","",5200.00,38946.00
,"Invoice","04-07-2024","MC05886",,"THE HOMEWAY SUPERMARKET LIMITED","Zelia Machine Wash 1L","Income","Zelia Carpet Cleaner",,"Accounts Receivable","",1034.48,39980.48
,"Sales Receipt","08-07-2024","2520",,"Brightfood Nasra","Zelia Machine Wash 1L","Income","Zelia Carpet Cleaner",,"Undeposited Funds","",160.00,40140.48
,"Sales Receipt","09-07-2024","2510",,"Cash Sales","Zelia Machine Wash 5L","Income","Zelia Carpet Cleaner",,"Undeposited Funds","",1300.00,41440.48
,"Sales Receipt","19-07-2024","2567",,"Cash Sales","Zelia Machine Wash 5L","Income","Zelia Carpet Cleaner",,"Undeposited Funds","",1080.00,42520.48
,"Sales Receipt","22-07-2024","2574",,"Cash Sales","Zelia Machine Wash 5L","Income","Zelia Carpet Cleaner",,"Undeposited Funds",0.00,"",42520.48
,"Sales Receipt","24-07-2024","2588",,"Cash Sales","Zelia Machine Wash 20L","Income","Zelia Carpet Cleaner",,"Undeposited Funds","",3270.00,45790.48
,"Invoice","08-08-2024","MC06017",,"INTEGRAL MEDIA LIMITED","Zelia Machine Wash 5L","Income","Zelia Carpet Cleaner",,"Accounts Receivable","",948.28,46738.76
,"Sales Receipt","14-08-2024","MC06017",,"Cash Sales","Zelia Machine Wash 5L","Income","Zelia Carpet Cleaner",,"Undeposited Funds","",1100.00,47838.76
,"Sales Receipt","21-08-2024","2854",,"Cash Sales","Zelia Carpet Cleaner 5L","Income","Zelia Carpet Cleaner",,"Undeposited Funds","",850.00,48688.76
,"Sales Receipt","23-08-2024","2879",,"Cash Sales","Zelia Carpet Cleaner 5L","Income","Zelia Carpet Cleaner",,"Undeposited Funds","",650.00,49338.76
,"Sales Receipt","02-09-2024","3007",,"Cash Sales","Zelia Machine Wash 5L","Income","Zelia Carpet Cleaner",,"Undeposited Funds","",1080.00,50418.76
,"Sales Receipt","13-09-2024","3031",,"Cash Sales","Zelia Machine Wash 5L","Income","Zelia Carpet Cleaner",,"Undeposited Funds","",1300.00,51718.76
,"Sales Receipt","13-09-2024","3032",,"Cash Sales","Zelia Machine Wash 5L","Income","Zelia Carpet Cleaner",,"Undeposited Funds","",880.00,52598.76
,"Sales Receipt","26-09-2024","3209",,"Cash Sales","Zelia Machine Wash 1L","Income","Zelia Carpet Cleaner",,"Undeposited Funds","",300.00,52898.76
,"Sales Receipt","01-10-2024","3217",,"Cash Sales","Zelia Machine Wash 5L","Income","Zelia Carpet Cleaner",,"Undeposited Funds","",1300.00,54198.76
,"Sales Receipt","07-10-2024","3255",,"Cash Sales","Zelia Machine Wash 5L","Income","Zelia Carpet Cleaner",,"Undeposited Funds","",850.00,55048.76
,"Sales Receipt","18-10-2024","3124",,"Cash Sales","Zelia Machine Wash 5L","Income","Zelia Carpet Cleaner",,"Undeposited Funds","",1080.00,56128.76
,"Sales Receipt","23-10-2024","3142",,"Cash Sales","Zelia Machine Wash 1L","Income","Zelia Carpet Cleaner",,"Undeposited Funds","",483.00,56611.76
,"Sales Receipt","26-10-2024","3161",,"Cash Sales","Zelia Machine Wash 5L","Income","Zelia Carpet Cleaner",,"Undeposited Funds","",1200.00,57811.76
,"Sales Receipt","26-10-2024","3162",,"Muleshe Wholesallers","Zelia Machine Wash 5L","Income","Zelia Carpet Cleaner",,"Undeposited Funds","",5672.00,63483.76
,"Sales Receipt","29-10-2024","3169",,"Cash Sales","Zelia Machine Wash 1L","Income","Zelia Carpet Cleaner",,"Undeposited Funds","",229.00,63712.76
,"Sales Receipt","31-10-2024","3195",,"Cash Sales","Zelia Machine Wash 5L","Income","Zelia Carpet Cleaner",,"Undeposited Funds","",1080.00,64792.76
,"Sales Receipt","07-11-2024","3239",,"Cash Sales","Zelia Machine Wash 5L","Income","Zelia Carpet Cleaner",,"Undeposited Funds",0.00,"",64792.76
,"Sales Receipt","12-11-2024","3431",,"Cash Sales","Zelia Machine Wash 5L","Income","Zelia Carpet Cleaner",,"Undeposited Funds","",9000.00,73792.76
,"Sales Receipt","12-11-2024","3433",,"Cash Sales","Zelia Machine Wash 5L","Income","Zelia Carpet Cleaner",,"Undeposited Funds","",1500.00,75292.76
,"Sales Receipt","18-11-2024","3468",,"Cash Sales","Zelia Machine Wash 20L","Income","Zelia Carpet Cleaner",,"Undeposited Funds","",3450.00,78742.76
,"Sales Receipt","29-11-2024","3758",,"Cash Sales","Zelia Machine Wash 20L","Income","Zelia Carpet Cleaner",,"Undeposited Funds","",3300.00,82042.76
"Total Zelia Carpet Cleaner",,,,,,,,,,,0.00,82042.76,82042.76
"Zelia Toilet Cleaner Liq",,,,,,,,,,,,,""
,"Sales Receipt","03-01-2024","1592",,"Cash Sales","-MULTIPLE-","Income","Zelia Toilet Cleaner Liq",,"Undeposited Funds","",1900.00,1900.00
,"Sales Receipt","03-01-2024","1597",,"Cash Sales","Zelia Toilet Cleaner Liquid 750ML","Income","Zelia Toilet Cleaner Liq",,"Undeposited Funds","",700.00,2600.00
,"Invoice","04-01-2024","MC05269",,"OFFSHORE GLOBAL LOGISTICS LIMITED","Zelia Toilet Cleaner Liquid 5L","Income","Zelia Toilet Cleaner Liq",,"Accounts Receivable","",5617.24,8217.24
,"Sales Receipt","04-01-2024","1705",,"Tawakal Wholesale Eastleigh","Zelia Toilet Cleaner Liquid 750ML","Income","Zelia Toilet Cleaner Liq",,"Undeposited Funds","",7868.00,16085.24
,"Sales Receipt","04-01-2024","1706",,"Tawakal Wholesale Eastleigh","Zelia Toilet Cleaner Liquid 750ML","Income","Zelia Toilet Cleaner Liq",,"Undeposited Funds","",7868.00,23953.24
,"Invoice","05-01-2024","MC05272",,"Mumsha Supamat","Zelia Toilet Cleaner Liquid 750ML","Income","Zelia Toilet Cleaner Liq",,"Accounts Receivable","",1686.21,25639.45
,"Sales Receipt","05-01-2024","1600",,"Cash Sales","Zelia Toilet Cleaner Liquid 750ML","Income","Zelia Toilet Cleaner Liq",,"Undeposited Funds","",800.00,26439.45
,"Sales Receipt","10-01-2024","1722",,"Cash Sales","Zelia Toilet Cleaner Liquid 5L","Income","Zelia Toilet Cleaner Liq",,"Undeposited Funds","",1600.00,28039.45
,"Sales Receipt","11-01-2024","1724",,"Mashallah Foodstuffs","Zelia Toilet Cleaner Liquid 750ML","Income","Zelia Toilet Cleaner Liq",,"Undeposited Funds","",3934.00,31973.45
,"Invoice","15-01-2024","MC05308",,"MUHINDI MWEUSI SUPERMARKET LIMITED","Zelia Toilet Cleaner Liquid 750ML","Income","Zelia Toilet Cleaner Liq",,"Accounts Receivable","",1686.21,33659.66
,"Invoice","15-01-2024","MC05310",,"MUHINDI MWEUSI SUPERMARKET LIMITED","Zelia Toilet Cleaner Liquid 750ML","Income","Zelia Toilet Cleaner Liq",,"Accounts Receivable","",843.10,34502.76
,"Invoice","15-01-2024","MC05311",,"Seasons lane Mart","Zelia Toilet Cleaner Liquid 750ML","Income","Zelia Toilet Cleaner Liq",,"Accounts Receivable","",1686.21,36188.97
,"Sales Receipt","15-01-2024","1729",,"Cash Sales","Zelia Toilet Cleaner Liquid 750ML","Income","Zelia Toilet Cleaner Liq",,"Undeposited Funds","",255.00,36443.97
,"Sales Receipt","15-01-2024","1731",,"RAZAQ AIRWAYS","Zelia Toilet Cleaner Liquid 750ML","Income","Zelia Toilet Cleaner Liq",,"Undeposited Funds","",3934.00,40377.97
,"Sales Receipt","16-01-2024","1740",,"Cash Sales","Zelia Toilet Cleaner Liquid 750ML","Income","Zelia Toilet Cleaner Liq",,"Undeposited Funds","",119.00,40496.97
,"Sales Receipt","17-01-2024","1748",,"Yasin Shop","Zelia Toilet Cleaner Liquid 750ML","Income","Zelia Toilet Cleaner Liq",,"Undeposited Funds","",562.00,41058.97
,"Sales Receipt","19-01-2024","1739",,"Cash Sales","Zelia Toilet Cleaner Liquid 750ML","Income","Zelia Toilet Cleaner Liq",,"Undeposited Funds",0.00,"",41058.97
,"Sales Receipt","19-01-2024","1742",,"Cash Sales","Zelia Toilet Cleaner Liquid 750ML","Income","Zelia Toilet Cleaner Liq",,"Undeposited Funds",0.00,"",41058.97
,"Sales Receipt","19-01-2024","1744",,"Cash Sales","Zelia Toilet Cleaner Liquid 750ML","Income","Zelia Toilet Cleaner Liq",,"Undeposited Funds","",900.00,41958.97
,"Sales Receipt","19-01-2024","1746",,"Cash Sales","Zelia Toilet Cleaner Liquid 750ML","Income","Zelia Toilet Cleaner Liq",,"Undeposited Funds","",251.00,42209.97
,"Sales Receipt","21-01-2024","AT186",,"Cash Sales","Zelia Toilet Cleaner Liquid 750ML","Income","Zelia Toilet Cleaner Liq",,"Undeposited Funds","",3934.00,46143.97
,"Invoice","24-01-2024","MC05346",,"Qways Supermarket","Zelia Toilet Cleaner Liquid 750ML","Income","Zelia Toilet Cleaner Liq",,"Accounts Receivable","",1686.21,47830.18
,"Invoice","24-01-2024","MC05348",,"MUHINDI MWEUSI SUPERMARKET LIMITED","Zelia Toilet Cleaner Liquid 750ML","Income","Zelia Toilet Cleaner Liq",,"Accounts Receivable","",1686.21,49516.39
,"Sales Receipt","24-01-2024","1755",,"Alma Mart","Zelia Toilet Cleaner Liquid 750ML","Income","Zelia Toilet Cleaner Liq",,"Undeposited Funds","",1686.00,51202.39
,"Sales Receipt","24-01-2024","1756",,"Cash Sales","Zelia Toilet Cleaner Liquid 750ML","Income","Zelia Toilet Cleaner Liq",,"Undeposited Funds","",1600.00,52802.39
,"Sales Receipt","25-01-2024","1758",,"Cash Sales","Zelia Toilet Cleaner Liquid 750ML","Income","Zelia Toilet Cleaner Liq",,"Undeposited Funds","",1050.00,53852.39
,"Sales Receipt","29-01-2024","1763",,"Cash Sales","Zelia Toilet Cleaner Liquid 750ML","Income","Zelia Toilet Cleaner Liq",,"Undeposited Funds","",300.00,54152.39
,"Sales Receipt","29-01-2024","1769",,"Cash Sales","Zelia Toilet Cleaner Liquid 750ML","Income","Zelia Toilet Cleaner Liq",,"Undeposited Funds",0.00,"",54152.39
,"Sales Receipt","30-01-2024","1766",,"Cash Sales","Zelia Toilet Cleaner Liquid 5L","Income","Zelia Toilet Cleaner Liq",,"Undeposited Funds","",1400.00,55552.39
,"Sales Receipt","30-01-2024","1767",,"Cash Sales","Zelia Toilet Cleaner Liquid 750ML","Income","Zelia Toilet Cleaner Liq",,"Undeposited Funds","",300.00,55852.39
,"Sales Receipt","30-01-2024","1768",,"Cash Sales","Zelia Toilet Cleaner Liquid 5L","Income","Zelia Toilet Cleaner Liq",,"Undeposited Funds","",1400.00,57252.39
,"Sales Receipt","31-01-2024","1773",,"Cash Sales","Zelia Toilet Cleaner Liquid 750ML","Income","Zelia Toilet Cleaner Liq",,"Undeposited Funds",0.00,"",57252.39
,"Sales Receipt","01-02-2024","1776",,"FARMERS BEST GROCERY","Zelia Toilet Cleaner Liquid 750ML","Income","Zelia Toilet Cleaner Liq",,"Undeposited Funds","",3912.00,61164.39
,"Invoice","02-02-2024","MC05378",,"MZOORI STORE LIMITED","Zelia Toilet Cleaner Liquid 750ML","Income","Zelia Toilet Cleaner Liq",,"Accounts Receivable","",1686.21,62850.60
,"Invoice","02-02-2024","MC05379",,"HOPEMART SELF SERVICES LTD","Zelia Toilet Cleaner Liquid 750ML","Income","Zelia Toilet Cleaner Liq",,"Accounts Receivable","",1686.21,64536.81
,"Sales Receipt","02-02-2024","1781",,"Restoration Traders","Zelia Toilet Cleaner Liquid 750ML","Income","Zelia Toilet Cleaner Liq",,"Undeposited Funds","",2912.00,67448.81
,"Sales Receipt","02-02-2024","1782",,"Cash Sales","Zelia Toilet Cleaner Liquid 750ML","Income","Zelia Toilet Cleaner Liq",,"Undeposited Funds","",208.00,67656.81
,"Sales Receipt","02-02-2024","1783",,"Cheche Minimart","Zelia Toilet Cleaner Liquid 750ML","Income","Zelia Toilet Cleaner Liq",,"Undeposited Funds","",1248.00,68904.81
,"Sales Receipt","02-02-2024","1784",,"Kandara minimart","Zelia Toilet Cleaner Liquid 750ML","Income","Zelia Toilet Cleaner Liq",,"Undeposited Funds","",832.00,69736.81
,"Sales Receipt","05-02-2024","1787",,"Cash Sales","Zelia Toilet Cleaner Liquid 750ML","Income","Zelia Toilet Cleaner Liq",,"Undeposited Funds",0.00,"",69736.81
,"Sales Receipt","05-02-2024","1793",,"Saacid Shop","Zelia Toilet Cleaner Liquid 750ML","Income","Zelia Toilet Cleaner Liq",,"Undeposited Funds","",2912.00,72648.81
,"Sales Receipt","06-02-2024","1796",,"Towba General Store","Zelia Toilet Cleaner Liquid 750ML","Income","Zelia Toilet Cleaner Liq",,"Undeposited Funds","",5824.00,78472.81
,"Sales Receipt","06-02-2024","1800",,"Mama Amina","Zelia Toilet Cleaner Liquid 750ML","Income","Zelia Toilet Cleaner Liq",,"Undeposited Funds","",1040.00,79512.81
,"Sales Receipt","06-02-2024","1805",,"Tawakal Wholesale Eastleigh","Zelia Toilet Cleaner Liquid 750ML","Income","Zelia Toilet Cleaner Liq",,"Undeposited Funds","",5824.00,85336.81
,"Sales Receipt","06-02-2024","1808",,"Cash Sales","Zelia Toilet Cleaner Liquid 750ML","Income","Zelia Toilet Cleaner Liq",,"Undeposited Funds","",186.00,85522.81
,"Sales Receipt","08-02-2024","1815",,"Cash Sales","Zelia Toilet Cleaner Liquid 750ML","Income","Zelia Toilet Cleaner Liq",,"Undeposited Funds",0.00,"",85522.81
,"Sales Receipt","08-02-2024","1816",,"Cash Sales","Zelia Toilet Cleaner Liquid 750ML","Income","Zelia Toilet Cleaner Liq",,"Undeposited Funds","",555.00,86077.81
,"Sales Receipt","08-02-2024","1817",,"Cash Sales","Zelia Toilet Cleaner Liquid 750ML","Income","Zelia Toilet Cleaner Liq",,"Undeposited Funds","",185.00,86262.81
,"Sales Receipt","09-02-2024","1820",,"Gure Yare Shop Nasra","Zelia Toilet Cleaner Liquid 750ML","Income","Zelia Toilet Cleaner Liq",,"Undeposited Funds","",14560.00,100822.81
,"Sales Receipt","12-02-2024","1825",,"Downtown Wholesalers","Zelia Toilet Cleaner Liquid 750ML","Income","Zelia Toilet Cleaner Liq",,"Undeposited Funds","",2912.00,103734.81
,"Sales Receipt","12-02-2024","1827",,"MWASPART AIRWAYS","Zelia Toilet Cleaner Liquid 750ML","Income","Zelia Toilet Cleaner Liq",,"Undeposited Funds","",2496.00,106230.81
,"Sales Receipt","12-02-2024","1830",,"Cash Sales","Zelia Toilet Cleaner Liquid 750ML","Income","Zelia Toilet Cleaner Liq",,"Undeposited Funds","",185.00,106415.81
,"Sales Receipt","14-02-2024","1838",,"Cash Sales","Zelia Toilet Cleaner Liquid 750ML","Income","Zelia Toilet Cleaner Liq",,"Undeposited Funds",0.00,"",106415.81
,"Sales Receipt","16-02-2024","1846",,"Muumini Skood","Zelia Toilet Cleaner Liquid 750ML","Income","Zelia Toilet Cleaner Liq",,"Undeposited Funds","",2912.00,109327.81
,"Sales Receipt","16-02-2024","1847",,"Gidesh Supermarket","Zelia Toilet Cleaner Liquid 750ML","Income","Zelia Toilet Cleaner Liq",,"Undeposited Funds","",1248.00,110575.81
,"Sales Receipt","16-02-2024","1852",,"Nuclear Supermarket","Zelia Toilet Cleaner Liquid 750ML","Income","Zelia Toilet Cleaner Liq",,"Undeposited Funds","",1248.00,111823.81
,"Sales Receipt","17-02-2024","1851",,"MumsCereal and General Stores","Zelia Toilet Cleaner Liquid 750ML","Income","Zelia Toilet Cleaner Liq",,"Undeposited Funds","",624.00,112447.81
,"Sales Receipt","21-02-2024","1856",,"Cash Sales","Zelia Toilet Cleaner Liquid 750ML","Income","Zelia Toilet Cleaner Liq",,"Undeposited Funds","",235.00,112682.81
,"Sales Receipt","21-02-2024","1859",,"Cash Sales","Zelia Toilet Cleaner Liquid 750ML","Income","Zelia Toilet Cleaner Liq",,"Undeposited Funds","",208.00,112890.81
,"Sales Receipt","21-02-2024","1861",,"Cash Sales","Zelia Toilet Cleaner Liquid 750ML","Income","Zelia Toilet Cleaner Liq",,"Undeposited Funds","",235.00,113125.81
,"Sales Receipt","21-02-2024","1862",,"Ebenezer  Minimart","Zelia Toilet Cleaner Liquid 750ML","Income","Zelia Toilet Cleaner Liq",,"Undeposited Funds","",1248.00,114373.81
,"Invoice","22-02-2024","MC05434",,"NASRI MART LIMITED","Zelia Toilet Cleaner Liquid 750ML","Income","Zelia Toilet Cleaner Liq",,"Accounts Receivable","",1008.62,115382.43
,"Sales Receipt","22-02-2024","1865",,"Cash Sales","Zelia Toilet Cleaner Liquid 750ML","Income","Zelia Toilet Cleaner Liq",,"Undeposited Funds",0.00,"",115382.43
,"Sales Receipt","22-02-2024","1866",,"Cash Sales","Zelia Toilet Cleaner Liquid 750ML","Income","Zelia Toilet Cleaner Liq",,"Undeposited Funds","",416.00,115798.43
,"Sales Receipt","22-02-2024","1868",,"Cash Sales","Zelia Toilet Cleaner Liquid 750ML","Income","Zelia Toilet Cleaner Liq",,"Undeposited Funds","",208.00,116006.43
,"Invoice","23-02-2024","MC05443",,"DAILY CHAMPIONS MINI SUPERMARKET LIMITED","Zelia Toilet Cleaner Liquid 750ML","Income","Zelia Toilet Cleaner Liq",,"Accounts Receivable","",1210.34,117216.77
,"Invoice","26-02-2024","MC05444",,"The Joymai Blessed Stores Limited","Zelia Toilet Cleaner Liquid 750ML","Income","Zelia Toilet Cleaner Liq",,"Accounts Receivable","",1210.35,118427.12
,"Invoice","26-02-2024","MC05445",,"Mumsha Supamat","Zelia Toilet Cleaner Liquid 750ML","Income","Zelia Toilet Cleaner Liq",,"Accounts Receivable","",1210.34,119637.46
,"Sales Receipt","26-02-2024","1872",,"Jombs wholesalers","Zelia Toilet Cleaner Liquid 750ML","Income","Zelia Toilet Cleaner Liq",,"Undeposited Funds","",832.00,120469.46
,"Sales Receipt","26-02-2024","1876",,"Leadmark school","Zelia Toilet Cleaner Liquid 5L","Income","Zelia Toilet Cleaner Liq",,"Undeposited Funds","",948.00,121417.46
,"Sales Receipt","27-02-2024","1878",,"Cash Sales","Zelia Toilet Cleaner Liquid 750ML","Income","Zelia Toilet Cleaner Liq",,"Undeposited Funds","",940.00,122357.46
,"Sales Receipt","27-02-2024","1882",,"AIDURUS GENERAL SHOP","Zelia Toilet Cleaner Liquid 750ML","Income","Zelia Toilet Cleaner Liq",,"Undeposited Funds","",2912.00,125269.46
,"Sales Receipt","28-02-2024","1806",,"Beraccah Wholesallers","Zelia Toilet Cleaner Liquid 750ML","Income","Zelia Toilet Cleaner Liq",,"Undeposited Funds","",624.00,125893.46
,"Sales Receipt","28-02-2024","1885",,"Amulqura Shop","Zelia Toilet Cleaner Liquid 750ML","Income","Zelia Toilet Cleaner Liq",,"Undeposited Funds","",2912.00,128805.46
,"Sales Receipt","28-02-2024","1887",,"Adno shop","Zelia Toilet Cleaner Liquid 750ML","Income","Zelia Toilet Cleaner Liq",,"Undeposited Funds","",1248.00,130053.46
,"Sales Receipt","29-02-2024","1890",,"Cash Sales","-MULTIPLE-","Income","Zelia Toilet Cleaner Liq",,"Undeposited Funds","",4650.00,134703.46
,"Sales Receipt","29-02-2024","AT185",,"Cash Sales","Zelia Toilet Cleaner Liquid 750ML","Income","Zelia Toilet Cleaner Liq",,"Undeposited Funds","",8067.92,142771.38
,"Sales Receipt","01-03-2024","1891",,"Mama Amina","Zelia Toilet Cleaner Liquid 750ML","Income","Zelia Toilet Cleaner Liq",,"Undeposited Funds","",2912.00,145683.38
,"Invoice","01-03-2024","MC05459",,"THE BRIGHT STAR SUPERMARKET LIMITED","Zelia Toilet Cleaner Liquid 750ML","Income","Zelia Toilet Cleaner Liq",,"Accounts Receivable","",1210.35,146893.73
,"Sales Receipt","01-03-2024","1892",,"Ilyas Retail Shop","Zelia Toilet Cleaner Liquid 750ML","Income","Zelia Toilet Cleaner Liq",,"Undeposited Funds","",2912.00,149805.73
,"Sales Receipt","04-03-2024","1894",,"Cash Sales","Zelia Toilet Cleaner Liquid 5L","Income","Zelia Toilet Cleaner Liq",,"Undeposited Funds","",948.00,150753.73
,"Sales Receipt","04-03-2024","1895",,"Cash Sales","Zelia Toilet Cleaner Liquid 750ML","Income","Zelia Toilet Cleaner Liq",,"Undeposited Funds","",208.00,150961.73
,"Sales Receipt","04-03-2024","1895",,"Cash Sales","Zelia Toilet Cleaner Liquid 750ML","Income","Zelia Toilet Cleaner Liq",,"Undeposited Funds",0.00,"",150961.73
,"Sales Receipt","04-03-2024","1896",,"Cash Sales","Zelia Toilet Cleaner Liquid 750ML","Income","Zelia Toilet Cleaner Liq",,"Undeposited Funds","",300.00,151261.73
,"Sales Receipt","04-03-2024","2001",,"AIDURUS GENERAL SHOP","Zelia Toilet Cleaner Liquid 750ML","Income","Zelia Toilet Cleaner Liq",,"Undeposited Funds","",2912.00,154173.73
,"Sales Receipt","04-03-2024","2002",,"Himilo Wholesalers","Zelia Toilet Cleaner Liquid 750ML","Income","Zelia Toilet Cleaner Liq",,"Undeposited Funds","",2912.00,157085.73
,"Invoice","05-03-2024","MC05471",,"PRICE CHOPPER STORES LIMITED","Zelia Toilet Cleaner Liquid 750ML","Income","Zelia Toilet Cleaner Liq",,"Accounts Receivable","",1210.34,158296.07
,"Sales Receipt","05-03-2024","2008",,"Cash Sales","Zelia Toilet Cleaner Liquid 750ML","Income","Zelia Toilet Cleaner Liq",,"Undeposited Funds","",235.00,158531.07
,"Sales Receipt","05-03-2024","2011",,"Cash Sales","Zelia Toilet Cleaner Liquid 750ML","Income","Zelia Toilet Cleaner Liq",,"Undeposited Funds","",470.00,159001.07
,"Sales Receipt","05-03-2024","2012",,"Cash Sales","Zelia Toilet Cleaner Liquid 750ML","Income","Zelia Toilet Cleaner Liq",,"Undeposited Funds","",235.00,159236.07
,"Sales Receipt","05-03-2024","2013",,"Summer Outlets","Zelia Toilet Cleaner Liquid 750ML","Income","Zelia Toilet Cleaner Liq",,"Undeposited Funds","",1248.00,160484.07
,"Sales Receipt","05-03-2024","2014",,"Maida Minimart","Zelia Toilet Cleaner Liquid 750ML","Income","Zelia Toilet Cleaner Liq",,"Undeposited Funds","",1248.00,161732.07
,"Sales Receipt","07-03-2024","2024",,"Ben Bellah Store","Zelia Toilet Cleaner Liquid 750ML","Income","Zelia Toilet Cleaner Liq",,"Undeposited Funds","",1035.00,162767.07
,"Sales Receipt","08-03-2024","2045",,"Cash Sales","Zelia Toilet Cleaner Liquid 750ML","Income","Zelia Toilet Cleaner Liq",,"Undeposited Funds","",740.00,163507.07
,"Invoice","11-03-2024","MC05484",,"MUHINDI MWEUSI SUPERMARKET LIMITED","Zelia Toilet Cleaner Liquid 750ML","Income","Zelia Toilet Cleaner Liq",,"Accounts Receivable","",2896.55,166403.62
,"Sales Receipt","11-03-2024","2055",,"Beta Traders","Zelia Toilet Cleaner Liquid 750ML","Income","Zelia Toilet Cleaner Liq",,"Undeposited Funds","",1248.00,167651.62
,"Sales Receipt","11-03-2024","2056",,"Nasib Wholesallers","Zelia Toilet Cleaner Liquid 750ML","Income","Zelia Toilet Cleaner Liq",,"Undeposited Funds","",2912.00,170563.62
,"Sales Receipt","13-03-2024","2059",,"Cash Sales","Zelia Toilet Cleaner Liquid 750ML","Income","Zelia Toilet Cleaner Liq",,"Undeposited Funds","",235.00,170798.62
,"Sales Receipt","13-03-2024","2062",,"Mama Shukri","Zelia Toilet Cleaner Liquid 750ML","Income","Zelia Toilet Cleaner Liq",,"Undeposited Funds","",1242.00,172040.62
,"Sales Receipt","14-03-2024","2063",,"Cash Sales","Zelia Toilet Cleaner Liquid 750ML","Income","Zelia Toilet Cleaner Liq",,"Undeposited Funds","",235.00,172275.62
,"Sales Receipt","14-03-2024","2064",,"Towba General Store","Zelia Toilet Cleaner Liquid 750ML","Income","Zelia Toilet Cleaner Liq",,"Undeposited Funds","",11592.00,183867.62
,"Sales Receipt","14-03-2024","2067",,"Nzurimart wholesale","Zelia Toilet Cleaner Liquid 5L","Income","Zelia Toilet Cleaner Liq",,"Undeposited Funds","",948.00,184815.62
,"Sales Receipt","15-03-2024","2068",,"Cash Sales","Zelia Toilet Cleaner Liquid 750ML","Income","Zelia Toilet Cleaner Liq",,"Undeposited Funds","",185.00,185000.62
,"Sales Receipt","15-03-2024","2069",,"Cash Sales","-MULTIPLE-","Income","Zelia Toilet Cleaner Liq",,"Undeposited Funds","",2612.00,187612.62
,"Invoice","18-03-2024","MC05497",,"MUHINDI MWEUSI SUPERMARKET LIMITED","Zelia Toilet Cleaner Liquid 750ML","Income","Zelia Toilet Cleaner Liq",,"Accounts Receivable","",2920.69,190533.31
,"Sales Receipt","18-03-2024","2072",,"Cash Sales","Zelia Toilet Cleaner Liquid 750ML","Income","Zelia Toilet Cleaner Liq",,"Undeposited Funds",0.00,"",190533.31
,"Sales Receipt","18-03-2024","2075",,"Cash Sales","Zelia Toilet Cleaner Liquid 750ML","Income","Zelia Toilet Cleaner Liq",,"Undeposited Funds","",250.00,190783.31
,"Invoice","19-03-2024","MC05499",,"EASEBYYTTE SUPERMARKET LIMITED","Zelia Toilet Cleaner Liquid 750ML","Income","Zelia Toilet Cleaner Liq",,"Accounts Receivable","",1210.34,191993.65
,"Invoice","19-03-2024","MC05502",,"Tupo Mart Limited","Zelia Toilet Cleaner Liquid 750ML","Income","Zelia Toilet Cleaner Liq",,"Accounts Receivable","",1210.34,193203.99
,"Invoice","19-03-2024","MC05503",,"LUCKY MART SUPERMARKET LIMITED","Zelia Toilet Cleaner Liquid 750ML","Income","Zelia Toilet Cleaner Liq",,"Accounts Receivable","",1210.34,194414.33
,"Sales Receipt","19-03-2024","2080",,"Arqam Savanna","Zelia Toilet Cleaner Liquid 750ML","Income","Zelia Toilet Cleaner Liq",,"Undeposited Funds","",2898.00,197312.33
,"Invoice","20-03-2024","MC05507",,"DAILY CHAMPIONS MINI SUPERMARKET LIMITED","Zelia Toilet Cleaner Liquid 750ML","Income","Zelia Toilet Cleaner Liq",,"Accounts Receivable","",1210.34,198522.67
,"Sales Receipt","20-03-2024","2087",,"Pambazuka Mart (K) Limited","Zelia Toilet Cleaner Liquid 750ML","Income","Zelia Toilet Cleaner Liq",,"Undeposited Funds","",2912.00,201434.67
,"Sales Receipt","21-03-2024","2092",,"Norham Groceries","Zelia Toilet Cleaner Liquid 750ML","Income","Zelia Toilet Cleaner Liq",,"Undeposited Funds","",2898.00,204332.67
,"Sales Receipt","21-03-2024","2101",,"Raymart Minimart","Zelia Toilet Cleaner Liquid 750ML","Income","Zelia Toilet Cleaner Liq",,"Undeposited Funds","",1242.00,205574.67
,"Sales Receipt","21-03-2024","2103",,"Ilyes Gas and Water ltd","Zelia Toilet Cleaner Liquid 750ML","Income","Zelia Toilet Cleaner Liq",,"Undeposited Funds","",2898.00,208472.67
,"Sales Receipt","22-03-2024","2098",,"Ushirika Shop","Zelia Toilet Cleaner Liquid 750ML","Income","Zelia Toilet Cleaner Liq",,"Undeposited Funds","",5796.00,214268.67
,"Sales Receipt","25-03-2024","2094",,"Instanbul Shop","Zelia Toilet Cleaner Liquid 750ML","Income","Zelia Toilet Cleaner Liq",,"Undeposited Funds","",2898.00,217166.67
,"Sales Receipt","25-03-2024","2106",,"Mamken Minimart","Zelia Toilet Cleaner Liquid 750ML","Income","Zelia Toilet Cleaner Liq",,"Undeposited Funds","",828.00,217994.67
,"Invoice","25-03-2024","MC05530",,"KASAMAT INVESTMENTS LTD","Zelia Toilet Cleaner Liquid 750ML","Income","Zelia Toilet Cleaner Liq",,"Accounts Receivable","",1210.34,219205.01
,"Sales Receipt","26-03-2024","2108",,"Cash Sales","Zelia Toilet Cleaner Liquid 750ML","Income","Zelia Toilet Cleaner Liq",,"Undeposited Funds","",250.00,219455.01
,"Invoice","27-03-2024","MC05542",,"BLUEMART SUPERMARKET LIMITED","Zelia Toilet Cleaner Liquid 750ML","Income","Zelia Toilet Cleaner Liq",,"Accounts Receivable","",1210.34,220665.35
,"Sales Receipt","27-03-2024","2110",,"Toyokom Wholesallers","Zelia Toilet Cleaner Liquid 750ML","Income","Zelia Toilet Cleaner Liq",,"Undeposited Funds","",11592.00,232257.35
,"Sales Receipt","28-03-2024","2119",,"Moonlight Wholesallers","Zelia Toilet Cleaner Liquid 750ML","Income","Zelia Toilet Cleaner Liq",,"Undeposited Funds","",5796.00,238053.35
,"Sales Receipt","28-03-2024","2121",,"Saacid Shop","Zelia Toilet Cleaner Liquid 750ML","Income","Zelia Toilet Cleaner Liq",,"Undeposited Funds","",2898.00,240951.35
,"Sales Receipt","28-03-2024","2122",,"Marwan Shop","Zelia Toilet Cleaner Liquid 750ML","Income","Zelia Toilet Cleaner Liq",,"Undeposited Funds","",2898.00,243849.35
,"Sales Receipt","28-03-2024","2124",,"First Choice Shop","Zelia Toilet Cleaner Liquid 750ML","Income","Zelia Toilet Cleaner Liq",,"Undeposited Funds","",2898.00,246747.35
,"Sales Receipt","28-03-2024","2125",,"Downtown Wholesalers","Zelia Toilet Cleaner Liquid 750ML","Income","Zelia Toilet Cleaner Liq",,"Undeposited Funds","",1455.00,248202.35
,"Sales Receipt","28-03-2024","2127",,"Cash Sales","Zelia Toilet Cleaner Liquid 750ML","Income","Zelia Toilet Cleaner Liq",,"Undeposited Funds",0.00,"",248202.35
,"Sales Receipt","28-03-2024","2129",,"Cash Sales","Zelia Toilet Cleaner Liquid 5L","Income","Zelia Toilet Cleaner Liq",,"Undeposited Funds","",1694.00,249896.35
,"Sales Receipt","02-04-2024","2131",,"Q-mart Minimart","Zelia Toilet Cleaner Liquid 750ML","Income","Zelia Toilet Cleaner Liq",,"Undeposited Funds","",414.00,250310.35
,"Sales Receipt","03-04-2024","2139",,"Tawakal Wholesale Eastleigh","Zelia Toilet Cleaner Liquid 750ML","Income","Zelia Toilet Cleaner Liq",,"Undeposited Funds","",14490.00,264800.35
,"Sales Receipt","03-04-2024","2140",,"Dacaad Wholesalers","Zelia Toilet Cleaner Liquid 750ML","Income","Zelia Toilet Cleaner Liq",,"Undeposited Funds","",5796.00,270596.35
,"Sales Receipt","03-04-2024","2142",,"AIDURUS GENERAL SHOP","Zelia Toilet Cleaner Liquid 750ML","Income","Zelia Toilet Cleaner Liq",,"Undeposited Funds","",2898.00,273494.35
,"Sales Receipt","05-04-2024","2155",,"Nasib Wholesallers","Zelia Toilet Cleaner Liquid 750ML","Income","Zelia Toilet Cleaner Liq",,"Undeposited Funds","",5796.00,279290.35
,"Sales Receipt","05-04-2024","2157",,"Cash Sales","Zelia Toilet Cleaner Liquid 750ML","Income","Zelia Toilet Cleaner Liq",,"Undeposited Funds","",235.00,279525.35
,"Sales Receipt","05-04-2024","2158",,"Cash Sales","Zelia Toilet Cleaner Liquid 750ML","Income","Zelia Toilet Cleaner Liq",,"Undeposited Funds","",235.00,279760.35
,"Sales Receipt","08-04-2024","2170",,"Antic Wholesallers","Zelia Toilet Cleaner Liquid 750ML","Income","Zelia Toilet Cleaner Liq",,"Undeposited Funds","",2898.00,282658.35
,"Sales Receipt","08-04-2024","2171",,"Raage mart","Zelia Toilet Cleaner Liquid 750ML","Income","Zelia Toilet Cleaner Liq",,"Undeposited Funds","",2898.00,285556.35
,"Sales Receipt","08-04-2024","2202",,"Antic Wholesallers","Zelia Toilet Cleaner Liquid 750ML","Income","Zelia Toilet Cleaner Liq",,"Undeposited Funds","",2898.00,288454.35
,"Sales Receipt","08-04-2024","2203",,"Raage mart","Zelia Toilet Cleaner Liquid 750ML","Income","Zelia Toilet Cleaner Liq",,"Undeposited Funds","",5796.00,294250.35
,"Sales Receipt","11-04-2024","2205",,"Gure Yare Shop Nasra","Zelia Toilet Cleaner Liquid 750ML","Income","Zelia Toilet Cleaner Liq",,"Undeposited Funds","",2898.00,297148.35
,"Sales Receipt","12-04-2024","2175",,"Tekonstruct LTD","Zelia Toilet Cleaner Liquid 5L","Income","Zelia Toilet Cleaner Liq",,"Undeposited Funds","",948.00,298096.35
,"Sales Receipt","12-04-2024","2176",,"Cash Sales","Zelia Toilet Cleaner Liquid 750ML","Income","Zelia Toilet Cleaner Liq",,"Undeposited Funds","",1896.00,299992.35
,"Sales Receipt","12-04-2024","2180",,"Elwak Stores Ltd","Zelia Toilet Cleaner Liquid 750ML","Income","Zelia Toilet Cleaner Liq",,"Undeposited Funds","",2898.00,302890.35
,"Sales Receipt","12-04-2024","2181",,"Amin Wholesalers","Zelia Toilet Cleaner Liquid 750ML","Income","Zelia Toilet Cleaner Liq",,"Undeposited Funds","",5796.00,308686.35
,"Sales Receipt","12-04-2024","2185",,"Mamken Minimart","Zelia Toilet Cleaner Liquid 750ML","Income","Zelia Toilet Cleaner Liq",,"Undeposited Funds","",1242.00,309928.35
,"Sales Receipt","12-04-2024","2186",,"Kandara minimart","Zelia Toilet Cleaner Liquid 750ML","Income","Zelia Toilet Cleaner Liq",,"Undeposited Funds","",828.00,310756.35
,"Sales Receipt","12-04-2024","2187",,"Kikamart Minimart","Zelia Toilet Cleaner Liquid 750ML","Income","Zelia Toilet Cleaner Liq",,"Undeposited Funds","",1242.00,311998.35
,"Sales Receipt","15-04-2024","2188",,"Delta Mart","Zelia Toilet Cleaner Liquid 750ML","Income","Zelia Toilet Cleaner Liq",,"Undeposited Funds","",207.00,312205.35
,"Sales Receipt","15-04-2024","2193",,"Diaspora Diaries","Zelia Toilet Cleaner Liquid 750ML","Income","Zelia Toilet Cleaner Liq",,"Undeposited Funds","",207.00,312412.35
,"Sales Receipt","15-04-2024","2195",,"Zulu Enterprises","Zelia Toilet Cleaner Liquid 750ML","Income","Zelia Toilet Cleaner Liq",,"Undeposited Funds","",2898.00,315310.35
,"Sales Receipt","15-04-2024","2197",,"Lekima Royal Merchants","Zelia Toilet Cleaner Liquid 750ML","Income","Zelia Toilet Cleaner Liq",,"Undeposited Funds","",1242.00,316552.35
,"Sales Receipt","15-04-2024","2199",,"Sharma Shop","Zelia Toilet Cleaner Liquid 750ML","Income","Zelia Toilet Cleaner Liq",,"Undeposited Funds","",2898.00,319450.35
,"Sales Receipt","17-04-2024","2214",,"Cash Sales","Zelia Toilet Cleaner Liquid 750ML","Income","Zelia Toilet Cleaner Liq",,"Undeposited Funds","",705.00,320155.35
,"Sales Receipt","17-04-2024","2216",,"Cash Sales","Zelia Toilet Cleaner Liquid 750ML","Income","Zelia Toilet Cleaner Liq",,"Undeposited Funds","",186.00,320341.35
,"Sales Receipt","18-04-2024","2223",,"Cash Sales","Zelia Toilet Cleaner Liquid 750ML","Income","Zelia Toilet Cleaner Liq",,"Undeposited Funds","",235.00,320576.35
,"Sales Receipt","18-04-2024","2228",,"Gods Favour","Zelia Toilet Cleaner Liquid 750ML","Income","Zelia Toilet Cleaner Liq",,"Undeposited Funds","",2898.00,323474.35
,"Invoice","19-04-2024","MC05610",,"DISII TRADERS LTD","Zelia Toilet Cleaner Liquid 750ML","Income","Zelia Toilet Cleaner Liq",,"Accounts Receivable","",2896.55,326370.90
,"Sales Receipt","19-04-2024","2232",,"Zonal Minimart","Zelia Toilet Cleaner Liquid 750ML","Income","Zelia Toilet Cleaner Liq",,"Undeposited Funds","",1242.00,327612.90
,"Sales Receipt","19-04-2024","2235",,"Publix Supermarket","Zelia Toilet Cleaner Liquid 750ML","Income","Zelia Toilet Cleaner Liq",,"Undeposited Funds","",1242.00,328854.90
,"Sales Receipt","20-04-2024","2243",,"Horn of Africa","Zelia Toilet Cleaner Liquid 750ML","Income","Zelia Toilet Cleaner Liq",,"Undeposited Funds","",2898.00,331752.90
,"Invoice","22-04-2024","MC05623",,"MUHINDI MWEUSI SUPERMARKET LIMITED","Zelia Toilet Cleaner Liquid 750ML","Income","Zelia Toilet Cleaner Liq",,"Accounts Receivable","",2896.55,334649.45
,"Sales Receipt","22-04-2024","2241",,"Cash Sales","Zelia Toilet Cleaner Liquid 750ML","Income","Zelia Toilet Cleaner Liq",,"Undeposited Funds","",184.00,334833.45
,"Sales Receipt","22-04-2024","2247",,"AL Zake minimart","Zelia Toilet Cleaner Liquid 750ML","Income","Zelia Toilet Cleaner Liq",,"Undeposited Funds","",1035.00,335868.45
,"Sales Receipt","22-04-2024","2248",,"Himilo Wholesalers","Zelia Toilet Cleaner Liquid 750ML","Income","Zelia Toilet Cleaner Liq",,"Undeposited Funds","",8694.00,344562.45
,"Sales Receipt","22-04-2024","2250",,"Brightfood Nasra","Zelia Toilet Cleaner Liquid 750ML","Income","Zelia Toilet Cleaner Liq",,"Undeposited Funds","",828.00,345390.45
,"Sales Receipt","23-04-2024","2252",,"Cash Sales","Zelia Toilet Cleaner Liquid 750ML","Income","Zelia Toilet Cleaner Liq",,"Undeposited Funds","",470.00,345860.45
,"Invoice","24-04-2024","MC05636",,"Maji Asili Limited","Zelia Toilet Cleaner Liquid 750ML","Income","Zelia Toilet Cleaner Liq",,"Accounts Receivable","",5793.10,351653.55
,"Sales Receipt","24-04-2024","2255",,"Cash Sales","Zelia Toilet Cleaner Liquid 750ML","Income","Zelia Toilet Cleaner Liq",,"Undeposited Funds","",235.00,351888.55
,"Sales Receipt","24-04-2024","2256",,"Kimathi Store","Zelia Toilet Cleaner Liquid 750ML","Income","Zelia Toilet Cleaner Liq",,"Undeposited Funds","",207.00,352095.55
,"Sales Receipt","24-04-2024","2259",,"Muleshe Wholesallers","Zelia Toilet Cleaner Liquid 750ML","Income","Zelia Toilet Cleaner Liq",,"Undeposited Funds","",2898.00,354993.55
,"Sales Receipt","25-04-2024","2261",,"Teyamo Enterprises","Zelia Toilet Cleaner Liquid 750ML","Income","Zelia Toilet Cleaner Liq",,"Undeposited Funds","",414.00,355407.55
,"Sales Receipt","25-04-2024","2263",,"Cash Sales","Zelia Toilet Cleaner Liquid 5L","Income","Zelia Toilet Cleaner Liq",,"Undeposited Funds","",948.00,356355.55
,"Sales Receipt","25-04-2024","2266",,"Goldmart Supermarket","Zelia Toilet Cleaner Liquid 750ML","Income","Zelia Toilet Cleaner Liq",,"Undeposited Funds","",1242.00,357597.55
,"Sales Receipt","25-04-2024","2268",,"Mama Amina","Zelia Toilet Cleaner Liquid 750ML","Income","Zelia Toilet Cleaner Liq",,"Undeposited Funds","",1242.00,358839.55
,"Sales Receipt","29-04-2024","2271",,"Cash Sales","Zelia Toilet Cleaner Liquid 750ML","Income","Zelia Toilet Cleaner Liq",,"Undeposited Funds","",414.00,359253.55
,"Sales Receipt","29-04-2024","2273",,"Blessed Shop","Zelia Toilet Cleaner Liquid 750ML","Income","Zelia Toilet Cleaner Liq",,"Undeposited Funds","",207.00,359460.55
,"Sales Receipt","29-04-2024","2275",,"Cash Sales","Zelia Toilet Cleaner Liquid 750ML","Income","Zelia Toilet Cleaner Liq",,"Undeposited Funds","",235.00,359695.55
,"Invoice","29-04-2024","MC05650",,"MUHINDI MWEUSI SUPERMARKET LIMITED","Zelia Toilet Cleaner Liquid 750ML","Income","Zelia Toilet Cleaner Liq",,"Accounts Receivable","",2482.76,362178.31
,"Sales Receipt","29-04-2024","2280",,"Cash Sales","Zelia Toilet Cleaner Liquid 750ML","Income","Zelia Toilet Cleaner Liq",,"Undeposited Funds","",185.00,362363.31
,"Sales Receipt","30-04-2024","2286",,"Homecare Enterprise","Zelia Toilet Cleaner Liquid 750ML","Income","Zelia Toilet Cleaner Liq",,"Undeposited Funds","",1449.00,363812.31
,"Sales Receipt","02-05-2024","2287",,"5pm Hotel","Zelia Toilet Cleaner Liquid 750ML","Income","Zelia Toilet Cleaner Liq",,"Undeposited Funds","",181.58,363993.89
,"Sales Receipt","02-05-2024","2290",,"Mama Amina","Zelia Toilet Cleaner Liquid 750ML","Income","Zelia Toilet Cleaner Liq",,"Undeposited Funds","",2898.00,366891.89
,"Sales Receipt","02-05-2024","2292",,"Jamilas Store","Zelia Toilet Cleaner Liquid 750ML","Income","Zelia Toilet Cleaner Liq",,"Undeposited Funds","",2898.00,369789.89
,"Sales Receipt","03-05-2024","2300",,"Cash Sales","Zelia Toilet Cleaner Liquid 750ML","Income","Zelia Toilet Cleaner Liq",,"Undeposited Funds",0.00,"",369789.89
,"Sales Receipt","03-05-2024","2301",,"Cash Sales","Zelia Toilet Cleaner Liquid 750ML","Income","Zelia Toilet Cleaner Liq",,"Undeposited Funds","",235.00,370024.89
,"Sales Receipt","03-05-2024","2303",,"Cash Sales","Zelia Toilet Cleaner Liquid 750ML","Income","Zelia Toilet Cleaner Liq",,"Undeposited Funds","",370.00,370394.89
,"Sales Receipt","03-05-2024","2305",,"Zuri Mart","Zelia Toilet Cleaner Liquid 750ML","Income","Zelia Toilet Cleaner Liq",,"Undeposited Funds","",1242.00,371636.89
,"Sales Receipt","05-05-2024","2308",,"Cash Sales","Zelia Toilet Cleaner Liquid 750ML","Income","Zelia Toilet Cleaner Liq",,"Undeposited Funds","",500.00,372136.89
,"Sales Receipt","06-05-2024","2309",,"Jackys Shop","Zelia Toilet Cleaner Liquid 750ML","Income","Zelia Toilet Cleaner Liq",,"Undeposited Funds","",207.00,372343.89
,"Invoice","08-05-2024","MC05676",,"LUCKY MART SUPERMARKET LIMITED","Zelia Toilet Cleaner Liquid 750ML","Income","Zelia Toilet Cleaner Liq",,"Accounts Receivable","",1210.35,373554.24
,"Sales Receipt","08-05-2024","2318",,"Adurus Wholesallers","Zelia Toilet Cleaner Liquid 750ML","Income","Zelia Toilet Cleaner Liq",,"Undeposited Funds","",2898.00,376452.24
,"Sales Receipt","08-05-2024","2319",,"Lekima Royal Merchants","Zelia Toilet Cleaner Liquid 750ML","Income","Zelia Toilet Cleaner Liq",,"Undeposited Funds","",2898.00,379350.24
,"Sales Receipt","08-05-2024","2323",,"Cash Sales","Zelia Toilet Cleaner Liquid 750ML","Income","Zelia Toilet Cleaner Liq",,"Undeposited Funds","",470.00,379820.24
,"Sales Receipt","08-05-2024","2327",,"Shahrazaad Wholesalers","Zelia Toilet Cleaner Liquid 750ML","Income","Zelia Toilet Cleaner Liq",,"Undeposited Funds","",1449.00,381269.24
,"Sales Receipt","09-05-2024","2332",,"Gitonga Store","Zelia Toilet Cleaner Liquid 750ML","Income","Zelia Toilet Cleaner Liq",,"Undeposited Funds","",2898.00,384167.24
,"Sales Receipt","09-05-2024","2333",,"RichMind Property","Zelia Toilet Cleaner Liquid 750ML","Income","Zelia Toilet Cleaner Liq",,"Undeposited Funds","",414.00,384581.24
,"Sales Receipt","09-05-2024","2339",,"Cash Sales","Zelia Toilet Cleaner Liquid 750ML","Income","Zelia Toilet Cleaner Liq",,"Undeposited Funds","",470.00,385051.24
,"Sales Receipt","09-05-2024","2341",,"Cash Sales","Zelia Toilet Cleaner Liquid 750ML","Income","Zelia Toilet Cleaner Liq",,"Undeposited Funds","",470.00,385521.24
,"Sales Receipt","10-05-2024","1918",,"Cash Sales","Zelia Toilet Cleaner Liquid 750ML","Income","Zelia Toilet Cleaner Liq",,"Undeposited Funds","",940.00,386461.24
,"Sales Receipt","13-05-2024","2345",,"Katani Foodstore","Zelia Toilet Cleaner Liquid 750ML","Income","Zelia Toilet Cleaner Liq",,"Undeposited Funds","",1242.00,387703.24
,"Sales Receipt","13-05-2024","2349",,"Arqam Savanna","Zelia Toilet Cleaner Liquid 750ML","Income","Zelia Toilet Cleaner Liq",,"Undeposited Funds","",2898.00,390601.24
,"Sales Receipt","13-05-2024","2350",,"Aymat Wholesalers","Zelia Toilet Cleaner Liquid 750ML","Income","Zelia Toilet Cleaner Liq",,"Undeposited Funds","",2898.00,393499.24
,"Sales Receipt","13-05-2024","2352",,"Himilo Wholesalers","Zelia Toilet Cleaner Liquid 750ML","Income","Zelia Toilet Cleaner Liq",,"Undeposited Funds","",5796.00,399295.24
,"Sales Receipt","13-05-2024","2354",,"Juliet Store","Zelia Toilet Cleaner Liquid 750ML","Income","Zelia Toilet Cleaner Liq",,"Undeposited Funds","",2898.00,402193.24
,"Sales Receipt","13-05-2024","2356",,"The Hub Minimart","Zelia Toilet Cleaner Liquid 750ML","Income","Zelia Toilet Cleaner Liq",,"Undeposited Funds","",414.00,402607.24
,"Sales Receipt","14-05-2024","2355",,"Beraccah Wholesallers","Zelia Toilet Cleaner Liquid 750ML","Income","Zelia Toilet Cleaner Liq",,"Undeposited Funds","",2898.00,405505.24
,"Sales Receipt","14-05-2024","2357",,"Horn of Africa","Zelia Toilet Cleaner Liquid 750ML","Income","Zelia Toilet Cleaner Liq",,"Undeposited Funds","",2898.00,408403.24
,"Sales Receipt","14-05-2024","2358",,"Faisel Wholesale","Zelia Toilet Cleaner Liquid 750ML","Income","Zelia Toilet Cleaner Liq",,"Undeposited Funds","",2898.00,411301.24
,"Sales Receipt","14-05-2024","2359",,"Beraccah Wholesallers","Zelia Toilet Cleaner Liquid 750ML","Income","Zelia Toilet Cleaner Liq",,"Undeposited Funds","",2898.00,414199.24
,"Sales Receipt","14-05-2024","1926",,"Cash Sales","Zelia Toilet Cleaner Liquid 750ML","Income","Zelia Toilet Cleaner Liq",,"Undeposited Funds","",470.00,414669.24
,"Invoice","15-05-2024","MC05700",,"BETTER DEAL WHOLESALERS LIMITED","Zelia Toilet Cleaner Liquid 750ML","Income","Zelia Toilet Cleaner Liq",,"Accounts Receivable","",14482.76,429152.00
,"Invoice","15-05-2024","MC05702",,"Seasons lane Mart","Zelia Toilet Cleaner Liquid 750ML","Income","Zelia Toilet Cleaner Liq",,"Accounts Receivable","",1210.35,430362.35
,"Sales Receipt","16-05-2024","2363",,"Corner Shop","Zelia Toilet Cleaner Liquid 750ML","Income","Zelia Toilet Cleaner Liq",,"Undeposited Funds","",2898.00,433260.35
,"Sales Receipt","16-05-2024","2370",,"Imani General Store","Zelia Toilet Cleaner Liquid 750ML","Income","Zelia Toilet Cleaner Liq",,"Undeposited Funds","",1242.00,434502.35
,"Sales Receipt","16-05-2024","2371",,"Juliet Store","Zelia Toilet Cleaner Liquid 750ML","Income","Zelia Toilet Cleaner Liq",,"Undeposited Funds","",2898.00,437400.35
,"Sales Receipt","17-05-2024","2372",,"Danaba Wholesalers","Zelia Toilet Cleaner Liquid 750ML","Income","Zelia Toilet Cleaner Liq",,"Undeposited Funds","",2898.00,440298.35
,"Sales Receipt","20-05-2024","1938",,"Gitonga Store","Zelia Toilet Cleaner Liquid 750ML","Income","Zelia Toilet Cleaner Liq",,"Undeposited Funds","",2898.00,443196.35
,"Sales Receipt","20-05-2024","1940",,"AL Zake minimart","Zelia Toilet Cleaner Liquid 750ML","Income","Zelia Toilet Cleaner Liq",,"Undeposited Funds","",2898.00,446094.35
,"Sales Receipt","21-05-2024","1942",,"Cash Sales","Zelia Toilet Cleaner Liquid 750ML","Income","Zelia Toilet Cleaner Liq",,"Undeposited Funds","",235.00,446329.35
,"Sales Receipt","21-05-2024","1943",,"Smart Choice","Zelia Toilet Cleaner Liquid 750ML","Income","Zelia Toilet Cleaner Liq",,"Undeposited Funds","",1449.00,447778.35
,"Sales Receipt","21-05-2024","1945",,"Kinoko Store","Zelia Toilet Cleaner Liquid 750ML","Income","Zelia Toilet Cleaner Liq",,"Undeposited Funds","",1449.00,449227.35
,"Sales Receipt","21-05-2024","1947",,"Minara Shop","Zelia Toilet Cleaner Liquid 750ML","Income","Zelia Toilet Cleaner Liq",,"Undeposited Funds","",5796.00,455023.35
,"Sales Receipt","21-05-2024","1948",,"Gure Yare Shop Nasra","Zelia Toilet Cleaner Liquid 750ML","Income","Zelia Toilet Cleaner Liq",,"Undeposited Funds","",5796.00,460819.35
,"Sales Receipt","21-05-2024","1951",,"Gidesh Supermarket","Zelia Toilet Cleaner Liquid 750ML","Income","Zelia Toilet Cleaner Liq",,"Undeposited Funds","",2898.00,463717.35
,"Sales Receipt","22-05-2024","2376",,"Towfiqq Shop","Zelia Toilet Cleaner Liquid 750ML","Income","Zelia Toilet Cleaner Liq",,"Undeposited Funds","",1242.00,464959.35
,"Sales Receipt","23-05-2024","2378",,"Cash Sales","Zelia Toilet Cleaner Liquid 750ML","Income","Zelia Toilet Cleaner Liq",,"Undeposited Funds","",621.00,465580.35
,"Sales Receipt","23-05-2024","1959",,"Shahrazaad Wholesalers","Zelia Toilet Cleaner Liquid 750ML","Income","Zelia Toilet Cleaner Liq",,"Undeposited Funds","",5796.00,471376.35
,"Sales Receipt","23-05-2024","1962",,"Anab Shop","Zelia Toilet Cleaner Liquid 750ML","Income","Zelia Toilet Cleaner Liq",,"Undeposited Funds","",1242.00,472618.35
,"Sales Receipt","23-05-2024","1963",,"Safa Shop","Zelia Toilet Cleaner Liquid 750ML","Income","Zelia Toilet Cleaner Liq",,"Undeposited Funds","",1449.00,474067.35
,"Sales Receipt","23-05-2024","1965",,"Marris Minimart","Zelia Toilet Cleaner Liquid 750ML","Income","Zelia Toilet Cleaner Liq",,"Undeposited Funds","",1242.00,475309.35
,"Sales Receipt","23-05-2024","1968",,"Moonlight Wholesallers","Zelia Toilet Cleaner Liquid 750ML","Income","Zelia Toilet Cleaner Liq",,"Undeposited Funds","",2898.00,478207.35
,"Invoice","24-05-2024","MC05741",,"MUHINDI MWEUSI SUPERMARKET LIMITED","Zelia Toilet Cleaner Liquid 750ML","Income","Zelia Toilet Cleaner Liq",,"Accounts Receivable","",2896.55,481103.90
,"Invoice","24-05-2024","MC05746",,"MUHINDI MWEUSI SUPERMARKET LIMITED","Zelia Toilet Cleaner Liquid 750ML","Income","Zelia Toilet Cleaner Liq",,"Accounts Receivable","",2482.76,483586.66
,"Invoice","24-05-2024","MC05747",,"NASRI MART LIMITED","Zelia Toilet Cleaner Liquid 750ML","Income","Zelia Toilet Cleaner Liq",,"Accounts Receivable","",2420.69,486007.35
,"Invoice","24-05-2024","MC05749",,"Ck Upscales Limited","Zelia Toilet Cleaner Liquid 750ML","Income","Zelia Toilet Cleaner Liq",,"Accounts Receivable","",2896.55,488903.90
,"Sales Receipt","24-05-2024","2380",,"Cash Sales","Zelia Toilet Cleaner Liquid 5L","Income","Zelia Toilet Cleaner Liq",,"Undeposited Funds","",1200.00,490103.90
,"Sales Receipt","24-05-2024","2382",,"Afrodrip LTD","Zelia Toilet Cleaner Liquid 5L","Income","Zelia Toilet Cleaner Liq",,"Undeposited Funds","",948.00,491051.90
,"Sales Receipt","27-05-2024","2385",,"Alma Mart","Zelia Toilet Cleaner Liquid 750ML","Income","Zelia Toilet Cleaner Liq",,"Undeposited Funds","",2898.00,493949.90
,"Sales Receipt","27-05-2024","2387",,"Nasib Wholesallers","Zelia Toilet Cleaner Liquid 750ML","Income","Zelia Toilet Cleaner Liq",,"Undeposited Funds","",5796.00,499745.90
,"Invoice","28-05-2024","MC05763",,"Mumsha Supamat","Zelia Toilet Cleaner Liquid 750ML","Income","Zelia Toilet Cleaner Liq",,"Accounts Receivable","",1210.35,500956.25
,"Invoice","28-05-2024","MC05764",,"DALLAS SHOPRITE LTD","Zelia Toilet Cleaner Liquid 750ML","Income","Zelia Toilet Cleaner Liq",,"Accounts Receivable","",1210.34,502166.59
,"Invoice","28-05-2024","MC05765",,"TAWALA SUPERMARKET LIMITED","Zelia Toilet Cleaner Liquid 750ML","Income","Zelia Toilet Cleaner Liq",,"Accounts Receivable","",2896.55,505063.14
,"Sales Receipt","28-05-2024","2389",,"Restoration Traders","Zelia Toilet Cleaner Liquid 750ML","Income","Zelia Toilet Cleaner Liq",,"Undeposited Funds","",5320.00,510383.14
,"Sales Receipt","29-05-2024","2391",,"Cash Sales","Zelia Toilet Cleaner Liquid 750ML","Income","Zelia Toilet Cleaner Liq",,"Undeposited Funds","",235.00,510618.14
,"Sales Receipt","29-05-2024","1970",,"Towba General Store","Zelia Toilet Cleaner Liquid 750ML","Income","Zelia Toilet Cleaner Liq",,"Undeposited Funds","",8694.00,519312.14
,"Sales Receipt","29-05-2024","1971",,"Freshfinds Wholesale","Zelia Toilet Cleaner Liquid 750ML","Income","Zelia Toilet Cleaner Liq",,"Undeposited Funds","",1242.00,520554.14
,"Sales Receipt","30-05-2024","2395",,"Beta Traders","Zelia Toilet Cleaner Liquid 750ML","Income","Zelia Toilet Cleaner Liq",,"Undeposited Funds","",1656.00,522210.14
,"Sales Receipt","31-05-2024","1937",,"Island Gift Shop","Zelia Toilet Cleaner Liquid 750ML","Income","Zelia Toilet Cleaner Liq",,"Undeposited Funds","",828.00,523038.14
,"Sales Receipt","31-05-2024","1975",,"Cash Sales","Zelia Toilet Cleaner Liquid 750ML","Income","Zelia Toilet Cleaner Liq",,"Undeposited Funds","",235.00,523273.14
,"Sales Receipt","03-06-2024","1975",,"Cash Sales","Zelia Toilet Cleaner Liquid 750ML","Income","Zelia Toilet Cleaner Liq",,"Undeposited Funds","",235.00,523508.14
,"Sales Receipt","03-06-2024","1983",,"Marris Mini mart","Zelia Toilet Cleaner Liquid 750ML","Income","Zelia Toilet Cleaner Liq",,"Undeposited Funds","",1242.00,524750.14
,"Sales Receipt","03-06-2024","2406",,"Downtown Wholesalers","Zelia Toilet Cleaner Liquid 750ML","Income","Zelia Toilet Cleaner Liq",,"Undeposited Funds","",2898.00,527648.14
,"Sales Receipt","03-06-2024","2407",,"Sharma Shop","Zelia Toilet Cleaner Liquid 750ML","Income","Zelia Toilet Cleaner Liq",,"Undeposited Funds","",2898.00,530546.14
,"Sales Receipt","05-06-2024","2418",,"Saacid Shop","Zelia Toilet Cleaner Liquid 750ML","Income","Zelia Toilet Cleaner Liq",,"Undeposited Funds","",5796.00,536342.14
,"Invoice","06-06-2024","MC05789",,"ONESTOP MINI SUPERMARKET LIMITED","Zelia Toilet Cleaner Liquid 5L","Income","Zelia Toilet Cleaner Liq",,"Accounts Receivable","",3789.66,540131.80
,"Sales Receipt","06-06-2024","2424",,"Bethel Store","Zelia Toilet Cleaner Liquid 750ML","Income","Zelia Toilet Cleaner Liq",,"Undeposited Funds","",1449.00,541580.80
,"Sales Receipt","06-06-2024","2423",,"Ekai moke wholesale","Zelia Toilet Cleaner Liquid 750ML","Income","Zelia Toilet Cleaner Liq",,"Undeposited Funds","",1470.00,543050.80
,"Sales Receipt","07-06-2024","1994",,"Cash Sales","Zelia Toilet Cleaner Liquid 750ML","Income","Zelia Toilet Cleaner Liq",,"Undeposited Funds","",185.00,543235.80
,"Sales Receipt","10-06-2024","2433",,"Cash Sales","Zelia Toilet Cleaner Liquid 750ML","Income","Zelia Toilet Cleaner Liq",,"Undeposited Funds","",185.00,543420.80
,"Sales Receipt","10-06-2024","2436",,"Arqam minimart","Zelia Toilet Cleaner Liquid 750ML","Income","Zelia Toilet Cleaner Liq",,"Undeposited Funds","",2898.00,546318.80
,"Sales Receipt","10-06-2024","2437",,"Al Mubarak Wholesalers","Zelia Toilet Cleaner Liquid 750ML","Income","Zelia Toilet Cleaner Liq",,"Undeposited Funds","",2898.00,549216.80
,"Invoice","11-06-2024","MC05815",,"MADINA SUPERMARKET LIMITED","Zelia Toilet Cleaner Liquid 750ML","Income","Zelia Toilet Cleaner Liq",,"Accounts Receivable","",1210.34,550427.14
,"Sales Receipt","11-06-2024","2439",,"Cash Sales","Zelia Toilet Cleaner Liquid 750ML","Income","Zelia Toilet Cleaner Liq",,"Undeposited Funds","",185.00,550612.14
,"Invoice","12-06-2024","MC05819",,"INTEGRAL MEDIA LIMITED","Zelia Toilet Cleaner Liquid 5L","Income","Zelia Toilet Cleaner Liq",,"Accounts Receivable","",947.42,551559.56
,"Sales Receipt","12-06-2024","2449",,"Cash Sales","Zelia Toilet Cleaner Liquid 750ML","Income","Zelia Toilet Cleaner Liq",,"Undeposited Funds","",250.00,551809.56
,"Sales Receipt","12-06-2024","2453",,"Cash Sales","Zelia Toilet Cleaner Liquid 750ML","Income","Zelia Toilet Cleaner Liq",,"Undeposited Funds","",7350.00,559159.56
,"Sales Receipt","12-06-2024","2460",,"Mt Kenya  mart","Zelia Toilet Cleaner Liquid 750ML","Income","Zelia Toilet Cleaner Liq",,"Undeposited Funds","",1449.00,560608.56
,"Sales Receipt","12-06-2024","2455",,"Antic Wholesallers","Zelia Toilet Cleaner Liquid 750ML","Income","Zelia Toilet Cleaner Liq",,"Undeposited Funds","",5796.00,566404.56
,"Sales Receipt","12-06-2024","2463",,"Raja Foodstuffs","Zelia Toilet Cleaner Liquid 750ML","Income","Zelia Toilet Cleaner Liq",,"Undeposited Funds","",2898.00,569302.56
,"Sales Receipt","13-06-2024","2464",,"Cash Sales","Zelia Toilet Cleaner Liquid 750ML","Income","Zelia Toilet Cleaner Liq",,"Undeposited Funds","",250.00,569552.56
,"Sales Receipt","13-06-2024","2473",,"Horn of Africa","Zelia Toilet Cleaner Liquid 750ML","Income","Zelia Toilet Cleaner Liq",,"Undeposited Funds","",2898.00,572450.56
,"Sales Receipt","14-06-2024","2475",,"Cash Sales","Zelia Toilet Cleaner Liquid 750ML","Income","Zelia Toilet Cleaner Liq",,"Undeposited Funds","",370.00,572820.56
,"Sales Receipt","14-06-2024","2480",,"Cash Sales","Zelia Toilet Cleaner Liquid 750ML","Income","Zelia Toilet Cleaner Liq",,"Undeposited Funds","",280.00,573100.56
,"Sales Receipt","14-06-2024","2481",,"Cash Sales","Zelia Toilet Cleaner Liquid 750ML","Income","Zelia Toilet Cleaner Liq",,"Undeposited Funds","",280.00,573380.56
,"Invoice","18-06-2024","MC05831",,"MUHINDI MWEUSI SUPERMARKET LIMITED","Zelia Toilet Cleaner Liquid 750ML","Income","Zelia Toilet Cleaner Liq",,"Accounts Receivable",0.00,"",573380.56
,"Sales Receipt","18-06-2024","2711",,"Cash Sales","Zelia Toilet Cleaner Liquid 750ML","Income","Zelia Toilet Cleaner Liq",,"Undeposited Funds","",185.00,573565.56
,"Sales Receipt","18-06-2024","2500",,"Al Hamdu shop","Zelia Toilet Cleaner Liquid 750ML","Income","Zelia Toilet Cleaner Liq",,"Undeposited Funds","",1449.00,575014.56
,"Invoice","19-06-2024","MC05837",,"MUHINDI MWEUSI SUPERMARKET LIMITED","Zelia Toilet Cleaner Liquid 750ML","Income","Zelia Toilet Cleaner Liq",,"Accounts Receivable","",1241.38,576255.94
,"Sales Receipt","19-06-2024","2483",,"Cash Sales","Zelia Toilet Cleaner Liquid 750ML","Income","Zelia Toilet Cleaner Liq",,"Undeposited Funds","",400.00,576655.94
,"Invoice","20-06-2024","MC05843",,"MUHINDI MWEUSI SUPERMARKET LIMITED","Zelia Toilet Cleaner Liquid 750ML","Income","Zelia Toilet Cleaner Liq",,"Accounts Receivable","",2896.55,579552.49
,"Sales Receipt","20-06-2024","2493",,"Cash Sales","Zelia Toilet Cleaner Liquid 750ML","Income","Zelia Toilet Cleaner Liq",,"Undeposited Funds",0.00,"",579552.49
,"Sales Receipt","21-06-2024","2723",,"Bethel Store","Zelia Toilet Cleaner Liquid 750ML","Income","Zelia Toilet Cleaner Liq",,"Undeposited Funds","",1449.00,581001.49
,"Sales Receipt","24-06-2024","2719",,"Cash Sales","Zelia Toilet Cleaner Liquid 750ML","Income","Zelia Toilet Cleaner Liq",,"Undeposited Funds","",207.00,581208.49
,"Sales Receipt","24-06-2024","2729",,"Natala Shop","Zelia Toilet Cleaner Liquid 750ML","Income","Zelia Toilet Cleaner Liq",,"Undeposited Funds","",1449.00,582657.49
,"Sales Receipt","25-06-2024","2730",,"Bei Nafuu Shop","Zelia Toilet Cleaner Liquid 750ML","Income","Zelia Toilet Cleaner Liq",,"Undeposited Funds","",1242.00,583899.49
,"Invoice","26-06-2024","MC05862",,"LUCKY MART SUPERMARKET LIMITED","Zelia Toilet Cleaner Liquid 750ML","Income","Zelia Toilet Cleaner Liq",,"Accounts Receivable","",1210.34,585109.83
,"Invoice","26-06-2024","MC05864",,"Seasons lane Mart","Zelia Toilet Cleaner Liquid 750ML","Income","Zelia Toilet Cleaner Liq",,"Accounts Receivable","",1241.38,586351.21
,"Invoice","26-06-2024","MC05865",,"KASAMAT INVESTMENTS LTD","Zelia Toilet Cleaner Liquid 750ML","Income","Zelia Toilet Cleaner Liq",,"Accounts Receivable","",1241.38,587592.59
,"Sales Receipt","28-06-2024","2737",,"Cash Sales","Zelia Toilet Cleaner Liquid 750ML","Income","Zelia Toilet Cleaner Liq",,"Undeposited Funds",0.00,"",587592.59
,"Sales Receipt","28-06-2024","2743",,"Cash Sales","Zelia Toilet Cleaner Liquid 750ML","Income","Zelia Toilet Cleaner Liq",,"Undeposited Funds","",372.00,587964.59
,"Sales Receipt","01-07-2024","2756",,"Cash Sales","Zelia Toilet Cleaner Liquid 750ML","Income","Zelia Toilet Cleaner Liq",,"Undeposited Funds","",250.00,588214.59
,"Sales Receipt","01-07-2024","2750",,"Adurus Wholesallers","Zelia Toilet Cleaner Liquid 750ML","Income","Zelia Toilet Cleaner Liq",,"Undeposited Funds","",2898.00,591112.59
,"Sales Receipt","01-07-2024","2751",,"Himilo Wholesallers","Zelia Toilet Cleaner Liquid 750ML","Income","Zelia Toilet Cleaner Liq",,"Undeposited Funds","",5796.00,596908.59
,"Sales Receipt","01-07-2024","2754",,"Hidika Shop","Zelia Toilet Cleaner Liquid 750ML","Income","Zelia Toilet Cleaner Liq",,"Undeposited Funds","",2898.00,599806.59
,"Sales Receipt","02-07-2024","2762",,"Maida Minimart","Zelia Toilet Cleaner Liquid 750ML","Income","Zelia Toilet Cleaner Liq",,"Undeposited Funds","",1242.00,601048.59
,"Sales Receipt","02-07-2024","2554",,"RichMind Property","Zelia Toilet Cleaner Liquid 750ML","Income","Zelia Toilet Cleaner Liq",,"Undeposited Funds","",210.00,601258.59
,"Invoice","03-07-2024","MC05880",,"SECUTOR LIMITED","Zelia Toilet Cleaner Liquid 750ML","Income","Zelia Toilet Cleaner Liq",,"Accounts Receivable","",250.00,601508.59
,"Sales Receipt","03-07-2024","2761",,"Cash Sales","Zelia Toilet Cleaner Liquid 750ML","Income","Zelia Toilet Cleaner Liq",,"Undeposited Funds",0.00,"",601508.59
,"Sales Receipt","03-07-2024","2767",,"Cash Sales","Zelia Toilet Cleaner Liquid 750ML","Income","Zelia Toilet Cleaner Liq",,"Undeposited Funds","",186.00,601694.59
,"Sales Receipt","03-07-2024","2773",,"Muleshe Wholesallers","Zelia Toilet Cleaner Liquid 750ML","Income","Zelia Toilet Cleaner Liq",,"Undeposited Funds","",5796.00,607490.59
,"Sales Receipt","03-07-2024","2774",,"Warfa Wholesale","Zelia Toilet Cleaner Liquid 750ML","Income","Zelia Toilet Cleaner Liq",,"Undeposited Funds","",5796.00,613286.59
,"Sales Receipt","03-07-2024","2778",,"Fresh Finds Mart","Zelia Toilet Cleaner Liquid 750ML","Income","Zelia Toilet Cleaner Liq",,"Undeposited Funds","",2898.00,616184.59
,"Sales Receipt","03-07-2024","2782",,"Towba general stores Eastleigh","Zelia Toilet Cleaner Liquid 750ML","Income","Zelia Toilet Cleaner Liq",,"Undeposited Funds","",5796.00,621980.59
,"Sales Receipt","03-07-2024","2770",,"Tayamo Wholesalers","Zelia Toilet Cleaner Liquid 750ML","Income","Zelia Toilet Cleaner Liq",,"Undeposited Funds","",414.00,622394.59
,"Sales Receipt","05-07-2024","2792",,"Cash Sales","Zelia Toilet Cleaner Liquid 750ML","Income","Zelia Toilet Cleaner Liq",,"Undeposited Funds","",186.00,622580.59
,"Sales Receipt","05-07-2024","2793",,"Cash Sales","Zelia Toilet Cleaner Liquid 750ML","Income","Zelia Toilet Cleaner Liq",,"Undeposited Funds","",1116.00,623696.59
,"Sales Receipt","05-07-2024","2797",,"Afro Drip LTD","Zelia Toilet Cleaner Liquid 5L","Income","Zelia Toilet Cleaner Liq",,"Undeposited Funds","",2844.00,626540.59
,"Sales Receipt","06-07-2024","2516",,"Baraka Cerials","Zelia Toilet Cleaner Liquid 750ML","Income","Zelia Toilet Cleaner Liq",,"Undeposited Funds","",621.00,627161.59
,"Sales Receipt","08-07-2024","2527",,"Afro Drip LTD","Zelia Toilet Cleaner Liquid 750ML","Income","Zelia Toilet Cleaner Liq",,"Undeposited Funds","",207.00,627368.59
,"Sales Receipt","08-07-2024","2520",,"Brightfood Nasra","Zelia Toilet Cleaner Liquid 750ML","Income","Zelia Toilet Cleaner Liq",,"Undeposited Funds","",1242.00,628610.59
,"Sales Receipt","09-07-2024","2509",,"Cash Sales","Zelia Toilet Cleaner Liquid 750ML","Income","Zelia Toilet Cleaner Liq",,"Undeposited Funds","",240.00,628850.59
,"Sales Receipt","09-07-2024","2526",,"Cash Sales","Zelia Toilet Cleaner Liquid 750ML","Income","Zelia Toilet Cleaner Liq",,"Undeposited Funds",0.00,"",628850.59
,"Sales Receipt","09-07-2024","2521",,"Sooyal Wholesalers","Zelia Toilet Cleaner Liquid 750ML","Income","Zelia Toilet Cleaner Liq",,"Undeposited Funds","",2898.00,631748.59
,"Sales Receipt","09-07-2024","2569",,"Al Hamdu shop","Zelia Toilet Cleaner Liquid 750ML","Income","Zelia Toilet Cleaner Liq",,"Undeposited Funds","",1449.00,633197.59
,"Sales Receipt","09-07-2024","2523",,"Mama Amina","Zelia Toilet Cleaner Liquid 750ML","Income","Zelia Toilet Cleaner Liq",,"Undeposited Funds","",2898.00,636095.59
,"Sales Receipt","10-07-2024","2533",,"Mega Shop","Zelia Toilet Cleaner Liquid 750ML","Income","Zelia Toilet Cleaner Liq",,"Undeposited Funds","",2898.00,638993.59
,"Invoice","15-07-2024","MC05933",,"MUHINDI MWEUSI SUPERMARKET LIMITED","Zelia Toilet Cleaner Liquid 750ML","Income","Zelia Toilet Cleaner Liq",,"Accounts Receivable","",2896.55,641890.14
,"Sales Receipt","15-07-2024","2542",,"Cash Sales","Zelia Toilet Cleaner Liquid 5L","Income","Zelia Toilet Cleaner Liq",,"Undeposited Funds","",1080.00,642970.14
,"Sales Receipt","16-07-2024","2550",,"Summer Outlets","Zelia Toilet Cleaner Liquid 750ML","Income","Zelia Toilet Cleaner Liq",,"Undeposited Funds","",1242.00,644212.14
,"Sales Receipt","16-07-2024","2563",,"Zulu Enterprise","Zelia Toilet Cleaner Liquid 750ML","Income","Zelia Toilet Cleaner Liq",,"Undeposited Funds","",2898.00,647110.14
,"Invoice","17-07-2024","MC05941",,"Ck Upscales Limited","Zelia Toilet Cleaner Liquid 750ML","Income","Zelia Toilet Cleaner Liq",,"Accounts Receivable","",1448.28,648558.42
,"Invoice","17-07-2024","MC05942",,"SUMM SUPERMARKET LIMITED","Zelia Toilet Cleaner Liquid 750ML","Income","Zelia Toilet Cleaner Liq",,"Accounts Receivable","",1448.28,650006.70
,"Sales Receipt","17-07-2024","2551",,"Cash Sales","Zelia Toilet Cleaner Liquid 750ML","Income","Zelia Toilet Cleaner Liq",,"Undeposited Funds",0.00,"",650006.70
,"Sales Receipt","18-07-2024","2565",,"Cash Sales","Zelia Toilet Cleaner Liquid 750ML","Income","Zelia Toilet Cleaner Liq",,"Undeposited Funds","",250.00,650256.70
,"Sales Receipt","19-07-2024","2605",,"Restoration Traders","Zelia Toilet Cleaner Liquid 750ML","Income","Zelia Toilet Cleaner Liq",,"Undeposited Funds","",5796.00,656052.70
,"Sales Receipt","22-07-2024","2573",,"Cash Sales","Zelia Toilet Cleaner Liquid 750ML","Income","Zelia Toilet Cleaner Liq",,"Undeposited Funds","",186.00,656238.70
,"Sales Receipt","22-07-2024","2574",,"Cash Sales","Zelia Toilet Cleaner Liquid 5L","Income","Zelia Toilet Cleaner Liq",,"Undeposited Funds",0.00,"",656238.70
,"Sales Receipt","22-07-2024","2570",,"Cash Sales","Zelia Toilet Cleaner Liquid 750ML","Income","Zelia Toilet Cleaner Liq",,"Undeposited Funds",0.00,"",656238.70
,"Sales Receipt","23-07-2024","2582",,"Cash Sales","Zelia Toilet Cleaner Liquid 750ML","Income","Zelia Toilet Cleaner Liq",,"Undeposited Funds","",186.00,656424.70
,"Sales Receipt","23-07-2024","2591",,"Cash Sales","Zelia Toilet Cleaner Liquid 750ML","Income","Zelia Toilet Cleaner Liq",,"Undeposited Funds","",300.00,656724.70
,"Sales Receipt","23-07-2024","2581",,"Cash Sales","Zelia Toilet Cleaner Liquid 750ML","Income","Zelia Toilet Cleaner Liq",,"Undeposited Funds",0.00,"",656724.70
,"Sales Receipt","23-07-2024","2607",,"Juli Mart","Zelia Toilet Cleaner Liquid 750ML","Income","Zelia Toilet Cleaner Liq",,"Undeposited Funds","",621.00,657345.70
,"Sales Receipt","24-07-2024","2588",,"Cash Sales","Zelia Toilet Cleaner Liquid 750ML","Income","Zelia Toilet Cleaner Liq",,"Undeposited Funds","",705.00,658050.70
,"Sales Receipt","24-07-2024","2589",,"Cash Sales","Zelia Toilet Cleaner Liquid 5L","Income","Zelia Toilet Cleaner Liq",,"Undeposited Funds","",2196.00,660246.70
,"Sales Receipt","24-07-2024","2608",,"Capital Halal","Zelia Toilet Cleaner Liquid 750ML","Income","Zelia Toilet Cleaner Liq",,"Undeposited Funds","",1242.00,661488.70
,"Sales Receipt","25-07-2024","2592",,"Cash Sales","Zelia Toilet Cleaner Liquid 5L","Income","Zelia Toilet Cleaner Liq",,"Undeposited Funds","",1080.00,662568.70
,"Sales Receipt","27-07-2024","2653",,"Danaba Wholesallers","Zelia Toilet Cleaner Liquid 750ML","Income","Zelia Toilet Cleaner Liq",,"Undeposited Funds","",1656.00,664224.70
,"Invoice","29-07-2024","MC05983",,"Muhaya & Rukundo Holdings Ltd","0001.12.00 Zelia Toilet Cleaner Liquid 12X750ML","Income","Zelia Toilet Cleaner Liq",,"Accounts Receivable","",2160.00,666384.70
,"Invoice","29-07-2024","MC05984",,"Mumsha Supamat","Zelia Toilet Cleaner Liquid 750ML","Income","Zelia Toilet Cleaner Liq",,"Accounts Receivable","",1210.34,667595.04
,"Sales Receipt","29-07-2024","2602",,"Cash Sales","Zelia Toilet Cleaner Liquid 750ML","Income","Zelia Toilet Cleaner Liq",,"Undeposited Funds",0.00,"",667595.04
,"Sales Receipt","29-07-2024","2612",,"Cash Sales","Zelia Toilet Cleaner Liquid 750ML","Income","Zelia Toilet Cleaner Liq",,"Undeposited Funds","",186.00,667781.04
,"Sales Receipt","29-07-2024","2616",,"Hidika Shop","Zelia Toilet Cleaner Liquid 750ML","Income","Zelia Toilet Cleaner Liq",,"Undeposited Funds","",1242.00,669023.04
,"Sales Receipt","29-07-2024","2922",,"Muhaya & Rukundo Holdings Ltd","Zelia Toilet Cleaner Liquid 12X750ML","Income","Zelia Toilet Cleaner Liq",,"Undeposited Funds","",4251.84,673274.88
,"Sales Receipt","30-07-2024","2620",,"Cash Sales","Zelia Toilet Cleaner Liquid 750ML","Income","Zelia Toilet Cleaner Liq",,"Undeposited Funds","",300.00,673574.88
,"Sales Receipt","30-07-2024","2629",,"Cash Sales","Zelia Toilet Cleaner Liquid 5L","Income","Zelia Toilet Cleaner Liq",,"Undeposited Funds","",1380.00,674954.88
,"Sales Receipt","30-07-2024","2622",,"Infinity Lines","Zelia Toilet Cleaner Liquid 5L","Income","Zelia Toilet Cleaner Liq",,"Undeposited Funds","",948.00,675902.88
,"Sales Receipt","30-07-2024","2623",,"Smart Choice","Zelia Toilet Cleaner Liquid 750ML","Income","Zelia Toilet Cleaner Liq",,"Undeposited Funds","",1449.00,677351.88
,"Sales Receipt","30-07-2024","2627",,"Elliane Wholesalers","Zelia Toilet Cleaner Liquid 750ML","Income","Zelia Toilet Cleaner Liq",,"Undeposited Funds","",1242.00,678593.88
,"Sales Receipt","30-07-2024","2626",,"Nzuri Supermarket","Zelia Toilet Cleaner Liquid 750ML","Income","Zelia Toilet Cleaner Liq",,"Undeposited Funds","",621.00,679214.88
,"Sales Receipt","31-07-2024","AT200",,"Cash Sales","Zelia Toilet Cleaner Liquid 750ML","Income","Zelia Toilet Cleaner Liq",,"Undeposited Funds","",3372.00,682586.88
,"Sales Receipt","01-08-2024","2642",,"Mango Shop","Zelia Toilet Cleaner Liquid 750ML","Income","Zelia Toilet Cleaner Liq",,"Undeposited Funds","",2898.00,685484.88
,"Sales Receipt","01-08-2024","2641",,"Taqwa Shop","Zelia Toilet Cleaner Liquid 750ML","Income","Zelia Toilet Cleaner Liq",,"Undeposited Funds","",1449.00,686933.88
,"Sales Receipt","01-08-2024","2640",,"Our Shop","Zelia Toilet Cleaner Liquid 750ML","Income","Zelia Toilet Cleaner Liq",,"Undeposited Funds","",1449.00,688382.88
,"Sales Receipt","01-08-2024","4353",,"Goldmart Supermarket","Zelia Toilet Cleaner Liquid 750ML","Income","Zelia Toilet Cleaner Liq",,"Undeposited Funds","",2898.00,691280.88
,"Sales Receipt","01-08-2024","2637",,"Burhani Shop","Zelia Toilet Cleaner Liquid 750ML","Income","Zelia Toilet Cleaner Liq",,"Undeposited Funds","",3360.00,694640.88
,"Sales Receipt","01-08-2024","2691",,"Ubwere Store","Zelia Toilet Cleaner Liquid 750ML","Income","Zelia Toilet Cleaner Liq",,"Undeposited Funds","",5838.00,700478.88
,"Sales Receipt","01-08-2024","2664",,"Mkulima Supermarket","Zelia Toilet Cleaner Liquid 750ML","Income","Zelia Toilet Cleaner Liq",,"Undeposited Funds","",2484.00,702962.88
,"Sales Receipt","02-08-2024","2644",,"Cash Sales","Zelia Toilet Cleaner Liquid 750ML","Income","Zelia Toilet Cleaner Liq",,"Undeposited Funds","",300.00,703262.88
,"Sales Receipt","02-08-2024","2649",,"Cash Sales","Zelia Toilet Cleaner Liquid 750ML","Income","Zelia Toilet Cleaner Liq",,"Undeposited Funds","",190.00,703452.88
,"Sales Receipt","02-08-2024","2650",,"Cash Sales","Zelia Toilet Cleaner Liquid 750ML","Income","Zelia Toilet Cleaner Liq",,"Undeposited Funds","",190.00,703642.88
,"Sales Receipt","05-08-2024","2658",,"Cash Sales","Zelia Toilet Cleaner Liquid 750ML","Income","Zelia Toilet Cleaner Liq",,"Undeposited Funds","",600.00,704242.88
,"Sales Receipt","05-08-2024","2661",,"Kibibi Wasai Store","Zelia Toilet Cleaner Liquid 750ML","Income","Zelia Toilet Cleaner Liq",,"Undeposited Funds","",2898.00,707140.88
,"Sales Receipt","05-08-2024","2671",,"Hidika Shop","Zelia Toilet Cleaner Liquid 750ML","Income","Zelia Toilet Cleaner Liq",,"Undeposited Funds","",1260.00,708400.88
,"Sales Receipt","05-08-2024","2675",,"Adurus Wholesallers","Zelia Toilet Cleaner Liquid 750ML","Income","Zelia Toilet Cleaner Liq",,"Undeposited Funds","",5880.00,714280.88
,"Sales Receipt","06-08-2024","2659",,"Cash Sales","Zelia Toilet Cleaner Liquid 5L","Income","Zelia Toilet Cleaner Liq",,"Undeposited Funds","",1300.00,715580.88
,"Sales Receipt","06-08-2024","2676",,"Warfa Wholesale","Zelia Toilet Cleaner Liquid 750ML","Income","Zelia Toilet Cleaner Liq",,"Undeposited Funds","",8694.00,724274.88
,"Sales Receipt","06-08-2024","2677",,"Saacid Shop","Zelia Toilet Cleaner Liquid 750ML","Income","Zelia Toilet Cleaner Liq",,"Undeposited Funds","",5796.00,730070.88
,"Sales Receipt","06-08-2024","2680",,"Juja Minimart","Zelia Toilet Cleaner Liquid 750ML","Income","Zelia Toilet Cleaner Liq",,"Undeposited Funds","",2898.00,732968.88
,"Sales Receipt","06-08-2024","2681",,"Adam Boss","Zelia Toilet Cleaner Liquid 750ML","Income","Zelia Toilet Cleaner Liq",,"Undeposited Funds","",1449.00,734417.88
,"Invoice","07-08-2024","MC06006",,"NASRI MART LIMITED","Zelia Toilet Cleaner Liquid 750ML","Income","Zelia Toilet Cleaner Liq",,"Accounts Receivable","",1241.38,735659.26
,"Sales Receipt","07-08-2024","2682",,"Watopz Wholesallers","Zelia Toilet Cleaner Liquid 750ML","Income","Zelia Toilet Cleaner Liq",,"Undeposited Funds","",4968.00,740627.26
,"Sales Receipt","07-08-2024","2683",,"Marris Mini mart","Zelia Toilet Cleaner Liquid 750ML","Income","Zelia Toilet Cleaner Liq",,"Undeposited Funds","",1449.00,742076.26
,"Sales Receipt","07-08-2024","2809",,"Safa Mart Wholesalers","Zelia Toilet Cleaner Liquid 750ML","Income","Zelia Toilet Cleaner Liq",,"Undeposited Funds","",1242.00,743318.26
,"Invoice","08-08-2024","MC06015",,"Burhani Private Mart Limited","Zelia Toilet Cleaner Liquid 750ML","Income","Zelia Toilet Cleaner Liq",,"Accounts Receivable","",2896.55,746214.81
,"Invoice","12-08-2024","MC06031",,"KAVYA SUPERMARKET LIMITED","Zelia Toilet Cleaner Liquid 750ML","Income","Zelia Toilet Cleaner Liq",,"Accounts Receivable","",2648.28,748863.09
,"Sales Receipt","12-08-2024","2813",,"Mamken Minimart","Zelia Toilet Cleaner Liquid 750ML","Income","Zelia Toilet Cleaner Liq",,"Undeposited Funds","",1242.00,750105.09
,"Sales Receipt","12-08-2024","2815",,"Kibibi Wasai Store","Zelia Toilet Cleaner Liquid 750ML","Income","Zelia Toilet Cleaner Liq",,"Undeposited Funds","",2898.00,753003.09
,"Sales Receipt","12-08-2024","2816",,"Freshtake wholesalers","Zelia Toilet Cleaner Liquid 750ML","Income","Zelia Toilet Cleaner Liq",,"Undeposited Funds","",4968.00,757971.09
,"Sales Receipt","14-08-2024","2834",,"Milimani Store","Zelia Toilet Cleaner Liquid 750ML","Income","Zelia Toilet Cleaner Liq",,"Undeposited Funds","",1449.00,759420.09
,"Sales Receipt","14-08-2024","2842",,"Kibibi Wasai Store","Zelia Toilet Cleaner Liquid 750ML","Income","Zelia Toilet Cleaner Liq",,"Undeposited Funds","",2898.00,762318.09
,"Sales Receipt","15-08-2024","2892",,"Makueni Store","Zelia Toilet Cleaner Liquid 750ML","Income","Zelia Toilet Cleaner Liq",,"Undeposited Funds","",210.00,762528.09
,"Sales Receipt","15-08-2024","2827",,"Capital Furniture","Zelia Toilet Cleaner Liquid 5L","Income","Zelia Toilet Cleaner Liq",,"Undeposited Funds","",950.00,763478.09
,"Sales Receipt","15-08-2024","2845",,"Rajah Foodstuffs","Zelia Toilet Cleaner Liquid 750ML","Income","Zelia Toilet Cleaner Liq",,"Undeposited Funds","",5796.00,769274.09
,"Sales Receipt","16-08-2024","2850",,"Hawkers Paradise","Zelia Toilet Cleaner Liquid 750ML","Income","Zelia Toilet Cleaner Liq",,"Undeposited Funds","",828.00,770102.09
,"Sales Receipt","16-08-2024","2851",,"Tahila Enterprises","Zelia Toilet Cleaner Liquid 750ML","Income","Zelia Toilet Cleaner Liq",,"Undeposited Funds","",828.00,770930.09
,"Sales Receipt","16-08-2024","2920",,"Kibibi Wasai Store","Zelia Toilet Cleaner Liquid 750ML","Income","Zelia Toilet Cleaner Liq",,"Undeposited Funds","",2898.00,773828.09
,"Sales Receipt","17-08-2024","2843",,"Horn of Africa","Zelia Toilet Cleaner Liquid 750ML","Income","Zelia Toilet Cleaner Liq",,"Undeposited Funds","",5796.00,779624.09
,"Sales Receipt","19-08-2024","2839",,"Cash Sales","Zelia Toilet Cleaner Liquid 750ML","Income","Zelia Toilet Cleaner Liq",,"Undeposited Funds",0.00,"",779624.09
,"Sales Receipt","19-08-2024","2835",,"Jombs Wholesale","Zelia Toilet Cleaner Liquid 750ML","Income","Zelia Toilet Cleaner Liq",,"Undeposited Funds","",840.00,780464.09
,"Sales Receipt","20-08-2024","2904",,"Cash Sales","Zelia Toilet Cleaner Liquid 750ML","Income","Zelia Toilet Cleaner Liq",,"Undeposited Funds","",182.00,780646.09
,"Sales Receipt","20-08-2024","2869",,"Soft Landing","Zelia Toilet Cleaner Liquid 750ML","Income","Zelia Toilet Cleaner Liq",,"Undeposited Funds","",434.00,781080.09
,"Sales Receipt","20-08-2024","2859",,"Nzuri Supermarket","Zelia Toilet Cleaner Liquid 750ML","Income","Zelia Toilet Cleaner Liq",,"Undeposited Funds","",1272.00,782352.09
,"Credit Note","21-08-2024","CN01064",,"Muhaya & Rukundo Holdings Ltd","0001.12.00 Zelia Toilet Cleaner Liquid 12X750ML","Income","Zelia Toilet Cleaner Liq",,"Accounts Receivable",2160.00,"",780192.09
,"Invoice","21-08-2024","MC06061",,"Muhaya & Rukundo Holdings Ltd","0001.12.00 Zelia Toilet Cleaner Liquid 12X750ML","Income","Zelia Toilet Cleaner Liq",,"Accounts Receivable","",69180.00,849372.09
,"Invoice","21-08-2024","MC06062",,"Muhaya & Rukundo Holdings Ltd","0001.12.00 Outer Toilet cleaner 12x750ML","Income","Zelia Toilet Cleaner Liq",,"Accounts Receivable","",173.15,849545.24
,"Invoice","21-08-2024","MC06063",,"BETTER DEAL WHOLESALERS LIMITED","Zelia Toilet Cleaner Liquid 750ML","Income","Zelia Toilet Cleaner Liq",,"Accounts Receivable","",15517.24,865062.48
,"Invoice","21-08-2024","MC06064",,"Ck Upscales Limited","Zelia Toilet Cleaner Liquid 750ML","Income","Zelia Toilet Cleaner Liq",,"Accounts Receivable","",2896.55,867959.03
,"Sales Receipt","21-08-2024","2853",,"Cash Sales","Zelia Toilet Cleaner Liquid 750ML","Income","Zelia Toilet Cleaner Liq",,"Undeposited Funds","",300.00,868259.03
,"Sales Receipt","21-08-2024","2864",,"Safwan Wholesalers","Zelia Toilet Cleaner Liquid 750ML","Income","Zelia Toilet Cleaner Liq",,"Undeposited Funds","",2940.00,871199.03
,"Sales Receipt","21-08-2024","2866",,"Budget Busket","Zelia Toilet Cleaner Liquid 750ML","Income","Zelia Toilet Cleaner Liq",,"Undeposited Funds","",1260.00,872459.03
,"Sales Receipt","21-08-2024","2855",,"Homecare Enterprise","Zelia Toilet Cleaner Liquid 5L","Income","Zelia Toilet Cleaner Liq",,"Undeposited Funds","",1053.00,873512.03
,"Invoice","22-08-2024","MC06068",,"BLUEMART SUPERMARKET LIMITED","Zelia Toilet Cleaner Liquid 750ML","Income","Zelia Toilet Cleaner Liq",,"Accounts Receivable","",1256.90,874768.93
,"Invoice","22-08-2024","MC06069",,"Mumsha Supamat","Zelia Toilet Cleaner Liquid 750ML","Income","Zelia Toilet Cleaner Liq",,"Accounts Receivable","",1256.90,876025.83
,"Invoice","22-08-2024","MC06070",,"LUCKY MART SUPERMARKET LIMITED","Zelia Toilet Cleaner Liquid 750ML","Income","Zelia Toilet Cleaner Liq",,"Accounts Receivable","",1256.90,877282.73
,"Sales Receipt","22-08-2024","2868",,"Cash Sales","Zelia Toilet Cleaner Liquid 750ML","Income","Zelia Toilet Cleaner Liq",,"Undeposited Funds","",1200.00,878482.73
,"Sales Receipt","22-08-2024","1206",,"Tangents Minimart","Zelia Toilet Cleaner Liquid 750ML","Income","Zelia Toilet Cleaner Liq",,"Undeposited Funds","",1085.00,879567.73
,"Sales Receipt","23-08-2024","2877",,"Cash Sales","Zelia Toilet Cleaner Liquid 750ML","Income","Zelia Toilet Cleaner Liq",,"Undeposited Funds","",240.00,879807.73
,"Sales Receipt","23-08-2024","2878",,"Cash Sales","Zelia Toilet Cleaner Liquid 750ML","Income","Zelia Toilet Cleaner Liq",,"Undeposited Funds","",182.00,879989.73
,"Sales Receipt","23-08-2024","2880",,"Cash Sales","Zelia Toilet Cleaner Liquid 750ML","Income","Zelia Toilet Cleaner Liq",,"Undeposited Funds","",400.00,880389.73
,"Sales Receipt","23-08-2024","2899",,"Beraccah Syokimau","Zelia Toilet Cleaner Liquid 750ML","Income","Zelia Toilet Cleaner Liq",,"Undeposited Funds","",2520.00,882909.73
,"Sales Receipt","24-08-2024","2887",,"Brightfood Nasra","Zelia Toilet Cleaner Liquid 750ML","Income","Zelia Toilet Cleaner Liq",,"Undeposited Funds","",1260.00,884169.73
,"Sales Receipt","26-08-2024","2883",,"Cash Sales","Zelia Toilet Cleaner Liquid 750ML","Income","Zelia Toilet Cleaner Liq",,"Undeposited Funds","",900.00,885069.73
,"Sales Receipt","26-08-2024","2889",,"Mama G shop","Zelia Toilet Cleaner Liquid 750ML","Income","Zelia Toilet Cleaner Liq",,"Undeposited Funds","",2940.00,888009.73
,"Sales Receipt","26-08-2024","2908",,"Himilo General Store","Zelia Toilet Cleaner Liquid 750ML","Income","Zelia Toilet Cleaner Liq",,"Undeposited Funds","",5880.00,893889.73
,"Sales Receipt","26-08-2024","1207",,"Kemera Discount","Zelia Toilet Cleaner Liquid 5L","Income","Zelia Toilet Cleaner Liq",,"Undeposited Funds","",948.00,894837.73
,"Sales Receipt","27-08-2024","2909",,"Horn of Africa","Zelia Toilet Cleaner Liquid 750ML","Income","Zelia Toilet Cleaner Liq",,"Undeposited Funds","",5880.00,900717.73
,"Sales Receipt","28-08-2024","2911",,"Infinity Lines","Zelia Toilet Cleaner Liquid 5L","Income","Zelia Toilet Cleaner Liq",,"Undeposited Funds","",2100.00,902817.73
,"Sales Receipt","28-08-2024","2914",,"Towba Eastleigh foodstuffs","Zelia Toilet Cleaner Liquid 750ML","Income","Zelia Toilet Cleaner Liq",,"Undeposited Funds","",5880.00,908697.73
,"Sales Receipt","29-08-2024","AT201",,"Cash Sales","Zelia Toilet Cleaner Liquid 750ML","Income","Zelia Toilet Cleaner Liq",,"Undeposited Funds","",3372.00,912069.73
,"Sales Receipt","02-09-2024","3225",,"Purity Shop","Zelia Toilet Cleaner Liquid 12X750ML","Income","Zelia Toilet Cleaner Liq",,"Undeposited Funds","",210.00,912279.73
,"Sales Receipt","02-09-2024","2916",,"Anne","Zelia Toilet Cleaner Liquid 12X750ML","Income","Zelia Toilet Cleaner Liq",,"Undeposited Funds","",210.00,912489.73
,"Sales Receipt","02-09-2024","2923",,"Blossom Beauty","Zelia Toilet Cleaner Liquid 12X750ML","Income","Zelia Toilet Cleaner Liq",,"Undeposited Funds","",1260.00,913749.73
,"Sales Receipt","02-09-2024","2925",,"Sharma Shop","Zelia Toilet Cleaner Liquid 12X750ML","Income","Zelia Toilet Cleaner Liq",,"Undeposited Funds","",2940.00,916689.73
,"Sales Receipt","02-09-2024","3006",,"Cash Sales","Zelia Toilet Cleaner Liquid 12X750ML","Income","Zelia Toilet Cleaner Liq",,"Undeposited Funds","",717.00,917406.73
,"Sales Receipt","03-09-2024","2931",,"Jombs wholesalers","Zelia Toilet Cleaner Liquid 12X750ML","Income","Zelia Toilet Cleaner Liq",,"Undeposited Funds","",1260.00,918666.73
,"Sales Receipt","03-09-2024","2932",,"Mama Amina","Zelia Toilet Cleaner Liquid 12X750ML","Income","Zelia Toilet Cleaner Liq",,"Undeposited Funds","",2940.00,921606.73
,"Sales Receipt","03-09-2024","3226",,"Soft Landing","Zelia Toilet Cleaner Liquid 4X5L","Income","Zelia Toilet Cleaner Liq",,"Undeposited Funds","",960.00,922566.73
,"Sales Receipt","03-09-2024","2922",,"Cash Sales","Zelia Toilet Cleaner Liquid 12X750ML","Income","Zelia Toilet Cleaner Liq",,"Undeposited Funds",0.00,"",922566.73
,"Invoice","04-09-2024","MC06108",,"PRICE CHOPPER STORES LIMITED","Zelia Toilet Cleaner Liquid 750ML","Income","Zelia Toilet Cleaner Liq",,"Accounts Receivable","",1241.38,923808.11
,"Sales Receipt","04-09-2024","2937",,"Restoration Traders","Zelia Toilet Cleaner Liquid 12X750ML","Income","Zelia Toilet Cleaner Liq",,"Undeposited Funds","",5880.00,929688.11
,"Sales Receipt","04-09-2024","3013",,"Ogena Matt","Zelia Toilet Cleaner Liquid 12X750ML","Income","Zelia Toilet Cleaner Liq",,"Undeposited Funds","",1085.00,930773.11
,"Sales Receipt","04-09-2024","3014",,"Gifted Hands","Zelia Toilet Cleaner Liquid 12X750ML","Income","Zelia Toilet Cleaner Liq",,"Undeposited Funds","",868.00,931641.11
,"Sales Receipt","05-09-2024","2947",,"Ushirika Shop","Zelia Toilet Cleaner Liquid 12X750ML","Income","Zelia Toilet Cleaner Liq",,"Undeposited Funds","",5880.00,937521.11
,"Sales Receipt","05-09-2024","2948",,"Jam Tower Shop","Zelia Toilet Cleaner Liquid 12X750ML","Income","Zelia Toilet Cleaner Liq",,"Undeposited Funds","",2940.00,940461.11
,"Sales Receipt","05-09-2024","2967",,"Freshtake wholesalers","Zelia Toilet Cleaner Liquid 12X750ML","Income","Zelia Toilet Cleaner Liq",,"Undeposited Funds","",5040.00,945501.11
,"Sales Receipt","05-09-2024","2944",,"Cash Sales","Zelia Toilet Cleaner Liquid 12X750ML","Income","Zelia Toilet Cleaner Liq",,"Undeposited Funds","",600.01,946101.12
,"Sales Receipt","05-09-2024","2950",,"Cash Sales","Zelia Toilet Cleaner Liquid 12X750ML","Income","Zelia Toilet Cleaner Liq",,"Undeposited Funds","",364.01,946465.13
,"Sales Receipt","05-09-2024","2955",,"Cash Sales","Zelia Toilet Cleaner Liquid 12X750ML","Income","Zelia Toilet Cleaner Liq",,"Undeposited Funds","",420.01,946885.14
,"Sales Receipt","06-09-2024","2961",,"Gure Yare Shop","Zelia Toilet Cleaner Liquid 12X750ML","Income","Zelia Toilet Cleaner Liq",,"Undeposited Funds","",5880.00,952765.14
,"Sales Receipt","08-09-2024","3227",,"Visina Stores","Zelia Toilet Cleaner Liquid 12X750ML","Income","Zelia Toilet Cleaner Liq",,"Undeposited Funds","",6720.00,959485.14
,"Sales Receipt","09-09-2024","2968",,"Hidika Shop","Zelia Toilet Cleaner Liquid 12X750ML","Income","Zelia Toilet Cleaner Liq",,"Undeposited Funds","",2520.00,962005.14
,"Sales Receipt","09-09-2024","2969",,"Elwak mart","Zelia Toilet Cleaner Liquid 12X750ML","Income","Zelia Toilet Cleaner Liq",,"Undeposited Funds","",2520.00,964525.14
,"Sales Receipt","09-09-2024","2974",,"Soft Landing","Zelia Toilet Cleaner Liquid 12X750ML","Income","Zelia Toilet Cleaner Liq",,"Undeposited Funds","",2898.00,967423.14
,"Sales Receipt","09-09-2024","2986",,"Pambazuka Mart (K) Limited","Zelia Toilet Cleaner Liquid 12X750ML","Income","Zelia Toilet Cleaner Liq",,"Undeposited Funds","",2520.00,969943.14
,"Sales Receipt","09-09-2024","2971",,"Cash Sales","Zelia Toilet Cleaner Liquid 12X750ML","Income","Zelia Toilet Cleaner Liq",,"Undeposited Funds","",181.99,970125.13
,"Sales Receipt","10-09-2024","2990",,"Maida Minimart","Zelia Toilet Cleaner Liquid 12X750ML","Income","Zelia Toilet Cleaner Liq",,"Undeposited Funds","",1260.00,971385.13
,"Sales Receipt","10-09-2024","2991",,"Nuclear Supermarket","Zelia Toilet Cleaner Liquid 12X750ML","Income","Zelia Toilet Cleaner Liq",,"Undeposited Funds","",1260.00,972645.13
,"Sales Receipt","10-09-2024","2992",,"Axis Lounge","Zelia Toilet Cleaner Liquid 12X750ML","Income","Zelia Toilet Cleaner Liq",,"Undeposited Funds","",2940.00,975585.13
,"Sales Receipt","10-09-2024","2975",,"Cash Sales","Zelia Toilet Cleaner Liquid 12X750ML","Income","Zelia Toilet Cleaner Liq",,"Undeposited Funds","",767.99,976353.12
,"Sales Receipt","10-09-2024","3015",,"Cash Sales","Zelia Toilet Cleaner Liquid 12X750ML","Income","Zelia Toilet Cleaner Liq",,"Undeposited Funds","",249.99,976603.11
,"Sales Receipt","10-09-2024","2976",,"Cash Sales","Zelia Toilet Cleaner Liquid 12X750ML","Income","Zelia Toilet Cleaner Liq",,"Undeposited Funds",0.00,"",976603.11
,"Sales Receipt","11-09-2024","2994",,"Mutawakal Stores","Zelia Toilet Cleaner Liquid 12X750ML","Income","Zelia Toilet Cleaner Liq",,"Undeposited Funds","",2940.00,979543.11
,"Sales Receipt","11-09-2024","2997",,"Domasco Wholesalers","-MULTIPLE-","Income","Zelia Toilet Cleaner Liq",,"Undeposited Funds","",2133.00,981676.11
,"Sales Receipt","11-09-2024","3011",,"Warfa Wholesale","Zelia Toilet Cleaner Liquid 12X750ML","Income","Zelia Toilet Cleaner Liq",,"Undeposited Funds","",8820.00,990496.11
,"Invoice","12-09-2024","MC06147",,"ZAIN SUPERMARKET LIMITED","Zelia Toilet Cleaner Liquid 12X750ML","Income","Zelia Toilet Cleaner Liq",,"Accounts Receivable","",1251.73,991747.84
,"Sales Receipt","12-09-2024","3021",,"Marwa Tower Shop","Zelia Toilet Cleaner Liquid 12X750ML","Income","Zelia Toilet Cleaner Liq",,"Undeposited Funds","",144.00,991891.84
,"Sales Receipt","12-09-2024","2987",,"Cash Sales","Zelia Toilet Cleaner Liquid 12X750ML","Income","Zelia Toilet Cleaner Liq",,"Undeposited Funds","",1199.99,993091.83
,"Sales Receipt","12-09-2024","3019",,"Cash Sales","Zelia Toilet Cleaner Liquid 12X750ML","Income","Zelia Toilet Cleaner Liq",,"Undeposited Funds","",249.99,993341.82
,"Sales Receipt","13-09-2024","3029",,"Omari Store","Zelia Toilet Cleaner Liquid 12X750ML","Income","Zelia Toilet Cleaner Liq",,"Undeposited Funds","",1100.00,994441.82
,"Sales Receipt","13-09-2024","3032",,"Cash Sales","Zelia Toilet Cleaner Liquid 12X750ML","Income","Zelia Toilet Cleaner Liq",,"Undeposited Funds","",480.01,994921.83
,"Sales Receipt","13-09-2024","3033",,"Cash Sales","Zelia Toilet Cleaner Liquid 12X750ML","Income","Zelia Toilet Cleaner Liq",,"Undeposited Funds","",206.99,995128.82
,"Sales Receipt","14-09-2024","3041",,"Lekima Wholesale","Zelia Toilet Cleaner Liquid 12X750ML","Income","Zelia Toilet Cleaner Liq",,"Undeposited Funds","",1242.00,996370.82
,"Sales Receipt","14-09-2024","3043",,"Gladys Wholesalers","Zelia Toilet Cleaner Liquid 12X750ML","Income","Zelia Toilet Cleaner Liq",,"Undeposited Funds","",1302.00,997672.82
,"Sales Receipt","16-09-2024","3044",,"Afro Drip LTD","Zelia Toilet Cleaner Liquid 4X5L","Income","Zelia Toilet Cleaner Liq",,"Undeposited Funds","",2106.00,999778.82
,"Sales Receipt","16-09-2024","3045",,"Afro Drip LTD Reception","Zelia Toilet Cleaner Liquid 12X750ML","Income","Zelia Toilet Cleaner Liq",,"Undeposited Funds","",210.00,999988.82
,"Sales Receipt","16-09-2024","3037",,"Cash Sales","Zelia Toilet Cleaner Liquid 4X5L","Income","Zelia Toilet Cleaner Liq",,"Undeposited Funds","",1380.00,1001368.82
,"Sales Receipt","16-09-2024","3039",,"Cash Sales","Zelia Toilet Cleaner Liquid 12X750ML","Income","Zelia Toilet Cleaner Liq",,"Undeposited Funds","",299.99,1001668.81
,"Sales Receipt","16-09-2024","3040",,"Cash Sales","Zelia Toilet Cleaner Liquid 4X5L","Income","Zelia Toilet Cleaner Liq",,"Undeposited Funds","",1200.00,1002868.81
,"Sales Receipt","17-09-2024","3050",,"Cash Sales","Zelia Toilet Cleaner Liquid 12X750ML","Income","Zelia Toilet Cleaner Liq",,"Undeposited Funds","",364.01,1003232.82
,"Sales Receipt","18-09-2024","3060",,"Faisel Wholesalers","Zelia Toilet Cleaner Liquid 12X750ML","Income","Zelia Toilet Cleaner Liq",,"Undeposited Funds","",5040.00,1008272.82
,"Sales Receipt","18-09-2024","3056",,"Cash Sales","Zelia Toilet Cleaner Liquid 12X750ML","Income","Zelia Toilet Cleaner Liq",,"Undeposited Funds","",299.99,1008572.81
,"Sales Receipt","20-09-2024","3094",,"Duto Rumo Store","Zelia Toilet Cleaner Liquid 12X750ML","Income","Zelia Toilet Cleaner Liq",,"Undeposited Funds","",434.00,1009006.81
,"Sales Receipt","20-09-2024","3204",,"Meghan Stores","Zelia Toilet Cleaner Liquid 12X750ML","Income","Zelia Toilet Cleaner Liq",,"Undeposited Funds","",217.00,1009223.81
,"Sales Receipt","23-09-2024","3087",,"Himilo General Store","Zelia Toilet Cleaner Liquid 12X750ML","Income","Zelia Toilet Cleaner Liq",,"Undeposited Funds","",5880.00,1015103.81
,"Invoice","24-09-2024","MC06194",,"OGENA PRIME DISTRIBUTORS LIMITED","Zelia Toilet Cleaner Liquid 12X750ML","Income","Zelia Toilet Cleaner Liq",,"Accounts Receivable","",935.35,1016039.16
,"Invoice","24-09-2024","MC06195",,"TAWALA SUPERMARKET LIMITED","Zelia Toilet Cleaner Liquid 12X750ML","Income","Zelia Toilet Cleaner Liq",,"Accounts Receivable","",2482.76,1018521.92
,"Invoice","24-09-2024","MC06196",,"KASAMAT INVESTMENTS LTD","Zelia Toilet Cleaner Liquid 12X750ML","Income","Zelia Toilet Cleaner Liq",,"Accounts Receivable","",1262.07,1019783.99
,"Credit Note","24-09-2024","CN01069",,"OGENA PRIME DISTRIBUTORS LIMITED","Zelia Toilet Cleaner Liquid 12X750ML","Income","Zelia Toilet Cleaner Liq",,"Accounts Receivable",935.35,"",1018848.64
,"Sales Receipt","24-09-2024","3090",,"Elliane Wholesalers","Zelia Toilet Cleaner Liquid 12X750ML","Income","Zelia Toilet Cleaner Liq",,"Undeposited Funds","",1260.00,1020108.64
,"Sales Receipt","24-09-2024","3234",,"Gifted Hands","Zelia Toilet Cleaner Liquid 12X750ML","Income","Zelia Toilet Cleaner Liq",,"Undeposited Funds","",532.00,1020640.64
,"Sales Receipt","24-09-2024","3078",,"Cash Sales","Zelia Toilet Cleaner Liquid 4X5L","Income","Zelia Toilet Cleaner Liq",,"Undeposited Funds","",910.00,1021550.64
,"Sales Receipt","24-09-2024","3079",,"Cash Sales","Zelia Toilet Cleaner Liquid 12X750ML","Income","Zelia Toilet Cleaner Liq",,"Undeposited Funds","",460.01,1022010.65
,"Sales Receipt","24-09-2024","3080",,"Cash Sales","Zelia Toilet Cleaner Liquid 12X750ML","Income","Zelia Toilet Cleaner Liq",,"Undeposited Funds","",229.99,1022240.64
,"Sales Receipt","24-09-2024","3091",,"Cash Sales","Zelia Toilet Cleaner Liquid 12X750ML","Income","Zelia Toilet Cleaner Liq",,"Undeposited Funds","",181.99,1022422.63
,"Sales Receipt","24-09-2024","3092",,"Cash Sales","Zelia Toilet Cleaner Liquid 12X750ML","Income","Zelia Toilet Cleaner Liq",,"Undeposited Funds","",181.99,1022604.62
,"Sales Receipt","25-09-2024","3096",,"Sharaazad Wholesalers","Zelia Toilet Cleaner Liquid 12X750ML","Income","Zelia Toilet Cleaner Liq",,"Undeposited Funds","",5880.00,1028484.62
,"Sales Receipt","25-09-2024","3099",,"Towba general stores Eastleigh","Zelia Toilet Cleaner Liquid 12X750ML","Income","Zelia Toilet Cleaner Liq",,"Undeposited Funds","",5880.00,1034364.62
,"Sales Receipt","25-09-2024","3095",,"Cash Sales","Zelia Toilet Cleaner Liquid 12X750ML","Income","Zelia Toilet Cleaner Liq",,"Undeposited Funds","",249.99,1034614.61
,"Sales Receipt","26-09-2024","3209",,"Cash Sales","Zelia Toilet Cleaner Liquid 12X750ML","Income","Zelia Toilet Cleaner Liq",,"Undeposited Funds","",249.99,1034864.60
,"Invoice","27-09-2024","MC06216",,"QUALITYMART SUPERMARKET LIMITED","Zelia Toilet Cleaner Liquid 12X750ML","Income","Zelia Toilet Cleaner Liq",,"Accounts Receivable","",1262.07,1036126.67
,"Invoice","27-09-2024","MC06218",,"LUCKY MART SUPERMARKET LIMITED","Zelia Toilet Cleaner Liquid 12X750ML","Income","Zelia Toilet Cleaner Liq",,"Accounts Receivable","",1262.07,1037388.74
,"Sales Receipt","27-09-2024","3215",,"Supaa Mart","Zelia Toilet Cleaner Liquid 12X750ML","Income","Zelia Toilet Cleaner Liq",,"Undeposited Funds","",1260.00,1038648.74
,"Sales Receipt","27-09-2024","3214",,"Kenya Yetu Mart","Zelia Toilet Cleaner Liquid 12X750ML","Income","Zelia Toilet Cleaner Liq",,"Undeposited Funds","",1260.00,1039908.74
,"Sales Receipt","27-09-2024","3213",,"DayBreak Shop","Zelia Toilet Cleaner Liquid 12X750ML","Income","Zelia Toilet Cleaner Liq",,"Undeposited Funds","",630.00,1040538.74
,"Sales Receipt","27-09-2024","3245",,"Florence Shop","Zelia Toilet Cleaner Liquid 12X750ML","Income","Zelia Toilet Cleaner Liq",,"Undeposited Funds","",420.00,1040958.74
,"Sales Receipt","27-09-2024","3212",,"Cash Sales","Zelia Toilet Cleaner Liquid 12X750ML","Income","Zelia Toilet Cleaner Liq",,"Undeposited Funds","",181.99,1041140.73
,"Sales Receipt","28-09-2024","3222",,"Gidesh Minimart","Zelia Toilet Cleaner Liquid 12X750ML","Income","Zelia Toilet Cleaner Liq",,"Undeposited Funds","",2520.00,1043660.73
,"Sales Receipt","28-09-2024","3221",,"Bulsho Wholesalers","Zelia Toilet Cleaner Liquid 12X750ML","Income","Zelia Toilet Cleaner Liq",,"Undeposited Funds","",1260.00,1044920.73
,"Sales Receipt","30-09-2024","3223",,"Brightfood Nasra","Zelia Toilet Cleaner Liquid 12X750ML","Income","Zelia Toilet Cleaner Liq",,"Undeposited Funds","",1260.00,1046180.73
,"Sales Receipt","01-10-2024","3220",,"Cash Sales","Zelia Toilet Cleaner Liquid 12X750ML","Income","Zelia Toilet Cleaner Liq",,"Undeposited Funds","",156.00,1046336.73
,"Sales Receipt","02-10-2024","3225",,"Cash Sales","Zelia Toilet Cleaner Liquid 750ML","Income","Zelia Toilet Cleaner Liq",,"Undeposited Funds","",182.00,1046518.73
,"Sales Receipt","02-10-2024","3225",,"Cash Sales","Zelia Toilet Cleaner Liquid 12X750ML","Income","Zelia Toilet Cleaner Liq",,"Undeposited Funds","",182.00,1046700.73
,"Sales Receipt","02-10-2024","3228",,"Cash Sales","Zelia Toilet Cleaner Liquid 12X750ML","Income","Zelia Toilet Cleaner Liq",,"Undeposited Funds","",300.00,1047000.73
,"Sales Receipt","02-10-2024","3234",,"Adam Boss","Zelia Toilet Cleaner Liquid 12X750ML","Income","Zelia Toilet Cleaner Liq",,"Undeposited Funds","",5880.00,1052880.73
,"Sales Receipt","03-10-2024","3250",,"Cash Sales","Zelia Toilet Cleaner Liquid 12X750ML","Income","Zelia Toilet Cleaner Liq",,"Undeposited Funds","",182.00,1053062.73
,"Sales Receipt","03-10-2024","3247",,"Warfa Wholesale","Zelia Toilet Cleaner Liquid 12X750ML","Income","Zelia Toilet Cleaner Liq",,"Undeposited Funds","",12600.00,1065662.73
,"Sales Receipt","03-10-2024","3248",,"Elwak Stores","Zelia Toilet Cleaner Liquid 12X750ML","Income","Zelia Toilet Cleaner Liq",,"Undeposited Funds","",2520.00,1068182.73
,"Sales Receipt","04-10-2024","3252",,"Cash Sales","Zelia Toilet Cleaner Liquid 12X750ML","Income","Zelia Toilet Cleaner Liq",,"Undeposited Funds",0.00,"",1068182.73
,"Sales Receipt","05-10-2024","3420",,"Danaba Wholesallers","Zelia Toilet Cleaner Liquid 12X750ML","Income","Zelia Toilet Cleaner Liq",,"Undeposited Funds","",4320.00,1072502.73
,"Sales Receipt","06-10-2024","3184",,"Precious Mart","Zelia Toilet Cleaner Liquid 12X750ML","Income","Zelia Toilet Cleaner Liq",,"Undeposited Funds","",162.75,1072665.48
,"Sales Receipt","06-10-2024","3422",,"Mikara Shop","Zelia Toilet Cleaner Liquid 12X750ML","Income","Zelia Toilet Cleaner Liq",,"Undeposited Funds","",420.00,1073085.48
,"Sales Receipt","06-10-2024","3423",,"Jikweri Minimart","Zelia Toilet Cleaner Liquid 12X750ML","Income","Zelia Toilet Cleaner Liq",,"Undeposited Funds","",1302.00,1074387.48
,"Sales Receipt","07-10-2024","3254",,"Cash Sales","Zelia Toilet Cleaner Liquid 12X750ML","Income","Zelia Toilet Cleaner Liq",,"Undeposited Funds","",185.99,1074573.47
,"Sales Receipt","07-10-2024","3288",,"Adurus Wholesallers","Zelia Toilet Cleaner Liquid 12X750ML","Income","Zelia Toilet Cleaner Liq",,"Undeposited Funds","",5880.00,1080453.47
,"Sales Receipt","07-10-2024","3259",,"Himilo General Store","Zelia Toilet Cleaner Liquid 12X750ML","Income","Zelia Toilet Cleaner Liq",,"Undeposited Funds","",8820.00,1089273.47
,"Invoice","08-10-2024","MC06237",,"MASABA DISCOUNT STORES LTD","Zelia Toilet Cleaner Liquid 12X750ML","Income","Zelia Toilet Cleaner Liq",,"Accounts Receivable","",2524.14,1091797.61
,"Sales Receipt","08-10-2024","3262",,"Cash Sales","Zelia Toilet Cleaner Liquid 4X5L","Income","Zelia Toilet Cleaner Liq",,"Undeposited Funds","",2400.00,1094197.61
,"Sales Receipt","08-10-2024","3263",,"Cash Sales","Zelia Toilet Cleaner Liquid 4X5L","Income","Zelia Toilet Cleaner Liq",,"Undeposited Funds","",1100.00,1095297.61
,"Sales Receipt","08-10-2024","3264",,"Cash Sales","Zelia Toilet Cleaner Liquid 12X750ML","Income","Zelia Toilet Cleaner Liq",,"Undeposited Funds","",299.99,1095597.60
,"Sales Receipt","08-10-2024","3269",,"Cash Sales","Zelia Toilet Cleaner Liquid 12X750ML","Income","Zelia Toilet Cleaner Liq",,"Undeposited Funds","",181.99,1095779.59
,"Sales Receipt","08-10-2024","3272",,"Nyipola Minimart","Zelia Toilet Cleaner Liquid 12X750ML","Income","Zelia Toilet Cleaner Liq",,"Undeposited Funds","",1260.00,1097039.59
,"Sales Receipt","08-10-2024","3273",,"Safwan Wholesalers","Zelia Toilet Cleaner Liquid 12X750ML","Income","Zelia Toilet Cleaner Liq",,"Undeposited Funds","",11760.00,1108799.59
,"Invoice","09-10-2024","MC06246",,"MASABA DISCOUNT STORES LTD","Zelia Toilet Cleaner Liquid 12X750ML","Income","Zelia Toilet Cleaner Liq",,"Accounts Receivable","",2524.14,1111323.73
,"Sales Receipt","09-10-2024","3276",,"Cash Sales","-MULTIPLE-","Income","Zelia Toilet Cleaner Liq",,"Undeposited Funds","",4900.00,1116223.73
,"Sales Receipt","09-10-2024","3276",,"Cash Sales","Zelia Toilet Cleaner Liquid 12X750ML","Income","Zelia Toilet Cleaner Liq",,"Undeposited Funds",0.00,"",1116223.73
,"Sales Receipt","09-10-2024","3279",,"Cash Sales","Zelia Toilet Cleaner Liquid 4X5L","Income","Zelia Toilet Cleaner Liq",,"Undeposited Funds","",1053.00,1117276.73
,"Sales Receipt","11-10-2024","3289",,"Cash Sales","Zelia Toilet Cleaner Liquid 4X5L","Income","Zelia Toilet Cleaner Liq",,"Undeposited Funds","",1300.00,1118576.73
,"Sales Receipt","11-10-2024","3291",,"Cash Sales","Zelia Toilet Cleaner Liquid 12X750ML","Income","Zelia Toilet Cleaner Liq",,"Undeposited Funds","",364.01,1118940.74
,"Sales Receipt","11-10-2024","3292",,"Cash Sales","Zelia Toilet Cleaner Liquid 12X750ML","Income","Zelia Toilet Cleaner Liq",,"Undeposited Funds","",460.01,1119400.75
,"Sales Receipt","12-10-2024","3294",,"Afrodrip JKIA","Zelia Toilet Cleaner Liquid 4X5L","Income","Zelia Toilet Cleaner Liq",,"Undeposited Funds","",1053.00,1120453.75
,"Sales Receipt","15-10-2024","3187",,"Big Fish Minimart","Zelia Toilet Cleaner Liquid 12X750ML","Income","Zelia Toilet Cleaner Liq",,"Undeposited Funds","",651.00,1121104.75
,"Sales Receipt","15-10-2024","3106",,"Amani Store","Zelia Toilet Cleaner Liquid 12X750ML","Income","Zelia Toilet Cleaner Liq",,"Undeposited Funds","",2520.00,1123624.75
,"Sales Receipt","16-10-2024","3110",,"Cash Sales","Zelia Toilet Cleaner Liquid 12X750ML","Income","Zelia Toilet Cleaner Liq",,"Undeposited Funds","",364.01,1123988.76
,"Sales Receipt","16-10-2024","3112",,"Ruksan Shop","Zelia Toilet Cleaner Liquid 12X750ML","Income","Zelia Toilet Cleaner Liq",,"Undeposited Funds","",2520.00,1126508.76
,"Sales Receipt","18-10-2024","3127",,"Cash Sales","Zelia Toilet Cleaner Liquid 12X750ML","Income","Zelia Toilet Cleaner Liq",,"Undeposited Funds","",374.01,1126882.77
,"Sales Receipt","19-10-2024","3180",,"Witgad Shop","Zelia Toilet Cleaner Liquid 12X750ML","Income","Zelia Toilet Cleaner Liq",,"Undeposited Funds","",1302.00,1128184.77
,"Sales Receipt","22-10-2024","3133",,"tRIPPLE M","Zelia Toilet Cleaner Liquid 12X750ML","Income","Zelia Toilet Cleaner Liq",,"Undeposited Funds","",840.00,1129024.77
,"Sales Receipt","22-10-2024","3134",,"Zulu Enterprise","Zelia Toilet Cleaner Liquid 12X750ML","Income","Zelia Toilet Cleaner Liq",,"Undeposited Funds","",2520.00,1131544.77
,"Sales Receipt","23-10-2024","3136",,"Cash Sales","Zelia Toilet Cleaner Liquid 12X750ML","Income","Zelia Toilet Cleaner Liq",,"Undeposited Funds","",600.01,1132144.78
,"Sales Receipt","23-10-2024","3138",,"Cash Sales","Zelia Toilet Cleaner Liquid 4X5L","Income","Zelia Toilet Cleaner Liq",,"Undeposited Funds","",1200.00,1133344.78
,"Sales Receipt","23-10-2024","3139",,"Cash Sales","Zelia Toilet Cleaner Liquid 12X750ML","Income","Zelia Toilet Cleaner Liq",,"Undeposited Funds","",900.00,1134244.78
,"Sales Receipt","23-10-2024","3142",,"Cash Sales","Zelia Toilet Cleaner Liquid 12X750ML","Income","Zelia Toilet Cleaner Liq",,"Undeposited Funds","",249.99,1134494.77
,"Sales Receipt","23-10-2024","3144",,"Cash Sales","Zelia Toilet Cleaner Liquid 12X750ML","Income","Zelia Toilet Cleaner Liq",,"Undeposited Funds","",180.99,1134675.76
,"Sales Receipt","23-10-2024","3141",,"Kibibi Wasai Store","Zelia Toilet Cleaner Liquid 12X750ML","Income","Zelia Toilet Cleaner Liq",,"Undeposited Funds","",9936.00,1144611.76
,"Sales Receipt","24-10-2024","3148",,"Cash Sales","Zelia Toilet Cleaner Liquid 12X750ML","Income","Zelia Toilet Cleaner Liq",,"Undeposited Funds","",800.02,1145411.78
,"Sales Receipt","24-10-2024","3154",,"Horn of Africa","Zelia Toilet Cleaner Liquid 12X750ML","Income","Zelia Toilet Cleaner Liq",,"Undeposited Funds","",2940.00,1148351.78
,"Sales Receipt","24-10-2024","3165",,"Mombasa Velvet","Zelia Toilet Cleaner Liquid 4X5L","Income","Zelia Toilet Cleaner Liq",,"Undeposited Funds","",1053.00,1149404.78
,"Sales Receipt","24-10-2024","3153",,"Golden Store","Zelia Toilet Cleaner Liquid 12X750ML","Income","Zelia Toilet Cleaner Liq",,"Undeposited Funds","",2940.00,1152344.78
,"Invoice","25-10-2024","MC06300",,"HAPPY VIEW SUPERMARKET LIMITED","Zelia Toilet Cleaner Liquid 12X750ML  6Pcs @244","Income","Zelia Toilet Cleaner Liq",,"Accounts Receivable","",1262.07,1153606.85
,"Sales Receipt","25-10-2024","3159",,"Marris Mini mart","Zelia Toilet Cleaner Liquid 12X750ML","Income","Zelia Toilet Cleaner Liq",,"Undeposited Funds","",2100.00,1155706.85
,"Sales Receipt","26-10-2024","3161",,"Cash Sales","Zelia Toilet Cleaner Liquid 12X750ML","Income","Zelia Toilet Cleaner Liq",,"Undeposited Funds","",600.01,1156306.86
,"Invoice","28-10-2024","MC06309",,"MUHINDI MWEUSI SUPERMARKET LIMITED","Zelia Toilet Cleaner Liquid 12X750ML  6Pcs @244","Income","Zelia Toilet Cleaner Liq",,"Accounts Receivable","",1262.07,1157568.93
,"Invoice","28-10-2024","MC06311",,"MUHINDI MWEUSI SUPERMARKET LIMITED","Zelia Toilet Cleaner Liquid 12X750ML","Income","Zelia Toilet Cleaner Liq",,"Accounts Receivable","",2524.14,1160093.07
,"Invoice","28-10-2024","MC06312",,"MUHINDI MWEUSI SUPERMARKET LIMITED","Zelia Toilet Cleaner Liquid 12X750ML","Income","Zelia Toilet Cleaner Liq",,"Accounts Receivable","",2524.14,1162617.21
,"Invoice","28-10-2024","MC06313",,"MUHINDI MWEUSI SUPERMARKET LIMITED","Zelia Toilet Cleaner Liquid 12X750ML","Income","Zelia Toilet Cleaner Liq",,"Accounts Receivable","",2524.14,1165141.35
,"Sales Receipt","28-10-2024","3173",,"Nasra Super stores","Zelia Toilet Cleaner Liquid 12X750ML","Income","Zelia Toilet Cleaner Liq",,"Undeposited Funds","",1260.00,1166401.35
,"Sales Receipt","29-10-2024","3167",,"Cash Sales","Zelia Toilet Cleaner Liquid 12X750ML","Income","Zelia Toilet Cleaner Liq",,"Undeposited Funds","",249.99,1166651.34
,"Sales Receipt","29-10-2024","3169",,"Cash Sales","Zelia Toilet Cleaner Liquid 4X5L","Income","Zelia Toilet Cleaner Liq",,"Undeposited Funds","",576.00,1167227.34
,"Sales Receipt","29-10-2024","3705",,"Elliane Wholesalers","Zelia Toilet Cleaner Liquid 12X750ML","Income","Zelia Toilet Cleaner Liq",,"Undeposited Funds","",630.00,1167857.34
,"Sales Receipt","30-10-2024","3171",,"Cash Sales","Zelia Toilet Cleaner Liquid 4X5L","Income","Zelia Toilet Cleaner Liq",,"Undeposited Funds","",1200.00,1169057.34
,"Sales Receipt","30-10-2024","3725",,"Safa Groceries","Zelia Toilet Cleaner Liquid 12X750ML","Income","Zelia Toilet Cleaner Liq",,"Undeposited Funds","",2520.00,1171577.34
,"Sales Receipt","30-10-2024","3727",,"Ellas Store","Zelia Toilet Cleaner Liquid 12X750ML","Income","Zelia Toilet Cleaner Liq",,"Undeposited Funds","",2928.00,1174505.34
,"Sales Receipt","04-11-2024","3709",,"Brinso Foodstufs","Zelia Toilet Cleaner Liquid 12X750ML","Income","Zelia Toilet Cleaner Liq",,"Undeposited Funds","",5880.00,1180385.34
,"Sales Receipt","05-11-2024","3198",,"Cash Sales","Zelia Toilet Cleaner Liquid 12X750ML","Income","Zelia Toilet Cleaner Liq",,"Undeposited Funds","",362.01,1180747.35
,"Sales Receipt","05-11-2024","3714",,"Marris Mini mart","Zelia Toilet Cleaner Liquid 12X750ML","Income","Zelia Toilet Cleaner Liq",,"Undeposited Funds","",630.00,1181377.35
,"Invoice","06-11-2024","MC06333",,"MUHINDI MWEUSI SUPERMARKET LIMITED","Zelia Toilet Cleaner Liquid 12X750ML  14Pcs @244","Income","Zelia Toilet Cleaner Liq",,"Accounts Receivable","",2944.84,1184322.19
,"Invoice","06-11-2024","MC06334",,"MUHINDI MWEUSI SUPERMARKET LIMITED","Zelia Toilet Cleaner Liquid 12X750ML  12Pcs @244","Income","Zelia Toilet Cleaner Liq",,"Accounts Receivable","",2524.14,1186846.33
,"Invoice","06-11-2024","MC06335",,"Guard Mart Supermarket Limited","Zelia Toilet Cleaner Liquid 12X750ML  1pc @250.56","Income","Zelia Toilet Cleaner Liq",,"Accounts Receivable","",215.99,1187062.32
,"Invoice","06-11-2024","MC06336",,"Ellas Store","Zelia Toilet Cleaner Liquid 12X750ML  12pc @250.56","Income","Zelia Toilet Cleaner Liq",,"Accounts Receivable","",2592.00,1189654.32
,"Sales Receipt","06-11-2024","3199",,"Cash Sales","Zelia Toilet Cleaner Liquid 12X750ML","Income","Zelia Toilet Cleaner Liq",,"Undeposited Funds","",362.01,1190016.33
,"Sales Receipt","06-11-2024","3200",,"Cash Sales","Zelia Toilet Cleaner Liquid 12X750ML","Income","Zelia Toilet Cleaner Liq",,"Undeposited Funds","",181.99,1190198.32
,"Sales Receipt","06-11-2024","3402",,"Cash Sales","Zelia Toilet Cleaner Liquid 12X750ML","Income","Zelia Toilet Cleaner Liq",,"Undeposited Funds","",209.99,1190408.31
,"Sales Receipt","06-11-2024","3403",,"Cash Sales","Zelia Toilet Cleaner Liquid 12X750ML","Income","Zelia Toilet Cleaner Liq",,"Undeposited Funds","",180.99,1190589.30
,"Sales Receipt","06-11-2024","3718",,"Towba foodstuffs","Zelia Toilet Cleaner Liquid 12X750ML","Income","Zelia Toilet Cleaner Liq",,"Undeposited Funds","",5880.00,1196469.30
,"Sales Receipt","07-11-2024","3416",,"Cash Sales","Zelia Toilet Cleaner Liquid 12X750ML","Income","Zelia Toilet Cleaner Liq",,"Undeposited Funds",0.00,"",1196469.30
,"Sales Receipt","07-11-2024","3457",,"Dylyn Enterprise","Zelia Toilet Cleaner Liquid 12X750ML","Income","Zelia Toilet Cleaner Liq",,"Undeposited Funds","",1302.00,1197771.30
,"Sales Receipt","08-11-2024","3409",,"Cash Sales","Zelia Toilet Cleaner Liquid 4X5L","Income","Zelia Toilet Cleaner Liq",,"Undeposited Funds","",1200.00,1198971.30
,"Sales Receipt","08-11-2024","3414",,"Cash Sales","Zelia Toilet Cleaner Liquid 12X750ML","Income","Zelia Toilet Cleaner Liq",,"Undeposited Funds","",181.99,1199153.29
,"Sales Receipt","08-11-2024","3458",,"Mama Sam Shop","Zelia Toilet Cleaner Liquid 12X750ML","Income","Zelia Toilet Cleaner Liq",,"Undeposited Funds","",1302.00,1200455.29
,"Sales Receipt","11-11-2024","3415",,"Cash Sales","Zelia Toilet Cleaner Liquid 12X750ML","Income","Zelia Toilet Cleaner Liq",,"Undeposited Funds","",364.01,1200819.30
,"Sales Receipt","11-11-2024","3420",,"Cash Sales","Zelia Toilet Cleaner Liquid 12X750ML","Income","Zelia Toilet Cleaner Liq",,"Undeposited Funds","",1200.00,1202019.30
,"Sales Receipt","11-11-2024","3421",,"Cash Sales","Zelia Toilet Cleaner Liquid 12X750ML","Income","Zelia Toilet Cleaner Liq",,"Undeposited Funds","",182.00,1202201.30
,"Sales Receipt","11-11-2024","3456",,"RichMind Property","Zelia Toilet Cleaner Liquid 12X750ML","Income","Zelia Toilet Cleaner Liq",,"Undeposited Funds","",420.00,1202621.30
,"Sales Receipt","11-11-2024","3424",,"Himilo General Store","Zelia Toilet Cleaner Liquid 12X750ML","Income","Zelia Toilet Cleaner Liq",,"Undeposited Funds","",11760.00,1214381.30
,"Sales Receipt","11-11-2024","3427",,"Aidurus shop","Zelia Toilet Cleaner Liquid 12X750ML","Income","Zelia Toilet Cleaner Liq",,"Undeposited Funds","",5880.00,1220261.30
,"Sales Receipt","12-11-2024","3431",,"Cash Sales","-MULTIPLE-","Income","Zelia Toilet Cleaner Liq",,"Undeposited Funds","",22300.00,1242561.30
,"Sales Receipt","12-11-2024","3437",,"Jombs wholesalers","Zelia Toilet Cleaner Liquid 12X750ML","Income","Zelia Toilet Cleaner Liq",,"Undeposited Funds","",630.00,1243191.30
,"Sales Receipt","12-11-2024","3459",,"Dawa min mitt","Zelia Toilet Cleaner Liquid 12X750ML","Income","Zelia Toilet Cleaner Liq",,"Undeposited Funds","",2604.00,1245795.30
,"Sales Receipt","12-11-2024","3439",,"Maida Minimart","Zelia Toilet Cleaner Liquid 12X750ML","Income","Zelia Toilet Cleaner Liq",,"Undeposited Funds","",1260.00,1247055.30
,"Invoice","13-11-2024","MC06356",,"Mumsha Supamat","Zelia Toilet Cleaner Liquid 12X750ML  6Pieces @243","Income","Zelia Toilet Cleaner Liq",,"Accounts Receivable","",1256.90,1248312.20
,"Invoice","13-11-2024","MC06358",,"BETTER DEAL WHOLESALERS LIMITED","Zelia Toilet Cleaner Liquid 12X750ML","Income","Zelia Toilet Cleaner Liq",,"Accounts Receivable","",15082.76,1263394.96
,"Invoice","13-11-2024","MC06359",,"PRICE CHOPPER STORES LIMITED","Zelia Toilet Cleaner Liquid 12X750ML  6Pieces@243","Income","Zelia Toilet Cleaner Liq",,"Accounts Receivable","",1256.89,1264651.85
,"Sales Receipt","13-11-2024","3440",,"Saacid Shop","Zelia Toilet Cleaner Liquid 12X750ML","Income","Zelia Toilet Cleaner Liq",,"Undeposited Funds","",2940.00,1267591.85
,"Sales Receipt","13-11-2024","3493",,"Mwambao Shop","Zelia Toilet Cleaner Liquid 12X750ML","Income","Zelia Toilet Cleaner Liq",,"Undeposited Funds","",420.00,1268011.85
,"Sales Receipt","13-11-2024","3460",,"Helly Supermarket","Zelia Toilet Cleaner Liquid 12X750ML","Income","Zelia Toilet Cleaner Liq",,"Undeposited Funds","",1320.00,1269331.85
,"Sales Receipt","13-11-2024","3444",,"Mango Shop","Zelia Toilet Cleaner Liquid 12X750ML","Income","Zelia Toilet Cleaner Liq",,"Undeposited Funds","",2940.00,1272271.85
,"Sales Receipt","13-11-2024","3445",,"Gold mart Supermarket","Zelia Toilet Cleaner Liquid 12X750ML","Income","Zelia Toilet Cleaner Liq",,"Undeposited Funds","",2940.00,1275211.85
,"Sales Receipt","14-11-2024","3447",,"Amir Wholesalers","Zelia Toilet Cleaner Liquid 12X750ML","Income","Zelia Toilet Cleaner Liq",,"Undeposited Funds","",1260.00,1276471.85
,"Invoice","15-11-2024","MC06366",,"MUHINDI MWEUSI SUPERMARKET LIMITED","Zelia Toilet Cleaner Liquid 12X750ML  12Pcs @244","Income","Zelia Toilet Cleaner Liq",,"Accounts Receivable","",2524.14,1278995.99
,"Sales Receipt","15-11-2024","3729",,"Cash Sales","Zelia Toilet Cleaner Liquid 12X750ML","Income","Zelia Toilet Cleaner Liq",,"Undeposited Funds","",182.00,1279177.99
,"Invoice","18-11-2024","MC06372",,"Guard Mart Supermarket Limited","Zelia Toilet Cleaner Liquid 12X750ML  12pc @250.56","Income","Zelia Toilet Cleaner Liq",,"Accounts Receivable","",2592.00,1281769.99
,"Credit Note","18-11-2024","CN01073",,"Guard Mart Supermarket Limited","Zelia Toilet Cleaner Liquid 12X750ML  1pc @250.56","Income","Zelia Toilet Cleaner Liq",,"Accounts Receivable",215.99,"",1281554.00
,"Sales Receipt","18-11-2024","3468",,"Cash Sales","Zelia Toilet Cleaner Liquid 12X750ML","Income","Zelia Toilet Cleaner Liq",,"Undeposited Funds","",1250.00,1282804.00
,"Sales Receipt","18-11-2024","3473",,"Cash Sales","Zelia Toilet Cleaner Liquid 12X750ML","Income","Zelia Toilet Cleaner Liq",,"Undeposited Funds",0.00,"",1282804.00
,"Sales Receipt","18-11-2024","3495",,"Murume Shop","Zelia Toilet Cleaner Liquid 12X750ML","Income","Zelia Toilet Cleaner Liq",,"Undeposited Funds","",630.00,1283434.00
,"Sales Receipt","18-11-2024","3463",,"Gifted Shop","Zelia Toilet Cleaner Liquid 12X750ML","Income","Zelia Toilet Cleaner Liq",,"Undeposited Funds","",1302.00,1284736.00
,"Sales Receipt","18-11-2024","3464",,"Restoration Traders","Zelia Toilet Cleaner Liquid 12X750ML","Income","Zelia Toilet Cleaner Liq",,"Undeposited Funds","",5880.00,1290616.00
,"Sales Receipt","18-11-2024","3465",,"Gure Yare Shop","Zelia Toilet Cleaner Liquid 12X750ML","Income","Zelia Toilet Cleaner Liq",,"Undeposited Funds","",5880.00,1296496.00
,"Sales Receipt","18-11-2024","3466",,"Faisel Wholesale","Zelia Toilet Cleaner Liquid 12X750ML","Income","Zelia Toilet Cleaner Liq",,"Undeposited Funds","",2460.00,1298956.00
,"Sales Receipt","18-11-2024","3467",,"Mombasa Velvet","Zelia Toilet Cleaner Liquid 4X5L","Income","Zelia Toilet Cleaner Liq",,"Undeposited Funds","",2106.00,1301062.00
,"Invoice","19-11-2024","MC06376",,"MUHINDI MWEUSI SUPERMARKET LIMITED","Zelia Toilet Cleaner Liquid 12X750ML  12Pcs @244","Income","Zelia Toilet Cleaner Liq",,"Accounts Receivable","",2524.14,1303586.14
,"Invoice","19-11-2024","MC06379",,"DALLAS SHOPRITE LTD","Zelia Toilet Cleaner Liquid 12X750ML  6Pcs@243","Income","Zelia Toilet Cleaner Liq",,"Accounts Receivable","",1256.90,1304843.04
,"Sales Receipt","19-11-2024","3475",,"Cash Sales","Zelia Toilet Cleaner Liquid 12X750ML","Income","Zelia Toilet Cleaner Liq",,"Undeposited Funds","",182.00,1305025.04
,"Sales Receipt","19-11-2024","3301",,"Cash Sales","Zelia Toilet Cleaner Liquid 12X750ML","Income","Zelia Toilet Cleaner Liq",,"Undeposited Funds","",364.00,1305389.04
,"Sales Receipt","19-11-2024","3471",,"Kedulle Enterprises","Zelia Toilet Cleaner Liquid 12X750ML","Income","Zelia Toilet Cleaner Liq",,"Undeposited Funds","",5880.00,1311269.04
,"Sales Receipt","20-11-2024","3477",,"Cash Sales","Zelia Toilet Cleaner Liquid 12X750ML","Income","Zelia Toilet Cleaner Liq",,"Undeposited Funds",0.00,"",1311269.04
,"Sales Receipt","20-11-2024","3497",,"032 minimart","Zelia Toilet Cleaner Liquid 12X750ML","Income","Zelia Toilet Cleaner Liq",,"Undeposited Funds","",1470.00,1312739.04
,"Sales Receipt","21-11-2024","3496",,"infinity Store","Zelia Toilet Cleaner Liquid 4X5L","Income","Zelia Toilet Cleaner Liq",,"Undeposited Funds","",2106.00,1314845.04
,"Sales Receipt","22-11-2024","3499",,"Cash Sales","-MULTIPLE-","Income","Zelia Toilet Cleaner Liq",,"Undeposited Funds","",2800.00,1317645.04
,"Sales Receipt","22-11-2024","3734",,"Cash Sales","Zelia Toilet Cleaner Liquid 12X750ML","Income","Zelia Toilet Cleaner Liq",,"Undeposited Funds","",182.00,1317827.04
,"Invoice","26-11-2024","MC06416",,"MUHINDI MWEUSI SUPERMARKET LIMITED","Zelia Toilet Cleaner Liquid 12X750ML  12Pcs @244","Income","Zelia Toilet Cleaner Liq",,"Accounts Receivable","",2524.14,1320351.18
,"Sales Receipt","26-11-2024","3740",,"Afrodrip JKIA","Zelia Toilet Cleaner Liquid 4X5L","Income","Zelia Toilet Cleaner Liq",,"Undeposited Funds","",2106.00,1322457.18
,"Sales Receipt","27-11-2024","3743",,"Mama Amina","Zelia Toilet Cleaner Liquid 12X750ML","Income","Zelia Toilet Cleaner Liq",,"Undeposited Funds","",2940.00,1325397.18
,"Sales Receipt","27-11-2024","3744",,"ABM Grocery Shop","Zelia Toilet Cleaner Liquid 12X750ML","Income","Zelia Toilet Cleaner Liq",,"Undeposited Funds","",2460.00,1327857.18
,"Sales Receipt","27-11-2024","3764",,"Molly Shop","Zelia Toilet Cleaner Liquid 12X750ML","Income","Zelia Toilet Cleaner Liq",,"Undeposited Funds","",1302.00,1329159.18
,"Sales Receipt","28-11-2024","3751",,"Cash Sales","Zelia Toilet Cleaner Liquid 4X5L","Income","Zelia Toilet Cleaner Liq",,"Undeposited Funds","",1400.00,1330559.18
,"Sales Receipt","28-11-2024","3753",,"Cash Sales","Zelia Toilet Cleaner Liquid 12X750ML","Income","Zelia Toilet Cleaner Liq",,"Undeposited Funds","",182.00,1330741.18
,"Sales Receipt","29-11-2024","3789",,"Ubwete Shop","Zelia Toilet Cleaner Liquid 12X750ML","Income","Zelia Toilet Cleaner Liq",,"Undeposited Funds","",2520.00,1333261.18
,"Sales Receipt","02-12-2024","3761",,"Cash Sales","Zelia Toilet Cleaner Liquid 4X5L","Income","Zelia Toilet Cleaner Liq",,"Undeposited Funds","",1380.00,1334641.18
,"Sales Receipt","02-12-2024","3767",,"Cash Sales","Zelia Toilet Cleaner Liquid 12X750ML","Income","Zelia Toilet Cleaner Liq",,"Undeposited Funds","",300.00,1334941.18
,"Sales Receipt","02-12-2024","3777",,"Cash Sales","Zelia Toilet Cleaner Liquid 12X750ML","Income","Zelia Toilet Cleaner Liq",,"Undeposited Funds","",250.00,1335191.18
,"Sales Receipt","02-12-2024","3773",,"Horn of Africa","Zelia Toilet Cleaner Liquid 12X750ML","Income","Zelia Toilet Cleaner Liq",,"Undeposited Funds","",2940.00,1338131.18
,"Sales Receipt","02-12-2024","3776",,"Elwak Stores","Zelia Toilet Cleaner Liquid 12X750ML","Income","Zelia Toilet Cleaner Liq",,"Undeposited Funds","",2460.00,1340591.18
,"Sales Receipt","03-12-2024","3782",,"Summer Outlets","Zelia Toilet Cleaner Liquid 12X750ML","Income","Zelia Toilet Cleaner Liq",,"Undeposited Funds","",2520.00,1343111.18
,"Invoice","04-12-2024","MC06436",,"LUCKY MART SUPERMARKET LIMITED","Zelia Toilet Cleaner Liquid 12X750ML  12Pcs@243","Income","Zelia Toilet Cleaner Liq",,"Accounts Receivable","",2513.79,1345624.97
,"Sales Receipt","04-12-2024","3784",,"Gure Yare Shop","Zelia Toilet Cleaner Liquid 12X750ML","Income","Zelia Toilet Cleaner Liq",,"Undeposited Funds","",11480.00,1357104.97
,"Sales Receipt","04-12-2024","3785",,"Towba Parkroad","Zelia Toilet Cleaner Liquid 12X750ML","Income","Zelia Toilet Cleaner Liq",,"Undeposited Funds","",5880.00,1362984.97
,"Invoice","05-12-2024","MC06447",,"NASRI MART LIMITED","Zelia Toilet Cleaner Liquid 12X750ML  12Pcs@244","Income","Zelia Toilet Cleaner Liq",,"Accounts Receivable","",2524.14,1365509.11
,"Sales Receipt","05-12-2024","3309",,"Freshfinds Mart","Zelia Toilet Cleaner Liquid 12X750ML","Income","Zelia Toilet Cleaner Liq",,"Undeposited Funds","",1260.00,1366769.11
,"Sales Receipt","05-12-2024","3796",,"Towba Eastleigh","Zelia Toilet Cleaner Liquid 12X750ML","Income","Zelia Toilet Cleaner Liq",,"Undeposited Funds","",5880.00,1372649.11
,"Sales Receipt","05-12-2024","3797",,"Britco Wholesalers","Zelia Toilet Cleaner Liquid 12X750ML","Income","Zelia Toilet Cleaner Liq",,"Undeposited Funds","",14350.00,1386999.11
,"Sales Receipt","05-12-2024","3798",,"Mama G shop","Zelia Toilet Cleaner Liquid 12X750ML","Income","Zelia Toilet Cleaner Liq",,"Undeposited Funds","",5040.00,1392039.11
,"Sales Receipt","05-12-2024","3306",,"Corner Shop","Zelia Toilet Cleaner Liquid 12X750ML","Income","Zelia Toilet Cleaner Liq",,"Undeposited Funds","",2940.00,1394979.11
,"Sales Receipt","05-12-2024","3327",,"Macbellah Shop","Zelia Toilet Cleaner Liquid 12X750ML","Income","Zelia Toilet Cleaner Liq",,"Undeposited Funds","",1302.00,1396281.11
,"Sales Receipt","10-12-2024","3321",,"Cash Sales","Zelia Toilet Cleaner Liquid 12X750ML","Income","Zelia Toilet Cleaner Liq",,"Undeposited Funds","",1800.00,1398081.11
,"Sales Receipt","10-12-2024","3347",,"Beta Traders","Zelia Toilet Cleaner Liquid 12X750ML","Income","Zelia Toilet Cleaner Liq",,"Undeposited Funds","",2940.00,1401021.11
,"Sales Receipt","10-12-2024","3332",,"Amir Wholesalers","Zelia Toilet Cleaner Liquid 12X750ML","Income","Zelia Toilet Cleaner Liq",,"Undeposited Funds","",1260.00,1402281.11
,"Sales Receipt","14-12-2024","3378",,"Egesa Shop","Zelia Toilet Cleaner Liquid 12X750ML","Income","Zelia Toilet Cleaner Liq",,"Undeposited Funds","",868.00,1403149.11
,"Sales Receipt","16-12-2024","3342",,"Cash Sales","Zelia Toilet Cleaner Liquid 12X750ML","Income","Zelia Toilet Cleaner Liq",,"Undeposited Funds","",250.00,1403399.11
,"Sales Receipt","16-12-2024","3345",,"Cash Sales","Zelia Toilet Cleaner Liquid 12X750ML","Income","Zelia Toilet Cleaner Liq",,"Undeposited Funds","",500.00,1403899.11
,"Sales Receipt","16-12-2024","3346",,"Cash Sales","Zelia Toilet Cleaner Liquid 4X5L","Income","Zelia Toilet Cleaner Liq",,"Undeposited Funds","",2400.00,1406299.11
,"Sales Receipt","16-12-2024","3348",,"Cash Sales","Zelia Toilet Cleaner Liquid 4X5L","Income","Zelia Toilet Cleaner Liq",,"Undeposited Funds","",1500.00,1407799.11
,"Invoice","17-12-2024","MC06475",,"MUHINDI MWEUSI SUPERMARKET LIMITED","Zelia Toilet Cleaner Liquid 12X750ML  14Pcs @244","Income","Zelia Toilet Cleaner Liq",,"Accounts Receivable","",2944.84,1410743.95
,"Sales Receipt","17-12-2024","3354",,"Cash Sales","Zelia Toilet Cleaner Liquid 12X750ML","Income","Zelia Toilet Cleaner Liq",,"Undeposited Funds","",800.00,1411543.95
,"Sales Receipt","17-12-2024","3357",,"Safwan Wholesalers","Zelia Toilet Cleaner Liquid 12X750ML","Income","Zelia Toilet Cleaner Liq",,"Undeposited Funds","",14760.00,1426303.95
,"Sales Receipt","18-12-2024","3363",,"Cash Sales","Zelia Toilet Cleaner Liquid 12X750ML","Income","Zelia Toilet Cleaner Liq",,"Undeposited Funds","",183.00,1426486.95
,"Sales Receipt","18-12-2024","3365",,"Mango Shop","Zelia Toilet Cleaner Liquid 12X750ML","Income","Zelia Toilet Cleaner Liq",,"Undeposited Funds","",2940.00,1429426.95
,"Sales Receipt","18-12-2024","3368",,"Warfa Wholesale","Zelia Toilet Cleaner Liquid 12X750ML","Income","Zelia Toilet Cleaner Liq",,"Undeposited Funds","",14760.00,1444186.95
"Total Zelia Toilet Cleaner Liq",,,,,,,,,,,3311.34,1447498.29,1444186.95
"Zelia Handwash Liquid",,,,,,,,,,,,,""
,"Sales Receipt","03-01-2024","1592",,"Cash Sales","Zelia Apple Handwash Liquid 500ML","Income","Zelia Handwash Liquid",,"Undeposited Funds","",450.00,450.00
,"Sales Receipt","03-01-2024","1594",,"ROYAL SEALS SUPERMARKET","-MULTIPLE-","Income","Zelia Handwash Liquid",,"Undeposited Funds","",1785.00,2235.00
,"Invoice","04-01-2024","MC05269",,"OFFSHORE GLOBAL LOGISTICS LIMITED","Zelia Strawberry Handwash Liquid 5L","Income","Zelia Handwash Liquid",,"Accounts Receivable","",1317.24,3552.24
,"Sales Receipt","04-01-2024","1704",,"Cash Sales","-MULTIPLE-","Income","Zelia Handwash Liquid",,"Undeposited Funds",0.00,"",3552.24
,"Sales Receipt","04-01-2024","1707",,"Mama Amina","-MULTIPLE-","Income","Zelia Handwash Liquid",,"Undeposited Funds","",1190.00,4742.24
,"Sales Receipt","05-01-2024","1711",,"Summer Outlets","-MULTIPLE-","Income","Zelia Handwash Liquid",,"Undeposited Funds","",1428.00,6170.24
,"Sales Receipt","07-01-2024","1714",,"Cash Sales","Zelia Strawberry Handwash Liquid 500ML","Income","Zelia Handwash Liquid",,"Undeposited Funds","",105.00,6275.24
,"Sales Receipt","08-01-2024","1713",,"Cash Sales","Zelia Strawberry Handwash Liquid 5L","Income","Zelia Handwash Liquid",,"Undeposited Funds",0.00,"",6275.24
,"Sales Receipt","10-01-2024","1718",,"Memos Supermarket","-MULTIPLE-","Income","Zelia Handwash Liquid",,"Undeposited Funds","",1428.00,7703.24
,"Sales Receipt","12-01-2024","1733",,"Cash Sales","Zelia Strawberry Handwash Liquid 5L","Income","Zelia Handwash Liquid",,"Undeposited Funds","",750.00,8453.24
,"Sales Receipt","12-01-2024","1733",,"Cash Sales","Zelia Strawberry Handwash Liquid 500ML","Income","Zelia Handwash Liquid",,"Undeposited Funds",0.00,"",8453.24
,"Invoice","15-01-2024","MC05311",,"Seasons lane Mart","-MULTIPLE-","Income","Zelia Handwash Liquid",,"Accounts Receivable","",1427.58,9880.82
,"Invoice","15-01-2024","MC05312",,"KASAMAT INVESTMENTS LTD","-MULTIPLE-","Income","Zelia Handwash Liquid",,"Accounts Receivable","",713.80,10594.62
,"Sales Receipt","15-01-2024","1729",,"Cash Sales","Zelia Apple Handwash Liquid 500ML","Income","Zelia Handwash Liquid",,"Undeposited Funds","",105.00,10699.62
,"Sales Receipt","15-01-2024","1730",,"tRIPPLE M","-MULTIPLE-","Income","Zelia Handwash Liquid",,"Undeposited Funds","",714.00,11413.62
,"Sales Receipt","15-01-2024","1731",,"RAZAQ AIRWAYS","-MULTIPLE-","Income","Zelia Handwash Liquid",,"Undeposited Funds","",6202.00,17615.62
,"Sales Receipt","15-01-2024","1732",,"Somo 1","-MULTIPLE-","Income","Zelia Handwash Liquid",,"Undeposited Funds","",1785.00,19400.62
,"Sales Receipt","16-01-2024","1740",,"Cash Sales","Zelia Strawberry Handwash Liquid 500ML","Income","Zelia Handwash Liquid",,"Undeposited Funds","",123.00,19523.62
,"Sales Receipt","17-01-2024","1734",,"Cash Sales","Zelia Strawberry Handwash Liquid 5L","Income","Zelia Handwash Liquid",,"Undeposited Funds","",2100.00,21623.62
,"Sales Receipt","17-01-2024","1748",,"Yasin Shop","Zelia Apple Handwash Liquid 500ML","Income","Zelia Handwash Liquid",,"Undeposited Funds","",119.00,21742.62
,"Invoice","19-01-2024","MC05331",,"Zenith Steel Fabricators Ltd","Zelia Strawberry Handwash Liquid 5L","Income","Zelia Handwash Liquid",,"Accounts Receivable","",13600.00,35342.62
,"Sales Receipt","19-01-2024","1739",,"Cash Sales","-MULTIPLE-","Income","Zelia Handwash Liquid",,"Undeposited Funds",0.00,"",35342.62
,"Sales Receipt","19-01-2024","1744",,"Cash Sales","Zelia Strawberry Handwash Liquid 500ML","Income","Zelia Handwash Liquid",,"Undeposited Funds","",3570.00,38912.62
,"Sales Receipt","19-01-2024","1744",,"Cash Sales","Zelia Apple Handwash Liquid 500ML","Income","Zelia Handwash Liquid",,"Undeposited Funds",0.00,"",38912.62
,"Sales Receipt","19-01-2024","1747",,"Nyipola Minimart","-MULTIPLE-","Income","Zelia Handwash Liquid",,"Undeposited Funds","",1785.00,40697.62
,"Invoice","24-01-2024","MC05346",,"Qways Supermarket","-MULTIPLE-","Income","Zelia Handwash Liquid",,"Accounts Receivable","",1784.48,42482.10
,"Invoice","25-01-2024","MC05350",,"Drychem Kenya Solutions Limited","Zelia Strawberry Handwash Liquid 5L","Income","Zelia Handwash Liquid",,"Accounts Receivable","",1400.00,43882.10
,"Sales Receipt","25-01-2024","1758",,"Cash Sales","Zelia Strawberry Handwash Liquid 5L","Income","Zelia Handwash Liquid",,"Undeposited Funds","",1500.00,45382.10
,"Sales Receipt","29-01-2024","1759",,"Cash Sales","-MULTIPLE-","Income","Zelia Handwash Liquid",,"Undeposited Funds","",714.00,46096.10
,"Sales Receipt","30-01-2024","1767",,"Cash Sales","Zelia Strawberry Handwash Liquid 500ML","Income","Zelia Handwash Liquid",,"Undeposited Funds","",300.00,46396.10
,"Sales Receipt","30-01-2024","1770",,"Pambazuka Mart (K) Limited","-MULTIPLE-","Income","Zelia Handwash Liquid",,"Undeposited Funds","",1785.00,48181.10
,"Sales Receipt","31-01-2024","1773",,"Cash Sales","-MULTIPLE-","Income","Zelia Handwash Liquid",,"Undeposited Funds",0.00,"",48181.10
,"Sales Receipt","01-02-2024","1776",,"FARMERS BEST GROCERY","Zelia Apple Handwash Liquid 500ML","Income","Zelia Handwash Liquid",,"Undeposited Funds","",828.00,49009.10
,"Invoice","02-02-2024","MC05378",,"MZOORI STORE LIMITED","Zelia Strawberry Handwash Liquid 500ML","Income","Zelia Handwash Liquid",,"Accounts Receivable","",713.79,49722.89
,"Invoice","02-02-2024","MC05379",,"HOPEMART SELF SERVICES LTD","-MULTIPLE-","Income","Zelia Handwash Liquid",,"Accounts Receivable","",3568.96,53291.85
,"Sales Receipt","02-02-2024","1783",,"Cheche Minimart","-MULTIPLE-","Income","Zelia Handwash Liquid",,"Undeposited Funds","",714.00,54005.85
,"Sales Receipt","02-02-2024","1784",,"Kandara minimart","-MULTIPLE-","Income","Zelia Handwash Liquid",,"Undeposited Funds","",714.00,54719.85
,"Sales Receipt","03-02-2024","1792",,"Soimo Minimart","-MULTIPLE-","Income","Zelia Handwash Liquid",,"Undeposited Funds","",714.00,55433.85
,"Invoice","05-02-2024","MC05384",,"INTEGRAL MEDIA LIMITED","-MULTIPLE-","Income","Zelia Handwash Liquid",,"Accounts Receivable","",3568.97,59002.82
,"Invoice","05-02-2024","MC05385",,"TAWALA SUPERMARKET LIMITED","-MULTIPLE-","Income","Zelia Handwash Liquid",,"Accounts Receivable","",2855.18,61858.00
,"Sales Receipt","05-02-2024","1787",,"Cash Sales","Zelia Strawberry Handwash Liquid 500ML","Income","Zelia Handwash Liquid",,"Undeposited Funds",0.00,"",61858.00
,"Sales Receipt","05-02-2024","1791",,"The Hub Minimart","-MULTIPLE-","Income","Zelia Handwash Liquid",,"Undeposited Funds","",476.00,62334.00
,"Sales Receipt","06-02-2024","1808",,"Cash Sales","Zelia Strawberry Handwash Liquid 500ML","Income","Zelia Handwash Liquid",,"Undeposited Funds","",111.00,62445.00
,"Sales Receipt","08-02-2024","1814",,"Cash Sales","Zelia Strawberry Handwash Liquid 500ML","Income","Zelia Handwash Liquid",,"Undeposited Funds",0.00,"",62445.00
,"Sales Receipt","08-02-2024","1815",,"Cash Sales","Zelia Strawberry Handwash Liquid 500ML","Income","Zelia Handwash Liquid",,"Undeposited Funds",0.00,"",62445.00
,"Sales Receipt","09-02-2024","1828",,"Kwa Zulu Wholesale Utawala","Zelia Strawberry Handwash Liquid 500ML","Income","Zelia Handwash Liquid",,"Undeposited Funds","",1428.00,63873.00
,"Sales Receipt","10-02-2024","1821",,"Alma Mart","-MULTIPLE-","Income","Zelia Handwash Liquid",,"Undeposited Funds","",714.00,64587.00
,"Invoice","12-02-2024","MC05396",,"OFFSHORE GLOBAL LOGISTICS LIMITED","Zelia Strawberry Handwash Liquid 20L","Income","Zelia Handwash Liquid",,"Accounts Receivable","",2193.10,66780.10
,"Invoice","12-02-2024","MC05400",,"KASAMAT INVESTMENTS LTD","Zelia Apple Handwash Liquid 500ML","Income","Zelia Handwash Liquid",,"Accounts Receivable","",356.90,67137.00
,"Sales Receipt","12-02-2024","1822",,"Deeps General Shop","Zelia Strawberry Handwash Liquid 500ML","Income","Zelia Handwash Liquid",,"Undeposited Funds","",238.00,67375.00
,"Sales Receipt","12-02-2024","1823",,"INTEGRAL MEDIA LIMITED","-MULTIPLE-","Income","Zelia Handwash Liquid",,"Undeposited Funds","",5355.00,72730.00
,"Invoice","14-02-2024","MC05407",,"Qways Supermarket","-MULTIPLE-","Income","Zelia Handwash Liquid",,"Accounts Receivable","",2855.17,75585.17
,"Sales Receipt","14-02-2024","1835",,"Bismillahi Shop","-MULTIPLE-","Income","Zelia Handwash Liquid",,"Undeposited Funds","",1428.00,77013.17
,"Sales Receipt","14-02-2024","1838",,"Cash Sales","Zelia Strawberry Handwash Liquid 5L","Income","Zelia Handwash Liquid",,"Undeposited Funds",0.00,"",77013.17
,"Sales Receipt","15-02-2024","1842",,"Gacal Wholesale","-MULTIPLE-","Income","Zelia Handwash Liquid",,"Undeposited Funds","",1428.00,78441.17
,"Sales Receipt","16-02-2024","1845",,"Cash Sales","Zelia Strawberry Handwash Liquid 500ML","Income","Zelia Handwash Liquid",,"Undeposited Funds",0.00,"",78441.17
,"Sales Receipt","16-02-2024","1847",,"Gidesh Supermarket","-MULTIPLE-","Income","Zelia Handwash Liquid",,"Undeposited Funds","",1428.00,79869.17
,"Sales Receipt","16-02-2024","1848",,"Cash Sales","Zelia Apple Handwash Liquid 500ML","Income","Zelia Handwash Liquid",,"Undeposited Funds","",110.00,79979.17
,"Sales Receipt","19-02-2024","1850",,"Zamaridi wholesalers","-MULTIPLE-","Income","Zelia Handwash Liquid",,"Undeposited Funds","",357.00,80336.17
,"Sales Receipt","20-02-2024","1854",,"Cash Sales","Zelia Strawberry Handwash Liquid 5L","Income","Zelia Handwash Liquid",,"Undeposited Funds",0.00,"",80336.17
,"Sales Receipt","21-02-2024","1855",,"Cash Sales","Zelia Apple Handwash Liquid 500ML","Income","Zelia Handwash Liquid",,"Undeposited Funds","",140.00,80476.17
,"Sales Receipt","21-02-2024","1859",,"Cash Sales","Zelia Strawberry Handwash Liquid 500ML","Income","Zelia Handwash Liquid",,"Undeposited Funds","",238.00,80714.17
,"Sales Receipt","21-02-2024","1860",,"Cash Sales","-MULTIPLE-","Income","Zelia Handwash Liquid",,"Undeposited Funds","",714.00,81428.17
,"Sales Receipt","21-02-2024","1862",,"Ebenezer  Minimart","-MULTIPLE-","Income","Zelia Handwash Liquid",,"Undeposited Funds","",714.00,82142.17
,"Sales Receipt","21-02-2024","1863",,"CLJ Baraka Enterprise","-MULTIPLE-","Income","Zelia Handwash Liquid",,"Undeposited Funds","",1428.00,83570.17
,"Invoice","22-02-2024","MC05429",,"INTEGRAL MEDIA LIMITED","-MULTIPLE-","Income","Zelia Handwash Liquid",,"Accounts Receivable","",1784.48,85354.65
,"Invoice","22-02-2024","MC05434",,"NASRI MART LIMITED","-MULTIPLE-","Income","Zelia Handwash Liquid",,"Accounts Receivable","",1189.66,86544.31
,"Invoice","23-02-2024","MC05443",,"DAILY CHAMPIONS MINI SUPERMARKET LIMITED","-MULTIPLE-","Income","Zelia Handwash Liquid",,"Accounts Receivable","",1784.48,88328.79
,"Sales Receipt","23-02-2024","1870",,"Home Cell Minimart","-MULTIPLE-","Income","Zelia Handwash Liquid",,"Undeposited Funds","",714.00,89042.79
,"Sales Receipt","23-02-2024","1871",,"Leelan Bookshop","-MULTIPLE-","Income","Zelia Handwash Liquid",,"Undeposited Funds","",2856.00,91898.79
,"Invoice","26-02-2024","MC05444",,"The Joymai Blessed Stores Limited","-MULTIPLE-","Income","Zelia Handwash Liquid",,"Accounts Receivable","",1427.58,93326.37
,"Invoice","26-02-2024","MC05445",,"Mumsha Supamat","-MULTIPLE-","Income","Zelia Handwash Liquid",,"Accounts Receivable","",713.80,94040.17
,"Sales Receipt","26-02-2024","1872",,"Jombs wholesalers","-MULTIPLE-","Income","Zelia Handwash Liquid",,"Undeposited Funds","",238.00,94278.17
,"Sales Receipt","26-02-2024","1873",,"mamkon minimart","-MULTIPLE-","Income","Zelia Handwash Liquid",,"Undeposited Funds","",238.00,94516.17
,"Sales Receipt","26-02-2024","1875",,"Cash Sales","Zelia Strawberry Handwash Liquid 500ML","Income","Zelia Handwash Liquid",,"Undeposited Funds","",595.00,95111.17
,"Sales Receipt","27-02-2024","1878",,"Cash Sales","Zelia Strawberry Handwash Liquid 5L","Income","Zelia Handwash Liquid",,"Undeposited Funds","",750.00,95861.17
,"Sales Receipt","28-02-2024","1885",,"Amulqura Shop","-MULTIPLE-","Income","Zelia Handwash Liquid",,"Undeposited Funds","",714.00,96575.17
,"Sales Receipt","29-02-2024","1889",,"Cash Sales","Zelia Apple Handwash Liquid 500ML","Income","Zelia Handwash Liquid",,"Undeposited Funds","",115.00,96690.17
,"Sales Receipt","29-02-2024","1890",,"Cash Sales","-MULTIPLE-","Income","Zelia Handwash Liquid",,"Undeposited Funds","",5100.00,101790.17
,"Invoice","01-03-2024","MC05459",,"THE BRIGHT STAR SUPERMARKET LIMITED","-MULTIPLE-","Income","Zelia Handwash Liquid",,"Accounts Receivable","",1427.58,103217.75
,"Sales Receipt","01-03-2024","1892",,"Ilyas Retail Shop","-MULTIPLE-","Income","Zelia Handwash Liquid",,"Undeposited Funds","",2856.00,106073.75
,"Sales Receipt","04-03-2024","1894",,"Cash Sales","Zelia Strawberry Handwash Liquid 5L","Income","Zelia Handwash Liquid",,"Undeposited Funds","",750.00,106823.75
,"Sales Receipt","04-03-2024","1899",,"Faisel Wholesale","-MULTIPLE-","Income","Zelia Handwash Liquid",,"Undeposited Funds","",1785.00,108608.75
,"Invoice","05-03-2024","MC05471",,"PRICE CHOPPER STORES LIMITED","-MULTIPLE-","Income","Zelia Handwash Liquid",,"Accounts Receivable","",1427.58,110036.33
,"Sales Receipt","05-03-2024","2008",,"Cash Sales","Zelia Strawberry Handwash Liquid 500ML","Income","Zelia Handwash Liquid",,"Undeposited Funds","",150.00,110186.33
,"Sales Receipt","05-03-2024","2011",,"Cash Sales","Zelia Strawberry Handwash Liquid 500ML","Income","Zelia Handwash Liquid",,"Undeposited Funds","",260.00,110446.33
,"Sales Receipt","05-03-2024","2013",,"Summer Outlets","-MULTIPLE-","Income","Zelia Handwash Liquid",,"Undeposited Funds","",1428.00,111874.33
,"Sales Receipt","05-03-2024","2014",,"Maida Minimart","-MULTIPLE-","Income","Zelia Handwash Liquid",,"Undeposited Funds","",952.00,112826.33
,"Sales Receipt","05-03-2024","2015",,"AL MANAN","-MULTIPLE-","Income","Zelia Handwash Liquid",,"Undeposited Funds","",2856.00,115682.33
,"Sales Receipt","06-03-2024","2021",,"Farhan Wholesellers","-MULTIPLE-","Income","Zelia Handwash Liquid",,"Undeposited Funds","",3570.00,119252.33
,"Sales Receipt","06-03-2024","2022",,"Libin Minimart","-MULTIPLE-","Income","Zelia Handwash Liquid",,"Undeposited Funds","",5355.00,124607.33
,"Sales Receipt","07-03-2024","2029",,"Cash Sales","Zelia Strawberry Handwash Liquid 500ML","Income","Zelia Handwash Liquid",,"Undeposited Funds","",110.00,124717.33
,"Sales Receipt","08-03-2024","2042",,"Fahal Wholesalers","-MULTIPLE-","Income","Zelia Handwash Liquid",,"Undeposited Funds","",17850.00,142567.33
,"Sales Receipt","08-03-2024","2043",,"Raage mart","-MULTIPLE-","Income","Zelia Handwash Liquid",,"Undeposited Funds","",7140.00,149707.33
,"Sales Receipt","11-03-2024","2048",,"Bon Bon Minimart","-MULTIPLE-","Income","Zelia Handwash Liquid",,"Undeposited Funds","",714.00,150421.33
,"Sales Receipt","11-03-2024","2050",,"tRIPPLE M","-MULTIPLE-","Income","Zelia Handwash Liquid",,"Undeposited Funds","",714.00,151135.33
,"Sales Receipt","11-03-2024","2052",,"Cash Sales","Zelia Strawberry Handwash Liquid 5L","Income","Zelia Handwash Liquid",,"Undeposited Funds",0.00,"",151135.33
,"Sales Receipt","11-03-2024","2054",,"Dalwo Wholesallers","-MULTIPLE-","Income","Zelia Handwash Liquid",,"Undeposited Funds","",1785.00,152920.33
,"Sales Receipt","11-03-2024","2055",,"Beta Traders","-MULTIPLE-","Income","Zelia Handwash Liquid",,"Undeposited Funds","",1428.00,154348.33
,"Sales Receipt","11-03-2024","2056",,"Nasib Wholesallers","-MULTIPLE-","Income","Zelia Handwash Liquid",,"Undeposited Funds","",1785.00,156133.33
,"Invoice","12-03-2024","MC05492",,"DALLAS SHOPRITE LTD","-MULTIPLE-","Income","Zelia Handwash Liquid",,"Accounts Receivable","",713.80,156847.13
,"Sales Receipt","13-03-2024","2059",,"Cash Sales","-MULTIPLE-","Income","Zelia Handwash Liquid",,"Undeposited Funds","",300.00,157147.13
,"Sales Receipt","13-03-2024","2061",,"Al Manir Wholesale","-MULTIPLE-","Income","Zelia Handwash Liquid",,"Undeposited Funds","",1785.00,158932.13
,"Sales Receipt","14-03-2024","2063",,"Cash Sales","Zelia Strawberry Handwash Liquid 500ML","Income","Zelia Handwash Liquid",,"Undeposited Funds","",150.00,159082.13
,"Sales Receipt","14-03-2024","2067",,"Nzurimart wholesale","Zelia Strawberry Handwash Liquid 500ML","Income","Zelia Handwash Liquid",,"Undeposited Funds","",119.00,159201.13
,"Sales Receipt","15-03-2024","2069",,"Cash Sales","Zelia Strawberry Handwash Liquid 500ML","Income","Zelia Handwash Liquid",,"Undeposited Funds","",1785.00,160986.13
,"Sales Receipt","15-03-2024","2079",,"Perfect Enterprise","-MULTIPLE-","Income","Zelia Handwash Liquid",,"Undeposited Funds","",1785.00,162771.13
,"Sales Receipt","18-03-2024","2076",,"Cash Sales","Zelia Strawberry Handwash Liquid 500ML","Income","Zelia Handwash Liquid",,"Undeposited Funds","",220.00,162991.13
,"Invoice","19-03-2024","MC05499",,"EASEBYYTTE SUPERMARKET LIMITED","-MULTIPLE-","Income","Zelia Handwash Liquid",,"Accounts Receivable","",1427.59,164418.72
,"Invoice","19-03-2024","MC05502",,"Tupo Mart Limited","-MULTIPLE-","Income","Zelia Handwash Liquid",,"Accounts Receivable","",1158.62,165577.34
,"Invoice","19-03-2024","MC05503",,"LUCKY MART SUPERMARKET LIMITED","-MULTIPLE-","Income","Zelia Handwash Liquid",,"Accounts Receivable","",1158.62,166735.96
,"Invoice","20-03-2024","MC05504",,"Zenith Steel Fabricators Ltd","Zelia 20L Antibacterial Handwash Liquid","Income","Zelia Handwash Liquid",,"Accounts Receivable","",10188.10,176924.06
,"Invoice","20-03-2024","MC05507",,"DAILY CHAMPIONS MINI SUPERMARKET LIMITED","Zelia Strawberry Handwash Liquid 500ML","Income","Zelia Handwash Liquid",,"Accounts Receivable","",1158.62,178082.68
,"Sales Receipt","20-03-2024","2087",,"Pambazuka Mart (K) Limited","Zelia Strawberry Handwash Liquid 500ML","Income","Zelia Handwash Liquid",,"Undeposited Funds","",1455.00,179537.68
,"Sales Receipt","20-03-2024","2088",,"Labook Enterprises","Zelia Strawberry Handwash Liquid 500ML","Income","Zelia Handwash Liquid",,"Undeposited Funds","",1455.00,180992.68
,"Sales Receipt","20-03-2024","2089",,"Restoration Traders","Zelia Strawberry Handwash Liquid 500ML","Income","Zelia Handwash Liquid",,"Undeposited Funds","",1455.00,182447.68
,"Sales Receipt","21-03-2024","2092",,"Norham Groceries","Zelia Strawberry Handwash Liquid 500ML","Income","Zelia Handwash Liquid",,"Undeposited Funds","",1164.00,183611.68
,"Sales Receipt","21-03-2024","2101",,"Raymart Minimart","Zelia Strawberry Handwash Liquid 500ML","Income","Zelia Handwash Liquid",,"Undeposited Funds","",582.00,184193.68
,"Sales Receipt","21-03-2024","2102",,"Umushan Shop","Zelia Strawberry Handwash Liquid 500ML","Income","Zelia Handwash Liquid",,"Undeposited Funds","",1164.00,185357.68
,"Sales Receipt","21-03-2024","2103",,"Ilyes Gas and Water ltd","Zelia Strawberry Handwash Liquid 500ML","Income","Zelia Handwash Liquid",,"Undeposited Funds","",1455.00,186812.68
,"Sales Receipt","25-03-2024","2094",,"Instanbul Shop","Zelia Strawberry Handwash Liquid 500ML","Income","Zelia Handwash Liquid",,"Undeposited Funds","",1164.00,187976.68
,"Invoice","25-03-2024","MC05530",,"KASAMAT INVESTMENTS LTD","-MULTIPLE-","Income","Zelia Handwash Liquid",,"Accounts Receivable","",579.32,188556.00
,"Sales Receipt","26-03-2024","2109",,"Cash Sales","Zelia Strawberry Handwash Liquid 5L","Income","Zelia Handwash Liquid",,"Undeposited Funds","",650.00,189206.00
,"Sales Receipt","26-03-2024","2113",,"AL MANAN","Zelia Strawberry Handwash Liquid 500ML","Income","Zelia Handwash Liquid",,"Undeposited Funds","",2910.00,192116.00
,"Sales Receipt","27-03-2024","2110",,"Toyokom Wholesallers","Zelia Strawberry Handwash Liquid 500ML","Income","Zelia Handwash Liquid",,"Undeposited Funds","",5820.00,197936.00
,"Sales Receipt","27-03-2024","2114",,"Freshtake Wholesallers","Zelia Strawberry Handwash Liquid 500ML","Income","Zelia Handwash Liquid",,"Undeposited Funds","",1455.00,199391.00
,"Sales Receipt","27-03-2024","2115",,"Jumaira Wholesalers","Zelia Strawberry Handwash Liquid 500ML","Income","Zelia Handwash Liquid",,"Undeposited Funds","",1455.00,200846.00
,"Sales Receipt","28-03-2024","2118",,"Cash Sales","Zelia Strawberry Handwash Liquid 5L","Income","Zelia Handwash Liquid",,"Undeposited Funds","",660.00,201506.00
,"Sales Receipt","28-03-2024","2123",,"ALHAMDULILAH","Zelia Strawberry Handwash Liquid 500ML","Income","Zelia Handwash Liquid",,"Undeposited Funds","",1455.00,202961.00
,"Sales Receipt","28-03-2024","2124",,"First Choice Shop","Zelia Strawberry Handwash Liquid 500ML","Income","Zelia Handwash Liquid",,"Undeposited Funds","",1455.00,204416.00
,"Sales Receipt","28-03-2024","2127",,"Cash Sales","Zelia Strawberry Handwash Liquid 500ML","Income","Zelia Handwash Liquid",,"Undeposited Funds",0.00,"",204416.00
,"Sales Receipt","28-03-2024","2129",,"Cash Sales","Zelia Strawberry Handwash Liquid 5L","Income","Zelia Handwash Liquid",,"Undeposited Funds","",526.00,204942.00
,"Sales Receipt","03-04-2024","2137",,"Gacal Wholesale","Zelia Strawberry Handwash Liquid 500ML","Income","Zelia Handwash Liquid",,"Undeposited Funds","",1455.00,206397.00
,"Sales Receipt","03-04-2024","2138",,"B Shop","Zelia Strawberry Handwash Liquid 500ML","Income","Zelia Handwash Liquid",,"Undeposited Funds","",2910.00,209307.00
,"Sales Receipt","03-04-2024","2140",,"Dacaad Wholesalers","Zelia Strawberry Handwash Liquid 500ML","Income","Zelia Handwash Liquid",,"Undeposited Funds","",5820.00,215127.00
,"Sales Receipt","03-04-2024","2142",,"AIDURUS GENERAL SHOP","Zelia Strawberry Handwash Liquid 500ML","Income","Zelia Handwash Liquid",,"Undeposited Funds","",1455.00,216582.00
,"Sales Receipt","04-04-2024","2143",,"Jubilee Candy  Shop","Zelia Strawberry Handwash Liquid 500ML","Income","Zelia Handwash Liquid",,"Undeposited Funds","",194.00,216776.00
,"Sales Receipt","04-04-2024","2152",,"Hanad Shop","Zelia Strawberry Handwash Liquid 500ML","Income","Zelia Handwash Liquid",,"Undeposited Funds","",1455.00,218231.00
,"Sales Receipt","05-04-2024","2155",,"Nasib Wholesallers","Zelia Strawberry Handwash Liquid 500ML","Income","Zelia Handwash Liquid",,"Undeposited Funds","",1455.00,219686.00
,"Sales Receipt","05-04-2024","2158",,"Cash Sales","Zelia Strawberry Handwash Liquid 500ML","Income","Zelia Handwash Liquid",,"Undeposited Funds","",105.00,219791.00
,"Sales Receipt","05-04-2024","AT 193",,"JUDY USENGE","Zelia Strawberry Handwash Liquid 500ML","Income","Zelia Handwash Liquid",,"Undeposited Funds","",8730.00,228521.00
,"Sales Receipt","06-04-2024","2209",,"RAZAQ AIRWAYS","-MULTIPLE-","Income","Zelia Handwash Liquid",,"Undeposited Funds","",1455.00,229976.00
,"Sales Receipt","08-04-2024","2164",,"Kangundo Briolly Bookshop","Zelia Strawberry Handwash Liquid 500ML","Income","Zelia Handwash Liquid",,"Undeposited Funds","",582.00,230558.00
,"Sales Receipt","08-04-2024","2166",,"Cash Sales","Zelia Strawberry Handwash Liquid 500ML","Income","Zelia Handwash Liquid",,"Undeposited Funds","",300.00,230858.00
,"Sales Receipt","08-04-2024","2168",,"Rowdha Minimart","-MULTIPLE-","Income","Zelia Handwash Liquid",,"Undeposited Funds","",1455.00,232313.00
,"Sales Receipt","08-04-2024","2170",,"Antic Wholesallers","-MULTIPLE-","Income","Zelia Handwash Liquid",,"Undeposited Funds","",2910.00,235223.00
,"Sales Receipt","08-04-2024","2171",,"Raage mart","-MULTIPLE-","Income","Zelia Handwash Liquid",,"Undeposited Funds","",7275.00,242498.00
,"Sales Receipt","08-04-2024","2201",,"City Save Wave","-MULTIPLE-","Income","Zelia Handwash Liquid",,"Undeposited Funds","",1455.00,243953.00
,"Sales Receipt","09-04-2024","2172",,"Cash Sales","Zelia Strawberry Handwash Liquid 500ML","Income","Zelia Handwash Liquid",,"Undeposited Funds","",110.00,244063.00
,"Sales Receipt","11-04-2024","2206",,"Mumtaz Shop","-MULTIPLE-","Income","Zelia Handwash Liquid",,"Undeposited Funds","",1455.00,245518.00
,"Sales Receipt","11-04-2024","2207",,"Kenafa Wholesalers","-MULTIPLE-","Income","Zelia Handwash Liquid",,"Undeposited Funds","",1455.00,246973.00
,"Sales Receipt","11-04-2024","2208",,"Sultan Iman Shop","-MULTIPLE-","Income","Zelia Handwash Liquid",,"Undeposited Funds","",2910.00,249883.00
,"Sales Receipt","11-04-2024","2210",,"Jumaira Wholesalers","-MULTIPLE-","Income","Zelia Handwash Liquid",,"Undeposited Funds","",1455.00,251338.00
,"Sales Receipt","12-04-2024","2175",,"Tekonstruct LTD","Zelia Strawberry Handwash Liquid 5L","Income","Zelia Handwash Liquid",,"Undeposited Funds","",588.00,251926.00
,"Sales Receipt","12-04-2024","2180",,"Elwak Stores Ltd","Zelia Strawberry Handwash Liquid 500ML","Income","Zelia Handwash Liquid",,"Undeposited Funds","",1455.00,253381.00
,"Sales Receipt","12-04-2024","2182",,"Cheaper Cheap","Zelia Strawberry Handwash Stickers 500ml","Income","Zelia Handwash Liquid",,"Undeposited Funds","",776.00,254157.00
,"Sales Receipt","12-04-2024","2183",,"Milimani  Stores","-MULTIPLE-","Income","Zelia Handwash Liquid",,"Undeposited Funds","",1164.00,255321.00
,"Sales Receipt","12-04-2024","2185",,"Mamken Minimart","Zelia Strawberry Handwash Liquid 500ML","Income","Zelia Handwash Liquid",,"Undeposited Funds","",582.00,255903.00
,"Sales Receipt","12-04-2024","2186",,"Kandara minimart","Zelia Strawberry Handwash Liquid 500ML","Income","Zelia Handwash Liquid",,"Undeposited Funds","",776.00,256679.00
,"Sales Receipt","12-04-2024","2246",,"Skype Traders","-MULTIPLE-","Income","Zelia Handwash Liquid",,"Undeposited Funds","",7275.00,263954.00
,"Sales Receipt","15-04-2024","2192",,"Sakina Minimart","-MULTIPLE-","Income","Zelia Handwash Liquid",,"Undeposited Funds","",1455.00,265409.00
,"Sales Receipt","15-04-2024","2195",,"Zulu Enterprises","Zelia Apple Handwash Liquid 500ML","Income","Zelia Handwash Liquid",,"Undeposited Funds","",582.00,265991.00
,"Sales Receipt","15-04-2024","2196",,"Ebenezer  Minimart","Zelia Apple Handwash Liquid 500ML","Income","Zelia Handwash Liquid",,"Undeposited Funds","",291.00,266282.00
,"Sales Receipt","15-04-2024","2198",,"Rio Deli Wholesallers","-MULTIPLE-","Income","Zelia Handwash Liquid",,"Undeposited Funds","",1455.00,267737.00
,"Sales Receipt","15-04-2024","2199",,"Sharma Shop","-MULTIPLE-","Income","Zelia Handwash Liquid",,"Undeposited Funds","",1455.00,269192.00
,"Sales Receipt","16-04-2024","2212",,"Cash Sales","Zelia Strawberry Handwash Liquid 500ML","Income","Zelia Handwash Liquid",,"Undeposited Funds","",300.00,269492.00
,"Sales Receipt","17-04-2024","2218",,"Maida Minimart","-MULTIPLE-","Income","Zelia Handwash Liquid",,"Undeposited Funds","",1164.00,270656.00
,"Sales Receipt","18-04-2024","2220",,"Towba General Store","-MULTIPLE-","Income","Zelia Handwash Liquid",,"Undeposited Funds","",2910.00,273566.00
,"Sales Receipt","18-04-2024","2223",,"Cash Sales","Zelia Strawberry Handwash Liquid 500ML","Income","Zelia Handwash Liquid",,"Undeposited Funds","",120.00,273686.00
,"Sales Receipt","18-04-2024","2224",,"Cash Sales","Zelia Strawberry Handwash Liquid 500ML","Income","Zelia Handwash Liquid",,"Undeposited Funds","",210.00,273896.00
,"Sales Receipt","18-04-2024","2229",,"Maasai One","-MULTIPLE-","Income","Zelia Handwash Liquid",,"Undeposited Funds","",679.00,274575.00
,"Sales Receipt","18-04-2024","2230",,"Ngomei Shop","-MULTIPLE-","Income","Zelia Handwash Liquid",,"Undeposited Funds","",2910.00,277485.00
,"Invoice","19-04-2024","MC05610",,"DISII TRADERS LTD","-MULTIPLE-","Income","Zelia Handwash Liquid",,"Accounts Receivable","",1448.28,278933.28
,"Invoice","19-04-2024","MC05613",,"HAPPY VIEW SUPERMARKET LIMITED","-MULTIPLE-","Income","Zelia Handwash Liquid",,"Accounts Receivable","",1158.62,280091.90
,"Sales Receipt","19-04-2024","2232",,"Zonal Minimart","Zelia Apple Handwash Liquid 500ML","Income","Zelia Handwash Liquid",,"Undeposited Funds","",582.00,280673.90
,"Sales Receipt","19-04-2024","2233",,"Hogol Wholesallers","-MULTIPLE-","Income","Zelia Handwash Liquid",,"Undeposited Funds","",4704.00,285377.90
,"Sales Receipt","19-04-2024","2234",,"Nasra wholesale","-MULTIPLE-","Income","Zelia Handwash Liquid",,"Undeposited Funds","",1455.00,286832.90
,"Sales Receipt","19-04-2024","2235",,"Publix Supermarket","Zelia Apple Handwash Liquid 500ML","Income","Zelia Handwash Liquid",,"Undeposited Funds","",582.00,287414.90
,"Sales Receipt","19-04-2024","2237",,"Garumo Wholesallers","-MULTIPLE-","Income","Zelia Handwash Liquid",,"Undeposited Funds","",2910.00,290324.90
,"Sales Receipt","19-04-2024","2238",,"Hometime Minimart","-MULTIPLE-","Income","Zelia Handwash Liquid",,"Undeposited Funds","",582.00,290906.90
,"Sales Receipt","19-04-2024","2239",,"Beraccah Wholesallers","-MULTIPLE-","Income","Zelia Handwash Liquid",,"Undeposited Funds","",1455.00,292361.90
,"Sales Receipt","20-04-2024","2243",,"Horn of Africa","-MULTIPLE-","Income","Zelia Handwash Liquid",,"Undeposited Funds","",1455.00,293816.90
,"Invoice","22-04-2024","MC05622",,"KASAMAT INVESTMENTS LTD","Zelia Strawberry Handwash Liquid 500ML","Income","Zelia Handwash Liquid",,"Accounts Receivable","",579.31,294396.21
,"Sales Receipt","22-04-2024","2241",,"Cash Sales","-MULTIPLE-","Income","Zelia Handwash Liquid",,"Undeposited Funds","",516.00,294912.21
,"Sales Receipt","22-04-2024","2242",,"tRIPPLE M","-MULTIPLE-","Income","Zelia Handwash Liquid",,"Undeposited Funds","",970.00,295882.21
,"Sales Receipt","22-04-2024","2244",,"MWASPART AIRWAYS","-MULTIPLE-","Income","Zelia Handwash Liquid",,"Undeposited Funds","",1164.00,297046.21
,"Sales Receipt","22-04-2024","2245",,"Bon Bon Minimart","-MULTIPLE-","Income","Zelia Handwash Liquid",,"Undeposited Funds","",582.00,297628.21
,"Sales Receipt","22-04-2024","2247",,"AL Zake minimart","-MULTIPLE-","Income","Zelia Handwash Liquid",,"Undeposited Funds","",1455.00,299083.21
,"Sales Receipt","22-04-2024","2248",,"Himilo Wholesalers","-MULTIPLE-","Income","Zelia Handwash Liquid",,"Undeposited Funds","",1455.00,300538.21
,"Sales Receipt","22-04-2024","2250",,"Brightfood Nasra","-MULTIPLE-","Income","Zelia Handwash Liquid",,"Undeposited Funds","",582.00,301120.21
,"Sales Receipt","23-04-2024","2251",,"Cash Sales","Zelia Apple Handwash Liquid 500ML","Income","Zelia Handwash Liquid",,"Undeposited Funds","",110.00,301230.21
,"Sales Receipt","23-04-2024","2253",,"Summer Outlets","-MULTIPLE-","Income","Zelia Handwash Liquid",,"Undeposited Funds","",2328.00,303558.21
,"Sales Receipt","23-04-2024","2254",,"Cash Sales","Zelia Strawberry Handwash Liquid 5L","Income","Zelia Handwash Liquid",,"Undeposited Funds",0.00,"",303558.21
,"Invoice","24-04-2024","MC05630",,"Mumsha Supamat","-MULTIPLE-","Income","Zelia Handwash Liquid",,"Accounts Receivable","",1158.62,304716.83
,"Invoice","24-04-2024","MC05631",,"PRICE CHOPPER STORES LIMITED","Zelia Apple Handwash Liquid 500ML","Income","Zelia Handwash Liquid",,"Accounts Receivable","",579.31,305296.14
,"Invoice","24-04-2024","MC05636",,"Maji Asili Limited","-MULTIPLE-","Income","Zelia Handwash Liquid",,"Accounts Receivable","",1448.27,306744.41
,"Sales Receipt","24-04-2024","2255",,"Cash Sales","-MULTIPLE-","Income","Zelia Handwash Liquid",,"Undeposited Funds","",240.00,306984.41
,"Sales Receipt","24-04-2024","2256",,"Kimathi Store","-MULTIPLE-","Income","Zelia Handwash Liquid",,"Undeposited Funds","",679.00,307663.41
,"Sales Receipt","24-04-2024","2260",,"Pambazuka Mart (K) Limited","-MULTIPLE-","Income","Zelia Handwash Liquid",,"Undeposited Funds","",1455.00,309118.41
,"Sales Receipt","25-04-2024","2262",,"Kiembeni Grocery","-MULTIPLE-","Income","Zelia Handwash Liquid",,"Undeposited Funds","",2910.00,312028.41
,"Sales Receipt","25-04-2024","2263",,"Cash Sales","Zelia Strawberry Handwash Liquid 5L","Income","Zelia Handwash Liquid",,"Undeposited Funds","",750.00,312778.41
,"Sales Receipt","26-04-2024","2270",,"Cash Sales","-MULTIPLE-","Income","Zelia Handwash Liquid",,"Undeposited Funds","",920.00,313698.41
,"Sales Receipt","28-04-2024","2276",,"Zamu Wholesalers","-MULTIPLE-","Income","Zelia Handwash Liquid",,"Undeposited Funds","",1455.00,315153.41
,"Sales Receipt","29-04-2024","2273",,"Blessed Shop","-MULTIPLE-","Income","Zelia Handwash Liquid",,"Undeposited Funds","",194.00,315347.41
,"Credit Note","29-04-2024","CN01058",,"INTEGRAL MEDIA LIMITED","-MULTIPLE-","Income","Zelia Handwash Liquid",,"Accounts Receivable",3568.97,"",311778.44
,"Sales Receipt","29-04-2024","2280",,"Cash Sales","Zelia Strawberry Handwash Liquid 500ML","Income","Zelia Handwash Liquid",,"Undeposited Funds","",87.00,311865.44
,"Sales Receipt","30-04-2024","2281",,"Geoffrey Kangethe","-MULTIPLE-","Income","Zelia Handwash Liquid",,"Undeposited Funds","",2500.02,314365.46
,"Invoice","30-04-2024","MC05652",,"OFFSHORE GLOBAL LOGISTICS LIMITED","Zelia Strawberry Handwash Liquid 5L","Income","Zelia Handwash Liquid",,"Accounts Receivable","",658.62,315024.08
,"Sales Receipt","30-04-2024","2282",,"Budget Store","-MULTIPLE-","Income","Zelia Handwash Liquid",,"Undeposited Funds","",1455.00,316479.08
,"Sales Receipt","30-04-2024","2286",,"Homecare Enterprise","-MULTIPLE-","Income","Zelia Handwash Liquid",,"Undeposited Funds","",582.00,317061.08
,"Sales Receipt","30-04-2024","2288",,"Simester General Stores","-MULTIPLE-","Income","Zelia Handwash Liquid",,"Undeposited Funds","",582.00,317643.08
,"Sales Receipt","02-05-2024","2293",,"Tuff Store","-MULTIPLE-","Income","Zelia Handwash Liquid",,"Undeposited Funds","",485.00,318128.08
,"Sales Receipt","02-05-2024","2295",,"New Ali Yare","-MULTIPLE-","Income","Zelia Handwash Liquid",,"Undeposited Funds","",1455.00,319583.08
,"Sales Receipt","02-05-2024","2297",,"D Madina Store","-MULTIPLE-","Income","Zelia Handwash Liquid",,"Undeposited Funds","",4365.00,323948.08
,"Sales Receipt","03-05-2024","2300",,"Cash Sales","Zelia Strawberry Handwash Liquid 500ML","Income","Zelia Handwash Liquid",,"Undeposited Funds",0.00,"",323948.08
,"Sales Receipt","03-05-2024","2305",,"Zuri Mart","-MULTIPLE-","Income","Zelia Handwash Liquid",,"Undeposited Funds","",582.00,324530.08
,"Sales Receipt","05-05-2024","2308",,"Cash Sales","-MULTIPLE-","Income","Zelia Handwash Liquid",,"Undeposited Funds","",860.00,325390.08
,"Sales Receipt","06-05-2024","2309",,"Jackys Shop","-MULTIPLE-","Income","Zelia Handwash Liquid",,"Undeposited Funds","",485.00,325875.08
,"Sales Receipt","06-05-2024","2310",,"Razia Wholesalers","-MULTIPLE-","Income","Zelia Handwash Liquid",,"Undeposited Funds","",485.00,326360.08
,"Sales Receipt","06-05-2024","2311",,"Cash Sales","Zelia Strawberry Handwash Liquid 5L","Income","Zelia Handwash Liquid",,"Undeposited Funds","",700.00,327060.08
,"Sales Receipt","06-05-2024","2312",,"Cash Sales","Zelia Strawberry Handwash Liquid 5L","Income","Zelia Handwash Liquid",,"Undeposited Funds","",2100.00,329160.08
,"Sales Receipt","06-05-2024","2314",,"Gargar Foodstuffs","-MULTIPLE-","Income","Zelia Handwash Liquid",,"Undeposited Funds","",14550.00,343710.08
,"Invoice","08-05-2024","MC05676",,"LUCKY MART SUPERMARKET LIMITED","-MULTIPLE-","Income","Zelia Handwash Liquid",,"Accounts Receivable","",1448.27,345158.35
,"Sales Receipt","08-05-2024","2318",,"Adurus Wholesallers","Zelia Apple Handwash Liquid 500ML","Income","Zelia Handwash Liquid",,"Undeposited Funds","",1164.00,346322.35
,"Sales Receipt","08-05-2024","2319",,"Lekima Royal Merchants","-MULTIPLE-","Income","Zelia Handwash Liquid",,"Undeposited Funds","",1455.00,347777.35
,"Sales Receipt","08-05-2024","2320",,"Johns Shop","-MULTIPLE-","Income","Zelia Handwash Liquid",,"Undeposited Funds","",1164.00,348941.35
,"Sales Receipt","08-05-2024","2321",,"Cash Sales","-MULTIPLE-","Income","Zelia Handwash Liquid",,"Undeposited Funds","",300.00,349241.35
,"Sales Receipt","08-05-2024","2324",,"Qudus Shop","-MULTIPLE-","Income","Zelia Handwash Liquid",,"Undeposited Funds","",1164.00,350405.35
,"Sales Receipt","09-05-2024","2333",,"RichMind Property","-MULTIPLE-","Income","Zelia Handwash Liquid",,"Undeposited Funds","",200.00,350605.35
,"Sales Receipt","09-05-2024","2334",,"Tuff Store","-MULTIPLE-","Income","Zelia Handwash Liquid",,"Undeposited Funds","",485.00,351090.35
,"Sales Receipt","09-05-2024","2335",,"County Wholesallers","Zelia Strawberry Handwash Liquid 500ML","Income","Zelia Handwash Liquid",,"Undeposited Funds","",1650.00,352740.35
,"Sales Receipt","09-05-2024","2337",,"Cash Sales","Zelia Apple Handwash Liquid 5L","Income","Zelia Handwash Liquid",,"Undeposited Funds","",750.00,353490.35
,"Sales Receipt","09-05-2024","2338",,"Cash Sales","Zelia Strawberry Handwash Liquid 5L","Income","Zelia Handwash Liquid",,"Undeposited Funds",0.00,"",353490.35
,"Sales Receipt","09-05-2024","2339",,"Cash Sales","Zelia Apple Handwash Liquid 500ML","Income","Zelia Handwash Liquid",,"Undeposited Funds","",220.00,353710.35
,"Sales Receipt","09-05-2024","2340",,"Cash Sales","Zelia Apple Handwash Liquid 500ML","Income","Zelia Handwash Liquid",,"Undeposited Funds","",97.00,353807.35
,"Sales Receipt","09-05-2024","2341",,"Cash Sales","-MULTIPLE-","Income","Zelia Handwash Liquid",,"Undeposited Funds","",194.00,354001.35
,"Sales Receipt","13-05-2024","2345",,"Katani Foodstore","-MULTIPLE-","Income","Zelia Handwash Liquid",,"Undeposited Funds","",1455.00,355456.35
,"Sales Receipt","13-05-2024","2347",,"Sharma Shop","Zelia Apple Handwash Liquid 500ML","Income","Zelia Handwash Liquid",,"Undeposited Funds","",1455.00,356911.35
,"Sales Receipt","13-05-2024","2348",,"Gargar Foodstuffs","-MULTIPLE-","Income","Zelia Handwash Liquid",,"Undeposited Funds","",2910.00,359821.35
,"Sales Receipt","13-05-2024","2350",,"Aymat Wholesalers","-MULTIPLE-","Income","Zelia Handwash Liquid",,"Undeposited Funds","",2910.00,362731.35
,"Sales Receipt","13-05-2024","2352",,"Himilo Wholesalers","-MULTIPLE-","Income","Zelia Handwash Liquid",,"Undeposited Funds","",2910.00,365641.35
,"Sales Receipt","13-05-2024","2353",,"Jumaira Wholesalers","-MULTIPLE-","Income","Zelia Handwash Liquid",,"Undeposited Funds","",2910.00,368551.35
,"Sales Receipt","13-05-2024","1921",,"Cash Sales","-MULTIPLE-","Income","Zelia Handwash Liquid",,"Undeposited Funds","",388.00,368939.35
,"Sales Receipt","13-05-2024","1922",,"Cash Sales","Zelia Strawberry Handwash Liquid 5L","Income","Zelia Handwash Liquid",,"Undeposited Funds","",750.00,369689.35
,"Sales Receipt","13-05-2024","1923",,"Cash Sales","Zelia Strawberry Handwash Liquid 5L","Income","Zelia Handwash Liquid",,"Undeposited Funds",0.00,"",369689.35
,"Sales Receipt","14-05-2024","2357",,"Horn of Africa","-MULTIPLE-","Income","Zelia Handwash Liquid",,"Undeposited Funds","",1455.00,371144.35
,"Sales Receipt","14-05-2024","2358",,"Faisel Wholesale","-MULTIPLE-","Income","Zelia Handwash Liquid",,"Undeposited Funds","",2910.00,374054.35
,"Invoice","15-05-2024","MC05702",,"Seasons lane Mart","-MULTIPLE-","Income","Zelia Handwash Liquid",,"Accounts Receivable","",1448.27,375502.62
,"Sales Receipt","15-05-2024","2362",,"Cash Sales","Zelia Strawberry Handwash Liquid 5L","Income","Zelia Handwash Liquid",,"Undeposited Funds","",750.00,376252.62
,"Sales Receipt","16-05-2024","2363",,"Corner Shop","-MULTIPLE-","Income","Zelia Handwash Liquid",,"Undeposited Funds","",2910.00,379162.62
,"Sales Receipt","16-05-2024","2364",,"Mashallah Foodstuffs","-MULTIPLE-","Income","Zelia Handwash Liquid",,"Undeposited Funds","",1455.00,380617.62
,"Sales Receipt","16-05-2024","2367",,"Khare Wholesalers","-MULTIPLE-","Income","Zelia Handwash Liquid",,"Undeposited Funds","",1455.00,382072.62
,"Sales Receipt","16-05-2024","2368",,"Rehoji Shop","-MULTIPLE-","Income","Zelia Handwash Liquid",,"Undeposited Funds","",1455.00,383527.62
,"Sales Receipt","16-05-2024","2370",,"Imani General Store","-MULTIPLE-","Income","Zelia Handwash Liquid",,"Undeposited Funds","",582.00,384109.62
,"Invoice","17-05-2024","MC05712",,"Maji Asili Limited","Zelia Apple Handwash Liquid 500ML","Income","Zelia Handwash Liquid",,"Accounts Receivable","",1448.28,385557.90
,"Invoice","17-05-2024","MC05713",,"DISII TRADERS LTD","-MULTIPLE-","Income","Zelia Handwash Liquid",,"Accounts Receivable","",1448.27,387006.17
,"Sales Receipt","17-05-2024","2372",,"Danaba Wholesalers","-MULTIPLE-","Income","Zelia Handwash Liquid",,"Undeposited Funds","",1455.00,388461.17
,"Sales Receipt","20-05-2024","1939",,"Nuclear Supermarket","Zelia Apple Handwash Liquid 500ML","Income","Zelia Handwash Liquid",,"Undeposited Funds","",87.00,388548.17
,"Sales Receipt","20-05-2024","1941",,"Jumaira Wholesalers","-MULTIPLE-","Income","Zelia Handwash Liquid",,"Undeposited Funds","",2910.00,391458.17
,"Sales Receipt","21-05-2024","1942",,"Cash Sales","-MULTIPLE-","Income","Zelia Handwash Liquid",,"Undeposited Funds","",220.00,391678.17
,"Sales Receipt","21-05-2024","1943",,"Smart Choice","-MULTIPLE-","Income","Zelia Handwash Liquid",,"Undeposited Funds","",1455.00,393133.17
,"Sales Receipt","21-05-2024","1944",,"Mt. Kenya","-MULTIPLE-","Income","Zelia Handwash Liquid",,"Undeposited Funds","",1164.00,394297.17
,"Sales Receipt","21-05-2024","1947",,"Minara Shop","-MULTIPLE-","Income","Zelia Handwash Liquid",,"Undeposited Funds","",2910.00,397207.17
,"Sales Receipt","21-05-2024","1950",,"Downtown Wholesalers","-MULTIPLE-","Income","Zelia Handwash Liquid",,"Undeposited Funds","",2910.00,400117.17
,"Sales Receipt","21-05-2024","1951",,"Gidesh Supermarket","-MULTIPLE-","Income","Zelia Handwash Liquid",,"Undeposited Funds","",1455.00,401572.17
,"Sales Receipt","22-05-2024","2373",,"Danaba Wholesalers","Zelia Strawberry Handwash Liquid 500ML","Income","Zelia Handwash Liquid",,"Undeposited Funds",0.00,"",401572.17
,"Sales Receipt","22-05-2024","2374",,"Al maca","-MULTIPLE-","Income","Zelia Handwash Liquid",,"Undeposited Funds","",1455.00,403027.17
,"Sales Receipt","22-05-2024","2376",,"Towfiqq Shop","-MULTIPLE-","Income","Zelia Handwash Liquid",,"Undeposited Funds","",1164.00,404191.17
,"Sales Receipt","23-05-2024","2378",,"Cash Sales","-MULTIPLE-","Income","Zelia Handwash Liquid",,"Undeposited Funds","",291.00,404482.17
,"Sales Receipt","23-05-2024","1960",,"Shukri Shop","-MULTIPLE-","Income","Zelia Handwash Liquid",,"Undeposited Funds","",1164.00,405646.17
,"Sales Receipt","23-05-2024","1962",,"Anab Shop","-MULTIPLE-","Income","Zelia Handwash Liquid",,"Undeposited Funds","",582.00,406228.17
,"Sales Receipt","23-05-2024","1966",,"Libin Minimart","-MULTIPLE-","Income","Zelia Handwash Liquid",,"Undeposited Funds","",2910.00,409138.17
,"Invoice","24-05-2024","MC05747",,"NASRI MART LIMITED","Zelia Strawberry Handwash Liquid 500ML","Income","Zelia Handwash Liquid",,"Accounts Receivable","",579.31,409717.48
,"Sales Receipt","24-05-2024","2380",,"Cash Sales","Zelia Strawberry Handwash Liquid 5L","Income","Zelia Handwash Liquid",,"Undeposited Funds","",3000.00,412717.48
,"Sales Receipt","27-05-2024","2383",,"Abby Mart","-MULTIPLE-","Income","Zelia Handwash Liquid",,"Undeposited Funds","",970.00,413687.48
,"Sales Receipt","27-05-2024","2384",,"Dream light Supermarket","-MULTIPLE-","Income","Zelia Handwash Liquid",,"Undeposited Funds","",291.00,413978.48
,"Invoice","28-05-2024","MC05758",,"Zenith Steel Fabricators Ltd","Zelia Strawberry Handwash Liquid 5L","Income","Zelia Handwash Liquid",,"Accounts Receivable","",13400.00,427378.48
,"Invoice","28-05-2024","MC05763",,"Mumsha Supamat","-MULTIPLE-","Income","Zelia Handwash Liquid",,"Accounts Receivable","",1158.62,428537.10
,"Sales Receipt","28-05-2024","2389",,"Restoration Traders","-MULTIPLE-","Income","Zelia Handwash Liquid",,"Undeposited Funds","",1455.00,429992.10
,"Sales Receipt","29-05-2024","1972",,"Farhan Wholesellers","-MULTIPLE-","Income","Zelia Handwash Liquid",,"Undeposited Funds","",2910.00,432902.10
,"Sales Receipt","29-05-2024","1973",,"Marwan Shop","-MULTIPLE-","Income","Zelia Handwash Liquid",,"Undeposited Funds","",1455.00,434357.10
,"Invoice","30-05-2024","MC05775",,"INTEGRAL MEDIA LIMITED","-MULTIPLE-","Income","Zelia Handwash Liquid",,"Accounts Receivable","",1448.28,435805.38
,"Sales Receipt","30-05-2024","2397",,"Rio Deli Wholesallers","-MULTIPLE-","Income","Zelia Handwash Liquid",,"Undeposited Funds","",2910.00,438715.38
,"Sales Receipt","31-05-2024","1937",,"Island Gift Shop","-MULTIPLE-","Income","Zelia Handwash Liquid",,"Undeposited Funds","",388.00,439103.38
,"Sales Receipt","03-06-2024","2398",,"Cash Sales","Zelia Strawberry Handwash Liquid 500ML","Income","Zelia Handwash Liquid",,"Undeposited Funds","",84.00,439187.38
,"Sales Receipt","03-06-2024","2410",,"Hidika Shop","-MULTIPLE-","Income","Zelia Handwash Liquid",,"Undeposited Funds","",1164.00,440351.38
,"Sales Receipt","03-06-2024","2411",,"Gure Yare Shop","-MULTIPLE-","Income","Zelia Handwash Liquid",,"Undeposited Funds","",5820.00,446171.38
,"Sales Receipt","03-06-2024","1982",,"Lekima Minimart","-MULTIPLE-","Income","Zelia Handwash Liquid",,"Undeposited Funds","",2910.00,449081.38
,"Sales Receipt","04-06-2024","2413",,"Horn of Africa","-MULTIPLE-","Income","Zelia Handwash Liquid",,"Undeposited Funds","",1164.00,450245.38
,"Sales Receipt","04-06-2024","2742",,"Arwa Wholesale","-MULTIPLE-","Income","Zelia Handwash Liquid",,"Undeposited Funds","",1455.00,451700.38
,"Sales Receipt","04-06-2024","2741",,"Sasa Wholesalers","-MULTIPLE-","Income","Zelia Handwash Liquid",,"Undeposited Funds","",5820.00,457520.38
,"Sales Receipt","04-06-2024","2740",,"Mash-B Wholesale","-MULTIPLE-","Income","Zelia Handwash Liquid",,"Undeposited Funds","",2910.00,460430.38
,"Sales Receipt","05-06-2024","2416",,"Amir shop","-MULTIPLE-","Income","Zelia Handwash Liquid",,"Undeposited Funds","",2910.00,463340.38
,"Sales Receipt","05-06-2024","2417",,"D-Madina Enterprise","-MULTIPLE-","Income","Zelia Handwash Liquid",,"Undeposited Funds","",2910.00,466250.38
,"Sales Receipt","05-06-2024","2418",,"Saacid Shop","-MULTIPLE-","Income","Zelia Handwash Liquid",,"Undeposited Funds","",1455.00,467705.38
,"Invoice","06-06-2024","MC05790",,"Karia Supermarkets Limited","-MULTIPLE-","Income","Zelia Handwash Liquid",,"Accounts Receivable","",4551.72,472257.10
,"Sales Receipt","06-06-2024","2429",,"Cash Sales","Zelia Strawberry Handwash Liquid 500ML","Income","Zelia Handwash Liquid",,"Undeposited Funds",0.00,"",472257.10
,"Sales Receipt","06-06-2024","2424",,"Bethel Store","-MULTIPLE-","Income","Zelia Handwash Liquid",,"Undeposited Funds","",582.00,472839.10
,"Sales Receipt","06-06-2024","2718",,"Mama G Wholesale","-MULTIPLE-","Income","Zelia Handwash Liquid",,"Undeposited Funds","",1455.00,474294.10
,"Sales Receipt","06-06-2024","2423",,"Ekai moke wholesale","-MULTIPLE-","Income","Zelia Handwash Liquid",,"Undeposited Funds","",1455.00,475749.10
,"Sales Receipt","06-06-2024","2422",,"Tender Store Limited","-MULTIPLE-","Income","Zelia Handwash Liquid",,"Undeposited Funds","",2910.00,478659.10
,"Sales Receipt","07-06-2024","1993",,"Cash Sales","Zelia Strawberry Handwash Liquid 5L","Income","Zelia Handwash Liquid",,"Undeposited Funds",0.00,"",478659.10
,"Sales Receipt","07-06-2024","1996",,"Cash Sales","Zelia Apple Handwash Liquid 500ML","Income","Zelia Handwash Liquid",,"Undeposited Funds","",258.00,478917.10
,"Sales Receipt","08-06-2024","2432",,"Cash Sales","Zelia Strawberry Handwash Liquid 500ML","Income","Zelia Handwash Liquid",,"Undeposited Funds","",522.00,479439.10
,"Sales Receipt","10-06-2024","2434",,"Cash Sales","Zelia Strawberry Handwash Liquid 500ML","Income","Zelia Handwash Liquid",,"Undeposited Funds","",140.00,479579.10
,"Sales Receipt","10-06-2024","2437",,"Al Mubarak Wholesalers","-MULTIPLE-","Income","Zelia Handwash Liquid",,"Undeposited Funds","",2910.00,482489.10
,"Invoice","11-06-2024","MC05815",,"MADINA SUPERMARKET LIMITED","-MULTIPLE-","Income","Zelia Handwash Liquid",,"Accounts Receivable","",579.31,483068.41
,"Sales Receipt","11-06-2024","2439",,"Cash Sales","Zelia Strawberry Handwash Liquid 500ML","Income","Zelia Handwash Liquid",,"Undeposited Funds","",110.00,483178.41
,"Sales Receipt","11-06-2024","2440",,"Cash Sales","Zelia Strawberry Handwash Liquid 500ML","Income","Zelia Handwash Liquid",,"Undeposited Funds","",120.00,483298.41
,"Sales Receipt","11-06-2024","2447",,"Cash Sales","Zelia Strawberry Handwash Liquid 5L","Income","Zelia Handwash Liquid",,"Undeposited Funds","",700.00,483998.41
,"Sales Receipt","11-06-2024","2715",,"Asfa Shop","-MULTIPLE-","Income","Zelia Handwash Liquid",,"Undeposited Funds","",582.00,484580.41
,"Sales Receipt","11-06-2024","2448",,"Farmwell Enterprises","-MULTIPLE-","Income","Zelia Handwash Liquid",,"Undeposited Funds","",582.00,485162.41
,"Invoice","12-06-2024","MC05819",,"INTEGRAL MEDIA LIMITED","-MULTIPLE-","Income","Zelia Handwash Liquid",,"Accounts Receivable","",1448.27,486610.68
,"Sales Receipt","12-06-2024","2449",,"Cash Sales","Zelia Apple Handwash Liquid 500ML","Income","Zelia Handwash Liquid",,"Undeposited Funds","",130.00,486740.68
,"Sales Receipt","12-06-2024","2453",,"Cash Sales","-MULTIPLE-","Income","Zelia Handwash Liquid",,"Undeposited Funds","",6750.00,493490.68
,"Sales Receipt","12-06-2024","2462",,"Mama Amina","-MULTIPLE-","Income","Zelia Handwash Liquid",,"Undeposited Funds","",1455.00,494945.68
,"Invoice","13-06-2024","MC05820",,"ZAIN SUPERMARKET LIMITED","-MULTIPLE-","Income","Zelia Handwash Liquid",,"Accounts Receivable","",1158.62,496104.30
,"Sales Receipt","13-06-2024","2464",,"Cash Sales","Zelia Apple Handwash Liquid 500ML","Income","Zelia Handwash Liquid",,"Undeposited Funds","",130.00,496234.30
,"Sales Receipt","13-06-2024","2474",,"Fahma Qali","-MULTIPLE-","Income","Zelia Handwash Liquid",,"Undeposited Funds","",1455.00,497689.30
,"Sales Receipt","14-06-2024","2477",,"Cash Sales","Zelia Apple Handwash Liquid 500ML","Income","Zelia Handwash Liquid",,"Undeposited Funds","",174.00,497863.30
,"Sales Receipt","14-06-2024","2480",,"Cash Sales","Zelia Apple Handwash Liquid 500ML","Income","Zelia Handwash Liquid",,"Undeposited Funds","",240.00,498103.30
,"Sales Receipt","14-06-2024","2481",,"Cash Sales","-MULTIPLE-","Income","Zelia Handwash Liquid",,"Undeposited Funds","",240.00,498343.30
,"Sales Receipt","14-06-2024","2713",,"032 minimart","-MULTIPLE-","Income","Zelia Handwash Liquid",,"Undeposited Funds","",1455.00,499798.30
,"Sales Receipt","14-06-2024","2710",,"tRIPPLE M","Zelia Strawberry Handwash Liquid 500ML","Income","Zelia Handwash Liquid",,"Undeposited Funds","",582.00,500380.30
,"Sales Receipt","14-06-2024","2709",,"mwaspart","-MULTIPLE-","Income","Zelia Handwash Liquid",,"Undeposited Funds","",1164.00,501544.30
,"Sales Receipt","18-06-2024","2711",,"Cash Sales","Zelia Strawberry Handwash Liquid 500ML","Income","Zelia Handwash Liquid",,"Undeposited Funds","",88.00,501632.30
,"Sales Receipt","18-06-2024","2500",,"Al Hamdu shop","-MULTIPLE-","Income","Zelia Handwash Liquid",,"Undeposited Funds","",582.00,502214.30
,"Sales Receipt","18-06-2024","2704",,"Himilo Wholesallers","-MULTIPLE-","Income","Zelia Handwash Liquid",,"Undeposited Funds","",2910.00,505124.30
,"Sales Receipt","19-06-2024","2484",,"Cash Sales","Zelia Strawberry Handwash Liquid 5L","Income","Zelia Handwash Liquid",,"Undeposited Funds","",660.00,505784.30
,"Invoice","20-06-2024","MC05842",,"HOPEMART SELF SERVICES LTD","-MULTIPLE-","Income","Zelia Handwash Liquid",,"Accounts Receivable","",2896.56,508680.86
,"Invoice","20-06-2024","MC05845",,"Azaavi Collections Limited","Zelia Apple Handwash Liquid 500ML","Income","Zelia Handwash Liquid",,"Accounts Receivable","",100.00,508780.86
,"Sales Receipt","20-06-2024","2493",,"Cash Sales","-MULTIPLE-","Income","Zelia Handwash Liquid",,"Undeposited Funds",0.00,"",508780.86
,"Sales Receipt","20-06-2024","AT197",,"Cash Sales","-MULTIPLE-","Income","Zelia Handwash Liquid",,"Undeposited Funds","",6101.76,514882.62
,"Sales Receipt","20-06-2024","AT198",,"Cash Sales","-MULTIPLE-","Income","Zelia Handwash Liquid",,"Undeposited Funds","",3177.98,518060.60
,"Sales Receipt","20-06-2024","2494",,"Restoration Traders","-MULTIPLE-","Income","Zelia Handwash Liquid",,"Undeposited Funds","",2910.00,520970.60
,"Sales Receipt","20-06-2024","2495",,"Nabcom Stores","-MULTIPLE-","Income","Zelia Handwash Liquid",,"Undeposited Funds","",1455.00,522425.60
,"Sales Receipt","20-06-2024","2498",,"Mamken Minimart","Zelia Apple Handwash Liquid 500ML","Income","Zelia Handwash Liquid",,"Undeposited Funds","",582.00,523007.60
,"Sales Receipt","21-06-2024","2722",,"Kika Mart","-MULTIPLE-","Income","Zelia Handwash Liquid",,"Undeposited Funds","",582.00,523589.60
,"Sales Receipt","21-06-2024","2724",,"Hypermart","-MULTIPLE-","Income","Zelia Handwash Liquid",,"Undeposited Funds","",582.00,524171.60
,"Sales Receipt","21-06-2024","2725",,"Marris Mini mart","-MULTIPLE-","Income","Zelia Handwash Liquid",,"Undeposited Funds","",582.00,524753.60
,"Invoice","24-06-2024","MC05851",,"SUMM SUPERMARKET LIMITED","Zelia Apple Handwash Liquid 500ML","Income","Zelia Handwash Liquid",,"Accounts Receivable","",579.31,525332.91
,"Sales Receipt","24-06-2024","2730",,"Neema Bei Nafuu","-MULTIPLE-","Income","Zelia Handwash Liquid",,"Undeposited Funds","",1455.00,526787.91
,"Sales Receipt","24-06-2024","2729",,"Natala Shop","-MULTIPLE-","Income","Zelia Handwash Liquid",,"Undeposited Funds","",582.00,527369.91
,"Sales Receipt","24-06-2024","2720",,"Cheaper Cheap","Zelia Apple Handwash Liquid 500ML","Income","Zelia Handwash Liquid",,"Undeposited Funds","",679.00,528048.91
,"Sales Receipt","24-06-2024","2728",,"Gidesh Supermarket","-MULTIPLE-","Income","Zelia Handwash Liquid",,"Undeposited Funds","",2910.00,530958.91
,"Sales Receipt","24-06-2024","8960",,"Pambazuka Mart (K) Limited","-MULTIPLE-","Income","Zelia Handwash Liquid",,"Undeposited Funds","",2328.00,533286.91
,"Invoice","26-06-2024","MC05861",,"TAWALA SUPERMARKET LIMITED","-MULTIPLE-","Income","Zelia Handwash Liquid",,"Accounts Receivable","",1448.28,534735.19
,"Invoice","26-06-2024","MC05862",,"LUCKY MART SUPERMARKET LIMITED","-MULTIPLE-","Income","Zelia Handwash Liquid",,"Accounts Receivable","",1158.62,535893.81
,"Invoice","26-06-2024","MC05863",,"Tupo Mart Limited","-MULTIPLE-","Income","Zelia Handwash Liquid",,"Accounts Receivable","",1158.62,537052.43
,"Invoice","26-06-2024","MC05865",,"KASAMAT INVESTMENTS LTD","Zelia Apple Handwash Liquid 500ML","Income","Zelia Handwash Liquid",,"Accounts Receivable","",289.65,537342.08
,"Invoice","26-06-2024","MC05866",,"DISII TRADERS LTD","Zelia Apple Handwash Liquid 500ML","Income","Zelia Handwash Liquid",,"Accounts Receivable","",579.31,537921.39
,"Sales Receipt","26-06-2024","2734",,"Wadajir Wholesalers","-MULTIPLE-","Income","Zelia Handwash Liquid",,"Undeposited Funds","",8730.00,546651.39
,"Sales Receipt","27-06-2024","2736",,"Cash Sales","Zelia Strawberry Handwash Liquid 5L","Income","Zelia Handwash Liquid",,"Undeposited Funds","",700.00,547351.39
,"Sales Receipt","28-06-2024","2738",,"Cash Sales","Zelia Strawberry Handwash Liquid 5L","Income","Zelia Handwash Liquid",,"Undeposited Funds","",455.00,547806.39
,"Sales Receipt","28-06-2024","2744",,"Cash Sales","-MULTIPLE-","Income","Zelia Handwash Liquid",,"Undeposited Funds","",194.00,548000.39
,"Sales Receipt","01-07-2024","2553",,"Soko Store","Zelia Apple Handwash Liquid 500ML","Income","Zelia Handwash Liquid",,"Undeposited Funds","",679.00,548679.39
,"Sales Receipt","02-07-2024","2760",,"Cash Sales","Zelia Apple Handwash Liquid 500ML","Income","Zelia Handwash Liquid",,"Undeposited Funds","",90.00,548769.39
,"Invoice","03-07-2024","MC05880",,"SECUTOR LIMITED","Zelia Apple Handwash Liquid 500ML","Income","Zelia Handwash Liquid",,"Accounts Receivable","",110.00,548879.39
,"Sales Receipt","03-07-2024","2761",,"Cash Sales","-MULTIPLE-","Income","Zelia Handwash Liquid",,"Undeposited Funds",0.00,"",548879.39
,"Sales Receipt","03-07-2024","2767",,"Cash Sales","-MULTIPLE-","Income","Zelia Handwash Liquid",,"Undeposited Funds","",180.00,549059.39
,"Sales Receipt","03-07-2024","2772",,"Ahlam Shop","-MULTIPLE-","Income","Zelia Handwash Liquid",,"Undeposited Funds","",1455.00,550514.39
,"Sales Receipt","03-07-2024","2773",,"Muleshe Wholesallers","-MULTIPLE-","Income","Zelia Handwash Liquid",,"Undeposited Funds","",2910.00,553424.39
,"Sales Receipt","03-07-2024","2774",,"Warfa Wholesale","-MULTIPLE-","Income","Zelia Handwash Liquid",,"Undeposited Funds","",2910.00,556334.39
,"Sales Receipt","03-07-2024","2777",,"Farhan Wholesallers","-MULTIPLE-","Income","Zelia Handwash Liquid",,"Undeposited Funds","",5820.00,562154.39
,"Sales Receipt","03-07-2024","2780",,"Adno shop","-MULTIPLE-","Income","Zelia Handwash Liquid",,"Undeposited Funds","",1455.00,563609.39
,"Sales Receipt","03-07-2024","2770",,"Tayamo Wholesalers","Zelia Apple Handwash Liquid 500ML","Income","Zelia Handwash Liquid",,"Undeposited Funds","",97.00,563706.39
,"Sales Receipt","05-07-2024","2798",,"Two Boys Shop","-MULTIPLE-","Income","Zelia Handwash Liquid",,"Undeposited Funds","",1164.00,564870.39
,"Sales Receipt","05-07-2024","2799",,"Milimani Store","-MULTIPLE-","Income","Zelia Handwash Liquid",,"Undeposited Funds","",582.00,565452.39
,"Sales Receipt","05-07-2024","2514",,"Tender Store Limited","-MULTIPLE-","Income","Zelia Handwash Liquid",,"Undeposited Funds","",5820.00,571272.39
,"Sales Receipt","06-07-2024","2515",,"Horn of Africa","-MULTIPLE-","Income","Zelia Handwash Liquid",,"Undeposited Funds","",1455.00,572727.39
,"Sales Receipt","06-07-2024","2516",,"Baraka Cerials","-MULTIPLE-","Income","Zelia Handwash Liquid",,"Undeposited Funds","",582.00,573309.39
,"Sales Receipt","08-07-2024","2527",,"Afro Drip LTD","-MULTIPLE-","Income","Zelia Handwash Liquid",,"Undeposited Funds","",291.00,573600.39
,"Sales Receipt","08-07-2024","2506",,"Gargar Foodstuffs","Zelia Apple Handwash Liquid 500ML","Income","Zelia Handwash Liquid",,"Undeposited Funds","",1455.00,575055.39
,"Sales Receipt","09-07-2024","2510",,"Cash Sales","Zelia Apple Handwash Liquid 500ML","Income","Zelia Handwash Liquid",,"Undeposited Funds",0.00,"",575055.39
,"Sales Receipt","09-07-2024","2526",,"Cash Sales","-MULTIPLE-","Income","Zelia Handwash Liquid",,"Undeposited Funds",0.00,"",575055.39
,"Sales Receipt","09-07-2024","2569",,"Al Hamdu shop","-MULTIPLE-","Income","Zelia Handwash Liquid",,"Undeposited Funds","",1455.00,576510.39
,"Sales Receipt","10-07-2024","2556",,"Ekai moke wholesale","-MULTIPLE-","Income","Zelia Handwash Liquid",,"Undeposited Funds","",2910.00,579420.39
,"Sales Receipt","12-07-2024","2537",,"Cash Sales","Zelia Apple Handwash Liquid 500ML","Income","Zelia Handwash Liquid",,"Undeposited Funds","",176.00,579596.39
,"Invoice","15-07-2024","MC05921",,"OFFSHORE GLOBAL LOGISTICS LIMITED","Zelia Apple Handwash Liquid 5L","Income","Zelia Handwash Liquid",,"Accounts Receivable","",646.55,580242.94
,"Invoice","15-07-2024","MC05924",,"Azaavi Collections Limited","Zelia Strawberry Handwash Liquid 500ML","Income","Zelia Handwash Liquid",,"Accounts Receivable","",112.00,580354.94
,"Invoice","15-07-2024","MC05931",,"KASAMAT INVESTMENTS LTD","-MULTIPLE-","Income","Zelia Handwash Liquid",,"Accounts Receivable","",1158.62,581513.56
,"Invoice","15-07-2024","MC05932",,"ROYMATT SUPERMARKET LIMITED","-MULTIPLE-","Income","Zelia Handwash Liquid",,"Accounts Receivable","",579.30,582092.86
,"Sales Receipt","15-07-2024","2546",,"Brinso Foodstufs","-MULTIPLE-","Income","Zelia Handwash Liquid",,"Undeposited Funds","",1455.00,583547.86
,"Sales Receipt","15-07-2024","2549",,"Himilo General Store","-MULTIPLE-","Income","Zelia Handwash Liquid",,"Undeposited Funds","",5820.00,589367.86
,"Sales Receipt","16-07-2024","2550",,"Summer Outlets","-MULTIPLE-","Income","Zelia Handwash Liquid",,"Undeposited Funds","",1455.00,590822.86
,"Sales Receipt","16-07-2024","2557",,"Somo 1 Mowlem","-MULTIPLE-","Income","Zelia Handwash Liquid",,"Undeposited Funds","",1455.00,592277.86
,"Sales Receipt","16-07-2024","2563",,"Zulu Enterprise","-MULTIPLE-","Income","Zelia Handwash Liquid",,"Undeposited Funds","",1455.00,593732.86
,"Invoice","17-07-2024","MC05940",,"Maji Asili Limited","-MULTIPLE-","Income","Zelia Handwash Liquid",,"Accounts Receivable","",2896.55,596629.41
,"Invoice","17-07-2024","MC05941",,"Ck Upscales Limited","-MULTIPLE-","Income","Zelia Handwash Liquid",,"Accounts Receivable","",965.52,597594.93
,"Sales Receipt","17-07-2024","2551",,"Cash Sales","Zelia Apple Handwash Liquid 500ML","Income","Zelia Handwash Liquid",,"Undeposited Funds",0.00,"",597594.93
,"Sales Receipt","17-07-2024","2561",,"Mama G shop","-MULTIPLE-","Income","Zelia Handwash Liquid",,"Undeposited Funds","",2910.00,600504.93
,"Sales Receipt","17-07-2024","2559",,"Libin Minimart","-MULTIPLE-","Income","Zelia Handwash Liquid",,"Undeposited Funds","",2910.00,603414.93
,"Sales Receipt","18-07-2024","2604",,"Qudus Wholesale","-MULTIPLE-","Income","Zelia Handwash Liquid",,"Undeposited Funds","",1455.00,604869.93
,"Sales Receipt","18-07-2024","2576",,"Mizpa Minimart","-MULTIPLE-","Income","Zelia Handwash Liquid",,"Undeposited Funds","",388.00,605257.93
,"Sales Receipt","19-07-2024","2605",,"Restoration Traders","-MULTIPLE-","Income","Zelia Handwash Liquid",,"Undeposited Funds","",2910.00,608167.93
,"Sales Receipt","22-07-2024","2575",,"Cash Sales","-MULTIPLE-","Income","Zelia Handwash Liquid",,"Undeposited Funds","",1455.00,609622.93
,"Sales Receipt","22-07-2024","2570",,"Cash Sales","-MULTIPLE-","Income","Zelia Handwash Liquid",,"Undeposited Funds",0.00,"",609622.93
,"Sales Receipt","22-07-2024","2606",,"Skype Traders","-MULTIPLE-","Income","Zelia Handwash Liquid",,"Undeposited Funds","",5820.00,615442.93
,"Sales Receipt","23-07-2024","2580",,"Cash Sales","-MULTIPLE-","Income","Zelia Handwash Liquid",,"Undeposited Funds","",174.00,615616.93
,"Sales Receipt","23-07-2024","2582",,"Cash Sales","-MULTIPLE-","Income","Zelia Handwash Liquid",,"Undeposited Funds","",348.00,615964.93
,"Sales Receipt","23-07-2024","2591",,"Cash Sales","Zelia Strawberry Handwash Liquid 5L","Income","Zelia Handwash Liquid",,"Undeposited Funds","",750.00,616714.93
,"Sales Receipt","23-07-2024","2581",,"Cash Sales","-MULTIPLE-","Income","Zelia Handwash Liquid",,"Undeposited Funds",0.00,"",616714.93
,"Sales Receipt","23-07-2024","2607",,"Juli Mart","-MULTIPLE-","Income","Zelia Handwash Liquid",,"Undeposited Funds","",582.00,617296.93
,"Sales Receipt","24-07-2024","2588",,"Cash Sales","Zelia Strawberry Handwash Liquid 5L","Income","Zelia Handwash Liquid",,"Undeposited Funds","",750.00,618046.93
,"Sales Receipt","24-07-2024","2593",,"Cash Sales","Zelia Apple Handwash Liquid 500ML","Income","Zelia Handwash Liquid",,"Undeposited Funds",0.00,"",618046.93
,"Sales Receipt","24-07-2024","2587",,"Cash Sales","Zelia Strawberry Handwash Liquid 5L","Income","Zelia Handwash Liquid",,"Undeposited Funds",0.00,"",618046.93
,"Sales Receipt","24-07-2024","2597",,"Neema Supermarket","-MULTIPLE-","Income","Zelia Handwash Liquid",,"Undeposited Funds","",1455.00,619501.93
,"Sales Receipt","24-07-2024","2608",,"Capital Halal","-MULTIPLE-","Income","Zelia Handwash Liquid",,"Undeposited Funds","",582.00,620083.93
,"Sales Receipt","25-07-2024","2592",,"Cash Sales","Zelia Strawberry Handwash Liquid 5L","Income","Zelia Handwash Liquid",,"Undeposited Funds","",800.00,620883.93
,"Sales Receipt","25-07-2024","2609",,"Zebra Minimart","-MULTIPLE-","Income","Zelia Handwash Liquid",,"Undeposited Funds","",582.00,621465.93
,"Invoice","26-07-2024","MC05976",,"SUMM SUPERMARKET LIMITED","-MULTIPLE-","Income","Zelia Handwash Liquid",,"Accounts Receivable","",868.96,622334.89
,"Sales Receipt","27-07-2024","2653",,"Danaba Wholesallers","-MULTIPLE-","Income","Zelia Handwash Liquid",,"Undeposited Funds","",2910.00,625244.89
,"Sales Receipt","27-07-2024","2652",,"Mash-B Wholesale","-MULTIPLE-","Income","Zelia Handwash Liquid",,"Undeposited Funds","",1455.00,626699.89
,"Invoice","29-07-2024","MC05983",,"Muhaya & Rukundo Holdings Ltd","0001.12.00 Zelia Apple Handwash Liquid 15X500ML","Income","Zelia Handwash Liquid",,"Accounts Receivable","",1080.00,627779.89
,"Invoice","29-07-2024","MC05984",,"Mumsha Supamat","-MULTIPLE-","Income","Zelia Handwash Liquid",,"Accounts Receivable","",1158.62,628938.51
,"Sales Receipt","29-07-2024","2602",,"Cash Sales","-MULTIPLE-","Income","Zelia Handwash Liquid",,"Undeposited Funds",0.00,"",628938.51
,"Sales Receipt","29-07-2024","2610",,"Cash Sales","Zelia Apple Handwash Liquid 500ML","Income","Zelia Handwash Liquid",,"Undeposited Funds",0.00,"",628938.51
,"Sales Receipt","29-07-2024","2614",,"Rio Deli Wholesalers","-MULTIPLE-","Income","Zelia Handwash Liquid",,"Undeposited Funds","",2910.00,631848.51
,"Sales Receipt","29-07-2024","2615",,"Sharma Shop","-MULTIPLE-","Income","Zelia Handwash Liquid",,"Undeposited Funds","",1455.00,633303.51
,"Sales Receipt","29-07-2024","2922",,"Muhaya & Rukundo Holdings Ltd","Zelia Apple Handwash Liquid 15X500ML","Income","Zelia Handwash Liquid",,"Undeposited Funds","",2714.10,636017.61
,"Invoice","30-07-2024","MC05985",,"LUCKY MART SUPERMARKET LIMITED","Zelia Strawberry Handwash Liquid 500ML","Income","Zelia Handwash Liquid",,"Accounts Receivable","",579.31,636596.92
,"Sales Receipt","30-07-2024","2619",,"Cash Sales","Zelia Strawberry Handwash Liquid 500ML","Income","Zelia Handwash Liquid",,"Undeposited Funds","",130.00,636726.92
,"Sales Receipt","30-07-2024","2620",,"Cash Sales","Zelia Strawberry Handwash Liquid 500ML","Income","Zelia Handwash Liquid",,"Undeposited Funds","",390.00,637116.92
,"Sales Receipt","30-07-2024","2629",,"Cash Sales","Zelia Strawberry Handwash Liquid 5L","Income","Zelia Handwash Liquid",,"Undeposited Funds","",750.00,637866.92
,"Sales Receipt","30-07-2024","2627",,"Elliane Wholesalers","-MULTIPLE-","Income","Zelia Handwash Liquid",,"Undeposited Funds","",582.00,638448.92
,"Sales Receipt","30-07-2024","2626",,"Nzuri Supermarket","-MULTIPLE-","Income","Zelia Handwash Liquid",,"Undeposited Funds","",582.00,639030.92
,"Sales Receipt","30-07-2024","2689",,"Mt Kenya  mart","-MULTIPLE-","Income","Zelia Handwash Liquid",,"Undeposited Funds","",1164.00,640194.92
,"Sales Receipt","31-07-2024","2631",,"Cash Sales","Zelia Strawberry Handwash Liquid 5L","Income","Zelia Handwash Liquid",,"Undeposited Funds",0.00,"",640194.92
,"Sales Receipt","31-07-2024","2635",,"Cash Sales","Zelia Strawberry Handwash Liquid 5L","Income","Zelia Handwash Liquid",,"Undeposited Funds",0.00,"",640194.92
,"Sales Receipt","31-07-2024","2633",,"Sharazad Wholesalers","-MULTIPLE-","Income","Zelia Handwash Liquid",,"Undeposited Funds","",1455.00,641649.92
,"Sales Receipt","31-07-2024","2634",,"Ushirika Shop","-MULTIPLE-","Income","Zelia Handwash Liquid",,"Undeposited Funds","",4365.00,646014.92
,"Sales Receipt","01-08-2024","4353",,"Goldmart Supermarket","-MULTIPLE-","Income","Zelia Handwash Liquid",,"Undeposited Funds","",1455.00,647469.92
,"Sales Receipt","01-08-2024","2638",,"BCB Shop","-MULTIPLE-","Income","Zelia Handwash Liquid",,"Undeposited Funds","",1455.00,648924.92
,"Sales Receipt","01-08-2024","2691",,"Ubwere Store","-MULTIPLE-","Income","Zelia Handwash Liquid",,"Undeposited Funds","",1164.00,650088.92
,"Sales Receipt","01-08-2024","2664",,"Mkulima Supermarket","-MULTIPLE-","Income","Zelia Handwash Liquid",,"Undeposited Funds","",2328.00,652416.92
,"Sales Receipt","02-08-2024","2644",,"Cash Sales","Zelia Strawberry Handwash Liquid 500ML","Income","Zelia Handwash Liquid",,"Undeposited Funds","",130.00,652546.92
,"Sales Receipt","02-08-2024","2650",,"Cash Sales","Zelia Apple Handwash Liquid 500ML","Income","Zelia Handwash Liquid",,"Undeposited Funds","",88.00,652634.92
,"Sales Receipt","02-08-2024","2666",,"Mama Amina","-MULTIPLE-","Income","Zelia Handwash Liquid",,"Undeposited Funds","",1455.00,654089.92
,"Sales Receipt","03-08-2024","2670",,"Gacal Wholesale","-MULTIPLE-","Income","Zelia Handwash Liquid",,"Undeposited Funds","",1455.00,655544.92
,"Sales Receipt","03-08-2024","2668",,"Freshtake wholesalers","-MULTIPLE-","Income","Zelia Handwash Liquid",,"Undeposited Funds","",1455.00,656999.92
,"Sales Receipt","05-08-2024","2657",,"Cash Sales","Zelia Strawberry Handwash Liquid 500ML","Income","Zelia Handwash Liquid",,"Undeposited Funds","",1500.00,658499.92
,"Sales Receipt","05-08-2024","2671",,"Hidika Shop","-MULTIPLE-","Income","Zelia Handwash Liquid",,"Undeposited Funds","",1500.00,659999.92
,"Sales Receipt","05-08-2024","2679",,"Golden Save","-MULTIPLE-","Income","Zelia Handwash Liquid",,"Undeposited Funds","",11700.00,671699.92
,"Sales Receipt","05-08-2024","2673",,"Gure Yare Shop","-MULTIPLE-","Income","Zelia Handwash Liquid",,"Undeposited Funds","",6000.00,677699.92
,"Invoice","06-08-2024","MC06004",,"HAPPY VIEW SUPERMARKET LIMITED","-MULTIPLE-","Income","Zelia Handwash Liquid",,"Accounts Receivable","",1158.62,678858.54
,"Invoice","06-08-2024","MC06005",,"TAWALA SUPERMARKET LIMITED","-MULTIPLE-","Income","Zelia Handwash Liquid",,"Accounts Receivable","",1448.28,680306.82
,"Sales Receipt","06-08-2024","2659",,"Cash Sales","Zelia Strawberry Handwash Liquid 5L","Income","Zelia Handwash Liquid",,"Undeposited Funds","",800.00,681106.82
,"Sales Receipt","06-08-2024","2674",,"Cash Sales","Zelia Strawberry Handwash Liquid 500ML","Income","Zelia Handwash Liquid",,"Undeposited Funds","",90.00,681196.82
,"Sales Receipt","06-08-2024","2676",,"Warfa Wholesale","-MULTIPLE-","Income","Zelia Handwash Liquid",,"Undeposited Funds","",2910.00,684106.82
,"Sales Receipt","06-08-2024","2680",,"Juja Minimart","-MULTIPLE-","Income","Zelia Handwash Liquid",,"Undeposited Funds","",1455.00,685561.82
,"Sales Receipt","07-08-2024","2683",,"Marris Mini mart","Zelia Apple Handwash Liquid 500ML","Income","Zelia Handwash Liquid",,"Undeposited Funds","",582.00,686143.82
,"Sales Receipt","07-08-2024","2686",,"Soimo Minimart","-MULTIPLE-","Income","Zelia Handwash Liquid",,"Undeposited Funds","",600.00,686743.82
,"Sales Receipt","07-08-2024","2809",,"Safa Mart Wholesalers","-MULTIPLE-","Income","Zelia Handwash Liquid",,"Undeposited Funds","",1455.00,688198.82
,"Invoice","08-08-2024","MC06016",,"DISII TRADERS LTD","-MULTIPLE-","Income","Zelia Handwash Liquid",,"Accounts Receivable","",1158.62,689357.44
,"Invoice","08-08-2024","MC06017",,"INTEGRAL MEDIA LIMITED","Zelia Apple Handwash Liquid 5L","Income","Zelia Handwash Liquid",,"Accounts Receivable","",575.86,689933.30
,"Sales Receipt","08-08-2024","2694",,"mwaspart","-MULTIPLE-","Income","Zelia Handwash Liquid",,"Undeposited Funds","",1455.00,691388.30
,"Invoice","09-08-2024","MC06019",,"ROYMATT SUPERMARKET LIMITED","-MULTIPLE-","Income","Zelia Handwash Liquid",,"Accounts Receivable","",1448.28,692836.58
,"Invoice","09-08-2024","MC06020",,"DALLAS SHOPRITE LTD","-MULTIPLE-","Income","Zelia Handwash Liquid",,"Accounts Receivable","",1158.62,693995.20
,"Sales Receipt","09-08-2024","2696",,"Cash Sales","Zelia Strawberry Handwash Liquid 500ML","Income","Zelia Handwash Liquid",,"Undeposited Funds","",90.00,694085.20
,"Sales Receipt","09-08-2024","2699",,"Cash Sales","Zelia Strawberry Handwash Liquid 500ML","Income","Zelia Handwash Liquid",,"Undeposited Funds","",90.00,694175.20
,"Sales Receipt","09-08-2024","2811",,"SK Groceries","-MULTIPLE-","Income","Zelia Handwash Liquid",,"Undeposited Funds","",1500.00,695675.20
,"Sales Receipt","09-08-2024","2697",,"Bismillah shop","-MULTIPLE-","Income","Zelia Handwash Liquid",,"Undeposited Funds","",776.00,696451.20
,"Invoice","12-08-2024","MC06030",,"MASABA DISCOUNT STORES LTD","-MULTIPLE-","Income","Zelia Handwash Liquid",,"Accounts Receivable","",3232.76,699683.96
,"Invoice","12-08-2024","MC06031",,"KAVYA SUPERMARKET LIMITED","-MULTIPLE-","Income","Zelia Handwash Liquid",,"Accounts Receivable","",3232.76,702916.72
,"Sales Receipt","12-08-2024","2700",,"Vane Wholesalers","-MULTIPLE-","Income","Zelia Handwash Liquid",,"Undeposited Funds","",1525.00,704441.72
,"Sales Receipt","12-08-2024","2802",,"Sylas Store","Zelia Strawberry Handwash Liquid 500ML","Income","Zelia Handwash Liquid",,"Undeposited Funds","",7275.00,711716.72
,"Sales Receipt","12-08-2024","2802",,"Sylas Store","Zelia Apple Handwash Liquid 500ML","Income","Zelia Handwash Liquid",,"Undeposited Funds",0.00,"",711716.72
,"Sales Receipt","12-08-2024","2803",,"Diamond Shop","-MULTIPLE-","Income","Zelia Handwash Liquid",,"Undeposited Funds","",642.00,712358.72
,"Sales Receipt","12-08-2024","2805",,"Misin Shop","-MULTIPLE-","Income","Zelia Handwash Liquid",,"Undeposited Funds","",2846.00,715204.72
,"Sales Receipt","12-08-2024","2806",,"Riverside Hotel","-MULTIPLE-","Income","Zelia Handwash Liquid",,"Undeposited Funds","",1605.00,716809.72
,"Sales Receipt","12-08-2024","2813",,"Mamken Minimart","Zelia Strawberry Handwash Liquid 500ML","Income","Zelia Handwash Liquid",,"Undeposited Funds","",582.00,717391.72
,"Sales Receipt","12-08-2024","2814",,"Asfa Shop","-MULTIPLE-","Income","Zelia Handwash Liquid",,"Undeposited Funds","",582.00,717973.72
,"Sales Receipt","12-08-2024","2815",,"Kibibi Wasai Store","-MULTIPLE-","Income","Zelia Handwash Liquid",,"Undeposited Funds","",1455.00,719428.72
,"Sales Receipt","12-08-2024","2818",,"Rumi Wholesalers","-MULTIPLE-","Income","Zelia Handwash Liquid",,"Undeposited Funds","",2910.00,722338.72
,"Sales Receipt","13-08-2024","2848",,"Discount Traders","-MULTIPLE-","Income","Zelia Handwash Liquid",,"Undeposited Funds","",1455.00,723793.72
,"Sales Receipt","14-08-2024","MC06017",,"Cash Sales","Zelia Strawberry Handwash Liquid 5L","Income","Zelia Handwash Liquid",,"Undeposited Funds","",668.00,724461.72
,"Sales Receipt","14-08-2024","2842",,"Kibibi Wasai Store","-MULTIPLE-","Income","Zelia Handwash Liquid",,"Undeposited Funds","",1176.00,725637.72
,"Sales Receipt","15-08-2024","2828",,"Nabcom Wholesalers","-MULTIPLE-","Income","Zelia Handwash Liquid",,"Undeposited Funds","",1455.00,727092.72
,"Sales Receipt","15-08-2024","2892",,"Makueni Store","Zelia Strawberry Handwash Liquid 500ML","Income","Zelia Handwash Liquid",,"Undeposited Funds","",100.00,727192.72
,"Sales Receipt","15-08-2024","2846",,"Hogol Wholesale","-MULTIPLE-","Income","Zelia Handwash Liquid",,"Undeposited Funds","",13524.00,740716.72
,"Sales Receipt","16-08-2024","2901",,"Cash Sales","-MULTIPLE-","Income","Zelia Handwash Liquid",,"Undeposited Funds","",174.00,740890.72
,"Sales Receipt","16-08-2024","2850",,"Hawkers Paradise","-MULTIPLE-","Income","Zelia Handwash Liquid",,"Undeposited Funds","",388.00,741278.72
,"Sales Receipt","16-08-2024","2851",,"Tahila Enterprises","-MULTIPLE-","Income","Zelia Handwash Liquid",,"Undeposited Funds","",582.00,741860.72
,"Sales Receipt","16-08-2024","2852",,"032 Mart","Zelia Strawberry Handwash Liquid 500ML","Income","Zelia Handwash Liquid",,"Undeposited Funds","",582.00,742442.72
,"Sales Receipt","16-08-2024","2919",,"Mwananchi","-MULTIPLE-","Income","Zelia Handwash Liquid",,"Undeposited Funds","",1500.00,743942.72
,"Sales Receipt","19-08-2024","2839",,"Cash Sales","Zelia Strawberry Handwash Liquid 500ML","Income","Zelia Handwash Liquid",,"Undeposited Funds",0.00,"",743942.72
,"Sales Receipt","19-08-2024","2840",,"Cash Sales","Zelia Apple Handwash Liquid 500ML","Income","Zelia Handwash Liquid",,"Undeposited Funds","",87.00,744029.72
,"Sales Receipt","19-08-2024","2835",,"Jombs Wholesale","-MULTIPLE-","Income","Zelia Handwash Liquid",,"Undeposited Funds","",300.00,744329.72
,"Sales Receipt","20-08-2024","2858",,"Home Soko Minimart","Zelia Strawberry Handwash Liquid 500ML","Income","Zelia Handwash Liquid",,"Undeposited Funds","",600.00,744929.72
,"Credit Note","21-08-2024","CN01064",,"Muhaya & Rukundo Holdings Ltd","0001.12.00 Zelia Apple Handwash Liquid 15X500ML","Income","Zelia Handwash Liquid",,"Accounts Receivable",1080.00,"",743849.72
,"Invoice","21-08-2024","MC06061",,"Muhaya & Rukundo Holdings Ltd","-MULTIPLE-","Income","Zelia Handwash Liquid",,"Accounts Receivable","",158849.88,902699.60
,"Invoice","21-08-2024","MC06062",,"Muhaya & Rukundo Holdings Ltd","0001.12.00 Outer Handwash Strawberry/Apple 15x500ML","Income","Zelia Handwash Liquid",,"Accounts Receivable","",285.80,902985.40
,"Sales Receipt","21-08-2024","2870",,"Soft Landing","Zelia Apple Handwash Liquid 500ML","Income","Zelia Handwash Liquid",,"Undeposited Funds","",1605.00,904590.40
,"Sales Receipt","21-08-2024","2860",,"Marris Mini mart","Zelia Strawberry Handwash Liquid 500ML","Income","Zelia Handwash Liquid",,"Undeposited Funds","",600.00,905190.40
,"Sales Receipt","21-08-2024","2861",,"Al Towba Shop","-MULTIPLE-","Income","Zelia Handwash Liquid",,"Undeposited Funds","",1200.00,906390.40
,"Sales Receipt","21-08-2024","2864",,"Safwan Wholesalers","-MULTIPLE-","Income","Zelia Handwash Liquid",,"Undeposited Funds","",6000.00,912390.40
,"Sales Receipt","21-08-2024","2866",,"Budget Busket","-MULTIPLE-","Income","Zelia Handwash Liquid",,"Undeposited Funds","",1500.00,913890.40
,"Sales Receipt","21-08-2024","2855",,"Homecare Enterprise","Zelia Strawberry Handwash Liquid 5L","Income","Zelia Handwash Liquid",,"Undeposited Funds","",667.00,914557.40
,"Invoice","22-08-2024","MC06066",,"Cash Sales","Zelia Apple Handwash Liquid 500ML","Income","Zelia Handwash Liquid",,"Accounts Receivable","",129.31,914686.71
,"Credit Note","22-08-2024","CN01065",,"Cash Sales","Zelia Apple Handwash Liquid 500ML","Income","Zelia Handwash Liquid",,"Accounts Receivable",129.31,"",914557.40
,"Invoice","22-08-2024","MC06068",,"BLUEMART SUPERMARKET LIMITED","-MULTIPLE-","Income","Zelia Handwash Liquid",,"Accounts Receivable","",600.00,915157.40
,"Invoice","22-08-2024","MC06070",,"LUCKY MART SUPERMARKET LIMITED","-MULTIPLE-","Income","Zelia Handwash Liquid",,"Accounts Receivable","",1448.27,916605.67
,"Sales Receipt","22-08-2024","2867",,"Sultan Iman Shop","Zelia Apple Handwash Liquid 500ML","Income","Zelia Handwash Liquid",,"Undeposited Funds","",1455.00,918060.67
,"Sales Receipt","22-08-2024","2875",,"Maida Minimart","-MULTIPLE-","Income","Zelia Handwash Liquid",,"Undeposited Funds","",1500.00,919560.67
,"Sales Receipt","22-08-2024","2897",,"Hayan Wholesalers","-MULTIPLE-","Income","Zelia Handwash Liquid",,"Undeposited Funds","",3000.00,922560.67
,"Sales Receipt","22-08-2024","1135",,"Ebenezer Minimart","-MULTIPLE-","Income","Zelia Handwash Liquid",,"Undeposited Funds","",600.00,923160.67
,"Sales Receipt","22-08-2024","1206",,"Tangents Minimart","-MULTIPLE-","Income","Zelia Handwash Liquid",,"Undeposited Funds","",428.00,923588.67
,"Sales Receipt","23-08-2024","2877",,"Cash Sales","Zelia Apple Handwash Liquid 500ML","Income","Zelia Handwash Liquid",,"Undeposited Funds","",150.00,923738.67
,"Sales Receipt","23-08-2024","2880",,"Cash Sales","Zelia Apple Handwash Liquid 500ML","Income","Zelia Handwash Liquid",,"Undeposited Funds","",150.00,923888.67
,"Sales Receipt","23-08-2024","2881",,"Cash Sales","Zelia Strawberry Handwash Liquid 5L","Income","Zelia Handwash Liquid",,"Undeposited Funds","",850.00,924738.67
,"Sales Receipt","23-08-2024","2899",,"Beraccah Syokimau","-MULTIPLE-","Income","Zelia Handwash Liquid",,"Undeposited Funds","",1200.00,925938.67
,"Sales Receipt","26-08-2024","2865",,"Cash Sales","Zelia Strawberry Handwash Liquid 500ML","Income","Zelia Handwash Liquid",,"Undeposited Funds","",90.00,926028.67
,"Sales Receipt","26-08-2024","2882",,"Cash Sales","Zelia Apple Handwash Liquid 500ML","Income","Zelia Handwash Liquid",,"Undeposited Funds","",150.00,926178.67
,"Sales Receipt","26-08-2024","2883",,"Cash Sales","Zelia Strawberry Handwash Liquid 500ML","Income","Zelia Handwash Liquid",,"Undeposited Funds","",450.00,926628.67
,"Sales Receipt","26-08-2024","2900",,"Al- Zake Shop","-MULTIPLE-","Income","Zelia Handwash Liquid",,"Undeposited Funds","",1500.00,928128.67
,"Sales Receipt","26-08-2024","2908",,"Himilo General Store","-MULTIPLE-","Income","Zelia Handwash Liquid",,"Undeposited Funds","",6000.00,934128.67
,"Sales Receipt","26-08-2024","1207",,"Kemera Discount","Zelia Strawberry Handwash Liquid 500ML","Income","Zelia Handwash Liquid",,"Undeposited Funds","",1605.00,935733.67
,"Sales Receipt","26-08-2024","1207",,"Kemera Discount","Zelia Apple Handwash Liquid 500ML","Income","Zelia Handwash Liquid",,"Undeposited Funds",0.00,"",935733.67
,"Sales Receipt","27-08-2024","2915",,"Cash Sales","Zelia Strawberry Handwash Liquid 5L","Income","Zelia Handwash Liquid",,"Undeposited Funds","",780.00,936513.67
,"Sales Receipt","27-08-2024","2910",,"Milele Shop","-MULTIPLE-","Income","Zelia Handwash Liquid",,"Undeposited Funds","",1500.00,938013.67
,"Sales Receipt","28-08-2024","2912",,"Libin Minimart","-MULTIPLE-","Income","Zelia Handwash Liquid",,"Undeposited Funds","",3000.00,941013.67
,"Sales Receipt","29-08-2024","AT201",,"Cash Sales","-MULTIPLE-","Income","Zelia Handwash Liquid",,"Undeposited Funds","",1271.20,942284.87
,"Sales Receipt","02-09-2024","3225",,"Purity Shop","-MULTIPLE-","Income","Zelia Handwash Liquid",,"Undeposited Funds","",300.00,942584.87
,"Sales Receipt","02-09-2024","2923",,"Blossom Beauty","-MULTIPLE-","Income","Zelia Handwash Liquid",,"Undeposited Funds","",1200.00,943784.87
,"Sales Receipt","02-09-2024","2924",,"Rio Deli Wholesalers","-MULTIPLE-","Income","Zelia Handwash Liquid",,"Undeposited Funds","",1500.00,945284.87
,"Sales Receipt","02-09-2024","2928",,"Beta Traders","-MULTIPLE-","Income","Zelia Handwash Liquid",,"Undeposited Funds","",1455.00,946739.87
,"Sales Receipt","02-09-2024","2926",,"Gacal Wholesale","-MULTIPLE-","Income","Zelia Handwash Liquid",,"Undeposited Funds","",7500.00,954239.87
,"Sales Receipt","03-09-2024","2930",,"Horn of Africa","-MULTIPLE-","Income","Zelia Handwash Liquid",,"Undeposited Funds","",1500.00,955739.87
,"Sales Receipt","03-09-2024","2931",,"Jombs wholesalers","Zelia Strawberry Handwash Liquid 15x500ML","Income","Zelia Handwash Liquid",,"Undeposited Funds","",672.00,956411.87
,"Sales Receipt","03-09-2024","3228",,"Hogol  E Wholesale","Zelia Strawberry Handwash Liquid 15x500ML","Income","Zelia Handwash Liquid",,"Undeposited Funds","",7500.00,963911.87
,"Sales Receipt","03-09-2024","2927",,"Cash Sales","Zelia Apple Handwash Liquid 15X500ML","Income","Zelia Handwash Liquid",,"Undeposited Funds","",120.01,964031.88
,"Sales Receipt","03-09-2024","2922",,"Cash Sales","Zelia Strawberry Handwash Liquid 15x500ML","Income","Zelia Handwash Liquid",,"Undeposited Funds",0.00,"",964031.88
,"Invoice","04-09-2024","MC06107",,"Tupo Mart Limited","-MULTIPLE-","Income","Zelia Handwash Liquid",,"Accounts Receivable","",1500.00,965531.88
,"Invoice","04-09-2024","MC06108",,"PRICE CHOPPER STORES LIMITED","Zelia Apple Handwash Liquid 500ML","Income","Zelia Handwash Liquid",,"Accounts Receivable","",1200.00,966731.88
,"Invoice","04-09-2024","MC06116",,"Zenith Steel Fabricators Ltd","Zelia Strawberry Handwash Liquid 5L","Income","Zelia Handwash Liquid",,"Accounts Receivable","",13400.00,980131.88
,"Sales Receipt","04-09-2024","2937",,"Restoration Traders","-MULTIPLE-","Income","Zelia Handwash Liquid",,"Undeposited Funds","",3000.00,983131.88
,"Sales Receipt","04-09-2024","2938",,"D-Madina Enterprise","-MULTIPLE-","Income","Zelia Handwash Liquid",,"Undeposited Funds","",3000.00,986131.88
,"Sales Receipt","04-09-2024","2939",,"Qudus Shop","-MULTIPLE-","Income","Zelia Handwash Liquid",,"Undeposited Funds","",1500.00,987631.88
,"Sales Receipt","04-09-2024","3013",,"Ogena Matt","Zelia Apple Handwash Liquid 15X500ML","Income","Zelia Handwash Liquid",,"Undeposited Funds","",1605.00,989236.88
,"Sales Receipt","04-09-2024","3014",,"Gifted Hands","-MULTIPLE-","Income","Zelia Handwash Liquid",,"Undeposited Funds","",440.00,989676.88
,"Sales Receipt","04-09-2024","2942",,"SK Groceries","-MULTIPLE-","Income","Zelia Handwash Liquid",,"Undeposited Funds","",1500.00,991176.88
,"Invoice","05-09-2024","MC06121",,"THE BRIGHT STAR SUPERMARKET LIMITED","-MULTIPLE-","Income","Zelia Handwash Liquid",,"Accounts Receivable","",1448.28,992625.16
,"Invoice","05-09-2024","MC06122",,"NASRI MART LIMITED","-MULTIPLE-","Income","Zelia Handwash Liquid",,"Accounts Receivable","",2000.00,994625.16
,"Credit Note","05-09-2024","CN01067",,"MASABA DISCOUNT STORES LTD","-MULTIPLE-","Income","Zelia Handwash Liquid",,"Accounts Receivable",3232.76,"",991392.40
,"Invoice","05-09-2024","MC06123",,"MASABA DISCOUNT STORES LTD","-MULTIPLE-","Income","Zelia Handwash Liquid",,"Accounts Receivable","",2844.83,994237.23
,"Sales Receipt","05-09-2024","2948",,"Jam Tower Shop","-MULTIPLE-","Income","Zelia Handwash Liquid",,"Undeposited Funds","",1500.00,995737.23
,"Sales Receipt","05-09-2024","2950",,"Cash Sales","Zelia Apple Handwash Liquid 15X500ML","Income","Zelia Handwash Liquid",,"Undeposited Funds","",87.00,995824.23
,"Sales Receipt","05-09-2024","2955",,"Cash Sales","-MULTIPLE-","Income","Zelia Handwash Liquid",,"Undeposited Funds","",767.01,996591.24
,"Sales Receipt","05-09-2024","2952",,"Cash Sales","Zelia Strawberry Handwash Liquid 15x500ML","Income","Zelia Handwash Liquid",,"Undeposited Funds",0.00,"",996591.24
,"Sales Receipt","06-09-2024","2961",,"Gure Yare Shop","-MULTIPLE-","Income","Zelia Handwash Liquid",,"Undeposited Funds","",6000.00,1002591.24
,"Sales Receipt","08-09-2024","3227",,"Visina Stores","-MULTIPLE-","Income","Zelia Handwash Liquid",,"Undeposited Funds","",7500.00,1010091.24
,"Sales Receipt","08-09-2024","2959",,"Cash Sales","Zelia Strawberry Handwash Liquid 4x5L","Income","Zelia Handwash Liquid",,"Undeposited Funds","",650.00,1010741.24
,"Sales Receipt","09-09-2024","2964",,"Dalwo Wholesalers","-MULTIPLE-","Income","Zelia Handwash Liquid",,"Undeposited Funds","",3000.00,1013741.24
,"Sales Receipt","09-09-2024","2960",,"Mizpa Minimart","-MULTIPLE-","Income","Zelia Handwash Liquid",,"Undeposited Funds","",600.00,1014341.24
,"Sales Receipt","09-09-2024","2986",,"Pambazuka Mart (K) Limited","-MULTIPLE-","Income","Zelia Handwash Liquid",,"Undeposited Funds","",3000.00,1017341.24
,"Sales Receipt","09-09-2024","2970",,"Cash Sales","Zelia Apple Handwash Liquid 15X500ML","Income","Zelia Handwash Liquid",,"Undeposited Funds","",87.00,1017428.24
,"Sales Receipt","10-09-2024","2980",,"Bei Nafuu Shop","-MULTIPLE-","Income","Zelia Handwash Liquid",,"Undeposited Funds","",1500.00,1018928.24
,"Sales Receipt","10-09-2024","2983",,"Summer Outlets","-MULTIPLE-","Income","Zelia Handwash Liquid",,"Undeposited Funds","",3000.00,1021928.24
,"Sales Receipt","10-09-2024","2984",,"Al manaan","-MULTIPLE-","Income","Zelia Handwash Liquid",,"Undeposited Funds","",2400.00,1024328.24
,"Sales Receipt","10-09-2024","2975",,"Cash Sales","Zelia Strawberry Handwash Liquid 15x500ML","Income","Zelia Handwash Liquid",,"Undeposited Funds","",380.00,1024708.24
,"Sales Receipt","10-09-2024","3015",,"Cash Sales","Zelia Strawberry Handwash Liquid 15x500ML","Income","Zelia Handwash Liquid",,"Undeposited Funds","",200.00,1024908.24
,"Sales Receipt","10-09-2024","3237",,"Cash Sales","-MULTIPLE-","Income","Zelia Handwash Liquid",,"Undeposited Funds",0.00,"",1024908.24
,"Sales Receipt","11-09-2024","2996",,"Freshfinds Mart","-MULTIPLE-","Income","Zelia Handwash Liquid",,"Undeposited Funds","",1500.00,1026408.24
,"Sales Receipt","11-09-2024","2997",,"Domasco Wholesalers","-MULTIPLE-","Income","Zelia Handwash Liquid",,"Undeposited Funds","",1605.00,1028013.24
,"Sales Receipt","11-09-2024","2999",,"Anab Shop","-MULTIPLE-","Income","Zelia Handwash Liquid",,"Undeposited Funds","",1500.00,1029513.24
,"Sales Receipt","11-09-2024","3000",,"Ushirika Shop","-MULTIPLE-","Income","Zelia Handwash Liquid",,"Undeposited Funds","",6000.00,1035513.24
,"Sales Receipt","11-09-2024","2998",,"Mumtaz Shop","-MULTIPLE-","Income","Zelia Handwash Liquid",,"Undeposited Funds","",1200.00,1036713.24
,"Sales Receipt","11-09-2024","3011",,"Warfa Wholesale","-MULTIPLE-","Income","Zelia Handwash Liquid",,"Undeposited Funds","",3000.00,1039713.24
,"Invoice","12-09-2024","MC06143",,"Karia Supermarkets Limited","-MULTIPLE-","Income","Zelia Handwash Liquid",,"Accounts Receivable","",4800.00,1044513.24
,"Invoice","12-09-2024","MC06147",,"ZAIN SUPERMARKET LIMITED","Zelia Apple Handwash Liquid 15X500ML","Income","Zelia Handwash Liquid",,"Accounts Receivable","",600.00,1045113.24
,"Sales Receipt","12-09-2024","3055",,"Mubarak Shop","-MULTIPLE-","Income","Zelia Handwash Liquid",,"Undeposited Funds","",1200.00,1046313.24
,"Sales Receipt","12-09-2024","2988",,"Kumlliye Shop","-MULTIPLE-","Income","Zelia Handwash Liquid",,"Undeposited Funds","",17100.00,1063413.24
,"Sales Receipt","12-09-2024","3020",,"Kamau Shop","-MULTIPLE-","Income","Zelia Handwash Liquid",,"Undeposited Funds","",1500.00,1064913.24
,"Sales Receipt","12-09-2024","3021",,"Marwa Tower Shop","-MULTIPLE-","Income","Zelia Handwash Liquid",,"Undeposited Funds","",1200.00,1066113.24
,"Sales Receipt","12-09-2024","1845",,"Daniel Shop","-MULTIPLE-","Income","Zelia Handwash Liquid",,"Undeposited Funds","",1605.00,1067718.24
,"Sales Receipt","12-09-2024","3026",,"Hemali Shop","-MULTIPLE-","Income","Zelia Handwash Liquid",,"Undeposited Funds","",2140.00,1069858.24
,"Sales Receipt","12-09-2024","2987",,"Cash Sales","Zelia Strawberry Handwash Liquid 4x5L","Income","Zelia Handwash Liquid",,"Undeposited Funds","",2400.00,1072258.24
,"Sales Receipt","13-09-2024","3034",,"Milele Shop","-MULTIPLE-","Income","Zelia Handwash Liquid",,"Undeposited Funds","",3000.00,1075258.24
,"Sales Receipt","13-09-2024","3032",,"Cash Sales","Zelia Strawberry Handwash Liquid 15x500ML","Income","Zelia Handwash Liquid",,"Undeposited Funds","",174.00,1075432.24
,"Sales Receipt","13-09-2024","3033",,"Cash Sales","Zelia Strawberry Handwash Liquid 15x500ML","Income","Zelia Handwash Liquid",,"Undeposited Funds","",200.00,1075632.24
,"Sales Receipt","14-09-2024","3041",,"Lekima Wholesale","-MULTIPLE-","Income","Zelia Handwash Liquid",,"Undeposited Funds","",1200.00,1076832.24
,"Sales Receipt","14-09-2024","3042",,"mwaspart","-MULTIPLE-","Income","Zelia Handwash Liquid",,"Undeposited Funds","",1200.00,1078032.24
,"Sales Receipt","14-09-2024","3043",,"Gladys Wholesalers","-MULTIPLE-","Income","Zelia Handwash Liquid",,"Undeposited Funds","",856.00,1078888.24
,"Sales Receipt","16-09-2024","3045",,"Afro Drip LTD Reception","Zelia Strawberry Handwash Liquid 15x500ML","Income","Zelia Handwash Liquid",,"Undeposited Funds","",100.00,1078988.24
,"Sales Receipt","16-09-2024","3037",,"Cash Sales","Zelia Strawberry Handwash Liquid 4x5L","Income","Zelia Handwash Liquid",,"Undeposited Funds","",750.00,1079738.24
,"Sales Receipt","16-09-2024","3039",,"Cash Sales","Zelia Strawberry Handwash Liquid 4x5L","Income","Zelia Handwash Liquid",,"Undeposited Funds","",800.00,1080538.24
,"Sales Receipt","16-09-2024","3040",,"Cash Sales","Zelia Strawberry Handwash Liquid 4x5L","Income","Zelia Handwash Liquid",,"Undeposited Funds","",800.00,1081338.24
,"Invoice","18-09-2024","MC06164",,"MKULIMA WANGIGE SUPERMARKET","-MULTIPLE-","Income","Zelia Handwash Liquid",,"Accounts Receivable","",1200.00,1082538.24
,"Invoice","18-09-2024","MC06165",,"MKULIMA MUCHATHA","-MULTIPLE-","Income","Zelia Handwash Liquid",,"Accounts Receivable","",1200.00,1083738.24
,"Sales Receipt","18-09-2024","3058",,"Primeken Shop","-MULTIPLE-","Income","Zelia Handwash Liquid",,"Undeposited Funds","",1500.00,1085238.24
,"Sales Receipt","18-09-2024","3059",,"Farhan Shop","-MULTIPLE-","Income","Zelia Handwash Liquid",,"Undeposited Funds","",1500.00,1086738.24
,"Sales Receipt","18-09-2024","3056",,"Cash Sales","Zelia Strawberry Handwash Liquid 15x500ML","Income","Zelia Handwash Liquid",,"Undeposited Funds","",150.01,1086888.25
,"Sales Receipt","19-09-2024","3093",,"Komondi Store","-MULTIPLE-","Income","Zelia Handwash Liquid",,"Undeposited Funds","",3210.00,1090098.25
,"Sales Receipt","19-09-2024","3065",,"Britco Wholesalers","-MULTIPLE-","Income","Zelia Handwash Liquid",,"Undeposited Funds","",7500.00,1097598.25
,"Invoice","20-09-2024","MC06179",,"OFFSHORE GLOBAL LOGISTICS LIMITED","Zelia Strawberry Handwash Liquid 4x5L","Income","Zelia Handwash Liquid",,"Accounts Receivable","",2565.00,1100163.25
,"Sales Receipt","20-09-2024","3094",,"Duto Rumo Store","-MULTIPLE-","Income","Zelia Handwash Liquid",,"Undeposited Funds","",642.00,1100805.25
,"Sales Receipt","20-09-2024","3203",,"Bei Poa","-MULTIPLE-","Income","Zelia Handwash Liquid",,"Undeposited Funds","",3210.00,1104015.25
,"Sales Receipt","20-09-2024","3075",,"Arqam minimart","-MULTIPLE-","Income","Zelia Handwash Liquid",,"Undeposited Funds","",1500.00,1105515.25
,"Sales Receipt","20-09-2024","3204",,"Meghan Stores","-MULTIPLE-","Income","Zelia Handwash Liquid",,"Undeposited Funds","",1712.00,1107227.25
,"Sales Receipt","20-09-2024","3205",,"Omundo Discount","-MULTIPLE-","Income","Zelia Handwash Liquid",,"Undeposited Funds","",3300.00,1110527.25
,"Sales Receipt","20-09-2024","3229",,"Kwetu Shop","-MULTIPLE-","Income","Zelia Handwash Liquid",,"Undeposited Funds","",642.00,1111169.25
,"Sales Receipt","21-09-2024","3244",,"Gladys Wholesalers","-MULTIPLE-","Income","Zelia Handwash Liquid",,"Undeposited Funds","",2354.00,1113523.25
,"Sales Receipt","22-09-2024","3230",,"Kamau Shop","-MULTIPLE-","Income","Zelia Handwash Liquid",,"Undeposited Funds","",1605.00,1115128.25
,"Sales Receipt","22-09-2024","3231",,"Hemali Shop","-MULTIPLE-","Income","Zelia Handwash Liquid",,"Undeposited Funds","",1070.00,1116198.25
,"Sales Receipt","23-09-2024","3085",,"Downtown Wholesalers","-MULTIPLE-","Income","Zelia Handwash Liquid",,"Undeposited Funds","",1500.00,1117698.25
,"Sales Receipt","23-09-2024","3086",,"Brinso Foodstufs","-MULTIPLE-","Income","Zelia Handwash Liquid",,"Undeposited Funds","",1500.00,1119198.25
,"Sales Receipt","23-09-2024","3074",,"Cash Sales","Zelia Strawberry Handwash Liquid 15x500ML","Income","Zelia Handwash Liquid",,"Undeposited Funds","",86.00,1119284.25
,"Invoice","24-09-2024","MC06194",,"OGENA PRIME DISTRIBUTORS LIMITED","Zelia Apple Handwash Liquid 15X500ML","Income","Zelia Handwash Liquid",,"Accounts Receivable","",1383.62,1120667.87
,"Invoice","24-09-2024","MC06195",,"TAWALA SUPERMARKET LIMITED","-MULTIPLE-","Income","Zelia Handwash Liquid",,"Accounts Receivable","",3000.00,1123667.87
,"Invoice","24-09-2024","MC06196",,"KASAMAT INVESTMENTS LTD","Zelia Apple Handwash Liquid 15X500ML","Income","Zelia Handwash Liquid",,"Accounts Receivable","",600.00,1124267.87
,"Credit Note","24-09-2024","CN01069",,"OGENA PRIME DISTRIBUTORS LIMITED","Zelia Apple Handwash Liquid 15X500ML","Income","Zelia Handwash Liquid",,"Accounts Receivable",1383.62,"",1122884.25
,"Sales Receipt","24-09-2024","3090",,"Elliane Wholesalers","Zelia Strawberry Handwash Liquid 15x500ML","Income","Zelia Handwash Liquid",,"Undeposited Funds","",600.00,1123484.25
,"Sales Receipt","24-09-2024","3234",,"Gifted Hands","Zelia Strawberry Handwash Liquid 15x500ML","Income","Zelia Handwash Liquid",,"Undeposited Funds","",428.00,1123912.25
,"Sales Receipt","24-09-2024","3083",,"Kibibi Wasai Store","Zelia Strawberry Handwash Liquid 5L","Income","Zelia Handwash Liquid",,"Undeposited Funds","",668.00,1124580.25
,"Invoice","25-09-2024","MC06197",,"Khetshi Dharamshi And Company Limited","Zelia Strawberry Handwash Liquid 4x5L","Income","Zelia Handwash Liquid",,"Accounts Receivable","",2600.00,1127180.25
,"Sales Receipt","25-09-2024","3100",,"Al- Malik Wholesalers","-MULTIPLE-","Income","Zelia Handwash Liquid",,"Undeposited Funds","",3000.00,1130180.25
,"Sales Receipt","25-09-2024","3201",,"Salama Shop","-MULTIPLE-","Income","Zelia Handwash Liquid",,"Undeposited Funds","",1500.00,1131680.25
,"Sales Receipt","25-09-2024","3218",,"Mary Super Store","-MULTIPLE-","Income","Zelia Handwash Liquid",,"Undeposited Funds","",3210.00,1134890.25
,"Invoice","26-09-2024","MC06206",,"INTEGRAL MEDIA LIMITED","-MULTIPLE-","Income","Zelia Handwash Liquid",,"Accounts Receivable","",4500.00,1139390.25
,"Sales Receipt","26-09-2024","3210",,"Rehoji Shop","-MULTIPLE-","Income","Zelia Handwash Liquid",,"Undeposited Funds","",1500.00,1140890.25
,"Sales Receipt","26-09-2024","3207",,"Kimu Shop","-MULTIPLE-","Income","Zelia Handwash Liquid",,"Undeposited Funds","",963.00,1141853.25
,"Sales Receipt","26-09-2024","3235",,"Oyugis Discount","-MULTIPLE-","Income","Zelia Handwash Liquid",,"Undeposited Funds","",6420.00,1148273.25
,"Sales Receipt","26-09-2024","3209",,"Cash Sales","Zelia Apple Handwash Liquid 15X500ML","Income","Zelia Handwash Liquid",,"Undeposited Funds","",200.00,1148473.25
,"Invoice","27-09-2024","MC06216",,"QUALITYMART SUPERMARKET LIMITED","-MULTIPLE-","Income","Zelia Handwash Liquid",,"Accounts Receivable","",1500.00,1149973.25
,"Invoice","27-09-2024","MC06217",,"Mumsha Supamat","-MULTIPLE-","Income","Zelia Handwash Liquid",,"Accounts Receivable","",1500.00,1151473.25
,"Invoice","27-09-2024","MC06218",,"LUCKY MART SUPERMARKET LIMITED","-MULTIPLE-","Income","Zelia Handwash Liquid",,"Accounts Receivable","",3000.00,1154473.25
,"Sales Receipt","27-09-2024","3215",,"Supaa Mart","-MULTIPLE-","Income","Zelia Handwash Liquid",,"Undeposited Funds","",1200.00,1155673.25
,"Sales Receipt","27-09-2024","3214",,"Kenya Yetu Mart","-MULTIPLE-","Income","Zelia Handwash Liquid",,"Undeposited Funds","",1200.00,1156873.25
,"Sales Receipt","27-09-2024","3213",,"DayBreak Shop","-MULTIPLE-","Income","Zelia Handwash Liquid",,"Undeposited Funds","",600.00,1157473.25
,"Sales Receipt","27-09-2024","3245",,"Florence Shop","-MULTIPLE-","Income","Zelia Handwash Liquid",,"Undeposited Funds","",300.00,1157773.25
,"Sales Receipt","27-09-2024","3216",,"Cash Sales","Zelia Strawberry Handwash Liquid 15x500ML","Income","Zelia Handwash Liquid",,"Undeposited Funds","",259.99,1158033.24
,"Sales Receipt","28-09-2024","3246",,"Gidesh Minimart","Zelia Strawberry Handwash Liquid 15x500ML","Income","Zelia Handwash Liquid",,"Undeposited Funds","",600.00,1158633.24
,"Sales Receipt","28-09-2024","3222",,"Gidesh Minimart","Zelia Apple Handwash Liquid 15X500ML","Income","Zelia Handwash Liquid",,"Undeposited Funds","",600.00,1159233.24
,"Sales Receipt","28-09-2024","3247",,"Milan Shop","-MULTIPLE-","Income","Zelia Handwash Liquid",,"Undeposited Funds","",1000.00,1160233.24
,"Sales Receipt","01-10-2024","3224",,"Cash Sales","Zelia Apple Handwash Liquid 15X500ML","Income","Zelia Handwash Liquid",,"Undeposited Funds","",150.01,1160383.25
,"Sales Receipt","01-10-2024","3217",,"Cash Sales","Zelia Strawberry Handwash Liquid 4x5L","Income","Zelia Handwash Liquid",,"Undeposited Funds","",700.00,1161083.25
,"Sales Receipt","01-10-2024","3224",,"Cash Sales","Zelia Apple Handwash Liquid 15X500ML","Income","Zelia Handwash Liquid",,"Undeposited Funds","",150.00,1161233.25
,"Sales Receipt","01-10-2024","3418",,"Duto Rumo Store","-MULTIPLE-","Income","Zelia Handwash Liquid",,"Undeposited Funds","",1070.00,1162303.25
,"Sales Receipt","01-10-2024","3257",,"Rio Deli Wholesalers","-MULTIPLE-","Income","Zelia Handwash Liquid",,"Undeposited Funds","",3000.00,1165303.25
,"Sales Receipt","02-10-2024","3228",,"Cash Sales","Zelia Strawberry Handwash Liquid 15x500ML","Income","Zelia Handwash Liquid",,"Undeposited Funds","",487.50,1165790.75
,"Sales Receipt","02-10-2024","3229",,"Towba general stores Parkroad","-MULTIPLE-","Income","Zelia Handwash Liquid",,"Undeposited Funds","",3000.00,1168790.75
,"Sales Receipt","02-10-2024","3230",,"Mama Amina","-MULTIPLE-","Income","Zelia Handwash Liquid",,"Undeposited Funds","",1500.00,1170290.75
,"Sales Receipt","02-10-2024","3419",,"Norhani Groceries","-MULTIPLE-","Income","Zelia Handwash Liquid",,"Undeposited Funds","",3000.00,1173290.75
,"Sales Receipt","02-10-2024","3244",,"B-Shop","-MULTIPLE-","Income","Zelia Handwash Liquid",,"Undeposited Funds","",4500.00,1177790.75
,"Sales Receipt","02-10-2024","3237",,"Farhan Wholesallers","-MULTIPLE-","Income","Zelia Handwash Liquid",,"Undeposited Funds","",6000.00,1183790.75
,"Sales Receipt","02-10-2024","3238",,"Libin Minimart","-MULTIPLE-","Income","Zelia Handwash Liquid",,"Undeposited Funds","",3000.00,1186790.75
,"Invoice","03-10-2024","MC06231",,"MASABA DISCOUNT STORES LTD","-MULTIPLE-","Income","Zelia Handwash Liquid",,"Accounts Receivable","",7112.07,1193902.82
,"Sales Receipt","03-10-2024","3246",,"Fahan Foodstuff","-MULTIPLE-","Income","Zelia Handwash Liquid",,"Undeposited Funds","",7500.00,1201402.82
,"Sales Receipt","03-10-2024","3248",,"Elwak Stores","-MULTIPLE-","Income","Zelia Handwash Liquid",,"Undeposited Funds","",1500.00,1202902.82
,"Sales Receipt","05-10-2024","3420",,"Danaba Wholesallers","-MULTIPLE-","Income","Zelia Handwash Liquid",,"Undeposited Funds","",10500.00,1213402.82
,"Sales Receipt","06-10-2024","3184",,"Precious Mart","-MULTIPLE-","Income","Zelia Handwash Liquid",,"Undeposited Funds","",1499.99,1214902.81
,"Sales Receipt","06-10-2024","3422",,"Mikara Shop","Zelia Apple Handwash Liquid 15X500ML","Income","Zelia Handwash Liquid",,"Undeposited Funds","",1500.00,1216402.81
,"Sales Receipt","06-10-2024","3423",,"Jikweri Minimart","-MULTIPLE-","Income","Zelia Handwash Liquid",,"Undeposited Funds","",999.99,1217402.80
,"Sales Receipt","07-10-2024","2923",,"Cash Sales","Peach Perfume","Income","Zelia Handwash Liquid",,"Undeposited Funds","",7500.00,1224902.80
,"Sales Receipt","07-10-2024","3254",,"Cash Sales","Zelia Strawberry Handwash Liquid 15x500ML","Income","Zelia Handwash Liquid",,"Undeposited Funds","",186.00,1225088.80
,"Sales Receipt","07-10-2024","3118",,"Sugar meats &Groceries","-MULTIPLE-","Income","Zelia Handwash Liquid",,"Undeposited Funds","",1200.00,1226288.80
,"Sales Receipt","07-10-2024","3260",,"Sharma Shop","-MULTIPLE-","Income","Zelia Handwash Liquid",,"Undeposited Funds","",1500.00,1227788.80
,"Sales Receipt","07-10-2024","3288",,"Adurus Wholesallers","-MULTIPLE-","Income","Zelia Handwash Liquid",,"Undeposited Funds","",3000.00,1230788.80
,"Invoice","08-10-2024","MC06241",,"OFFSHORE GLOBAL LOGISTICS LIMITED","Zelia Strawberry Handwash Liquid 4x5L","Income","Zelia Handwash Liquid",,"Accounts Receivable","",2241.38,1233030.18
,"Sales Receipt","08-10-2024","3271",,"Horn of Africa","-MULTIPLE-","Income","Zelia Handwash Liquid",,"Undeposited Funds","",1500.00,1234530.18
,"Sales Receipt","08-10-2024","3272",,"Nyipola Minimart","-MULTIPLE-","Income","Zelia Handwash Liquid",,"Undeposited Funds","",1500.00,1236030.18
,"Invoice","09-10-2024","MC06242",,"BLUEMART SUPERMARKET LIMITED","-MULTIPLE-","Income","Zelia Handwash Liquid",,"Accounts Receivable","",1200.00,1237230.18
,"Sales Receipt","09-10-2024","3276",,"Cash Sales","Zelia Apple Handwash Liquid 15X500ML","Income","Zelia Handwash Liquid",,"Undeposited Funds",0.00,"",1237230.18
,"Sales Receipt","09-10-2024","3279",,"Cash Sales","Zelia Strawberry Handwash Liquid 4x5L","Income","Zelia Handwash Liquid",,"Undeposited Funds","",580.00,1237810.18
,"Sales Receipt","09-10-2024","3280",,"Cash Sales","Zelia Strawberry Handwash Liquid 15x500ML","Income","Zelia Handwash Liquid",,"Undeposited Funds","",87.00,1237897.18
,"Sales Receipt","09-10-2024","3277",,"Kibibi Wasai Store","Zelia Strawberry Handwash Liquid 20L","Income","Zelia Handwash Liquid",,"Undeposited Funds","",2250.00,1240147.18
,"Sales Receipt","09-10-2024","3287",,"Baba Ali Shop","-MULTIPLE-","Income","Zelia Handwash Liquid",,"Undeposited Funds","",1500.00,1241647.18
,"Sales Receipt","09-10-2024","3286",,"Mumtaz Shop","-MULTIPLE-","Income","Zelia Handwash Liquid",,"Undeposited Funds","",1500.00,1243147.18
,"Sales Receipt","11-10-2024","3289",,"Cash Sales","Zelia Strawberry Handwash Liquid 15x500ML","Income","Zelia Handwash Liquid",,"Undeposited Funds","",130.01,1243277.19
,"Sales Receipt","11-10-2024","3296",,"Restoration Traders","-MULTIPLE-","Income","Zelia Handwash Liquid",,"Undeposited Funds","",3000.00,1246277.19
,"Sales Receipt","11-10-2024","3174",,"Ethiopian Store","-MULTIPLE-","Income","Zelia Handwash Liquid",,"Undeposited Funds","",3210.00,1249487.19
,"Sales Receipt","11-10-2024","3175",,"Garissa Mini mart","-MULTIPLE-","Income","Zelia Handwash Liquid",,"Undeposited Funds","",1605.00,1251092.19
,"Sales Receipt","12-10-2024","3294",,"Afrodrip JKIA","-MULTIPLE-","Income","Zelia Handwash Liquid",,"Undeposited Funds","",200.00,1251292.19
,"Sales Receipt","12-10-2024","3176",,"Hawkers Wholesale","-MULTIPLE-","Income","Zelia Handwash Liquid",,"Undeposited Funds","",1070.00,1252362.19
,"Sales Receipt","12-10-2024","3177",,"Aggy Malimali shop","-MULTIPLE-","Income","Zelia Handwash Liquid",,"Undeposited Funds","",1498.00,1253860.19
,"Sales Receipt","14-10-2024","3178",,"Adam Mart","-MULTIPLE-","Income","Zelia Handwash Liquid",,"Undeposited Funds","",1498.00,1255358.19
,"Sales Receipt","16-10-2024","3114",,"Bismillahi Shop","-MULTIPLE-","Income","Zelia Handwash Liquid",,"Undeposited Funds","",1500.00,1256858.19
,"Sales Receipt","16-10-2024","3113",,"Himilo General Store","-MULTIPLE-","Income","Zelia Handwash Liquid",,"Undeposited Funds","",9000.00,1265858.19
,"Sales Receipt","16-10-2024","3111",,"Everlast Shop","-MULTIPLE-","Income","Zelia Handwash Liquid",,"Undeposited Funds","",1500.00,1267358.19
,"Sales Receipt","17-10-2024","3119",,"Cash Sales","Zelia Apple Handwash Liquid 15X500ML","Income","Zelia Handwash Liquid",,"Undeposited Funds","",86.00,1267444.19
,"Sales Receipt","17-10-2024","3120",,"Cash Sales","-MULTIPLE-","Income","Zelia Handwash Liquid",,"Undeposited Funds",0.00,"",1267444.19
,"Sales Receipt","18-10-2024","3122",,"Cash Sales","Zelia Strawberry Handwash Liquid 15x500ML","Income","Zelia Handwash Liquid",,"Undeposited Funds","",100.01,1267544.20
,"Sales Receipt","18-10-2024","3126",,"Cash Sales","Zelia Apple Handwash Liquid 15X500ML","Income","Zelia Handwash Liquid",,"Undeposited Funds","",174.00,1267718.20
,"Sales Receipt","19-10-2024","3186",,"Dans Shop","-MULTIPLE-","Income","Zelia Handwash Liquid",,"Undeposited Funds","",3210.00,1270928.20
,"Sales Receipt","19-10-2024","3180",,"Witgad Shop","-MULTIPLE-","Income","Zelia Handwash Liquid",,"Undeposited Funds","",642.00,1271570.20
,"Sales Receipt","19-10-2024","3185",,"Golden Shop","-MULTIPLE-","Income","Zelia Handwash Liquid",,"Undeposited Funds","",3210.00,1274780.20
,"Sales Receipt","22-10-2024","3130",,"Cash Sales","Zelia Strawberry Handwash Liquid 15x500ML","Income","Zelia Handwash Liquid",,"Undeposited Funds","",261.00,1275041.20
,"Sales Receipt","22-10-2024","3132",,"Hidika Shop","-MULTIPLE-","Income","Zelia Handwash Liquid",,"Undeposited Funds","",1500.00,1276541.20
,"Sales Receipt","22-10-2024","3133",,"tRIPPLE M","-MULTIPLE-","Income","Zelia Handwash Liquid",,"Undeposited Funds","",1500.00,1278041.20
,"Sales Receipt","22-10-2024","3134",,"Zulu Enterprise","-MULTIPLE-","Income","Zelia Handwash Liquid",,"Undeposited Funds","",1500.00,1279541.20
,"Sales Receipt","22-10-2024","3135",,"Discount Traders","-MULTIPLE-","Income","Zelia Handwash Liquid",,"Undeposited Funds","",3000.00,1282541.20
,"Sales Receipt","23-10-2024","3139",,"Cash Sales","Zelia Apple Handwash Liquid 15X500ML","Income","Zelia Handwash Liquid",,"Undeposited Funds","",299.99,1282841.19
,"Sales Receipt","23-10-2024","3144",,"Cash Sales","Zelia Strawberry Handwash Liquid 4x5L","Income","Zelia Handwash Liquid",,"Undeposited Funds",0.00,"",1282841.19
,"Sales Receipt","23-10-2024","3146",,"Libin Minimart","-MULTIPLE-","Income","Zelia Handwash Liquid",,"Undeposited Funds","",3000.00,1285841.19
,"Sales Receipt","23-10-2024","3141",,"Kibibi Wasai Store","-MULTIPLE-","Income","Zelia Handwash Liquid",,"Undeposited Funds","",2910.00,1288751.19
,"Sales Receipt","24-10-2024","3147",,"Cash Sales","-MULTIPLE-","Income","Zelia Handwash Liquid",,"Undeposited Funds","",1250.00,1290001.19
,"Sales Receipt","24-10-2024","3148",,"Cash Sales","Zelia Strawberry Handwash Liquid 15x500ML","Income","Zelia Handwash Liquid",,"Undeposited Funds","",299.99,1290301.18
,"Sales Receipt","24-10-2024","3149",,"Cash Sales","Zelia Apple Handwash Liquid 15X500ML","Income","Zelia Handwash Liquid",,"Undeposited Funds","",100.01,1290401.19
,"Sales Receipt","24-10-2024","3152",,"Aisha Collections","-MULTIPLE-","Income","Zelia Handwash Liquid",,"Undeposited Funds","",1500.00,1291901.19
,"Invoice","25-10-2024","MC06299",,"THE BRIGHT STAR SUPERMARKET LIMITED","-MULTIPLE-","Income","Zelia Handwash Liquid",,"Accounts Receivable","",2400.00,1294301.19
,"Invoice","25-10-2024","MC06300",,"HAPPY VIEW SUPERMARKET LIMITED","-MULTIPLE-","Income","Zelia Handwash Liquid",,"Accounts Receivable","",1200.00,1295501.19
,"Sales Receipt","25-10-2024","3155",,"Cash Sales","Zelia Strawberry Handwash Liquid 4x5L","Income","Zelia Handwash Liquid",,"Undeposited Funds","",2680.00,1298181.19
,"Sales Receipt","25-10-2024","3159",,"Marris Mini mart","-MULTIPLE-","Income","Zelia Handwash Liquid",,"Undeposited Funds","",600.00,1298781.19
,"Sales Receipt","25-10-2024","3157",,"Mamken Minimart","-MULTIPLE-","Income","Zelia Handwash Liquid",,"Undeposited Funds","",1500.00,1300281.19
,"Sales Receipt","26-10-2024","3161",,"Cash Sales","Zelia Apple Handwash Liquid 15X500ML","Income","Zelia Handwash Liquid",,"Undeposited Funds","",299.99,1300581.18
,"Sales Receipt","26-10-2024","3193",,"032 minimart","-MULTIPLE-","Income","Zelia Handwash Liquid",,"Undeposited Funds","",1200.00,1301781.18
,"Sales Receipt","26-10-2024","3183",,"Tosha Matt","-MULTIPLE-","Income","Zelia Handwash Liquid",,"Undeposited Funds","",3210.00,1304991.18
,"Sales Receipt","26-10-2024","3182",,"Nyaugenya Mini Matt","-MULTIPLE-","Income","Zelia Handwash Liquid",,"Undeposited Funds","",3210.00,1308201.18
,"Sales Receipt","28-10-2024","3181",,"Mahitaji Store","-MULTIPLE-","Income","Zelia Handwash Liquid",,"Undeposited Funds","",3210.00,1311411.18
,"Sales Receipt","29-10-2024","3169",,"Cash Sales","Zelia Apple Handwash Liquid 4x5L","Income","Zelia Handwash Liquid",,"Undeposited Funds","",910.00,1312321.18
,"Sales Receipt","29-10-2024","3704",,"Home Soko Minimart","Zelia Apple Handwash Liquid 15X500ML","Income","Zelia Handwash Liquid",,"Undeposited Funds","",600.00,1312921.18
,"Invoice","30-10-2024","MC06322",,"OFFSHORE GLOBAL LOGISTICS LIMITED","Zelia Strawberry Handwash Liquid 4x5L","Income","Zelia Handwash Liquid",,"Accounts Receivable","",2800.00,1315721.18
,"Sales Receipt","30-10-2024","3725",,"Safa Groceries","-MULTIPLE-","Income","Zelia Handwash Liquid",,"Undeposited Funds","",1200.00,1316921.18
,"Sales Receipt","30-10-2024","3726",,"Msafi Shop","-MULTIPLE-","Income","Zelia Handwash Liquid",,"Undeposited Funds","",6210.00,1323131.18
,"Sales Receipt","30-10-2024","3727",,"Ellas Store","-MULTIPLE-","Income","Zelia Handwash Liquid",,"Undeposited Funds","",1605.00,1324736.18
,"Sales Receipt","31-10-2024","3192",,"Cash Sales","Zelia Strawberry Handwash Liquid 4x5L","Income","Zelia Handwash Liquid",,"Undeposited Funds","",2250.00,1326986.18
,"Sales Receipt","31-10-2024","3196",,"Cash Sales","Zelia Strawberry Handwash Liquid 15x500ML","Income","Zelia Handwash Liquid",,"Undeposited Funds","",200.00,1327186.18
,"Sales Receipt","02-11-2024","3707",,"Cheaper Cheap","-MULTIPLE-","Income","Zelia Handwash Liquid",,"Undeposited Funds","",3000.00,1330186.18
,"Sales Receipt","04-11-2024","3197",,"Cash Sales","Zelia Strawberry Handwash Liquid 15x500ML","Income","Zelia Handwash Liquid",,"Undeposited Funds","",90.00,1330276.18
,"Sales Receipt","04-11-2024","3709",,"Brinso Foodstufs","-MULTIPLE-","Income","Zelia Handwash Liquid",,"Undeposited Funds","",1500.00,1331776.18
,"Sales Receipt","05-11-2024","3713",,"Elwak Minimart","-MULTIPLE-","Income","Zelia Handwash Liquid",,"Undeposited Funds","",1500.00,1333276.18
,"Sales Receipt","05-11-2024","3714",,"Marris Mini mart","-MULTIPLE-","Income","Zelia Handwash Liquid",,"Undeposited Funds","",600.00,1333876.18
,"Sales Receipt","05-11-2024","3712",,"Hidika Shop","-MULTIPLE-","Income","Zelia Handwash Liquid",,"Undeposited Funds","",1500.00,1335376.18
,"Invoice","06-11-2024","MC06335",,"Guard Mart Supermarket Limited","-MULTIPLE-","Income","Zelia Handwash Liquid",,"Accounts Receivable","",218.02,1335594.20
,"Invoice","06-11-2024","MC06336",,"Ellas Store","-MULTIPLE-","Income","Zelia Handwash Liquid",,"Accounts Receivable","",1633.00,1337227.20
,"Sales Receipt","06-11-2024","3402",,"Cash Sales","Zelia Apple Handwash Liquid 15X500ML","Income","Zelia Handwash Liquid",,"Undeposited Funds","",200.00,1337427.20
,"Sales Receipt","06-11-2024","3721",,"Towba foodstuffs","-MULTIPLE-","Income","Zelia Handwash Liquid",,"Undeposited Funds","",3000.00,1340427.20
,"Sales Receipt","06-11-2024","3719",,"Adam Boss","-MULTIPLE-","Income","Zelia Handwash Liquid",,"Undeposited Funds","",1500.00,1341927.20
,"Sales Receipt","07-11-2024","3722",,"D-Madina Enterprise","-MULTIPLE-","Income","Zelia Handwash Liquid",,"Undeposited Funds","",1500.00,1343427.20
,"Sales Receipt","08-11-2024","3458",,"Mama Sam Shop","-MULTIPLE-","Income","Zelia Handwash Liquid",,"Undeposited Funds","",1600.00,1345027.20
,"Sales Receipt","11-11-2024","3420",,"Cash Sales","Zelia Strawberry Handwash Liquid 15x500ML","Income","Zelia Handwash Liquid",,"Undeposited Funds","",450.00,1345477.20
,"Sales Receipt","11-11-2024","3426",,"Golden Save","-MULTIPLE-","Income","Zelia Handwash Liquid",,"Undeposited Funds","",7500.00,1352977.20
,"Sales Receipt","11-11-2024","3429",,"Downtown Wholesalers","-MULTIPLE-","Income","Zelia Handwash Liquid",,"Undeposited Funds","",3000.00,1355977.20
,"Sales Receipt","11-11-2024","3430",,"Dalwo Wholesallers","-MULTIPLE-","Income","Zelia Handwash Liquid",,"Undeposited Funds","",1500.00,1357477.20
,"Sales Receipt","12-11-2024","3431",,"Cash Sales","-MULTIPLE-","Income","Zelia Handwash Liquid",,"Undeposited Funds","",19800.00,1377277.20
,"Sales Receipt","12-11-2024","3436",,"Horn of Africa","-MULTIPLE-","Income","Zelia Handwash Liquid",,"Undeposited Funds","",2400.00,1379677.20
,"Sales Receipt","12-11-2024","3439",,"Maida Minimart","Zelia Apple Handwash Liquid 15X500ML","Income","Zelia Handwash Liquid",,"Undeposited Funds","",600.00,1380277.20
,"Invoice","13-11-2024","MC06355",,"KASAMAT INVESTMENTS LTD","-MULTIPLE-","Income","Zelia Handwash Liquid",,"Accounts Receivable","",1200.00,1381477.20
,"Invoice","13-11-2024","MC06357",,"LUCKY MART SUPERMARKET LIMITED","-MULTIPLE-","Income","Zelia Handwash Liquid",,"Accounts Receivable","",3000.00,1384477.20
,"Invoice","13-11-2024","MC06359",,"PRICE CHOPPER STORES LIMITED","Zelia Apple Handwash Liquid 15X500ML  6Pieces@116","Income","Zelia Handwash Liquid",,"Accounts Receivable","",600.00,1385077.20
,"Sales Receipt","13-11-2024","3434",,"Cash Sales","Zelia Apple Handwash Liquid 4x5L","Income","Zelia Handwash Liquid",,"Undeposited Funds","",1700.00,1386777.20
,"Sales Receipt","13-11-2024","3493",,"Mwambao Shop","-MULTIPLE-","Income","Zelia Handwash Liquid",,"Undeposited Funds","",400.00,1387177.20
,"Sales Receipt","13-11-2024","3441",,"Publix Supermarket","-MULTIPLE-","Income","Zelia Handwash Liquid",,"Undeposited Funds","",1500.00,1388677.20
,"Sales Receipt","13-11-2024","3445",,"Gold mart Supermarket","Zelia Apple Handwash Liquid 15X500ML","Income","Zelia Handwash Liquid",,"Undeposited Funds","",600.00,1389277.20
,"Sales Receipt","14-11-2024","3728",,"Cash Sales","Zelia Apple Handwash Liquid 4x5L","Income","Zelia Handwash Liquid",,"Undeposited Funds",0.00,"",1389277.20
,"Sales Receipt","14-11-2024","3461",,"Kopeyo Shop","-MULTIPLE-","Income","Zelia Handwash Liquid",,"Undeposited Funds","",6420.00,1395697.20
,"Invoice","15-11-2024","MC06367",,"ROAM MART","-MULTIPLE-","Income","Zelia Handwash Liquid",,"Accounts Receivable","",3300.00,1398997.20
,"Sales Receipt","15-11-2024","3448",,"Cash Sales","Zelia Strawberry Handwash Liquid 4x5L","Income","Zelia Handwash Liquid",,"Undeposited Funds","",850.00,1399847.20
,"Sales Receipt","15-11-2024","3730",,"Cash Sales","Zelia Strawberry Handwash Liquid 15x500ML","Income","Zelia Handwash Liquid",,"Undeposited Funds","",87.00,1399934.20
,"Invoice","18-11-2024","MC06372",,"Guard Mart Supermarket Limited","-MULTIPLE-","Income","Zelia Handwash Liquid",,"Accounts Receivable","",3330.00,1403264.20
,"Credit Note","18-11-2024","CN01073",,"Guard Mart Supermarket Limited","-MULTIPLE-","Income","Zelia Handwash Liquid",,"Accounts Receivable",218.02,"",1403046.18
,"Sales Receipt","18-11-2024","3450",,"Cash Sales","Zelia Strawberry Handwash Liquid 15x500ML","Income","Zelia Handwash Liquid",,"Undeposited Funds","",168.00,1403214.18
,"Sales Receipt","18-11-2024","3472",,"Cash Sales","Zelia Strawberry Handwash Liquid 4x5L","Income","Zelia Handwash Liquid",,"Undeposited Funds",0.00,"",1403214.18
,"Sales Receipt","18-11-2024","3733",,"Cash Sales","Zelia Strawberry Handwash Liquid 20L","Income","Zelia Handwash Liquid",,"Undeposited Funds","",2250.00,1405464.18
,"Sales Receipt","18-11-2024","3462",,"Nabcom Stores","-MULTIPLE-","Income","Zelia Handwash Liquid",,"Undeposited Funds","",1500.00,1406964.18
,"Sales Receipt","18-11-2024","3464",,"Restoration Traders","-MULTIPLE-","Income","Zelia Handwash Liquid",,"Undeposited Funds","",3000.00,1409964.18
,"Sales Receipt","18-11-2024","3466",,"Faisel Wholesale","-MULTIPLE-","Income","Zelia Handwash Liquid",,"Undeposited Funds","",3000.00,1412964.18
,"Invoice","19-11-2024","MC06374",,"SUMM SUPERMARKET LIMITED","Zelia Strawberry Handwash Liquid 15x500ML  6Pcs @117","Income","Zelia Handwash Liquid",,"Accounts Receivable","",605.17,1413569.35
,"Invoice","19-11-2024","MC06378",,"ROYMATT SUPERMARKET LIMITED","-MULTIPLE-","Income","Zelia Handwash Liquid",,"Accounts Receivable","",1500.00,1415069.35
,"Invoice","19-11-2024","MC06379",,"DALLAS SHOPRITE LTD","-MULTIPLE-","Income","Zelia Handwash Liquid",,"Accounts Receivable","",1500.00,1416569.35
,"Sales Receipt","19-11-2024","3471",,"Kedulle Enterprises","-MULTIPLE-","Income","Zelia Handwash Liquid",,"Undeposited Funds","",9000.00,1425569.35
,"Sales Receipt","19-11-2024","3474",,"Milele Shop","-MULTIPLE-","Income","Zelia Handwash Liquid",,"Undeposited Funds","",1500.00,1427069.35
,"Sales Receipt","20-11-2024","3477",,"Cash Sales","Zelia Strawberry Handwash Liquid 15x500ML","Income","Zelia Handwash Liquid",,"Undeposited Funds",0.00,"",1427069.35
,"Sales Receipt","20-11-2024","3479",,"Dola Wholesalers","-MULTIPLE-","Income","Zelia Handwash Liquid",,"Undeposited Funds","",3000.00,1430069.35
,"Sales Receipt","21-11-2024","3482",,"Cash Sales","Zelia Strawberry Handwash Liquid 15x500ML","Income","Zelia Handwash Liquid",,"Undeposited Funds","",84.00,1430153.35
,"Sales Receipt","22-11-2024","3488",,"Cash Sales","Zelia Strawberry Handwash Liquid 15x500ML","Income","Zelia Handwash Liquid",,"Undeposited Funds","",720.00,1430873.35
,"Sales Receipt","22-11-2024","3499",,"Cash Sales","Zelia Strawberry Handwash Liquid 4x5L","Income","Zelia Handwash Liquid",,"Undeposited Funds","",1400.00,1432273.35
,"Sales Receipt","22-11-2024","3494",,"Asfa Shop","Zelia Strawberry Handwash Liquid 15x500ML","Income","Zelia Handwash Liquid",,"Undeposited Funds","",600.00,1432873.35
,"Sales Receipt","25-11-2024","3762",,"Oyugis Discount","-MULTIPLE-","Income","Zelia Handwash Liquid",,"Undeposited Funds","",6420.00,1439293.35
,"Sales Receipt","25-11-2024","3763",,"Domie Shop","-MULTIPLE-","Income","Zelia Handwash Liquid",,"Undeposited Funds","",1712.00,1441005.35
,"Invoice","26-11-2024","MC06412",,"Seasons lane Mart","-MULTIPLE-","Income","Zelia Handwash Liquid",,"Accounts Receivable","",1500.00,1442505.35
,"Sales Receipt","26-11-2024","3740",,"Afrodrip JKIA","Zelia Apple Handwash Liquid 15X500ML","Income","Zelia Handwash Liquid",,"Undeposited Funds","",100.00,1442605.35
,"Sales Receipt","27-11-2024","3743",,"Mama Amina","-MULTIPLE-","Income","Zelia Handwash Liquid",,"Undeposited Funds","",1500.00,1444105.35
,"Sales Receipt","27-11-2024","3764",,"Molly Shop","-MULTIPLE-","Income","Zelia Handwash Liquid",,"Undeposited Funds","",856.00,1444961.35
,"Sales Receipt","27-11-2024","3765",,"Duto Rumo Store","-MULTIPLE-","Income","Zelia Handwash Liquid",,"Undeposited Funds","",1605.00,1446566.35
,"Sales Receipt","28-11-2024","3751",,"Cash Sales","Zelia Strawberry Handwash Liquid 4x5L","Income","Zelia Handwash Liquid",,"Undeposited Funds","",800.00,1447366.35
,"Sales Receipt","28-11-2024","3752",,"Cash Sales","Zelia Strawberry Handwash Liquid 15x500ML","Income","Zelia Handwash Liquid",,"Undeposited Funds","",200.00,1447566.35
,"Sales Receipt","29-11-2024","3754",,"Cash Sales","Zelia Strawberry Handwash Liquid 15x500ML","Income","Zelia Handwash Liquid",,"Undeposited Funds","",140.00,1447706.35
,"Sales Receipt","29-11-2024","3755",,"Cash Sales","Zelia Strawberry Handwash Liquid 15x500ML","Income","Zelia Handwash Liquid",,"Undeposited Funds","",140.00,1447846.35
,"Sales Receipt","29-11-2024","3756",,"Cash Sales","Zelia Strawberry Handwash Liquid 15x500ML","Income","Zelia Handwash Liquid",,"Undeposited Funds","",140.00,1447986.35
,"Sales Receipt","29-11-2024","3789",,"Ubwete Shop","-MULTIPLE-","Income","Zelia Handwash Liquid",,"Undeposited Funds","",1200.00,1449186.35
,"Sales Receipt","30-11-2024","3760",,"Cash Sales","Zelia Apple Handwash Liquid 15X500ML","Income","Zelia Handwash Liquid",,"Undeposited Funds","",400.00,1449586.35
,"Sales Receipt","30-11-2024","AT203",,"Cash Sales","Zelia Strawberry Handwash Liquid 15x500ML","Income","Zelia Handwash Liquid",,"Undeposited Funds","",1906.80,1451493.15
,"Sales Receipt","30-11-2024","3766",,"Muga Shop","-MULTIPLE-","Income","Zelia Handwash Liquid",,"Undeposited Funds","",6000.00,1457493.15
,"Sales Receipt","02-12-2024","3761",,"Cash Sales","Zelia Strawberry Handwash Liquid 4x5L","Income","Zelia Handwash Liquid",,"Undeposited Funds","",750.00,1458243.15
,"Sales Receipt","02-12-2024","3767",,"Cash Sales","Zelia Strawberry Handwash Liquid 15x500ML","Income","Zelia Handwash Liquid",,"Undeposited Funds","",150.00,1458393.15
,"Sales Receipt","02-12-2024","3775",,"Gacal Wholesale","-MULTIPLE-","Income","Zelia Handwash Liquid",,"Undeposited Funds","",1500.00,1459893.15
,"Sales Receipt","03-12-2024","3782",,"Summer Outlets","-MULTIPLE-","Income","Zelia Handwash Liquid",,"Undeposited Funds","",1500.00,1461393.15
,"Sales Receipt","03-12-2024","3783",,"Tender Store Limited","-MULTIPLE-","Income","Zelia Handwash Liquid",,"Undeposited Funds","",6000.00,1467393.15
,"Sales Receipt","04-12-2024","3784",,"Gure Yare Shop","-MULTIPLE-","Income","Zelia Handwash Liquid",,"Undeposited Funds","",3000.00,1470393.15
,"Sales Receipt","04-12-2024","3785",,"Towba Parkroad","-MULTIPLE-","Income","Zelia Handwash Liquid",,"Undeposited Funds","",3000.00,1473393.15
,"Sales Receipt","04-12-2024","3326",,"Mwananchi Store","-MULTIPLE-","Income","Zelia Handwash Liquid",,"Undeposited Funds","",3210.00,1476603.15
,"Sales Receipt","04-12-2024","3786",,"Warfa Wholesale","-MULTIPLE-","Income","Zelia Handwash Liquid",,"Undeposited Funds","",6000.00,1482603.15
,"Sales Receipt","04-12-2024","3791",,"Gold mart Supermarket","Zelia Strawberry Handwash Liquid 15x500ML","Income","Zelia Handwash Liquid",,"Undeposited Funds","",600.00,1483203.15
,"Invoice","05-12-2024","MC06447",,"NASRI MART LIMITED","Zelia Apple Handwash Liquid 15X500ML  6Pcs@118","Income","Zelia Handwash Liquid",,"Accounts Receivable","",610.34,1483813.49
,"Sales Receipt","05-12-2024","3793",,"BCB Shop","-MULTIPLE-","Income","Zelia Handwash Liquid",,"Undeposited Funds","",1140.00,1484953.49
,"Sales Receipt","05-12-2024","3799",,"Hayan Wholesalers","-MULTIPLE-","Income","Zelia Handwash Liquid",,"Undeposited Funds","",3000.00,1487953.49
,"Sales Receipt","05-12-2024","3327",,"Macbellah Shop","-MULTIPLE-","Income","Zelia Handwash Liquid",,"Undeposited Funds","",3210.00,1491163.49
,"Sales Receipt","07-12-2024","3323",,"Mahitaji Store","-MULTIPLE-","Income","Zelia Handwash Liquid",,"Undeposited Funds","",3210.00,1494373.49
,"Sales Receipt","07-12-2024","3324",,"Queen of Cleaning","-MULTIPLE-","Income","Zelia Handwash Liquid",,"Undeposited Funds","",2140.00,1496513.49
,"Sales Receipt","07-12-2024","3325",,"Blossom Shop","-MULTIPLE-","Income","Zelia Handwash Liquid",,"Undeposited Funds","",6420.00,1502933.49
,"Invoice","09-12-2024","MC06452",,"DISII TRADERS LTD","-MULTIPLE-","Income","Zelia Handwash Liquid",,"Accounts Receivable","",2420.69,1505354.18
,"Invoice","09-12-2024","MC06456",,"OFFSHORE GLOBAL LOGISTICS LIMITED","Zelia Strawberry Handwash Liquid 4x5L","Income","Zelia Handwash Liquid",,"Accounts Receivable","",1400.00,1506754.18
,"Sales Receipt","09-12-2024","3310",,"Cash Sales","Zelia Strawberry Handwash Liquid 4x5L","Income","Zelia Handwash Liquid",,"Undeposited Funds",0.00,"",1506754.18
,"Sales Receipt","09-12-2024","3317",,"Cash Sales","Zelia Strawberry Handwash Liquid 15x500ML","Income","Zelia Handwash Liquid",,"Undeposited Funds","",120.00,1506874.18
,"Sales Receipt","09-12-2024","3315",,"Shop 5","-MULTIPLE-","Income","Zelia Handwash Liquid",,"Undeposited Funds","",1500.00,1508374.18
,"Sales Receipt","10-12-2024","3328",,"Horn of Africa","-MULTIPLE-","Income","Zelia Handwash Liquid",,"Undeposited Funds","",1500.00,1509874.18
,"Sales Receipt","10-12-2024","3329",,"Soimo Mini mart","-MULTIPLE-","Income","Zelia Handwash Liquid",,"Undeposited Funds","",600.00,1510474.18
,"Sales Receipt","11-12-2024","3339",,"Fahal Wholesalers","-MULTIPLE-","Income","Zelia Handwash Liquid",,"Undeposited Funds","",7500.00,1517974.18
,"Sales Receipt","11-12-2024","3338",,"Freshfinds Mart","-MULTIPLE-","Income","Zelia Handwash Liquid",,"Undeposited Funds","",1500.00,1519474.18
,"Sales Receipt","13-12-2024","3349",,"032 minimart","-MULTIPLE-","Income","Zelia Handwash Liquid",,"Undeposited Funds","",1500.00,1520974.18
,"Sales Receipt","16-12-2024","3342",,"Cash Sales","Zelia Apple Handwash Liquid 15X500ML","Income","Zelia Handwash Liquid",,"Undeposited Funds","",100.00,1521074.18
,"Sales Receipt","16-12-2024","3345",,"Cash Sales","Zelia Strawberry Handwash Liquid 15x500ML","Income","Zelia Handwash Liquid",,"Undeposited Funds","",150.00,1521224.18
,"Sales Receipt","16-12-2024","3348",,"Cash Sales","Zelia Strawberry Handwash Liquid 4x5L","Income","Zelia Handwash Liquid",,"Undeposited Funds","",850.00,1522074.18
,"Sales Receipt","16-12-2024","3352",,"Rayyan Shop","-MULTIPLE-","Income","Zelia Handwash Liquid",,"Undeposited Funds","",1500.00,1523574.18
,"Invoice","17-12-2024","MC06477",,"OFFSHORE GLOBAL LOGISTICS LIMITED","Zelia Strawberry Handwash Liquid 4x5L","Income","Zelia Handwash Liquid",,"Accounts Receivable","",1500.00,1525074.18
,"Sales Receipt","17-12-2024","3354",,"Cash Sales","Zelia Strawberry Handwash Liquid 15x500ML","Income","Zelia Handwash Liquid",,"Undeposited Funds","",300.00,1525374.18
,"Sales Receipt","17-12-2024","3356",,"Restoration Traders","-MULTIPLE-","Income","Zelia Handwash Liquid",,"Undeposited Funds","",6000.00,1531374.18
,"Sales Receipt","18-12-2024","3358",,"Cash Sales","Zelia Strawberry Handwash Liquid 15x500ML","Income","Zelia Handwash Liquid",,"Undeposited Funds","",87.00,1531461.18
,"Sales Receipt","18-12-2024","3364",,"Gold mart Supermarket","-MULTIPLE-","Income","Zelia Handwash Liquid",,"Undeposited Funds","",2400.00,1533861.18
,"Sales Receipt","18-12-2024","3366",,"Libim Minimart","-MULTIPLE-","Income","Zelia Handwash Liquid",,"Undeposited Funds","",6000.00,1539861.18
"Total Zelia Handwash Liquid",,,,,,,,,,,9612.68,1549473.86,1539861.18
"Zelia Scouring Powder",,,,,,,,,,,,,""
,"Invoice","04-01-2024","MC05269",,"OFFSHORE GLOBAL LOGISTICS LIMITED","Zelia Scourer Lemon 500g","Income","Zelia Scouring Powder",,"Accounts Receivable","",586.21,586.21
,"Sales Receipt","12-01-2024","1733",,"Cash Sales","Zelia Scourer Lemon 500g","Income","Zelia Scouring Powder",,"Undeposited Funds","",280.00,866.21
,"Sales Receipt","15-01-2024","1729",,"Cash Sales","Zelia Scourer Lemon 500g","Income","Zelia Scouring Powder",,"Undeposited Funds","",60.00,926.21
,"Sales Receipt","29-01-2024","1763",,"Cash Sales","Zelia Scourer Lemon 500g","Income","Zelia Scouring Powder",,"Undeposited Funds","",60.00,986.21
,"Sales Receipt","08-02-2024","1816",,"Cash Sales","Zelia Scourer Lemon 500g","Income","Zelia Scouring Powder",,"Undeposited Funds","",236.00,1222.21
,"Invoice","12-02-2024","MC05396",,"OFFSHORE GLOBAL LOGISTICS LIMITED","Zelia Scourer Lemon 500g","Income","Zelia Scouring Powder",,"Accounts Receivable","",732.76,1954.97
,"Sales Receipt","27-02-2024","1878",,"Cash Sales","Zelia Scourer Lemon 500g","Income","Zelia Scouring Powder",,"Undeposited Funds","",210.00,2164.97
,"Sales Receipt","05-03-2024","2008",,"Cash Sales","Zelia Scourer Lemon 500g","Income","Zelia Scouring Powder",,"Undeposited Funds","",80.00,2244.97
,"Sales Receipt","05-03-2024","2009",,"Cash Sales","Zelia Scourer Lemon 500g","Income","Zelia Scouring Powder",,"Undeposited Funds","",80.00,2324.97
,"Sales Receipt","05-03-2024","2012",,"Cash Sales","Zelia Scourer Lemon 500g","Income","Zelia Scouring Powder",,"Undeposited Funds","",60.00,2384.97
,"Sales Receipt","06-03-2024","2018",,"Cash Sales","Zelia Scourer Lemon 500g","Income","Zelia Scouring Powder",,"Undeposited Funds","",70.00,2454.97
,"Invoice","07-03-2024","MC05477",,"OFFSHORE GLOBAL LOGISTICS LIMITED","Zelia Scourer Lemon 500g","Income","Zelia Scouring Powder",,"Accounts Receivable","",293.10,2748.07
,"Sales Receipt","07-03-2024","2030",,"Blue Bubble Homecare Products Ltd","Zelia Scourer Lemon 500g","Income","Zelia Scouring Powder",,"Undeposited Funds","",140.00,2888.07
,"Sales Receipt","07-03-2024","2032",,"Cash Sales","Zelia Scourer Lemon 500g","Income","Zelia Scouring Powder",,"Undeposited Funds","",70.00,2958.07
,"Sales Receipt","07-03-2024","2037",,"Cash Sales","Zelia Scourer Lemon 500g","Income","Zelia Scouring Powder",,"Undeposited Funds","",70.00,3028.07
,"Sales Receipt","08-03-2024","2045",,"Cash Sales","Zelia Scourer Lemon 500g","Income","Zelia Scouring Powder",,"Undeposited Funds","",236.00,3264.07
,"Sales Receipt","18-03-2024","2074",,"Cash Sales","Zelia Scourer Lemon 500g","Income","Zelia Scouring Powder",,"Undeposited Funds","",280.00,3544.07
,"Sales Receipt","28-03-2024","2127",,"Cash Sales","Zelia Scourer Lemon 500g","Income","Zelia Scouring Powder",,"Undeposited Funds",0.00,"",3544.07
,"Sales Receipt","15-04-2024","2190",,"Cash Sales","Zelia Scourer Lemon 500g","Income","Zelia Scouring Powder",,"Undeposited Funds","",120.00,3664.07
,"Sales Receipt","18-04-2024","2223",,"Cash Sales","Zelia Scourer Lemon 500g","Income","Zelia Scouring Powder",,"Undeposited Funds","",70.00,3734.07
,"Sales Receipt","19-04-2024","2231",,"Cash Sales","Zelia Scourer Lemon 500g","Income","Zelia Scouring Powder",,"Undeposited Funds","",118.00,3852.07
,"Sales Receipt","29-04-2024","2271",,"Cash Sales","Zelia Scourer Lemon 500g","Income","Zelia Scouring Powder",,"Undeposited Funds","",120.00,3972.07
,"Sales Receipt","29-04-2024","2277",,"Cash Sales","Zelia Scourer Lemon 500g","Income","Zelia Scouring Powder",,"Undeposited Funds","",840.00,4812.07
,"Invoice","30-04-2024","MC05652",,"OFFSHORE GLOBAL LOGISTICS LIMITED","Zelia Scourer Lemon 500g","Income","Zelia Scouring Powder",,"Accounts Receivable","",439.66,5251.73
,"Sales Receipt","05-05-2024","2308",,"Cash Sales","Zelia Scourer Lemon 500g","Income","Zelia Scouring Powder",,"Undeposited Funds",0.00,"",5251.73
,"Sales Receipt","09-05-2024","2336",,"Donation","Zelia Scourer Lemon 500g","Income","Zelia Scouring Powder",,"Undeposited Funds",0.00,"",5251.73
,"Sales Receipt","09-05-2024","2342",,"Cash Sales","Zelia Scourer Lemon 500g","Income","Zelia Scouring Powder",,"Undeposited Funds","",1680.00,6931.73
,"Sales Receipt","15-05-2024","1927",,"Cash Sales","Zelia Scourer Lemon 500g","Income","Zelia Scouring Powder",,"Undeposited Funds","",70.00,7001.73
,"Invoice","30-05-2024","MC05776",,"OFFSHORE GLOBAL LOGISTICS LIMITED","Zelia Scourer Lemon 500g","Income","Zelia Scouring Powder",,"Accounts Receivable","",586.21,7587.94
,"Sales Receipt","03-06-2024","2406",,"Downtown Wholesalers","Zelia Scourer Lemon 500g","Income","Zelia Scouring Powder",,"Undeposited Funds","",1344.00,8931.94
,"Sales Receipt","03-06-2024","2407",,"Sharma Shop","Zelia Scourer Lemon 500g","Income","Zelia Scouring Powder",,"Undeposited Funds","",1344.00,10275.94
,"Sales Receipt","03-06-2024","2408",,"Fatah Wholesaler","Zelia Scourer Lemon 500g","Income","Zelia Scouring Powder",,"Undeposited Funds","",13440.00,23715.94
,"Sales Receipt","03-06-2024","2409",,"Faaz Minimart","Zelia Scourer Lemon 500g","Income","Zelia Scouring Powder",,"Undeposited Funds","",1344.00,25059.94
,"Sales Receipt","03-06-2024","2410",,"Hidika Shop","Zelia Scourer Lemon 500g","Income","Zelia Scouring Powder",,"Undeposited Funds","",672.00,25731.94
,"Sales Receipt","03-06-2024","2411",,"Gure Yare Shop","Zelia Scourer Lemon 500g","Income","Zelia Scouring Powder",,"Undeposited Funds","",6720.00,32451.94
,"Sales Receipt","03-06-2024","2412",,"Adurus Wholesallers","Zelia Scourer Lemon 500g","Income","Zelia Scouring Powder",,"Undeposited Funds","",1344.00,33795.94
,"Sales Receipt","04-06-2024","2413",,"Horn of Africa","Zelia Scourer Lemon 500g","Income","Zelia Scouring Powder",,"Undeposited Funds","",672.00,34467.94
,"Sales Receipt","04-06-2024","2717",,"Jamilas Store","Zelia Scourer Lemon 500g","Income","Zelia Scouring Powder",,"Undeposited Funds","",1344.00,35811.94
,"Sales Receipt","04-06-2024","2414",,"Tawakal Wholesale","Zelia Scourer Lemon 500g","Income","Zelia Scouring Powder",,"Undeposited Funds","",2688.00,38499.94
,"Sales Receipt","04-06-2024","2415",,"Towba general stores","Zelia Scourer Lemon 500g","Income","Zelia Scouring Powder",,"Undeposited Funds","",1344.00,39843.94
,"Sales Receipt","05-06-2024","2417",,"D-Madina Enterprise","Zelia Scourer Lemon 500g","Income","Zelia Scouring Powder",,"Undeposited Funds","",2688.00,42531.94
,"Sales Receipt","05-06-2024","2419",,"Publix Supermarket","Zelia Scourer Lemon 500g","Income","Zelia Scouring Powder",,"Undeposited Funds","",672.00,43203.94
,"Sales Receipt","05-06-2024","2420",,"Labook Enterprise","Zelia Scourer Lemon 500g","Income","Zelia Scouring Powder",,"Undeposited Funds","",1344.00,44547.94
,"Sales Receipt","06-06-2024","2429",,"Cash Sales","Zelia Scourer Lemon 500g","Income","Zelia Scouring Powder",,"Undeposited Funds",0.00,"",44547.94
,"Sales Receipt","06-06-2024","2425",,"Soimo Minimart","Zelia Scourer Lemon 500g","Income","Zelia Scouring Powder",,"Undeposited Funds","",336.00,44883.94
,"Sales Receipt","06-06-2024","2718",,"Mama G Wholesale","Zelia Scourer Lemon 500g","Income","Zelia Scouring Powder",,"Undeposited Funds","",1344.00,46227.94
,"Sales Receipt","07-06-2024","1996",,"Cash Sales","Zelia Scourer Lemon 500g","Income","Zelia Scouring Powder",,"Undeposited Funds","",348.00,46575.94
,"Sales Receipt","07-06-2024","2427",,"Garumo Wholesale","Zelia Scourer Lemon 500g","Income","Zelia Scouring Powder",,"Undeposited Funds","",1344.00,47919.94
,"Sales Receipt","10-06-2024","2433",,"Cash Sales","Zelia Scourer Lemon 500g","Income","Zelia Scouring Powder",,"Undeposited Funds","",56.00,47975.94
,"Sales Receipt","10-06-2024","2436",,"Arqam minimart","Zelia Scourer Lemon 500g","Income","Zelia Scouring Powder",,"Undeposited Funds","",1344.00,49319.94
,"Sales Receipt","10-06-2024","2437",,"Al Mubarak Wholesalers","Zelia Scourer Lemon 500g","Income","Zelia Scouring Powder",,"Undeposited Funds","",1344.00,50663.94
,"Sales Receipt","10-06-2024","2438",,"Tayokom Wholesalers","Zelia Scourer Lemon 500g","Income","Zelia Scouring Powder",,"Undeposited Funds","",6720.00,57383.94
,"Invoice","11-06-2024","MC05815",,"MADINA SUPERMARKET LIMITED","Zelia Scourer Lemon 500g","Income","Zelia Scouring Powder",,"Accounts Receivable","",336.21,57720.15
,"Sales Receipt","11-06-2024","2439",,"Cash Sales","Zelia Scourer Lemon 500g","Income","Zelia Scouring Powder",,"Undeposited Funds","",60.00,57780.15
,"Sales Receipt","11-06-2024","2448",,"Farmwell Enterprises","Zelia Scourer Lemon 500g","Income","Zelia Scouring Powder",,"Undeposited Funds","",336.00,58116.15
,"Invoice","12-06-2024","MC05818",,"KIRINYAGA FLOUR MILLS LIMITED","Zelia Scourer Lemon 500g","Income","Zelia Scouring Powder",,"Accounts Receivable","",275.86,58392.01
,"Sales Receipt","12-06-2024","2449",,"Cash Sales","Zelia Scourer Lemon 500g","Income","Zelia Scouring Powder",,"Undeposited Funds","",60.00,58452.01
,"Sales Receipt","12-06-2024","2453",,"Cash Sales","Zelia Scourer Lemon 500g","Income","Zelia Scouring Powder",,"Undeposited Funds","",2100.00,60552.01
,"Sales Receipt","12-06-2024","2461",,"Cash Sales","Zelia Scourer Lemon 500g","Income","Zelia Scouring Powder",,"Undeposited Funds","",58.00,60610.01
,"Sales Receipt","12-06-2024","2459",,"Baasmart Store","Zelia Scourer Lemon 500g","Income","Zelia Scouring Powder",,"Undeposited Funds","",2688.00,63298.01
,"Sales Receipt","12-06-2024","2457",,"Elwak Stores","Zelia Scourer Lemon 500g","Income","Zelia Scouring Powder",,"Undeposited Funds","",1344.00,64642.01
,"Sales Receipt","12-06-2024","2456",,"Tawakal","Zelia Scourer Lemon 500g","Income","Zelia Scouring Powder",,"Undeposited Funds","",1344.00,65986.01
,"Sales Receipt","12-06-2024","2455",,"Antic Wholesallers","Zelia Scourer Lemon 500g","Income","Zelia Scouring Powder",,"Undeposited Funds","",6720.00,72706.01
,"Sales Receipt","12-06-2024","2465",,"Gacal Wholesale","Zelia Scourer Lemon 500g","Income","Zelia Scouring Powder",,"Undeposited Funds","",1344.00,74050.01
,"Sales Receipt","12-06-2024","2463",,"Raja Foodstuffs","Zelia Scourer Lemon 500g","Income","Zelia Scouring Powder",,"Undeposited Funds","",1344.00,75394.01
,"Sales Receipt","12-06-2024","2747",,"Smart Choice","Zelia Scourer Lemon 500g","Income","Zelia Scouring Powder",,"Undeposited Funds","",672.00,76066.01
,"Sales Receipt","13-06-2024","2474",,"Fahma Qali","Zelia Scourer Lemon 500g","Income","Zelia Scouring Powder",,"Undeposited Funds","",672.00,76738.01
,"Sales Receipt","14-06-2024","2709",,"mwaspart","Zelia Scourer Lemon 500g","Income","Zelia Scouring Powder",,"Undeposited Funds","",336.00,77074.01
,"Sales Receipt","18-06-2024","2703",,"Cash Sales","Zelia Scourer Lemon 500g","Income","Zelia Scouring Powder",,"Undeposited Funds",0.00,"",77074.01
,"Sales Receipt","18-06-2024","2711",,"Cash Sales","Zelia Scourer Lemon 500g","Income","Zelia Scouring Powder",,"Undeposited Funds","",116.00,77190.01
,"Sales Receipt","18-06-2024","2707",,"Beta Traders","Zelia Scourer Lemon 500g","Income","Zelia Scouring Powder",,"Undeposited Funds","",672.00,77862.01
,"Sales Receipt","19-06-2024","2483",,"Cash Sales","Zelia Scourer Lemon 500g","Income","Zelia Scouring Powder",,"Undeposited Funds","",85.00,77947.01
,"Sales Receipt","19-06-2024","2490",,"Bismillahi Shop","Zelia Scourer Lemon 500g","Income","Zelia Scouring Powder",,"Undeposited Funds","",1344.00,79291.01
,"Sales Receipt","20-06-2024","2494",,"Restoration Traders","Zelia Scourer Lemon 500g","Income","Zelia Scouring Powder",,"Undeposited Funds","",4032.00,83323.01
,"Sales Receipt","20-06-2024","2498",,"Mamken Minimart","Zelia Scourer Lemon 500g","Income","Zelia Scouring Powder",,"Undeposited Funds","",336.00,83659.01
,"Sales Receipt","21-06-2024","2721",,"Home Soko Minimart","Zelia Scourer Lemon 500g","Income","Zelia Scouring Powder",,"Undeposited Funds","",336.00,83995.01
,"Sales Receipt","21-06-2024","2722",,"Kika Mart","Zelia Scourer Lemon 500g","Income","Zelia Scouring Powder",,"Undeposited Funds","",336.00,84331.01
,"Sales Receipt","21-06-2024","2725",,"Marris Mini mart","Zelia Scourer Lemon 500g","Income","Zelia Scouring Powder",,"Undeposited Funds","",336.00,84667.01
,"Invoice","24-06-2024","MC05851",,"SUMM SUPERMARKET LIMITED","Zelia Scourer Lemon 500g","Income","Zelia Scouring Powder",,"Accounts Receivable","",336.21,85003.22
,"Sales Receipt","24-06-2024","2719",,"Cash Sales","Zelia Scourer Lemon 500g","Income","Zelia Scouring Powder",,"Undeposited Funds","",56.00,85059.22
,"Sales Receipt","24-06-2024","2730",,"Neema Bei Nafuu","Zelia Scourer Lemon 500g","Income","Zelia Scouring Powder",,"Undeposited Funds","",672.00,85731.22
,"Sales Receipt","24-06-2024","2729",,"Natala Shop","Zelia Scourer Lemon 500g","Income","Zelia Scouring Powder",,"Undeposited Funds","",672.00,86403.22
,"Sales Receipt","24-06-2024","2728",,"Gidesh Supermarket","Zelia Scourer Lemon 500g","Income","Zelia Scouring Powder",,"Undeposited Funds","",1344.00,87747.22
,"Sales Receipt","24-06-2024","2750",,"Mabini store","Zelia Scourer Lemon 500g","Income","Zelia Scouring Powder",,"Undeposited Funds","",336.00,88083.22
,"Sales Receipt","25-06-2024","2730",,"Bei Nafuu Shop","Zelia Scourer Lemon 500g","Income","Zelia Scouring Powder",,"Undeposited Funds","",336.00,88419.22
,"Invoice","26-06-2024","MC05866",,"DISII TRADERS LTD","Zelia Scourer Lemon 500g","Income","Zelia Scouring Powder",,"Accounts Receivable","",336.21,88755.43
,"Sales Receipt","26-06-2024","2732",,"Instanbul Shop","Zelia Scourer Lemon 500g","Income","Zelia Scouring Powder",,"Undeposited Funds","",336.00,89091.43
,"Sales Receipt","28-06-2024","2737",,"Cash Sales","Zelia Scourer Lemon 500g","Income","Zelia Scouring Powder",,"Undeposited Funds",0.00,"",89091.43
,"Sales Receipt","28-06-2024","2743",,"Cash Sales","Zelia Scourer Lemon 500g","Income","Zelia Scouring Powder",,"Undeposited Funds","",224.00,89315.43
,"Sales Receipt","28-06-2024","2744",,"Cash Sales","Zelia Scourer Lemon 500g","Income","Zelia Scouring Powder",,"Undeposited Funds","",280.00,89595.43
,"Sales Receipt","29-06-2024","593",,"Danaba Wholesallers","Zelia Scourer Lemon 500g","Income","Zelia Scouring Powder",,"Undeposited Funds","",1344.00,90939.43
,"Sales Receipt","02-07-2024","2762",,"Maida Minimart","Zelia Scourer Lemon 500g","Income","Zelia Scouring Powder",,"Undeposited Funds","",336.00,91275.43
,"Invoice","03-07-2024","MC05880",,"SECUTOR LIMITED","Zelia Scourer Lemon 500g","Income","Zelia Scouring Powder",,"Accounts Receivable","",70.00,91345.43
,"Sales Receipt","03-07-2024","2761",,"Cash Sales","Zelia Scourer Lemon 500g","Income","Zelia Scouring Powder",,"Undeposited Funds",0.00,"",91345.43
,"Sales Receipt","03-07-2024","2773",,"Muleshe Wholesallers","Zelia Scourer Lemon 500g","Income","Zelia Scouring Powder",,"Undeposited Funds","",1344.00,92689.43
,"Sales Receipt","03-07-2024","2774",,"Warfa Wholesale","Zelia Scourer Lemon 500g","Income","Zelia Scouring Powder",,"Undeposited Funds","",2688.00,95377.43
,"Sales Receipt","03-07-2024","2768",,"Madini mart","Zelia Scourer Lemon 500g","Income","Zelia Scouring Powder",,"Undeposited Funds","",336.00,95713.43
,"Sales Receipt","05-07-2024","2799",,"Milimani Store","Zelia Scourer Lemon 500g","Income","Zelia Scouring Powder",,"Undeposited Funds","",336.00,96049.43
,"Sales Receipt","06-07-2024","2516",,"Baraka Cerials","Zelia Scourer Lemon 500g","Income","Zelia Scouring Powder",,"Undeposited Funds","",336.00,96385.43
,"Sales Receipt","08-07-2024","2518",,"Freshtake wholesalers","Zelia Scourer Lemon 500g","Income","Zelia Scouring Powder",,"Undeposited Funds","",1344.00,97729.43
,"Sales Receipt","09-07-2024","2509",,"Cash Sales","Zelia Scourer Lemon 500g","Income","Zelia Scouring Powder",,"Undeposited Funds","",60.00,97789.43
,"Sales Receipt","09-07-2024","2526",,"Cash Sales","Zelia Scourer Lemon 500g","Income","Zelia Scouring Powder",,"Undeposited Funds",0.00,"",97789.43
,"Sales Receipt","09-07-2024","2569",,"Al Hamdu shop","Zelia Scourer Lemon 500g","Income","Zelia Scouring Powder",,"Undeposited Funds","",1344.00,99133.43
,"Sales Receipt","09-07-2024","2522",,"Beraccah Syokimau","Zelia Scourer Lemon 500g","Income","Zelia Scouring Powder",,"Undeposited Funds","",1344.00,100477.43
,"Sales Receipt","10-07-2024","2532",,"Norhani Groceries","Zelia Scourer Lemon 500g","Income","Zelia Scouring Powder",,"Undeposited Funds","",672.00,101149.43
,"Invoice","15-07-2024","MC05921",,"OFFSHORE GLOBAL LOGISTICS LIMITED","Zelia Scourer Lemon 500g","Income","Zelia Scouring Powder",,"Accounts Receivable","",879.31,102028.74
,"Invoice","15-07-2024","MC05932",,"ROYMATT SUPERMARKET LIMITED","Zelia Scourer Lemon 500g","Income","Zelia Scouring Powder",,"Accounts Receivable","",336.21,102364.95
,"Sales Receipt","15-07-2024","2543",,"Cash Sales","Zelia Scourer Lemon 500g","Income","Zelia Scouring Powder",,"Undeposited Funds","",112.00,102476.95
,"Sales Receipt","15-07-2024","2546",,"Brinso Foodstufs","Zelia Scourer Lemon 500g","Income","Zelia Scouring Powder",,"Undeposited Funds","",1344.00,103820.95
,"Sales Receipt","16-07-2024","2557",,"Somo 1 Mowlem","Zelia Scourer Lemon 500g","Income","Zelia Scouring Powder",,"Undeposited Funds","",336.00,104156.95
,"Sales Receipt","16-07-2024","2558",,"Somo Supermarket","Zelia Scourer Lemon 500g","Income","Zelia Scouring Powder",,"Undeposited Funds","",336.00,104492.95
,"Invoice","17-07-2024","MC05938",,"DISII TRADERS LTD","Zelia Scourer Lemon 500g","Income","Zelia Scouring Powder",,"Accounts Receivable","",672.41,105165.36
,"Sales Receipt","17-07-2024","2551",,"Cash Sales","Zelia Scourer Lemon 500g","Income","Zelia Scouring Powder",,"Undeposited Funds",0.00,"",105165.36
,"Sales Receipt","18-07-2024","2576",,"Mizpa Minimart","Zelia Scourer Lemon 500g","Income","Zelia Scouring Powder",,"Undeposited Funds","",336.00,105501.36
,"Sales Receipt","22-07-2024","2570",,"Cash Sales","Zelia Scourer Lemon 500g","Income","Zelia Scouring Powder",,"Undeposited Funds",0.00,"",105501.36
,"Sales Receipt","23-07-2024","2591",,"Cash Sales","Zelia Scourer Lemon 500g","Income","Zelia Scouring Powder",,"Undeposited Funds","",400.00,105901.36
,"Sales Receipt","23-07-2024","2581",,"Cash Sales","Zelia Scourer Lemon 500g","Income","Zelia Scouring Powder",,"Undeposited Funds",0.00,"",105901.36
,"Sales Receipt","23-07-2024","2584",,"Elwak Stores","Zelia Scourer Lemon 500g","Income","Zelia Scouring Powder",,"Undeposited Funds","",1344.00,107245.36
,"Sales Receipt","24-07-2024","2588",,"Cash Sales","Zelia Scourer Lemon 500g","Income","Zelia Scouring Powder",,"Undeposited Funds","",280.00,107525.36
,"Sales Receipt","24-07-2024","2593",,"Cash Sales","Zelia Scourer Lemon 500g","Income","Zelia Scouring Powder",,"Undeposited Funds",0.00,"",107525.36
,"Sales Receipt","24-07-2024","2608",,"Capital Halal","Zelia Scourer Lemon 500g","Income","Zelia Scouring Powder",,"Undeposited Funds","",336.00,107861.36
,"Sales Receipt","25-07-2024","2609",,"Zebra Minimart","Zelia Scourer Lemon 500g","Income","Zelia Scouring Powder",,"Undeposited Funds","",448.00,108309.36
,"Invoice","26-07-2024","MC05976",,"SUMM SUPERMARKET LIMITED","Zelia Scourer Lemon 500g","Income","Zelia Scouring Powder",,"Accounts Receivable","",336.21,108645.57
,"Invoice","29-07-2024","MC05983",,"Muhaya & Rukundo Holdings Ltd","0001.12.00 Zelia Scourer Lemon 24x500g","Income","Zelia Scouring Powder",,"Accounts Receivable","",223600.00,332245.57
,"Sales Receipt","29-07-2024","2602",,"Cash Sales","Zelia Scourer Lemon 500g","Income","Zelia Scouring Powder",,"Undeposited Funds",0.00,"",332245.57
,"Sales Receipt","29-07-2024","2922",,"Muhaya & Rukundo Holdings Ltd","Zelia Scourer Lemon 24x500g","Income","Zelia Scouring Powder",,"Undeposited Funds","",367348.80,699594.37
,"Sales Receipt","30-07-2024","2619",,"Cash Sales","Zelia Scourer Lemon 500g","Income","Zelia Scouring Powder",,"Undeposited Funds","",70.00,699664.37
,"Sales Receipt","30-07-2024","2620",,"Cash Sales","Zelia Scourer Lemon 500g","Income","Zelia Scouring Powder",,"Undeposited Funds","",140.00,699804.37
,"Sales Receipt","30-07-2024","2623",,"Smart Choice","Zelia Scourer Lemon 500g","Income","Zelia Scouring Powder",,"Undeposited Funds","",672.00,700476.37
,"Sales Receipt","31-07-2024","AT200",,"Cash Sales","Zelia Scourer Lemon 500g","Income","Zelia Scouring Powder",,"Undeposited Funds","",1423.68,701900.05
,"Sales Receipt","31-07-2024","2631",,"Cash Sales","Zelia Scourer Lemon 500g","Income","Zelia Scouring Powder",,"Undeposited Funds",0.00,"",701900.05
,"Sales Receipt","31-07-2024","2633",,"Sharazad Wholesalers","Zelia Scourer Lemon 500g","Income","Zelia Scouring Powder",,"Undeposited Funds","",1344.00,703244.05
,"Sales Receipt","01-08-2024","2641",,"Taqwa Shop","Zelia Scourer Lemon 500g","Income","Zelia Scouring Powder",,"Undeposited Funds","",672.00,703916.05
,"Sales Receipt","01-08-2024","2637",,"Burhani Shop","Zelia Scourer Lemon 500g","Income","Zelia Scouring Powder",,"Undeposited Funds","",780.00,704696.05
,"Sales Receipt","01-08-2024","2691",,"Ubwere Store","Zelia Scourer Lemon 500g","Income","Zelia Scouring Powder",,"Undeposited Funds","",672.00,705368.05
,"Sales Receipt","01-08-2024","2664",,"Mkulima Supermarket","Zelia Scourer Lemon 500g","Income","Zelia Scouring Powder",,"Undeposited Funds","",672.00,706040.05
,"Sales Receipt","01-08-2024","2918",,"Burhani Shop","Zelia Scourer Lemon 500g","Income","Zelia Scouring Powder",,"Undeposited Funds","",6720.00,712760.05
,"Sales Receipt","02-08-2024","2644",,"Cash Sales","Zelia Scourer Lemon 500g","Income","Zelia Scouring Powder",,"Undeposited Funds","",70.00,712830.05
,"Sales Receipt","02-08-2024","2645",,"Cash Sales","Zelia Scourer Lemon 500g","Income","Zelia Scouring Powder",,"Undeposited Funds","",50.00,712880.05
,"Sales Receipt","02-08-2024","2649",,"Cash Sales","Zelia Scourer Lemon 500g","Income","Zelia Scouring Powder",,"Undeposited Funds","",200.00,713080.05
,"Sales Receipt","02-08-2024","2650",,"Cash Sales","Zelia Scourer Lemon 500g","Income","Zelia Scouring Powder",,"Undeposited Funds","",100.00,713180.05
,"Sales Receipt","03-08-2024","2670",,"Gacal Wholesale","Zelia Scourer Lemon 500g","Income","Zelia Scouring Powder",,"Undeposited Funds","",1344.00,714524.05
,"Sales Receipt","05-08-2024","2658",,"Cash Sales","Zelia Scourer Lemon 500g","Income","Zelia Scouring Powder",,"Undeposited Funds","",160.00,714684.05
,"Sales Receipt","05-08-2024","2661",,"Kibibi Wasai Store","Zelia Scourer Lemon 500g","Income","Zelia Scouring Powder",,"Undeposited Funds","",1344.00,716028.05
,"Sales Receipt","05-08-2024","2671",,"Hidika Shop","Zelia Scourer Lemon 500g","Income","Zelia Scouring Powder",,"Undeposited Funds","",696.00,716724.05
,"Sales Receipt","05-08-2024","2675",,"Adurus Wholesallers","Zelia Scourer Lemon 500g","Income","Zelia Scouring Powder",,"Undeposited Funds","",1392.00,718116.05
,"Sales Receipt","06-08-2024","2659",,"Cash Sales","Zelia Scourer Lemon 500g","Income","Zelia Scouring Powder",,"Undeposited Funds","",320.00,718436.05
,"Sales Receipt","06-08-2024","2680",,"Juja Minimart","Zelia Scourer Lemon 500g","Income","Zelia Scouring Powder",,"Undeposited Funds","",1344.00,719780.05
,"Sales Receipt","07-08-2024","2809",,"Safa Mart Wholesalers","Zelia Scourer Lemon 500g","Income","Zelia Scouring Powder",,"Undeposited Funds","",672.00,720452.05
,"Invoice","08-08-2024","MC06015",,"Burhani Private Mart Limited","Zelia Scourer Lemon 500g","Income","Zelia Scouring Powder",,"Accounts Receivable","",672.41,721124.46
,"Invoice","08-08-2024","MC06016",,"DISII TRADERS LTD","Zelia Scourer Lemon 500g","Income","Zelia Scouring Powder",,"Accounts Receivable","",672.41,721796.87
,"Invoice","08-08-2024","MC06018",,"OFFSHORE GLOBAL LOGISTICS LIMITED","Zelia Scourer Lemon 500g","Income","Zelia Scouring Powder",,"Accounts Receivable","",480.00,722276.87
,"Sales Receipt","08-08-2024","2694",,"mwaspart","Zelia Scourer Lemon 500g","Income","Zelia Scouring Powder",,"Undeposited Funds","",336.00,722612.87
,"Sales Receipt","12-08-2024","2816",,"Freshtake wholesalers","Zelia Scourer Lemon 500g","Income","Zelia Scouring Powder",,"Undeposited Funds","",1392.00,724004.87
,"Sales Receipt","13-08-2024","2820",,"Cash Sales","Zelia Scourer Lemon 500g","Income","Zelia Scouring Powder",,"Undeposited Funds","",100.00,724104.87
,"Sales Receipt","13-08-2024","2819",,"Tawakal Shop","Zelia Scourer Lemon 500g","Income","Zelia Scouring Powder",,"Undeposited Funds","",1344.00,725448.87
,"Sales Receipt","14-08-2024","2823",,"Cash Sales","Zelia Scourer Lemon 500g","Income","Zelia Scouring Powder",,"Undeposited Funds","",147.00,725595.87
,"Sales Receipt","14-08-2024","2834",,"Milimani Store","Zelia Scourer Lemon 500g","Income","Zelia Scouring Powder",,"Undeposited Funds","",672.00,726267.87
,"Sales Receipt","14-08-2024","2842",,"Kibibi Wasai Store","Zelia Scourer Lemon 500g","Income","Zelia Scouring Powder",,"Undeposited Funds","",1344.00,727611.87
,"Sales Receipt","14-08-2024","2829",,"First Choice","Zelia Scourer Lemon 500g","Income","Zelia Scouring Powder",,"Undeposited Funds","",1344.00,728955.87
,"Sales Receipt","15-08-2024","2892",,"Makueni Store","Zelia Scourer Lemon 500g","Income","Zelia Scouring Powder",,"Undeposited Funds","",60.00,729015.87
,"Sales Receipt","16-08-2024","2901",,"Cash Sales","Zelia Scourer Lemon 500g","Income","Zelia Scouring Powder",,"Undeposited Funds","",49.00,729064.87
,"Sales Receipt","16-08-2024","2851",,"Tahila Enterprises","Zelia Scourer Lemon 500g","Income","Zelia Scouring Powder",,"Undeposited Funds","",336.00,729400.87
,"Sales Receipt","19-08-2024","2839",,"Cash Sales","Zelia Scourer Lemon 500g","Income","Zelia Scouring Powder",,"Undeposited Funds",0.00,"",729400.87
,"Sales Receipt","19-08-2024","2835",,"Jombs Wholesale","Zelia Scourer Lemon 500g","Income","Zelia Scouring Powder",,"Undeposited Funds","",171.00,729571.87
,"Sales Receipt","20-08-2024","2858",,"Home Soko Minimart","Zelia Scourer Lemon 500g","Income","Zelia Scouring Powder",,"Undeposited Funds","",342.00,729913.87
,"Sales Receipt","20-08-2024","2869",,"Soft Landing","Zelia Scourer Lemon 500g","Income","Zelia Scouring Powder",,"Undeposited Funds","",136.00,730049.87
,"Sales Receipt","20-08-2024","2859",,"Nzuri Supermarket","Zelia Scourer Lemon 500g","Income","Zelia Scouring Powder",,"Undeposited Funds","",342.00,730391.87
,"Credit Note","21-08-2024","CN01064",,"Muhaya & Rukundo Holdings Ltd","0001.12.00 Zelia Scourer Lemon 24x500g","Income","Zelia Scouring Powder",,"Accounts Receivable",223600.00,"",506791.87
,"Invoice","21-08-2024","MC06062",,"Muhaya & Rukundo Holdings Ltd","0001.12.00 Outer Zelia Scourer Lemon 500g","Income","Zelia Scouring Powder",,"Accounts Receivable","",3939.00,510730.87
,"Sales Receipt","21-08-2024","2863",,"alhamdulilah shop","Zelia Scourer Lemon 500g","Income","Zelia Scouring Powder",,"Undeposited Funds","",696.00,511426.87
,"Invoice","22-08-2024","MC06067",,"Cash Sales","Zelia Scourer Lemon 500g","Income","Zelia Scouring Powder",,"Accounts Receivable","",120.69,511547.56
,"Credit Note","22-08-2024","CN01066",,"Cash Sales","Zelia Scourer Lemon 500g","Income","Zelia Scouring Powder",,"Accounts Receivable",120.69,"",511426.87
,"Sales Receipt","22-08-2024","2868",,"Cash Sales","Zelia Scourer Lemon 500g","Income","Zelia Scouring Powder",,"Undeposited Funds","",70.00,511496.87
,"Sales Receipt","23-08-2024","2877",,"Cash Sales","Zelia Scourer Lemon 500g","Income","Zelia Scouring Powder",,"Undeposited Funds","",70.00,511566.87
,"Sales Receipt","23-08-2024","2881",,"Cash Sales","Zelia Scourer Lemon 500g","Income","Zelia Scouring Powder",,"Undeposited Funds","",120.00,511686.87
,"Sales Receipt","24-08-2024","2887",,"Brightfood Nasra","Zelia Scourer Lemon 500g","Income","Zelia Scouring Powder",,"Undeposited Funds","",348.00,512034.87
,"Invoice","26-08-2024","MC06082",,"SUMM SUPERMARKET LIMITED","Zelia Scourer Lemon 500g","Income","Zelia Scouring Powder",,"Accounts Receivable","",336.21,512371.08
,"Sales Receipt","26-08-2024","2882",,"Cash Sales","Zelia Scourer Lemon 500g","Income","Zelia Scouring Powder",,"Undeposited Funds","",140.00,512511.08
,"Sales Receipt","26-08-2024","2883",,"Cash Sales","Zelia Scourer Lemon 500g","Income","Zelia Scouring Powder",,"Undeposited Funds","",170.00,512681.08
,"Sales Receipt","26-08-2024","2900",,"Al- Zake Shop","Zelia Scourer Lemon 500g","Income","Zelia Scouring Powder",,"Undeposited Funds","",348.00,513029.08
,"Sales Receipt","02-09-2024","3225",,"Purity Shop","Zelia Scourer Lemon 24x500g Standard","Income","Zelia Scouring Powder",,"Undeposited Funds","",112.00,513141.08
,"Sales Receipt","02-09-2024","2923",,"Blossom Beauty","Zelia Scourer Lemon 24x500g Standard","Income","Zelia Scouring Powder",,"Undeposited Funds","",348.00,513489.08
,"Sales Receipt","02-09-2024","3001",,"Cash Sales","Zelia Scourer Lemon 24x500g Standard","Income","Zelia Scouring Powder",,"Undeposited Funds","",64.01,513553.09
,"Sales Receipt","03-09-2024","2930",,"Horn of Africa","Zelia Scourer Lemon 24x500g Standard","Income","Zelia Scouring Powder",,"Undeposited Funds","",696.00,514249.09
,"Sales Receipt","03-09-2024","2931",,"Jombs wholesalers","Zelia Scourer Lemon 24x500g Standard","Income","Zelia Scouring Powder",,"Undeposited Funds","",348.00,514597.09
,"Sales Receipt","03-09-2024","2922",,"Cash Sales","Zelia Scourer Lemon 24x500g Standard","Income","Zelia Scouring Powder",,"Undeposited Funds",0.00,"",514597.09
,"Invoice","04-09-2024","MC06109",,"ROYMATT SUPERMARKET LIMITED","Zelia Scourer Lemon 500g","Income","Zelia Scouring Powder",,"Accounts Receivable","",351.73,514948.82
,"Sales Receipt","04-09-2024","2937",,"Restoration Traders","Zelia Scourer Lemon 24x500g Standard","Income","Zelia Scouring Powder",,"Undeposited Funds","",2784.00,517732.82
,"Sales Receipt","04-09-2024","3013",,"Ogena Matt","Zelia Scourer Lemon 24x500g Standard","Income","Zelia Scouring Powder",,"Undeposited Funds","",350.00,518082.82
,"Sales Receipt","04-09-2024","3014",,"Gifted Hands","Zelia Scourer Lemon 24x500g Standard","Income","Zelia Scouring Powder",,"Undeposited Funds","",280.00,518362.82
,"Sales Receipt","05-09-2024","2948",,"Jam Tower Shop","Zelia Scourer Lemon 24x500g Standard","Income","Zelia Scouring Powder",,"Undeposited Funds","",696.00,519058.82
,"Sales Receipt","05-09-2024","2967",,"Freshtake wholesalers","Zelia Scourer Lemon 24x500g Standard","Income","Zelia Scouring Powder",,"Undeposited Funds","",1392.00,520450.82
,"Sales Receipt","05-09-2024","2952",,"Cash Sales","Zelia Scourer Lemon 24x500g Standard","Income","Zelia Scouring Powder",,"Undeposited Funds",0.00,"",520450.82
,"Sales Receipt","10-09-2024","3015",,"Cash Sales","Zelia Scourer Lemon 24x500g Standard","Income","Zelia Scouring Powder",,"Undeposited Funds","",70.01,520520.83
,"Sales Receipt","11-09-2024","2994",,"Mutawakal Stores","Zelia Scourer Lemon 24x500g Standard","Income","Zelia Scouring Powder",,"Undeposited Funds","",696.00,521216.83
,"Sales Receipt","11-09-2024","2999",,"Anab Shop","Zelia Scourer Lemon 24x500g Standard","Income","Zelia Scouring Powder",,"Undeposited Funds","",348.00,521564.83
,"Sales Receipt","11-09-2024","3011",,"Warfa Wholesale","Zelia Scourer Lemon 24x500g Standard","Income","Zelia Scouring Powder",,"Undeposited Funds","",5568.00,527132.83
,"Invoice","12-09-2024","MC06147",,"ZAIN SUPERMARKET LIMITED","Zelia Scourer Lemon 24x500g Standard","Income","Zelia Scouring Powder",,"Accounts Receivable","",346.55,527479.38
,"Sales Receipt","12-09-2024","3021",,"Marwa Tower Shop","Zelia Scourer Lemon 24x500g Standard","Income","Zelia Scouring Powder",,"Undeposited Funds","",1344.00,528823.38
,"Sales Receipt","12-09-2024","2987",,"Cash Sales","Zelia Scourer Lemon 24x500g Standard","Income","Zelia Scouring Powder",,"Undeposited Funds",0.00,"",528823.38
,"Sales Receipt","12-09-2024","3019",,"Cash Sales","Zelia Scourer Lemon 24x500g Standard","Income","Zelia Scouring Powder",,"Undeposited Funds","",60.00,528883.38
,"Sales Receipt","13-09-2024","3029",,"Omari Store","Zelia Scourer Lemon 24x500g Standard","Income","Zelia Scouring Powder",,"Undeposited Funds","",350.00,529233.38
,"Sales Receipt","16-09-2024","3039",,"Cash Sales","Zelia Scourer Lemon 24x500g Standard","Income","Zelia Scouring Powder",,"Undeposited Funds","",139.99,529373.37
,"Sales Receipt","16-09-2024","3047",,"Cash Sales","Zelia Scourer Lemon 24x500g Standard","Income","Zelia Scouring Powder",,"Undeposited Funds","",96.00,529469.37
,"Sales Receipt","17-09-2024","3050",,"Cash Sales","Zelia Scourer Lemon 24x500g Standard","Income","Zelia Scouring Powder",,"Undeposited Funds","",147.00,529616.37
,"Invoice","18-09-2024","MC06163",,"MKULIMA WANGIGE SUPERMARKET","Zelia Scourer Lemon 24x500g Standard","Income","Zelia Scouring Powder",,"Accounts Receivable","",341.38,529957.75
,"Sales Receipt","18-09-2024","3057",,"Jimos Wholesalers","Zelia Scourer Lemon 24x500g Standard","Income","Zelia Scouring Powder",,"Undeposited Funds","",342.00,530299.75
,"Sales Receipt","18-09-2024","3060",,"Faisel Wholesalers","Zelia Scourer Lemon 24x500g Standard","Income","Zelia Scouring Powder",,"Undeposited Funds","",1392.00,531691.75
,"Sales Receipt","18-09-2024","3061",,"Cash Sales","Zelia Scourer Lemon 24x500g Standard","Income","Zelia Scouring Powder",,"Undeposited Funds","",343.00,532034.75
,"Invoice","20-09-2024","MC06179",,"OFFSHORE GLOBAL LOGISTICS LIMITED","Zelia Scourer Lemon 24x500g Standard","Income","Zelia Scouring Powder",,"Accounts Receivable","",320.01,532354.76
,"Sales Receipt","20-09-2024","3094",,"Duto Rumo Store","Zelia Scourer Lemon 24x500g Standard","Income","Zelia Scouring Powder",,"Undeposited Funds","",70.00,532424.76
,"Invoice","24-09-2024","MC06194",,"OGENA PRIME DISTRIBUTORS LIMITED","Zelia Scourer Lemon 24x500g Standard","Income","Zelia Scouring Powder",,"Accounts Receivable","",301.72,532726.48
,"Credit Note","24-09-2024","CN01069",,"OGENA PRIME DISTRIBUTORS LIMITED","Zelia Scourer Lemon 24x500g Standard","Income","Zelia Scouring Powder",,"Accounts Receivable",301.72,"",532424.76
,"Sales Receipt","24-09-2024","3090",,"Elliane Wholesalers","Zelia Scourer Lemon 24x500g Standard","Income","Zelia Scouring Powder",,"Undeposited Funds","",348.00,532772.76
,"Invoice","26-09-2024","MC06205",,"OFFSHORE GLOBAL LOGISTICS LIMITED","Zelia Scourer Lemon 24x500g Standard","Income","Zelia Scouring Powder",,"Accounts Receivable","",639.99,533412.75
,"Credit Note","27-09-2024","CN01070",,"ROYMATT SUPERMARKET LIMITED","Zelia Scourer Lemon 500g","Income","Zelia Scouring Powder",,"Accounts Receivable",351.73,"",533061.02
,"Invoice","27-09-2024","MC06216",,"QUALITYMART SUPERMARKET LIMITED","Zelia Scourer Lemon 24x500g Standard","Income","Zelia Scouring Powder",,"Accounts Receivable","",351.72,533412.74
,"Sales Receipt","27-09-2024","3215",,"Supaa Mart","Zelia Scourer Lemon 24x500g Standard","Income","Zelia Scouring Powder",,"Undeposited Funds","",1368.00,534780.74
,"Sales Receipt","27-09-2024","3213",,"DayBreak Shop","Zelia Scourer Lemon 24x500g Standard","Income","Zelia Scouring Powder",,"Undeposited Funds","",171.00,534951.74
,"Sales Receipt","27-09-2024","3211",,"Cash Sales","Zelia Scourer Lemon 24x500g Standard","Income","Zelia Scouring Powder",,"Undeposited Funds",0.00,"",534951.74
,"Sales Receipt","27-09-2024","3216",,"Cash Sales","Zelia Scourer Lemon 24x500g Standard","Income","Zelia Scouring Powder",,"Undeposited Funds","",139.99,535091.73
,"Sales Receipt","28-09-2024","3221",,"Bulsho Wholesalers","Zelia Scourer Lemon 24x500g Standard","Income","Zelia Scouring Powder",,"Undeposited Funds","",342.00,535433.73
,"Sales Receipt","02-10-2024","3244",,"B-Shop","Zelia Scourer Lemon 24x500g Standard","Income","Zelia Scouring Powder",,"Undeposited Funds","",1392.00,536825.73
,"Sales Receipt","03-10-2024","3246",,"Fahan Foodstuff","Zelia Scourer Lemon 24x500g Standard","Income","Zelia Scouring Powder",,"Undeposited Funds","",2784.00,539609.73
,"Sales Receipt","03-10-2024","3248",,"Elwak Stores","Zelia Scourer Lemon 24x500g Standard","Income","Zelia Scouring Powder",,"Undeposited Funds","",1392.00,541001.73
,"Sales Receipt","06-10-2024","3184",,"Precious Mart","Zelia Scourer Lemon 24x500g Standard","Income","Zelia Scouring Powder",,"Undeposited Funds","",204.00,541205.73
,"Sales Receipt","06-10-2024","3422",,"Mikara Shop","Zelia Scourer Lemon 24x500g Standard","Income","Zelia Scouring Powder",,"Undeposited Funds","",696.00,541901.73
,"Sales Receipt","06-10-2024","3423",,"Jikweri Minimart","-MULTIPLE-","Income","Zelia Scouring Powder",,"Undeposited Funds","",3344.00,545245.73
,"Sales Receipt","09-10-2024","3276",,"Cash Sales","Zelia Scourer Lemon 24x500g Standard","Income","Zelia Scouring Powder",,"Undeposited Funds",0.00,"",545245.73
,"Sales Receipt","09-10-2024","3279",,"Cash Sales","Zelia Scourer Lemon 24x500g Standard","Income","Zelia Scouring Powder",,"Undeposited Funds","",100.00,545345.73
,"Sales Receipt","09-10-2024","3287",,"Baba Ali Shop","Zelia Scourer Lemon 24x500g Standard","Income","Zelia Scouring Powder",,"Undeposited Funds","",696.00,546041.73
,"Invoice","11-10-2024","MC06251",,"HOPEMART SELF SERVICES LTD","Zelia Scourer Lemon 24x500g Standard  6 Pieces @66.12","Income","Zelia Scouring Powder",,"Accounts Receivable","",342.00,546383.73
,"Sales Receipt","11-10-2024","3291",,"Cash Sales","Zelia Scourer Lemon 24x500g Standard","Income","Zelia Scouring Powder",,"Undeposited Funds","",98.00,546481.73
,"Sales Receipt","14-10-2024","3105",,"Faaz Mart","Zelia Scourer Lemon 24x500g Standard","Income","Zelia Scouring Powder",,"Undeposited Funds","",1392.00,547873.73
,"Sales Receipt","14-10-2024","3104",,"Adurus Wholesallers","Zelia Scourer Lemon 24x500g Standard","Income","Zelia Scouring Powder",,"Undeposited Funds","",1392.00,549265.73
,"Sales Receipt","15-10-2024","3187",,"Big Fish Minimart","Zelia Scourer Lemon 24x500g Standard","Income","Zelia Scouring Powder",,"Undeposited Funds","",204.00,549469.73
,"Sales Receipt","16-10-2024","3112",,"Ruksan Shop","Zelia Scourer Lemon 24x500g Standard","Income","Zelia Scouring Powder",,"Undeposited Funds","",1392.00,550861.73
,"Sales Receipt","17-10-2024","3120",,"Cash Sales","Zelia Scourer Lemon 24x500g Standard","Income","Zelia Scouring Powder",,"Undeposited Funds",0.00,"",550861.73
,"Sales Receipt","17-10-2024","3115",,"Corner Shop","Zelia Scourer Lemon 24x500g Standard","Income","Zelia Scouring Powder",,"Undeposited Funds","",1392.00,552253.73
,"Sales Receipt","17-10-2024","3117",,"Freshtake wholesalers","Zelia Scourer Lemon 24x500g Standard","Income","Zelia Scouring Powder",,"Undeposited Funds","",1392.00,553645.73
,"Sales Receipt","19-10-2024","3180",,"Witgad Shop","Zelia Scourer Lemon 24x500g Standard","Income","Zelia Scouring Powder",,"Undeposited Funds","",408.00,554053.73
,"Sales Receipt","22-10-2024","3132",,"Hidika Shop","Zelia Scourer Lemon 24x500g Standard","Income","Zelia Scouring Powder",,"Undeposited Funds","",696.00,554749.73
,"Sales Receipt","23-10-2024","3151",,"Cash Sales","Zelia Scourer Lemon 24x500g Standard","Income","Zelia Scouring Powder",,"Undeposited Funds","",159.99,554909.72
,"Sales Receipt","23-10-2024","3139",,"Cash Sales","Zelia Scourer Lemon 24x500g Standard","Income","Zelia Scouring Powder",,"Undeposited Funds","",240.00,555149.72
,"Sales Receipt","23-10-2024","3142",,"Cash Sales","Zelia Scourer Lemon 24x500g Standard","Income","Zelia Scouring Powder",,"Undeposited Funds","",80.01,555229.73
,"Sales Receipt","24-10-2024","3149",,"Cash Sales","Zelia Scourer Lemon 24x500g Standard","Income","Zelia Scouring Powder",,"Undeposited Funds","",60.00,555289.73
,"Sales Receipt","24-10-2024","3701",,"One Stop Minimart","Zelia Scourer Lemon 12x1Kg","Income","Zelia Scouring Powder",,"Undeposited Funds","",2592.00,557881.73
,"Sales Receipt","25-10-2024","3159",,"Marris Mini mart","Zelia Scourer Lemon 24x500g Standard","Income","Zelia Scouring Powder",,"Undeposited Funds","",171.00,558052.73
,"Sales Receipt","28-10-2024","3702",,"Adurus Wholesallers","Zelia Scourer Lemon 12x1Kg","Income","Zelia Scouring Powder",,"Undeposited Funds","",2544.00,560596.73
,"Sales Receipt","28-10-2024","3703",,"Himilo General Store","-MULTIPLE-","Income","Zelia Scouring Powder",,"Undeposited Funds","",3936.00,564532.73
,"Sales Receipt","29-10-2024","3704",,"Home Soko Minimart","Zelia Scourer Lemon 12x1Kg","Income","Zelia Scouring Powder",,"Undeposited Funds","",636.00,565168.73
,"Sales Receipt","29-10-2024","3705",,"Elliane Wholesalers","Zelia Scourer Lemon 12x1Kg","Income","Zelia Scouring Powder",,"Undeposited Funds","",636.00,565804.73
,"Invoice","30-10-2024","MC06322",,"OFFSHORE GLOBAL LOGISTICS LIMITED","Zelia Scourer Lemon 24x500g Standard","Income","Zelia Scouring Powder",,"Accounts Receivable","",800.01,566604.74
,"Sales Receipt","02-11-2024","3707",,"Cheaper Cheap","-MULTIPLE-","Income","Zelia Scouring Powder",,"Undeposited Funds","",2664.00,569268.74
,"Sales Receipt","04-11-2024","3430",,"Mabini Minimart","Zelia Scourer Lemon 24x500g Standard","Income","Zelia Scouring Powder",,"Undeposited Funds","",684.00,569952.74
,"Sales Receipt","04-11-2024","3708",,"Gure Yare Shop","-MULTIPLE-","Income","Zelia Scouring Powder",,"Undeposited Funds","",4056.00,574008.74
,"Sales Receipt","04-11-2024","3709",,"Brinso Foodstufs","Zelia Scourer Lemon 12x1Kg","Income","Zelia Scouring Powder",,"Undeposited Funds","",2544.00,576552.74
,"Sales Receipt","05-11-2024","3713",,"Elwak Minimart","Zelia Scourer Lemon 12x1Kg","Income","Zelia Scouring Powder",,"Undeposited Funds","",2544.00,579096.74
,"Sales Receipt","05-11-2024","3714",,"Marris Mini mart","Zelia Scourer Lemon 24x500g Standard","Income","Zelia Scouring Powder",,"Undeposited Funds","",171.00,579267.74
,"Invoice","06-11-2024","MC06335",,"Guard Mart Supermarket Limited","Zelia Scourer Lemon 24x500g Standard  1pc @73.08","Income","Zelia Scouring Powder",,"Accounts Receivable","",63.01,579330.75
,"Sales Receipt","06-11-2024","3721",,"Towba foodstuffs","Zelia Scourer Lemon 12x1Kg","Income","Zelia Scouring Powder",,"Undeposited Funds","",2544.00,581874.75
,"Sales Receipt","06-11-2024","3719",,"Adam Boss","Zelia Scourer Lemon 24x500g Standard","Income","Zelia Scouring Powder",,"Undeposited Funds","",1392.00,583266.75
,"Sales Receipt","07-11-2024","3407",,"Cash Sales","Zelia Scourer Lemon 24x500g Standard","Income","Zelia Scouring Powder",,"Undeposited Funds","",98.01,583364.76
,"Sales Receipt","07-11-2024","3722",,"D-Madina Enterprise","-MULTIPLE-","Income","Zelia Scouring Powder",,"Undeposited Funds","",5328.00,588692.76
,"Sales Receipt","07-11-2024","3457",,"Dylyn Enterprise","Zelia Scourer Lemon 24x500g Standard","Income","Zelia Scouring Powder",,"Undeposited Funds","",340.00,589032.76
,"Sales Receipt","08-11-2024","3409",,"Cash Sales","Zelia Scourer Lemon 12x1Kg","Income","Zelia Scouring Powder",,"Undeposited Funds","",360.01,589392.77
,"Sales Receipt","11-11-2024","3415",,"Cash Sales","Zelia Scourer Lemon 12x1Kg","Income","Zelia Scouring Powder",,"Undeposited Funds","",182.00,589574.77
,"Sales Receipt","11-11-2024","3420",,"Cash Sales","Zelia Scourer Lemon 12x1Kg","Income","Zelia Scouring Powder",,"Undeposited Funds","",450.00,590024.77
,"Sales Receipt","12-11-2024","3431",,"Cash Sales","-MULTIPLE-","Income","Zelia Scouring Powder",,"Undeposited Funds","",11650.00,601674.77
,"Sales Receipt","12-11-2024","3436",,"Horn of Africa","-MULTIPLE-","Income","Zelia Scouring Powder",,"Undeposited Funds","",1968.00,603642.77
,"Sales Receipt","12-11-2024","3437",,"Jombs wholesalers","Zelia Scourer Lemon 24x500g Standard","Income","Zelia Scouring Powder",,"Undeposited Funds","",348.00,603990.77
,"Sales Receipt","13-11-2024","3441",,"Publix Supermarket","Zelia Scourer Lemon 12x1Kg","Income","Zelia Scouring Powder",,"Undeposited Funds","",636.00,604626.77
,"Sales Receipt","14-11-2024","3446",,"One Stop Minimart","Zelia Scourer Lemon 12x1Kg","Income","Zelia Scouring Powder",,"Undeposited Funds","",2544.00,607170.77
,"Invoice","18-11-2024","MC06372",,"Guard Mart Supermarket Limited","Zelia Scourer Lemon 24x500g Standard  24pc @73.08","Income","Zelia Scouring Powder",,"Accounts Receivable","",1512.00,608682.77
,"Credit Note","18-11-2024","CN01073",,"Guard Mart Supermarket Limited","Zelia Scourer Lemon 24x500g Standard  1pc @73.08","Income","Zelia Scouring Powder",,"Accounts Receivable",63.01,"",608619.76
,"Sales Receipt","18-11-2024","3451",,"Cash Sales","Zelia Scourer Lemon 12x1Kg","Income","Zelia Scouring Powder",,"Undeposited Funds","",100.00,608719.76
,"Sales Receipt","18-11-2024","3468",,"Cash Sales","-MULTIPLE-","Income","Zelia Scouring Powder",,"Undeposited Funds","",290.00,609009.76
,"Sales Receipt","18-11-2024","3466",,"Faisel Wholesale","-MULTIPLE-","Income","Zelia Scouring Powder",,"Undeposited Funds","",2448.00,611457.76
,"Invoice","19-11-2024","MC06374",,"SUMM SUPERMARKET LIMITED","Zelia Scourer Lemon 24x500g Standard  6Pcs@66","Income","Zelia Scouring Powder",,"Accounts Receivable","",341.38,611799.14
,"Invoice","19-11-2024","MC06378",,"ROYMATT SUPERMARKET LIMITED","-MULTIPLE-","Income","Zelia Scouring Powder",,"Accounts Receivable","",910.34,612709.48
,"Sales Receipt","20-11-2024","3481",,"Norhani Groceries","-MULTIPLE-","Income","Zelia Scouring Powder",,"Undeposited Funds","",1824.00,614533.48
,"Sales Receipt","20-11-2024","3480",,"Burhani Shop","Zelia Scourer Lemon 24x500g Standard","Income","Zelia Scouring Powder",,"Undeposited Funds","",6240.00,620773.48
,"Sales Receipt","25-11-2024","3763",,"Domie Shop","Zelia Scourer Lemon 24x500g Standard","Income","Zelia Scouring Powder",,"Undeposited Funds","",560.00,621333.48
,"Sales Receipt","27-11-2024","3739",,"Eugombe Enterprises","Zelia Scourer Lemon 24x500g Standard","Income","Zelia Scouring Powder",,"Undeposited Funds","",1320.00,622653.48
,"Sales Receipt","27-11-2024","3764",,"Molly Shop","Zelia Scourer Lemon 24x500g Standard","Income","Zelia Scouring Powder",,"Undeposited Funds","",420.00,623073.48
,"Invoice","28-11-2024","MC06426",,"ZAIN SUPERMARKET LIMITED","Zelia Scourer Lemon 12x1Kg  6Pcs @116","Income","Zelia Scouring Powder",,"Accounts Receivable","",600.00,623673.48
,"Sales Receipt","28-11-2024","3750",,"Cash Sales","Zelia Scourer Lemon 24x500g Standard","Income","Zelia Scouring Powder",,"Undeposited Funds","",240.00,623913.48
,"Sales Receipt","29-11-2024","3755",,"Cash Sales","Zelia Scourer Lemon 12x1Kg","Income","Zelia Scouring Powder",,"Undeposited Funds","",100.00,624013.48
,"Sales Receipt","30-11-2024","3760",,"Cash Sales","Zelia Scourer Lemon 12x1Kg","Income","Zelia Scouring Powder",,"Undeposited Funds","",700.00,624713.48
,"Sales Receipt","30-11-2024","AT203",,"Cash Sales","-MULTIPLE-","Income","Zelia Scouring Powder",,"Undeposited Funds","",2623.68,627337.16
,"Sales Receipt","30-11-2024","3766",,"Muga Shop","-MULTIPLE-","Income","Zelia Scouring Powder",,"Undeposited Funds","",1824.00,629161.16
,"Sales Receipt","02-12-2024","3767",,"Cash Sales","Zelia Scourer Lemon 24x500g Standard","Income","Zelia Scouring Powder",,"Undeposited Funds","",50.00,629211.16
,"Sales Receipt","02-12-2024","3777",,"Cash Sales","Zelia Scourer Lemon 12x1Kg","Income","Zelia Scouring Powder",,"Undeposited Funds","",100.00,629311.16
,"Sales Receipt","02-12-2024","3780",,"Cash Sales","Zelia Scourer Lemon 12x1Kg","Income","Zelia Scouring Powder",,"Undeposited Funds","",100.00,629411.16
,"Sales Receipt","02-12-2024","3774",,"Downtown Wholesalers","Zelia Scourer Lemon 12x1Kg","Income","Zelia Scouring Powder",,"Undeposited Funds","",2400.00,631811.16
,"Sales Receipt","02-12-2024","3775",,"Gacal Wholesale","-MULTIPLE-","Income","Zelia Scouring Powder",,"Undeposited Funds","",2448.00,634259.16
,"Sales Receipt","02-12-2024","3776",,"Elwak Stores","Zelia Scourer Lemon 24x500g Standard","Income","Zelia Scouring Powder",,"Undeposited Funds","",1248.00,635507.16
,"Sales Receipt","04-12-2024","3791",,"Gold mart Supermarket","Zelia Scourer Lemon 24x500g Standard","Income","Zelia Scouring Powder",,"Undeposited Funds","",696.00,636203.16
,"Sales Receipt","05-12-2024","3800",,"Saacid Shop","Zelia Scourer Lemon 12x1Kg","Income","Zelia Scouring Powder",,"Undeposited Funds","",2400.00,638603.16
,"Invoice","09-12-2024","MC06452",,"DISII TRADERS LTD","Zelia Scourer Lemon 24x500g Standard  12Pcs@66","Income","Zelia Scouring Powder",,"Accounts Receivable","",682.76,639285.92
,"Invoice","09-12-2024","MC06453",,"Maji Asili Limited","Zelia Scourer Lemon 24x500g Standard  12Pcs@66","Income","Zelia Scouring Powder",,"Accounts Receivable","",682.76,639968.68
,"Invoice","09-12-2024","MC06456",,"OFFSHORE GLOBAL LOGISTICS LIMITED","Zelia Scourer Lemon 12x1Kg","Income","Zelia Scouring Powder",,"Accounts Receivable","",480.00,640448.68
,"Sales Receipt","09-12-2024","3316",,"Cash Sales","Zelia Scourer Lemon 12x1Kg","Income","Zelia Scouring Powder",,"Undeposited Funds","",400.00,640848.68
,"Sales Receipt","10-12-2024","3321",,"Cash Sales","Zelia Scourer Lemon 24x500g Standard","Income","Zelia Scouring Powder",,"Undeposited Funds","",480.00,641328.68
,"Sales Receipt","10-12-2024","3329",,"Soimo Mini mart","-MULTIPLE-","Income","Zelia Scouring Powder",,"Undeposited Funds","",912.00,642240.68
,"Sales Receipt","11-12-2024","3339",,"Fahal Wholesalers","Zelia Scourer Lemon 12x1Kg","Income","Zelia Scouring Powder",,"Undeposited Funds","",1200.00,643440.68
,"Sales Receipt","13-12-2024","3340",,"Cash Sales","Zelia Scourer Lemon 12x1Kg","Income","Zelia Scouring Powder",,"Undeposited Funds","",150.00,643590.68
,"Sales Receipt","13-12-2024","3341",,"Cash Sales","Zelia Scourer Lemon 24x500g Standard","Income","Zelia Scouring Powder",,"Undeposited Funds","",96.00,643686.68
,"Sales Receipt","14-12-2024","3351",,"Hidika Shop","-MULTIPLE-","Income","Zelia Scouring Powder",,"Undeposited Funds","",2448.00,646134.68
,"Sales Receipt","14-12-2024","3378",,"Egesa Shop","Zelia Scourer Lemon 24x500g Standard","Income","Zelia Scouring Powder",,"Undeposited Funds","",210.00,646344.68
,"Sales Receipt","16-12-2024","3345",,"Cash Sales","Zelia Scourer Lemon 12x1Kg","Income","Zelia Scouring Powder",,"Undeposited Funds","",100.00,646444.68
,"Sales Receipt","16-12-2024","3348",,"Cash Sales","Zelia Scourer Lemon 24x500g Standard","Income","Zelia Scouring Powder",,"Undeposited Funds","",480.00,646924.68
,"Sales Receipt","17-12-2024","3354",,"Cash Sales","Zelia Scourer Lemon 12x1Kg","Income","Zelia Scouring Powder",,"Undeposited Funds","",300.00,647224.68
,"Sales Receipt","17-12-2024","3357",,"Safwan Wholesalers","Zelia Scourer Lemon 12x1Kg","Income","Zelia Scouring Powder",,"Undeposited Funds","",6000.00,653224.68
"Total Zelia Scouring Powder",,,,,,,,,,,224437.15,877661.83,653224.68
"Zelia Multipurpose Liquid Soap",,,,,,,,,,,,,""
,"Sales Receipt","03-01-2024","1592",,"Cash Sales","Zelia Green Multipurpose Liquid Detergent 500ML","Income","Zelia Multipurpose Liquid Soap",,"Undeposited Funds","",100.00,100.00
,"Sales Receipt","03-01-2024","1593",,"Cash Sales","Zelia Green Multipurpose Liquid Detergent 5L","Income","Zelia Multipurpose Liquid Soap",,"Undeposited Funds","",1220.00,1320.00
,"Sales Receipt","03-01-2024","1596",,"Cash Sales","-MULTIPLE-","Income","Zelia Multipurpose Liquid Soap",,"Undeposited Funds",0.00,"",1320.00
,"Sales Receipt","03-01-2024","1597",,"Cash Sales","Zelia Green Multipurpose Liquid Detergent 5L","Income","Zelia Multipurpose Liquid Soap",,"Undeposited Funds","",610.00,1930.00
,"Invoice","04-01-2024","MC05269",,"OFFSHORE GLOBAL LOGISTICS LIMITED","Zelia Green Multipurpose Liquid Detergent 20L","Income","Zelia Multipurpose Liquid Soap",,"Accounts Receivable","",2079.31,4009.31
,"Sales Receipt","04-01-2024","1704",,"Cash Sales","Zelia Green Multipurpose Liquid Detergent 500ML","Income","Zelia Multipurpose Liquid Soap",,"Undeposited Funds",0.00,"",4009.31
,"Sales Receipt","04-01-2024","1707",,"Mama Amina","Zelia Green Multipurpose Liquid Detergent 500ML","Income","Zelia Multipurpose Liquid Soap",,"Undeposited Funds","",528.00,4537.31
,"Sales Receipt","04-01-2024","1709",,"Cash Sales","Zelia Green Multipurpose Liquid Detergent 5L","Income","Zelia Multipurpose Liquid Soap",,"Undeposited Funds","",610.00,5147.31
,"Invoice","05-01-2024","MC05272",,"Mumsha Supamat","-MULTIPLE-","Income","Zelia Multipurpose Liquid Soap",,"Accounts Receivable","",1422.42,6569.73
,"Sales Receipt","05-01-2024","1711",,"Summer Outlets","Zelia Green Multipurpose Liquid Detergent 500ML","Income","Zelia Multipurpose Liquid Soap",,"Undeposited Funds","",528.00,7097.73
,"Sales Receipt","05-01-2024","AT187",,"Cash Sales","Zelia Green Multipurpose Liquid Detergent 5L","Income","Zelia Multipurpose Liquid Soap",,"Undeposited Funds","",9880.00,16977.73
,"Sales Receipt","07-01-2024","1714",,"Cash Sales","Zelia Green Multipurpose Liquid Detergent 5L","Income","Zelia Multipurpose Liquid Soap",,"Undeposited Funds","",478.00,17455.73
,"Sales Receipt","08-01-2024","1719",,"Kwiksave supermarket","-MULTIPLE-","Income","Zelia Multipurpose Liquid Soap",,"Undeposited Funds","",1956.00,19411.73
,"Sales Receipt","09-01-2024","1716",,"Pambazuka Mart (K) Limited","Zelia Green Multipurpose Liquid Detergent Lite 20L","Income","Zelia Multipurpose Liquid Soap",,"Undeposited Funds","",2000.00,21411.73
,"Sales Receipt","09-01-2024","1720",,"Kwiksave supermarket","Zelia Green Multipurpose Liquid Detergent 500ML","Income","Zelia Multipurpose Liquid Soap",,"Undeposited Funds","",1056.00,22467.73
,"Sales Receipt","10-01-2024","1718",,"Memos Supermarket","Zelia Green Multipurpose Liquid Detergent 500ML","Income","Zelia Multipurpose Liquid Soap",,"Undeposited Funds","",1056.00,23523.73
,"Sales Receipt","10-01-2024","1722",,"Cash Sales","Zelia Green Multipurpose Liquid Detergent 20L","Income","Zelia Multipurpose Liquid Soap",,"Undeposited Funds","",2400.00,25923.73
,"Sales Receipt","11-01-2024","1723",,"Cash Sales","Zelia Green Multipurpose Liquid Detergent 5L","Income","Zelia Multipurpose Liquid Soap",,"Undeposited Funds","",610.00,26533.73
,"Sales Receipt","11-01-2024","1724",,"Mashallah Foodstuffs","Zelia Green Multipurpose Liquid Detergent 500ML","Income","Zelia Multipurpose Liquid Soap",,"Undeposited Funds","",2112.00,28645.73
,"Invoice","12-01-2024","MC05299",,"MUHINDI MWEUSI SUPERMARKET LIMITED","Zelia Green Multipurpose Liquid Detergent 500ML","Income","Zelia Multipurpose Liquid Soap",,"Accounts Receivable","",1055.17,29700.90
,"Invoice","12-01-2024","MC05302",,"MUHINDI MWEUSI SUPERMARKET LIMITED","Zelia Green Multipurpose Liquid Detergent 500ML","Income","Zelia Multipurpose Liquid Soap",,"Accounts Receivable","",527.59,30228.49
,"Invoice","12-01-2024","MC05306",,"Azaavi Collections Limited","Zelia 5L Green Multipurpose Liquid Detergent","Income","Zelia Multipurpose Liquid Soap",,"Accounts Receivable","",580.00,30808.49
,"Invoice","15-01-2024","MC05307",,"THE REAL IPM COMPANY (KENYA)LIMITED","Zelia Green Multipurpose Liquid Detergent 20L","Income","Zelia Multipurpose Liquid Soap",,"Accounts Receivable","",12000.00,42808.49
,"Invoice","15-01-2024","MC05308",,"MUHINDI MWEUSI SUPERMARKET LIMITED","Zelia Green Multipurpose Liquid Detergent 500ML","Income","Zelia Multipurpose Liquid Soap",,"Accounts Receivable","",1055.17,43863.66
,"Invoice","15-01-2024","MC05309",,"MUHINDI MWEUSI SUPERMARKET LIMITED","Zelia Green Multipurpose Liquid Detergent 500ML","Income","Zelia Multipurpose Liquid Soap",,"Accounts Receivable","",1055.17,44918.83
,"Invoice","15-01-2024","MC05315",,"MUHINDI MWEUSI SUPERMARKET LIMITED","-MULTIPLE-","Income","Zelia Multipurpose Liquid Soap",,"Accounts Receivable","",2844.83,47763.66
,"Sales Receipt","15-01-2024","1728",,"Cash Sales","Zelia Green Multipurpose Liquid Detergent 5L","Income","Zelia Multipurpose Liquid Soap",,"Undeposited Funds",0.00,"",47763.66
,"Sales Receipt","15-01-2024","1729",,"Cash Sales","Zelia Green Multipurpose Liquid Detergent 1L","Income","Zelia Multipurpose Liquid Soap",,"Undeposited Funds","",140.00,47903.66
,"Sales Receipt","15-01-2024","1731",,"RAZAQ AIRWAYS","-MULTIPLE-","Income","Zelia Multipurpose Liquid Soap",,"Undeposited Funds","",2880.00,50783.66
,"Sales Receipt","16-01-2024","1753",,"Cash Sales","Zelia Green Multipurpose Liquid Detergent 5L","Income","Zelia Multipurpose Liquid Soap",,"Undeposited Funds","",478.00,51261.66
,"Sales Receipt","17-01-2024","1734",,"Cash Sales","Zelia Green Multipurpose Liquid Detergent 5L","Income","Zelia Multipurpose Liquid Soap",,"Undeposited Funds","",1650.00,52911.66
,"Sales Receipt","18-01-2024","1741",,"Newclear Minimart Fedha","Zelia Green Multipurpose Liquid Detergent 500ML","Income","Zelia Multipurpose Liquid Soap",,"Undeposited Funds","",528.00,53439.66
,"Sales Receipt","19-01-2024","1744",,"Cash Sales","-MULTIPLE-","Income","Zelia Multipurpose Liquid Soap",,"Undeposited Funds","",22848.00,76287.66
,"Sales Receipt","19-01-2024","1746",,"Cash Sales","Zelia Green Multipurpose Liquid Detergent 500ML","Income","Zelia Multipurpose Liquid Soap",,"Undeposited Funds","",79.00,76366.66
,"Sales Receipt","21-01-2024","AT186",,"Cash Sales","Zelia Green Multipurpose Liquid Detergent 5L","Income","Zelia Multipurpose Liquid Soap",,"Undeposited Funds","",3120.00,79486.66
,"Invoice","23-01-2024","MC05342",,"Khetshi Dharamshi And Company Limited","Zelia Green Multipurpose Liquid Detergent Lite 20L","Income","Zelia Multipurpose Liquid Soap",,"Accounts Receivable","",9600.00,89086.66
,"Invoice","23-01-2024","MC05343",,"MUHINDI MWEUSI SUPERMARKET LIMITED","-MULTIPLE-","Income","Zelia Multipurpose Liquid Soap",,"Accounts Receivable","",2844.83,91931.49
,"Invoice","23-01-2024","MC05344",,"OFFSHORE GLOBAL LOGISTICS LIMITED","Zelia Green Multipurpose Liquid Detergent 20L","Income","Zelia Multipurpose Liquid Soap",,"Accounts Receivable","",2079.31,94010.80
,"Sales Receipt","23-01-2024","1749",,"Cash Sales","Zelia Green Multipurpose Liquid Detergent Lite 20L","Income","Zelia Multipurpose Liquid Soap",,"Undeposited Funds","",2000.00,96010.80
,"Invoice","24-01-2024","MC05345",,"THE REAL IPM COMPANY (KENYA)LIMITED","Zelia Green Multipurpose Liquid Detergent 20L","Income","Zelia Multipurpose Liquid Soap",,"Accounts Receivable","",12000.00,108010.80
,"Invoice","24-01-2024","MC05348",,"MUHINDI MWEUSI SUPERMARKET LIMITED","Zelia Green Multipurpose Liquid Detergent 500ML","Income","Zelia Multipurpose Liquid Soap",,"Accounts Receivable","",1055.17,109065.97
,"Sales Receipt","24-01-2024","1755",,"Alma Mart","-MULTIPLE-","Income","Zelia Multipurpose Liquid Soap",,"Undeposited Funds","",2128.00,111193.97
,"Sales Receipt","24-01-2024","1756",,"Cash Sales","Zelia Green Multipurpose Liquid Detergent 5L","Income","Zelia Multipurpose Liquid Soap",,"Undeposited Funds","",610.00,111803.97
,"Sales Receipt","25-01-2024","1758",,"Cash Sales","Zelia Green Multipurpose Liquid Detergent 5L","Income","Zelia Multipurpose Liquid Soap",,"Undeposited Funds","",610.00,112413.97
,"Sales Receipt","29-01-2024","1759",,"Cash Sales","Zelia Green Multipurpose Liquid Detergent 500ML","Income","Zelia Multipurpose Liquid Soap",,"Undeposited Funds","",528.00,112941.97
,"Sales Receipt","29-01-2024","1763",,"Cash Sales","Zelia Green Multipurpose Liquid Detergent 1L","Income","Zelia Multipurpose Liquid Soap",,"Undeposited Funds","",150.00,113091.97
,"Sales Receipt","29-01-2024","1769",,"Cash Sales","-MULTIPLE-","Income","Zelia Multipurpose Liquid Soap",,"Undeposited Funds",0.00,"",113091.97
,"Sales Receipt","30-01-2024","1766",,"Cash Sales","Zelia Green Multipurpose Liquid Detergent 5L","Income","Zelia Multipurpose Liquid Soap",,"Undeposited Funds","",1220.00,114311.97
,"Sales Receipt","30-01-2024","1768",,"Cash Sales","Zelia Green Multipurpose Liquid Detergent 5L","Income","Zelia Multipurpose Liquid Soap",,"Undeposited Funds","",610.00,114921.97
,"Sales Receipt","30-01-2024","1770",,"Pambazuka Mart (K) Limited","Zelia Green Multipurpose Liquid Detergent Lite 20L","Income","Zelia Multipurpose Liquid Soap",,"Undeposited Funds","",2000.00,116921.97
,"Sales Receipt","30-01-2024","1771",,"Arqam Savanna","-MULTIPLE-","Income","Zelia Multipurpose Liquid Soap",,"Undeposited Funds","",3944.00,120865.97
,"Sales Receipt","30-01-2024","1772",,"Amina Shop","Zelia Green Multipurpose Liquid Detergent 500ML","Income","Zelia Multipurpose Liquid Soap",,"Undeposited Funds","",1056.00,121921.97
,"Sales Receipt","31-01-2024","1773",,"Cash Sales","Zelia Green Multipurpose Liquid Detergent 500ML","Income","Zelia Multipurpose Liquid Soap",,"Undeposited Funds",0.00,"",121921.97
,"Sales Receipt","01-02-2024","1775",,"Faisel Wholesale","-MULTIPLE-","Income","Zelia Multipurpose Liquid Soap",,"Undeposited Funds","",4256.00,126177.97
,"Sales Receipt","01-02-2024","1776",,"FARMERS BEST GROCERY","Zelia Green Multipurpose Liquid Detergent 1L","Income","Zelia Multipurpose Liquid Soap",,"Undeposited Funds","",2076.00,128253.97
,"Sales Receipt","01-02-2024","1777",,"Cash Sales","Zelia Green Multipurpose Liquid Detergent 5L","Income","Zelia Multipurpose Liquid Soap",,"Undeposited Funds","",550.00,128803.97
,"Sales Receipt","01-02-2024","1780",,"Cash Sales","Zelia Green Multipurpose Liquid Detergent 1L","Income","Zelia Multipurpose Liquid Soap",,"Undeposited Funds","",150.00,128953.97
,"Invoice","02-02-2024","MC05378",,"MZOORI STORE LIMITED","Zelia Green Multipurpose Liquid Detergent 500ML","Income","Zelia Multipurpose Liquid Soap",,"Accounts Receivable","",527.59,129481.56
,"Invoice","02-02-2024","MC05379",,"HOPEMART SELF SERVICES LTD","-MULTIPLE-","Income","Zelia Multipurpose Liquid Soap",,"Accounts Receivable","",5705.18,135186.74
,"Sales Receipt","02-02-2024","1783",,"Cheche Minimart","-MULTIPLE-","Income","Zelia Multipurpose Liquid Soap",,"Undeposited Funds","",714.00,135900.74
,"Sales Receipt","02-02-2024","1785",,"Cash Sales","Zelia Green Multipurpose Liquid Detergent 5L","Income","Zelia Multipurpose Liquid Soap",,"Undeposited Funds","",610.00,136510.74
,"Sales Receipt","02-02-2024","1786",,"Cash Sales","Zelia Green Multipurpose Liquid Detergent 5L","Income","Zelia Multipurpose Liquid Soap",,"Undeposited Funds","",478.00,136988.74
,"Invoice","05-02-2024","MC05385",,"TAWALA SUPERMARKET LIMITED","-MULTIPLE-","Income","Zelia Multipurpose Liquid Soap",,"Accounts Receivable","",2844.82,139833.56
,"Sales Receipt","05-02-2024","1787",,"Cash Sales","Zelia Green Multipurpose Liquid Detergent 500ML","Income","Zelia Multipurpose Liquid Soap",,"Undeposited Funds",0.00,"",139833.56
,"Sales Receipt","05-02-2024","1788",,"Cash Sales","Zelia Green Multipurpose Liquid Detergent 5L","Income","Zelia Multipurpose Liquid Soap",,"Undeposited Funds","",478.00,140311.56
,"Sales Receipt","05-02-2024","1790",,"Cash Sales","Zelia Green Multipurpose Liquid Detergent 5L","Income","Zelia Multipurpose Liquid Soap",,"Undeposited Funds","",24000.00,164311.56
,"Sales Receipt","05-02-2024","1791",,"The Hub Minimart","-MULTIPLE-","Income","Zelia Multipurpose Liquid Soap",,"Undeposited Funds","",1506.00,165817.56
,"Sales Receipt","06-02-2024","1797",,"Libin Minimart","Zelia Green Multipurpose Liquid Detergent 1L","Income","Zelia Multipurpose Liquid Soap",,"Undeposited Funds","",3600.00,169417.56
,"Sales Receipt","06-02-2024","1800",,"Mama Amina","Zelia Green Multipurpose Liquid Detergent 500ML","Income","Zelia Multipurpose Liquid Soap",,"Undeposited Funds","",528.00,169945.56
,"Sales Receipt","06-02-2024","1808",,"Cash Sales","Zelia Green Multipurpose Liquid Detergent 1L","Income","Zelia Multipurpose Liquid Soap",,"Undeposited Funds","",133.00,170078.56
,"Sales Receipt","07-02-2024","1811",,"Cash Sales","Zelia Green Multipurpose Liquid Detergent 500ML","Income","Zelia Multipurpose Liquid Soap",,"Undeposited Funds",0.00,"",170078.56
,"Sales Receipt","08-02-2024","1814",,"Cash Sales","Zelia Green Multipurpose Liquid Detergent 500ML","Income","Zelia Multipurpose Liquid Soap",,"Undeposited Funds",0.00,"",170078.56
,"Sales Receipt","08-02-2024","1815",,"Cash Sales","Zelia Green Multipurpose Liquid Detergent 500ML","Income","Zelia Multipurpose Liquid Soap",,"Undeposited Funds",0.00,"",170078.56
,"Sales Receipt","08-02-2024","1816",,"Cash Sales","Zelia Green Multipurpose Liquid Detergent 1L","Income","Zelia Multipurpose Liquid Soap",,"Undeposited Funds","",536.00,170614.56
,"Invoice","09-02-2024","MC05394",,"THE REAL IPM COMPANY (KENYA)LIMITED","Zelia Green Multipurpose Liquid Detergent 20L","Income","Zelia Multipurpose Liquid Soap",,"Accounts Receivable","",12000.00,182614.56
,"Sales Receipt","09-02-2024","1819",,"Cash Sales","Zelia Green Multipurpose Liquid Detergent 5L","Income","Zelia Multipurpose Liquid Soap",,"Undeposited Funds","",478.00,183092.56
,"Sales Receipt","10-02-2024","1821",,"Alma Mart","Zelia Green Multipurpose Liquid Detergent 500ML","Income","Zelia Multipurpose Liquid Soap",,"Undeposited Funds","",528.00,183620.56
,"Invoice","12-02-2024","MC05396",,"OFFSHORE GLOBAL LOGISTICS LIMITED","-MULTIPLE-","Income","Zelia Multipurpose Liquid Soap",,"Accounts Receivable","",2614.66,186235.22
,"Sales Receipt","12-02-2024","1822",,"Deeps General Shop","Zelia Green Multipurpose Liquid Detergent 500ML","Income","Zelia Multipurpose Liquid Soap",,"Undeposited Funds","",176.00,186411.22
,"Sales Receipt","12-02-2024","1823",,"INTEGRAL MEDIA LIMITED","Zelia Green Multipurpose Liquid Detergent 500ML","Income","Zelia Multipurpose Liquid Soap",,"Undeposited Funds","",2112.00,188523.22
,"Sales Receipt","12-02-2024","1829",,"Blue Wholesale","-MULTIPLE-","Income","Zelia Multipurpose Liquid Soap",,"Undeposited Funds","",2408.00,190931.22
,"Sales Receipt","13-02-2024","1832",,"Cash Sales","Zelia Green Multipurpose Liquid Detergent 5L","Income","Zelia Multipurpose Liquid Soap",,"Undeposited Funds","",478.00,191409.22
,"Sales Receipt","14-02-2024","1835",,"Bismillahi Shop","Zelia Green Multipurpose Liquid Detergent 5L","Income","Zelia Multipurpose Liquid Soap",,"Undeposited Funds","",2144.00,193553.22
,"Sales Receipt","14-02-2024","1838",,"Cash Sales","Zelia Green Multipurpose Liquid Detergent 5L","Income","Zelia Multipurpose Liquid Soap",,"Undeposited Funds",0.00,"",193553.22
,"Sales Receipt","15-02-2024","1840",,"Cash Sales","Zelia Green Multipurpose Liquid Detergent 5L","Income","Zelia Multipurpose Liquid Soap",,"Undeposited Funds","",610.00,194163.22
,"Sales Receipt","16-02-2024","1845",,"Cash Sales","Zelia Green Multipurpose Liquid Detergent 500ML","Income","Zelia Multipurpose Liquid Soap",,"Undeposited Funds",0.00,"",194163.22
,"Sales Receipt","17-02-2024","1851",,"MumsCereal and General Stores","Zelia Green Multipurpose Liquid Detergent 500ML","Income","Zelia Multipurpose Liquid Soap",,"Undeposited Funds","",264.00,194427.22
,"Sales Receipt","19-02-2024","1850",,"Zamaridi wholesalers","Zelia Green Multipurpose Liquid Detergent 500ML","Income","Zelia Multipurpose Liquid Soap",,"Undeposited Funds","",264.00,194691.22
,"Sales Receipt","20-02-2024","1854",,"Cash Sales","Zelia Green Multipurpose Liquid Detergent 5L","Income","Zelia Multipurpose Liquid Soap",,"Undeposited Funds",0.00,"",194691.22
,"Sales Receipt","21-02-2024","1855",,"Cash Sales","Zelia Green Multipurpose Liquid Detergent 1L","Income","Zelia Multipurpose Liquid Soap",,"Undeposited Funds","",170.00,194861.22
,"Sales Receipt","21-02-2024","1856",,"Cash Sales","Zelia Green Multipurpose Liquid Detergent 1L","Income","Zelia Multipurpose Liquid Soap",,"Undeposited Funds","",170.00,195031.22
,"Sales Receipt","21-02-2024","1859",,"Cash Sales","-MULTIPLE-","Income","Zelia Multipurpose Liquid Soap",,"Undeposited Funds","",624.00,195655.22
,"Sales Receipt","21-02-2024","1860",,"Cash Sales","Zelia Green Multipurpose Liquid Detergent 500ML","Income","Zelia Multipurpose Liquid Soap",,"Undeposited Funds","",264.00,195919.22
,"Sales Receipt","21-02-2024","1862",,"Ebenezer  Minimart","Zelia Green Multipurpose Liquid Detergent 5L","Income","Zelia Multipurpose Liquid Soap",,"Undeposited Funds","",490.00,196409.22
,"Invoice","22-02-2024","MC05434",,"NASRI MART LIMITED","Zelia Green Multipurpose Liquid Detergent 500ML","Income","Zelia Multipurpose Liquid Soap",,"Accounts Receivable","",439.65,196848.87
,"Sales Receipt","22-02-2024","1865",,"Cash Sales","Zelia Green Multipurpose Liquid Detergent 500ML","Income","Zelia Multipurpose Liquid Soap",,"Undeposited Funds",0.00,"",196848.87
,"Sales Receipt","22-02-2024","1866",,"Cash Sales","Zelia Green Multipurpose Liquid Detergent 1L","Income","Zelia Multipurpose Liquid Soap",,"Undeposited Funds","",150.00,196998.87
,"Sales Receipt","22-02-2024","1868",,"Cash Sales","Zelia Green Multipurpose Liquid Detergent 1L","Income","Zelia Multipurpose Liquid Soap",,"Undeposited Funds","",150.00,197148.87
,"Invoice","23-02-2024","MC05443",,"DAILY CHAMPIONS MINI SUPERMARKET LIMITED","Zelia Green Multipurpose Liquid Detergent 500ML","Income","Zelia Multipurpose Liquid Soap",,"Accounts Receivable","",527.59,197676.46
,"Sales Receipt","23-02-2024","1869",,"Cash Sales","Zelia Green Multipurpose Liquid Detergent 5L","Income","Zelia Multipurpose Liquid Soap",,"Undeposited Funds","",550.00,198226.46
,"Invoice","26-02-2024","MC05445",,"Mumsha Supamat","Zelia Green Multipurpose Liquid Detergent 1L","Income","Zelia Multipurpose Liquid Soap",,"Accounts Receivable","",894.83,199121.29
,"Sales Receipt","26-02-2024","1874",,"Cash Sales","Zelia Green Multipurpose Liquid Detergent 500ML","Income","Zelia Multipurpose Liquid Soap",,"Undeposited Funds","",264.00,199385.29
,"Invoice","27-02-2024","MC05446",,"THE REAL IPM COMPANY (KENYA)LIMITED","Zelia Green Multipurpose Liquid Detergent 20L","Income","Zelia Multipurpose Liquid Soap",,"Accounts Receivable","",12000.00,211385.29
,"Sales Receipt","27-02-2024","1878",,"Cash Sales","Zelia Green Multipurpose Liquid Detergent 5L","Income","Zelia Multipurpose Liquid Soap",,"Undeposited Funds","",1830.00,213215.29
,"Sales Receipt","27-02-2024","1880",,"Cash Sales","Zelia Green Multipurpose Liquid Detergent 5L","Income","Zelia Multipurpose Liquid Soap",,"Undeposited Funds","",610.00,213825.29
,"Sales Receipt","27-02-2024","1881",,"Gure Yare Shop Nasra","Zelia Green Multipurpose Liquid Detergent 5L","Income","Zelia Multipurpose Liquid Soap",,"Undeposited Funds","",5880.00,219705.29
,"Sales Receipt","27-02-2024","1882",,"AIDURUS GENERAL SHOP","Zelia Green Multipurpose Liquid Detergent 500ML","Income","Zelia Multipurpose Liquid Soap",,"Undeposited Funds","",1056.00,220761.29
,"Sales Receipt","27-02-2024","1883",,"Cash Sales","Zelia Green Multipurpose Liquid Detergent 1L","Income","Zelia Multipurpose Liquid Soap",,"Undeposited Funds",0.00,"",220761.29
,"Sales Receipt","28-02-2024","1806",,"Beraccah Wholesallers","Zelia Green Multipurpose Liquid Detergent 500ML","Income","Zelia Multipurpose Liquid Soap",,"Undeposited Funds","",528.00,221289.29
,"Sales Receipt","29-02-2024","1888",,"Cash Sales","Zelia Green Multipurpose Liquid Detergent 5L","Income","Zelia Multipurpose Liquid Soap",,"Undeposited Funds","",478.00,221767.29
,"Sales Receipt","29-02-2024","1889",,"Cash Sales","Zelia Green Multipurpose Liquid Detergent 1L","Income","Zelia Multipurpose Liquid Soap",,"Undeposited Funds","",135.00,221902.29
,"Sales Receipt","29-02-2024","1890",,"Cash Sales","-MULTIPLE-","Income","Zelia Multipurpose Liquid Soap",,"Undeposited Funds","",4350.00,226252.29
,"Sales Receipt","29-02-2024","AT185",,"Cash Sales","-MULTIPLE-","Income","Zelia Multipurpose Liquid Soap",,"Undeposited Funds","",7322.16,233574.45
,"Sales Receipt","29-02-2024","AT187",,"Cash Sales","Zelia Green Multipurpose Liquid Detergent 5L","Income","Zelia Multipurpose Liquid Soap",,"Undeposited Funds","",478.00,234052.45
,"Sales Receipt","01-03-2024","AT191",,"Agnes","Zelia Green Multipurpose Liquid Detergent 5L","Income","Zelia Multipurpose Liquid Soap",,"Undeposited Funds","",5200.00,239252.45
,"Sales Receipt","04-03-2024","1893",,"Print Parts Limited","Zelia Green Multipurpose Liquid Detergent 5L","Income","Zelia Multipurpose Liquid Soap",,"Undeposited Funds","",2200.00,241452.45
,"Sales Receipt","04-03-2024","1894",,"Cash Sales","Zelia Green Multipurpose Liquid Detergent 5L","Income","Zelia Multipurpose Liquid Soap",,"Undeposited Funds","",610.00,242062.45
,"Sales Receipt","04-03-2024","1895",,"Cash Sales","Zelia Green Multipurpose Liquid Detergent 1L","Income","Zelia Multipurpose Liquid Soap",,"Undeposited Funds","",150.00,242212.45
,"Sales Receipt","04-03-2024","1897",,"Cash Sales","Zelia Green Multipurpose Liquid Detergent 5L","Income","Zelia Multipurpose Liquid Soap",,"Undeposited Funds","",956.00,243168.45
,"Sales Receipt","04-03-2024","1900",,"Dollar Signs Traders","Zelia Green Multipurpose Liquid Detergent 500ML","Income","Zelia Multipurpose Liquid Soap",,"Undeposited Funds","",2112.00,245280.45
,"Sales Receipt","04-03-2024","2003",,"Cash Sales","-MULTIPLE-","Income","Zelia Multipurpose Liquid Soap",,"Undeposited Funds","",292.00,245572.45
,"Sales Receipt","04-03-2024","2005",,"Cash Sales","Zelia Green Multipurpose Liquid Detergent 5L","Income","Zelia Multipurpose Liquid Soap",,"Undeposited Funds",0.00,"",245572.45
,"Sales Receipt","05-03-2024","2008",,"Cash Sales","Zelia Green Multipurpose Liquid Detergent 1L","Income","Zelia Multipurpose Liquid Soap",,"Undeposited Funds","",150.00,245722.45
,"Sales Receipt","05-03-2024","2010",,"Cash Sales","Zelia Green Multipurpose Liquid Detergent 20L","Income","Zelia Multipurpose Liquid Soap",,"Undeposited Funds","",2000.00,247722.45
,"Sales Receipt","05-03-2024","2011",,"Cash Sales","Zelia Green Multipurpose Liquid Detergent 5L","Income","Zelia Multipurpose Liquid Soap",,"Undeposited Funds","",500.00,248222.45
,"Sales Receipt","05-03-2024","2012",,"Cash Sales","Zelia Green Multipurpose Liquid Detergent 5L","Income","Zelia Multipurpose Liquid Soap",,"Undeposited Funds","",1000.00,249222.45
,"Sales Receipt","06-03-2024","2016",,"Cash Sales","Zelia Green Multipurpose Liquid Detergent 5L","Income","Zelia Multipurpose Liquid Soap",,"Undeposited Funds","",610.00,249832.45
,"Sales Receipt","06-03-2024","2017",,"Cash Sales","Zelia Green Multipurpose Liquid Detergent 20L","Income","Zelia Multipurpose Liquid Soap",,"Undeposited Funds","",2370.00,252202.45
,"Sales Receipt","06-03-2024","2019",,"Bismillahi Shop","-MULTIPLE-","Income","Zelia Multipurpose Liquid Soap",,"Undeposited Funds","",2328.00,254530.45
,"Sales Receipt","06-03-2024","2023",,"Kenafa Wholesalers","Zelia Green Multipurpose Liquid Detergent 500ML","Income","Zelia Multipurpose Liquid Soap",,"Undeposited Funds","",1056.00,255586.45
,"Sales Receipt","06-03-2024","2026",,"Mama Amina","-MULTIPLE-","Income","Zelia Multipurpose Liquid Soap",,"Undeposited Funds","",1428.00,257014.45
,"Invoice","07-03-2024","MC05473",,"Khetshi Dharamshi And Company Limited","Zelia Green Multipurpose Liquid Detergent Lite 20L","Income","Zelia Multipurpose Liquid Soap",,"Accounts Receivable","",16000.00,273014.45
,"Invoice","07-03-2024","MC05477",,"OFFSHORE GLOBAL LOGISTICS LIMITED","Zelia Green Multipurpose Liquid Detergent 5L","Income","Zelia Multipurpose Liquid Soap",,"Accounts Receivable","",2141.38,275155.83
,"Sales Receipt","07-03-2024","2034",,"Cash Sales","Zelia Green Multipurpose Liquid Detergent 1L","Income","Zelia Multipurpose Liquid Soap",,"Undeposited Funds","",135.00,275290.83
,"Sales Receipt","07-03-2024","2038",,"Cash Sales","Zelia Green Multipurpose Liquid Detergent 5L","Income","Zelia Multipurpose Liquid Soap",,"Undeposited Funds","",478.00,275768.83
,"Sales Receipt","08-03-2024","2045",,"Cash Sales","Zelia Green Multipurpose Liquid Detergent 1L","Income","Zelia Multipurpose Liquid Soap",,"Undeposited Funds","",532.00,276300.83
,"Invoice","11-03-2024","MC05484",,"MUHINDI MWEUSI SUPERMARKET LIMITED","-MULTIPLE-","Income","Zelia Multipurpose Liquid Soap",,"Accounts Receivable","",1422.42,277723.25
,"Sales Receipt","11-03-2024","2050",,"tRIPPLE M","Zelia Green Multipurpose Liquid Detergent 500ML","Income","Zelia Multipurpose Liquid Soap",,"Undeposited Funds","",264.00,277987.25
,"Sales Receipt","11-03-2024","2053",,"Cash Sales","Zelia Green Multipurpose Liquid Detergent 5L","Income","Zelia Multipurpose Liquid Soap",,"Undeposited Funds","",610.00,278597.25
,"Sales Receipt","11-03-2024","2056",,"Nasib Wholesallers","Zelia Green Multipurpose Liquid Detergent 500ML","Income","Zelia Multipurpose Liquid Soap",,"Undeposited Funds","",2112.00,280709.25
,"Invoice","12-03-2024","MC05492",,"DALLAS SHOPRITE LTD","Zelia Green Multipurpose Liquid Detergent 500ML","Income","Zelia Multipurpose Liquid Soap",,"Accounts Receivable","",522.41,281231.66
,"Sales Receipt","13-03-2024","2059",,"Cash Sales","Zelia Green Multipurpose Liquid Detergent 1L","Income","Zelia Multipurpose Liquid Soap",,"Undeposited Funds","",150.00,281381.66
,"Invoice","14-03-2024","MC05496",,"THE REAL IPM COMPANY (KENYA)LIMITED","Zelia Green Multipurpose Liquid Detergent 20L","Income","Zelia Multipurpose Liquid Soap",,"Accounts Receivable","",12000.00,293381.66
,"Sales Receipt","14-03-2024","2063",,"Cash Sales","Zelia Green Multipurpose Liquid Detergent 1L","Income","Zelia Multipurpose Liquid Soap",,"Undeposited Funds","",150.00,293531.66
,"Sales Receipt","14-03-2024","2067",,"Nzurimart wholesale","Zelia Green Multipurpose Liquid Detergent 5L","Income","Zelia Multipurpose Liquid Soap",,"Undeposited Funds","",490.00,294021.66
,"Sales Receipt","15-03-2024","2069",,"Cash Sales","-MULTIPLE-","Income","Zelia Multipurpose Liquid Soap",,"Undeposited Funds","",1278.00,295299.66
,"Sales Receipt","18-03-2024","2072",,"Cash Sales","Zelia Green Multipurpose Liquid Detergent 5L","Income","Zelia Multipurpose Liquid Soap",,"Undeposited Funds",0.00,"",295299.66
,"Sales Receipt","18-03-2024","2073",,"Cash Sales","Zelia Green Multipurpose Liquid Detergent 5L","Income","Zelia Multipurpose Liquid Soap",,"Undeposited Funds",0.00,"",295299.66
,"Sales Receipt","18-03-2024","2073",,"Cash Sales","Zelia Green Multipurpose Liquid Detergent 5L","Income","Zelia Multipurpose Liquid Soap",,"Undeposited Funds",0.00,"",295299.66
,"Sales Receipt","18-03-2024","2074",,"Cash Sales","Zelia Green Multipurpose Liquid Detergent 5L","Income","Zelia Multipurpose Liquid Soap",,"Undeposited Funds","",1160.00,296459.66
,"Sales Receipt","18-03-2024","2077",,"Cash Sales","Zelia Green Multipurpose Liquid Detergent 1L","Income","Zelia Multipurpose Liquid Soap",,"Undeposited Funds","",150.00,296609.66
,"Invoice","19-03-2024","MC05502",,"Tupo Mart Limited","Zelia Green Multipurpose Liquid Detergent 500ML","Income","Zelia Multipurpose Liquid Soap",,"Accounts Receivable","",501.72,297111.38
,"Invoice","20-03-2024","MC05507",,"DAILY CHAMPIONS MINI SUPERMARKET LIMITED","Zelia Green Multipurpose Liquid Detergent 500ML","Income","Zelia Multipurpose Liquid Soap",,"Accounts Receivable","",501.72,297613.10
,"Sales Receipt","20-03-2024","2081",,"Cash Sales","Zelia Green Multipurpose Liquid Detergent 20L","Income","Zelia Multipurpose Liquid Soap",,"Undeposited Funds","",1980.00,299593.10
,"Sales Receipt","20-03-2024","2082",,"Cash Sales","Zelia Green Multipurpose Liquid Detergent 20L","Income","Zelia Multipurpose Liquid Soap",,"Undeposited Funds","",1980.00,301573.10
,"Sales Receipt","20-03-2024","2084",,"Cash Sales","Zelia Green Multipurpose Liquid Detergent 5L","Income","Zelia Multipurpose Liquid Soap",,"Undeposited Funds","",610.00,302183.10
,"Sales Receipt","20-03-2024","2086",,"Cash Sales","Zelia Green Multipurpose Liquid Detergent 500ML","Income","Zelia Multipurpose Liquid Soap",,"Undeposited Funds","",90.00,302273.10
,"Sales Receipt","20-03-2024","2087",,"Pambazuka Mart (K) Limited","Zelia Green Multipurpose Liquid Detergent 500ML","Income","Zelia Multipurpose Liquid Soap",,"Undeposited Funds","",2016.00,304289.10
,"Sales Receipt","21-03-2024","2090",,"Cash Sales","Zelia Green Multipurpose Liquid Detergent 20L","Income","Zelia Multipurpose Liquid Soap",,"Undeposited Funds","",1600.00,305889.10
,"Sales Receipt","21-03-2024","2092",,"Norham Groceries","Zelia Green Multipurpose Liquid Detergent 500ML","Income","Zelia Multipurpose Liquid Soap",,"Undeposited Funds","",504.00,306393.10
,"Sales Receipt","21-03-2024","2096",,"Cash Sales","Zelia Green Multipurpose Liquid Detergent 5L","Income","Zelia Multipurpose Liquid Soap",,"Undeposited Funds","",550.00,306943.10
,"Sales Receipt","21-03-2024","2097",,"Cash Sales","Zelia Green Multipurpose Liquid Detergent 5L","Income","Zelia Multipurpose Liquid Soap",,"Undeposited Funds","",536.00,307479.10
,"Sales Receipt","21-03-2024","2101",,"Raymart Minimart","Zelia Green Multipurpose Liquid Detergent 500ML","Income","Zelia Multipurpose Liquid Soap",,"Undeposited Funds","",252.00,307731.10
,"Sales Receipt","21-03-2024","2104",,"Nuclear Supermarket","Zelia Green Multipurpose Liquid Detergent 500ML","Income","Zelia Multipurpose Liquid Soap",,"Undeposited Funds","",528.00,308259.10
,"Sales Receipt","25-03-2024","2099",,"Cash Sales","Zelia Green Multipurpose Liquid Detergent 500ML","Income","Zelia Multipurpose Liquid Soap",,"Undeposited Funds",0.00,"",308259.10
,"Invoice","25-03-2024","MC05530",,"KASAMAT INVESTMENTS LTD","Zelia Green Multipurpose Liquid Detergent 500ML","Income","Zelia Multipurpose Liquid Soap",,"Accounts Receivable","",250.86,308509.96
,"Sales Receipt","25-03-2024","2107",,"Cash Sales","Zelia Green Multipurpose Liquid Detergent 5L","Income","Zelia Multipurpose Liquid Soap",,"Undeposited Funds",0.00,"",308509.96
,"Sales Receipt","27-03-2024","2117",,"Cash Sales","Zelia Green Multipurpose Liquid Detergent 5L","Income","Zelia Multipurpose Liquid Soap",,"Undeposited Funds","",478.00,308987.96
,"Sales Receipt","28-03-2024","2118",,"Cash Sales","Zelia Green Multipurpose Liquid Detergent 5L","Income","Zelia Multipurpose Liquid Soap",,"Undeposited Funds","",1200.00,310187.96
,"Sales Receipt","28-03-2024","2126",,"Cash Sales","Zelia Green Multipurpose Liquid Detergent 5L","Income","Zelia Multipurpose Liquid Soap",,"Undeposited Funds","",478.00,310665.96
,"Sales Receipt","28-03-2024","2127",,"Cash Sales","Zelia Green Multipurpose Liquid Detergent 500ML","Income","Zelia Multipurpose Liquid Soap",,"Undeposited Funds",0.00,"",310665.96
,"Sales Receipt","28-03-2024","2129",,"Cash Sales","Zelia Green Multipurpose Liquid Detergent 5L","Income","Zelia Multipurpose Liquid Soap",,"Undeposited Funds","",956.00,311621.96
,"Sales Receipt","02-04-2024","2133",,"Cash Sales","Zelia Green Multipurpose Liquid Detergent 1L","Income","Zelia Multipurpose Liquid Soap",,"Undeposited Funds","",532.00,312153.96
,"Invoice","03-04-2024","MC05553",,"THE REAL IPM COMPANY (KENYA)LIMITED","Zelia Green Multipurpose Liquid Detergent 20L","Income","Zelia Multipurpose Liquid Soap",,"Accounts Receivable","",12000.00,324153.96
,"Sales Receipt","03-04-2024","2142",,"AIDURUS GENERAL SHOP","Zelia Green Multipurpose Liquid Detergent 1L","Income","Zelia Multipurpose Liquid Soap",,"Undeposited Funds","",1692.00,325845.96
,"Sales Receipt","03-04-2024","2147",,"Cash Sales","Zelia Green Multipurpose Liquid Detergent 5L","Income","Zelia Multipurpose Liquid Soap",,"Undeposited Funds","",1100.00,326945.96
,"Sales Receipt","03-04-2024","2148",,"Cash Sales","-MULTIPLE-","Income","Zelia Multipurpose Liquid Soap",,"Undeposited Funds","",250.00,327195.96
,"Invoice","04-04-2024","MC05564",,"Azaavi Collections Limited","Zelia Green Multipurpose Liquid Detergent 5L","Income","Zelia Multipurpose Liquid Soap",,"Accounts Receivable","",535.34,327731.30
,"Sales Receipt","04-04-2024","2143",,"Jubilee Candy  Shop","Zelia Green Multipurpose Liquid Detergent 5L","Income","Zelia Multipurpose Liquid Soap",,"Undeposited Funds","",1072.00,328803.30
,"Sales Receipt","04-04-2024","2153",,"Budget Store","-MULTIPLE-","Income","Zelia Multipurpose Liquid Soap",,"Undeposited Funds","",1404.00,330207.30
,"Invoice","05-04-2024","MC05576",,"Azaavi Collections Limited","Zelia Green Multipurpose Liquid Detergent 5L","Income","Zelia Multipurpose Liquid Soap",,"Accounts Receivable","",535.34,330742.64
,"Sales Receipt","05-04-2024","2155",,"Nasib Wholesallers","Zelia Green Multipurpose Liquid Detergent 1L","Income","Zelia Multipurpose Liquid Soap",,"Undeposited Funds","",1692.00,332434.64
,"Sales Receipt","05-04-2024","2156",,"D -Madina Enterprise","Zelia Green Multipurpose Liquid Detergent 1L","Income","Zelia Multipurpose Liquid Soap",,"Undeposited Funds","",3600.00,336034.64
,"Sales Receipt","05-04-2024","2159",,"Cash Sales","Zelia Green Multipurpose Liquid Detergent 1L","Income","Zelia Multipurpose Liquid Soap",,"Undeposited Funds","",126.00,336160.64
,"Sales Receipt","05-04-2024","AT 194",,"Agnes","Zelia Green Multipurpose Liquid Detergent 5L","Income","Zelia Multipurpose Liquid Soap",,"Undeposited Funds","",10400.00,346560.64
,"Sales Receipt","05-04-2024","AT 193",,"JUDY USENGE","-MULTIPLE-","Income","Zelia Multipurpose Liquid Soap",,"Undeposited Funds","",57174.00,403734.64
,"Sales Receipt","08-04-2024","2164",,"Kangundo Briolly Bookshop","Zelia Green Multipurpose Liquid Detergent 500ML","Income","Zelia Multipurpose Liquid Soap",,"Undeposited Funds","",84.00,403818.64
,"Sales Receipt","08-04-2024","2166",,"Cash Sales","Zelia Green Multipurpose Liquid Detergent 1L","Income","Zelia Multipurpose Liquid Soap",,"Undeposited Funds","",300.00,404118.64
,"Sales Receipt","08-04-2024","2167",,"Cash Sales","Zelia Green Multipurpose Liquid Detergent 500ML","Income","Zelia Multipurpose Liquid Soap",,"Undeposited Funds","",500.00,404618.64
,"Sales Receipt","11-04-2024","2173",,"Cash Sales","Zelia Green Multipurpose Liquid Detergent 5L","Income","Zelia Multipurpose Liquid Soap",,"Undeposited Funds","",1130.00,405748.64
,"Sales Receipt","11-04-2024","2174",,"Cash Sales","Zelia Green Multipurpose Liquid Detergent Lite 20L","Income","Zelia Multipurpose Liquid Soap",,"Undeposited Funds",0.00,"",405748.64
,"Sales Receipt","11-04-2024","2204",,"Cash Sales","Zelia Green Multipurpose Liquid Detergent 5L","Income","Zelia Multipurpose Liquid Soap",,"Undeposited Funds","",1100.00,406848.64
,"Sales Receipt","11-04-2024","2205",,"Gure Yare Shop Nasra","Zelia Green Multipurpose Liquid Detergent 5L","Income","Zelia Multipurpose Liquid Soap",,"Undeposited Funds","",5880.00,412728.64
,"Sales Receipt","11-04-2024","2208",,"Sultan Iman Shop","-MULTIPLE-","Income","Zelia Multipurpose Liquid Soap",,"Undeposited Funds","",3816.00,416544.64
,"Sales Receipt","12-04-2024","2175",,"Tekonstruct LTD","Zelia Green Multipurpose Liquid Detergent 5L","Income","Zelia Multipurpose Liquid Soap",,"Undeposited Funds","",509.00,417053.64
,"Sales Receipt","12-04-2024","2177",,"Cash Sales","Zelia Green Multipurpose Liquid Detergent 5L","Income","Zelia Multipurpose Liquid Soap",,"Undeposited Funds","",509.00,417562.64
,"Sales Receipt","12-04-2024","2178",,"Cash Sales","Zelia Green Multipurpose Liquid Detergent 1L","Income","Zelia Multipurpose Liquid Soap",,"Undeposited Funds","",125.00,417687.64
,"Sales Receipt","12-04-2024","2180",,"Elwak Stores Ltd","Zelia Green Multipurpose Liquid Detergent 1L","Income","Zelia Multipurpose Liquid Soap",,"Undeposited Funds","",1800.00,419487.64
,"Sales Receipt","12-04-2024","2182",,"Cheaper Cheap","Zelia Green Multipurpose Liquid Detergent 500ML","Income","Zelia Multipurpose Liquid Soap",,"Undeposited Funds","",2016.00,421503.64
,"Sales Receipt","12-04-2024","2183",,"Milimani  Stores","Zelia Green Multipurpose Liquid Detergent 500ML","Income","Zelia Multipurpose Liquid Soap",,"Undeposited Funds","",1008.00,422511.64
,"Sales Receipt","12-04-2024","2185",,"Mamken Minimart","Zelia Green Multipurpose Liquid Detergent 500ML","Income","Zelia Multipurpose Liquid Soap",,"Undeposited Funds","",504.00,423015.64
,"Sales Receipt","12-04-2024","2186",,"Kandara minimart","Zelia Green Multipurpose Liquid Detergent 500ML","Income","Zelia Multipurpose Liquid Soap",,"Undeposited Funds","",504.00,423519.64
,"Sales Receipt","12-04-2024","2187",,"Kikamart Minimart","Zelia Green Multipurpose Liquid Detergent 500ML","Income","Zelia Multipurpose Liquid Soap",,"Undeposited Funds","",504.00,424023.64
,"Sales Receipt","15-04-2024","2188",,"Delta Mart","Zelia Green Multipurpose Liquid Detergent 500ML","Income","Zelia Multipurpose Liquid Soap",,"Undeposited Funds","",168.00,424191.64
,"Sales Receipt","15-04-2024","2193",,"Diaspora Diaries","Zelia Green Multipurpose Liquid Detergent 5L","Income","Zelia Multipurpose Liquid Soap",,"Undeposited Funds","",490.00,424681.64
,"Invoice","16-04-2024","MC05603",,"Riverwest Company Limited","Zelia Green Multipurpose Liquid Detergent 20L","Income","Zelia Multipurpose Liquid Soap",,"Accounts Receivable","",3960.00,428641.64
,"Sales Receipt","17-04-2024","2214",,"Cash Sales","Zelia Green Multipurpose Liquid Detergent Lite 20L","Income","Zelia Multipurpose Liquid Soap",,"Undeposited Funds","",3960.00,432601.64
,"Sales Receipt","17-04-2024","2215",,"Best Ratino Stores","Zelia Green Multipurpose Liquid Detergent 5L","Income","Zelia Multipurpose Liquid Soap",,"Undeposited Funds","",2144.00,434745.64
,"Sales Receipt","18-04-2024","2223",,"Cash Sales","Zelia Green Multipurpose Liquid Detergent 5L","Income","Zelia Multipurpose Liquid Soap",,"Undeposited Funds","",550.00,435295.64
,"Sales Receipt","18-04-2024","2225",,"Cash Sales","Zelia Green Multipurpose Liquid Detergent 1L","Income","Zelia Multipurpose Liquid Soap",,"Undeposited Funds","",125.00,435420.64
,"Sales Receipt","18-04-2024","2226",,"Zambia Shopping Centre","Zelia Green Multipurpose Liquid Detergent 500ML","Income","Zelia Multipurpose Liquid Soap",,"Undeposited Funds","",504.00,435924.64
,"Sales Receipt","18-04-2024","2227",,"El Magina Store","Zelia Green Multipurpose Liquid Detergent 500ML","Income","Zelia Multipurpose Liquid Soap",,"Undeposited Funds","",504.00,436428.64
,"Invoice","19-04-2024","MC05610",,"DISII TRADERS LTD","Zelia Green Multipurpose Liquid Detergent 500ML","Income","Zelia Multipurpose Liquid Soap",,"Accounts Receivable","",1003.45,437432.09
,"Sales Receipt","19-04-2024","2235",,"Publix Supermarket","Zelia Green Multipurpose Liquid Detergent 1L","Income","Zelia Multipurpose Liquid Soap",,"Undeposited Funds","",846.00,438278.09
,"Sales Receipt","19-04-2024","2240",,"Cash Sales","Zelia Green Multipurpose Liquid Detergent 5L","Income","Zelia Multipurpose Liquid Soap",,"Undeposited Funds","",455.00,438733.09
,"Invoice","22-04-2024","MC05622",,"KASAMAT INVESTMENTS LTD","Zelia Green Multipurpose Liquid Detergent 500ML","Income","Zelia Multipurpose Liquid Soap",,"Accounts Receivable","",522.41,439255.50
,"Invoice","22-04-2024","MC05624",,"THE REAL IPM COMPANY (KENYA)LIMITED","Zelia Green Multipurpose Liquid Detergent 20L","Income","Zelia Multipurpose Liquid Soap",,"Accounts Receivable","",12000.00,451255.50
,"Sales Receipt","22-04-2024","2241",,"Cash Sales","Zelia Green Multipurpose Liquid Detergent 500ML","Income","Zelia Multipurpose Liquid Soap",,"Undeposited Funds","",450.00,451705.50
,"Sales Receipt","22-04-2024","2247",,"AL Zake minimart","Zelia Green Multipurpose Liquid Detergent 500ML","Income","Zelia Multipurpose Liquid Soap",,"Undeposited Funds","",420.00,452125.50
,"Sales Receipt","23-04-2024","2252",,"Cash Sales","Zelia Green Multipurpose Liquid Detergent 500ML","Income","Zelia Multipurpose Liquid Soap",,"Undeposited Funds","",100.00,452225.50
,"Sales Receipt","23-04-2024","2254",,"Cash Sales","Zelia Green Multipurpose Liquid Detergent 5L","Income","Zelia Multipurpose Liquid Soap",,"Undeposited Funds",0.00,"",452225.50
,"Invoice","24-04-2024","MC05636",,"Maji Asili Limited","-MULTIPLE-","Income","Zelia Multipurpose Liquid Soap",,"Accounts Receivable","",7386.21,459611.71
,"Sales Receipt","24-04-2024","2255",,"Cash Sales","Zelia Green Multipurpose Liquid Detergent 1L","Income","Zelia Multipurpose Liquid Soap",,"Undeposited Funds","",300.00,459911.71
,"Sales Receipt","24-04-2024","2256",,"Kimathi Store","Zelia Green Multipurpose Liquid Detergent 500ML","Income","Zelia Multipurpose Liquid Soap",,"Undeposited Funds","",84.00,459995.71
,"Sales Receipt","24-04-2024","2259",,"Muleshe Wholesallers","-MULTIPLE-","Income","Zelia Multipurpose Liquid Soap",,"Undeposited Funds","",4052.00,464047.71
,"Sales Receipt","24-04-2024","2260",,"Pambazuka Mart (K) Limited","Zelia Green Multipurpose Liquid Detergent Lite 20L","Income","Zelia Multipurpose Liquid Soap",,"Undeposited Funds","",1600.00,465647.71
,"Sales Receipt","25-04-2024","2261",,"Teyamo Enterprises","Zelia Green Multipurpose Liquid Detergent 500ML","Income","Zelia Multipurpose Liquid Soap",,"Undeposited Funds","",168.00,465815.71
,"Sales Receipt","25-04-2024","2264",,"Memos Supermarket","-MULTIPLE-","Income","Zelia Multipurpose Liquid Soap",,"Undeposited Funds","",3708.00,469523.71
,"Sales Receipt","25-04-2024","2263",,"Cash Sales","Zelia Green Multipurpose Liquid Detergent 5L","Income","Zelia Multipurpose Liquid Soap",,"Undeposited Funds","",610.00,470133.71
,"Sales Receipt","25-04-2024","2266",,"Goldmart Supermarket","Zelia Green Multipurpose Liquid Detergent 500ML","Income","Zelia Multipurpose Liquid Soap",,"Undeposited Funds","",504.00,470637.71
,"Sales Receipt","26-04-2024","2270",,"Cash Sales","Zelia Green Multipurpose Liquid Detergent 5L","Income","Zelia Multipurpose Liquid Soap",,"Undeposited Funds","",1160.00,471797.71
,"Sales Receipt","28-04-2024","2276",,"Zamu Wholesalers","Zelia Green Multipurpose Liquid Detergent 1L","Income","Zelia Multipurpose Liquid Soap",,"Undeposited Funds","",3384.00,475181.71
,"Sales Receipt","29-04-2024","2273",,"Blessed Shop","Zelia Green Multipurpose Liquid Detergent 1L","Income","Zelia Multipurpose Liquid Soap",,"Undeposited Funds","",282.00,475463.71
,"Credit Note","29-04-2024","CN01059",,"TAWALA SUPERMARKET LIMITED","Zelia Green Multipurpose Liquid Detergent 1L","Income","Zelia Multipurpose Liquid Soap",,"Accounts Receivable",1789.65,"",473674.06
,"Invoice","29-04-2024","MC05651",,"MUHINDI MWEUSI SUPERMARKET LIMITED","-MULTIPLE-","Income","Zelia Multipurpose Liquid Soap",,"Accounts Receivable","",3693.10,477367.16
,"Sales Receipt","29-04-2024","2278",,"Hidika Shop","-MULTIPLE-","Income","Zelia Multipurpose Liquid Soap",,"Undeposited Funds","",1350.00,478717.16
,"Sales Receipt","29-04-2024","2279",,"Cash Sales","Zelia Green Multipurpose Liquid Detergent 5L","Income","Zelia Multipurpose Liquid Soap",,"Undeposited Funds","",427.00,479144.16
,"Sales Receipt","29-04-2024","2280",,"Cash Sales","Zelia Green Multipurpose Liquid Detergent 5L","Income","Zelia Multipurpose Liquid Soap",,"Undeposited Funds","",455.00,479599.16
,"Sales Receipt","30-04-2024","2281",,"Geoffrey Kangethe","Zelia Green Multipurpose Liquid Detergent 5L","Income","Zelia Multipurpose Liquid Soap",,"Undeposited Funds","",491.53,480090.69
,"Invoice","30-04-2024","MC05652",,"OFFSHORE GLOBAL LOGISTICS LIMITED","-MULTIPLE-","Income","Zelia Multipurpose Liquid Soap",,"Accounts Receivable","",2614.65,482705.34
,"Sales Receipt","30-04-2024","2284",,"Cash Sales","Zelia Green Multipurpose Liquid Detergent 5L","Income","Zelia Multipurpose Liquid Soap",,"Undeposited Funds","",1100.00,483805.34
,"Sales Receipt","02-05-2024","2285",,"Cash Sales","Zelia Green Multipurpose Liquid Detergent 1L","Income","Zelia Multipurpose Liquid Soap",,"Undeposited Funds","",125.00,483930.34
,"Sales Receipt","02-05-2024","2287",,"5pm Hotel","Zelia Green Multipurpose Liquid Detergent 1L","Income","Zelia Multipurpose Liquid Soap",,"Undeposited Funds","",121.55,484051.89
,"Sales Receipt","02-05-2024","2293",,"Tuff Store","Zelia Green Multipurpose Liquid Detergent 500ML","Income","Zelia Multipurpose Liquid Soap",,"Undeposited Funds","",504.00,484555.89
,"Sales Receipt","02-05-2024","2294",,"Cash Sales","Zelia Green Multipurpose Liquid Detergent 5L","Income","Zelia Multipurpose Liquid Soap",,"Undeposited Funds","",478.00,485033.89
,"Sales Receipt","02-05-2024","2298",,"Cash Sales","Zelia Green Multipurpose Liquid Detergent 5L","Income","Zelia Multipurpose Liquid Soap",,"Undeposited Funds","",455.00,485488.89
,"Sales Receipt","03-05-2024","2299",,"Cash Sales","Zelia Green Multipurpose Liquid Detergent 5L","Income","Zelia Multipurpose Liquid Soap",,"Undeposited Funds","",1072.00,486560.89
,"Sales Receipt","03-05-2024","2300",,"Cash Sales","Zelia Green Multipurpose Liquid Detergent 500ML","Income","Zelia Multipurpose Liquid Soap",,"Undeposited Funds",0.00,"",486560.89
,"Sales Receipt","03-05-2024","2301",,"Cash Sales","Zelia Green Multipurpose Liquid Detergent 1L","Income","Zelia Multipurpose Liquid Soap",,"Undeposited Funds","",200.00,486760.89
,"Sales Receipt","03-05-2024","2302",,"Cash Sales","Zelia Green Multipurpose Liquid Detergent 20L","Income","Zelia Multipurpose Liquid Soap",,"Undeposited Funds","",2000.00,488760.89
,"Sales Receipt","03-05-2024","2303",,"Cash Sales","Zelia Green Multipurpose Liquid Detergent 1L","Income","Zelia Multipurpose Liquid Soap",,"Undeposited Funds","",125.00,488885.89
,"Sales Receipt","03-05-2024","2306",,"Cash Sales","Zelia Green Multipurpose Liquid Detergent 1L","Income","Zelia Multipurpose Liquid Soap",,"Undeposited Funds","",126.00,489011.89
,"Sales Receipt","05-05-2024","2308",,"Cash Sales","Zelia Green Multipurpose Liquid Detergent 1L","Income","Zelia Multipurpose Liquid Soap",,"Undeposited Funds","",300.00,489311.89
,"Sales Receipt","06-05-2024","2309",,"Jackys Shop","Zelia Green Multipurpose Liquid Detergent 1L","Income","Zelia Multipurpose Liquid Soap",,"Undeposited Funds","",84.00,489395.89
,"Sales Receipt","06-05-2024","2311",,"Cash Sales","Zelia Green Multipurpose Liquid Detergent 5L","Income","Zelia Multipurpose Liquid Soap",,"Undeposited Funds","",610.00,490005.89
,"Sales Receipt","06-05-2024","2312",,"Cash Sales","Zelia Green Multipurpose Liquid Detergent 5L","Income","Zelia Multipurpose Liquid Soap",,"Undeposited Funds","",1650.00,491655.89
,"Sales Receipt","07-05-2024","2315",,"Cash Sales","Zelia Green Multipurpose Liquid Detergent 5L","Income","Zelia Multipurpose Liquid Soap",,"Undeposited Funds","",455.00,492110.89
,"Invoice","08-05-2024","MC05681",,"THE REAL IPM COMPANY (KENYA)LIMITED","Zelia Green Multipurpose Liquid Detergent 20L","Income","Zelia Multipurpose Liquid Soap",,"Accounts Receivable","",12000.00,504110.89
,"Sales Receipt","08-05-2024","2321",,"Cash Sales","Zelia Green Multipurpose Liquid Detergent 5L","Income","Zelia Multipurpose Liquid Soap",,"Undeposited Funds","",610.00,504720.89
,"Sales Receipt","08-05-2024","2322",,"Cash Sales","Zelia Green Multipurpose Liquid Detergent 5L","Income","Zelia Multipurpose Liquid Soap",,"Undeposited Funds","",1830.00,506550.89
,"Sales Receipt","08-05-2024","2323",,"Cash Sales","Zelia Green Multipurpose Liquid Detergent 5L","Income","Zelia Multipurpose Liquid Soap",,"Undeposited Funds","",509.00,507059.89
,"Sales Receipt","08-05-2024","2330",,"Neema Bei Nafuu Shop","Zelia Green Multipurpose Liquid Detergent 500ML","Income","Zelia Multipurpose Liquid Soap",,"Undeposited Funds","",1008.00,508067.89
,"Sales Receipt","09-05-2024","2333",,"RichMind Property","Zelia Green Multipurpose Liquid Detergent 5L","Income","Zelia Multipurpose Liquid Soap",,"Undeposited Funds","",510.00,508577.89
,"Sales Receipt","09-05-2024","2334",,"Tuff Store","Zelia Green Multipurpose Liquid Detergent 500ML","Income","Zelia Multipurpose Liquid Soap",,"Undeposited Funds","",504.00,509081.89
,"Sales Receipt","09-05-2024","2336",,"Donation","Zelia Green Multipurpose Liquid Detergent 500ML","Income","Zelia Multipurpose Liquid Soap",,"Undeposited Funds",0.00,"",509081.89
,"Sales Receipt","09-05-2024","2341",,"Cash Sales","Zelia Green Multipurpose Liquid Detergent 500ML","Income","Zelia Multipurpose Liquid Soap",,"Undeposited Funds","",200.00,509281.89
,"Sales Receipt","10-05-2024","1917",,"Cash Sales","Zelia Green Multipurpose Liquid Detergent 5L","Income","Zelia Multipurpose Liquid Soap",,"Undeposited Funds","",455.00,509736.89
,"Sales Receipt","10-05-2024","1918",,"Cash Sales","-MULTIPLE-","Income","Zelia Multipurpose Liquid Soap",,"Undeposited Funds","",2520.00,512256.89
,"Sales Receipt","13-05-2024","2344",,"Cash Sales","Zelia Green Multipurpose Liquid Detergent 500ML","Income","Zelia Multipurpose Liquid Soap",,"Undeposited Funds","",1008.00,513264.89
,"Sales Receipt","13-05-2024","2346",,"Garumo Wholesallers","Zelia Green Multipurpose Liquid Detergent 500ML","Income","Zelia Multipurpose Liquid Soap",,"Undeposited Funds","",2016.00,515280.89
,"Sales Receipt","13-05-2024","2349",,"Arqam Savanna","Zelia Green Multipurpose Liquid Detergent 1L","Income","Zelia Multipurpose Liquid Soap",,"Undeposited Funds","",1692.00,516972.89
,"Sales Receipt","13-05-2024","1921",,"Cash Sales","Zelia Green Multipurpose Liquid Detergent 500ML","Income","Zelia Multipurpose Liquid Soap",,"Undeposited Funds","",336.00,517308.89
,"Sales Receipt","14-05-2024","2358",,"Faisel Wholesale","-MULTIPLE-","Income","Zelia Multipurpose Liquid Soap",,"Undeposited Funds","",3728.00,521036.89
,"Sales Receipt","14-05-2024","2360",,"Elwak Stores Ltd","-MULTIPLE-","Income","Zelia Multipurpose Liquid Soap",,"Undeposited Funds","",3728.00,524764.89
,"Sales Receipt","15-05-2024","1927",,"Cash Sales","Zelia Green Multipurpose Liquid Detergent 1L","Income","Zelia Multipurpose Liquid Soap",,"Undeposited Funds","",150.00,524914.89
,"Sales Receipt","16-05-2024","2370",,"Imani General Store","Zelia Green Multipurpose Liquid Detergent 500ML","Income","Zelia Multipurpose Liquid Soap",,"Undeposited Funds","",504.00,525418.89
,"Sales Receipt","16-05-2024","1930",,"Cash Sales","Zelia Green Multipurpose Liquid Detergent 5L","Income","Zelia Multipurpose Liquid Soap",,"Undeposited Funds","",610.00,526028.89
,"Invoice","17-05-2024","MC05713",,"DISII TRADERS LTD","Zelia Green Multipurpose Liquid Detergent 500ML","Income","Zelia Multipurpose Liquid Soap",,"Accounts Receivable","",2006.90,528035.79
,"Sales Receipt","17-05-2024","1931",,"Cash Sales","Zelia Green Multipurpose Liquid Detergent 5L","Income","Zelia Multipurpose Liquid Soap",,"Undeposited Funds","",455.00,528490.79
,"Sales Receipt","17-05-2024","1932",,"Cash Sales","Zelia Green Multipurpose Liquid Detergent 5L","Income","Zelia Multipurpose Liquid Soap",,"Undeposited Funds","",455.00,528945.79
,"Sales Receipt","20-05-2024","1936",,"Cash Sales","Zelia Green Multipurpose Liquid Detergent 500ML","Income","Zelia Multipurpose Liquid Soap",,"Undeposited Funds",0.00,"",528945.79
,"Sales Receipt","21-05-2024","1942",,"Cash Sales","Zelia Green Multipurpose Liquid Detergent 5L","Income","Zelia Multipurpose Liquid Soap",,"Undeposited Funds","",509.00,529454.79
,"Sales Receipt","21-05-2024","1945",,"Kinoko Store","Zelia Green Multipurpose Liquid Detergent 500ML","Income","Zelia Multipurpose Liquid Soap",,"Undeposited Funds","",504.00,529958.79
,"Sales Receipt","21-05-2024","1948",,"Gure Yare Shop Nasra","Zelia Green Multipurpose Liquid Detergent 5L","Income","Zelia Multipurpose Liquid Soap",,"Undeposited Funds","",2036.00,531994.79
,"Invoice","22-05-2024","MC05730",,"THE REAL IPM COMPANY (KENYA)LIMITED","Zelia Green Multipurpose Liquid Detergent 20L","Income","Zelia Multipurpose Liquid Soap",,"Accounts Receivable","",12000.00,543994.79
,"Sales Receipt","22-05-2024","2373",,"Danaba Wholesalers","-MULTIPLE-","Income","Zelia Multipurpose Liquid Soap",,"Undeposited Funds","",3612.00,547606.79
,"Invoice","23-05-2024","MC05731",,"Khetshi Dharamshi And Company Limited","Zelia Green Multipurpose Liquid Detergent Lite 20L","Income","Zelia Multipurpose Liquid Soap",,"Accounts Receivable","",8000.00,555606.79
,"Sales Receipt","23-05-2024","2377",,"Cash Sales","Zelia Green Multipurpose Liquid Detergent 5L","Income","Zelia Multipurpose Liquid Soap",,"Undeposited Funds",0.00,"",555606.79
,"Sales Receipt","23-05-2024","1953",,"Cash Sales","Zelia Green Multipurpose Liquid Detergent 5L","Income","Zelia Multipurpose Liquid Soap",,"Undeposited Funds","",580.00,556186.79
,"Sales Receipt","23-05-2024","1956",,"Cash Sales","Zelia Green Multipurpose Liquid Detergent 5L","Income","Zelia Multipurpose Liquid Soap",,"Undeposited Funds","",455.00,556641.79
,"Sales Receipt","23-05-2024","1965",,"Marris Minimart","Zelia Green Multipurpose Liquid Detergent 500ML","Income","Zelia Multipurpose Liquid Soap",,"Undeposited Funds","",504.00,557145.79
,"Invoice","24-05-2024","MC05741",,"MUHINDI MWEUSI SUPERMARKET LIMITED","Zelia Green Multipurpose Liquid Detergent 500ML","Income","Zelia Multipurpose Liquid Soap",,"Accounts Receivable","",1003.45,558149.24
,"Invoice","24-05-2024","MC05748",,"MUHINDI MWEUSI SUPERMARKET LIMITED","Zelia Green Multipurpose Liquid Detergent 500ML","Income","Zelia Multipurpose Liquid Soap",,"Accounts Receivable","",1003.45,559152.69
,"Sales Receipt","24-05-2024","2380",,"Cash Sales","Zelia Green Multipurpose Liquid Detergent 5L","Income","Zelia Multipurpose Liquid Soap",,"Undeposited Funds","",1200.00,560352.69
,"Sales Receipt","24-05-2024","2382",,"Afrodrip LTD","Zelia Green Multipurpose Liquid Detergent 5L","Income","Zelia Multipurpose Liquid Soap",,"Undeposited Funds","",1018.00,561370.69
,"Invoice","28-05-2024","MC05761",,"MUHINDI MWEUSI SUPERMARKET LIMITED","Zelia Green Multipurpose Liquid Detergent 500ML","Income","Zelia Multipurpose Liquid Soap",,"Accounts Receivable","",501.72,561872.41
,"Sales Receipt","29-05-2024","2390",,"Cash Sales","Zelia Green Multipurpose Liquid Detergent 1L","Income","Zelia Multipurpose Liquid Soap",,"Undeposited Funds","",125.00,561997.41
,"Sales Receipt","29-05-2024","1971",,"Freshfinds Wholesale","Zelia Green Multipurpose Liquid Detergent 500ML","Income","Zelia Multipurpose Liquid Soap",,"Undeposited Funds","",504.00,562501.41
,"Invoice","30-05-2024","MC05776",,"OFFSHORE GLOBAL LOGISTICS LIMITED","-MULTIPLE-","Income","Zelia Multipurpose Liquid Soap",,"Accounts Receivable","",2614.65,565116.06
,"Sales Receipt","30-05-2024","2395",,"Beta Traders","Zelia Green Multipurpose Liquid Detergent 500ML","Income","Zelia Multipurpose Liquid Soap",,"Undeposited Funds","",672.00,565788.06
,"Sales Receipt","30-05-2024","1974",,"Cash Sales","Zelia Green Multipurpose Liquid Detergent 5L","Income","Zelia Multipurpose Liquid Soap",,"Undeposited Funds","",470.00,566258.06
,"Sales Receipt","31-05-2024","1937",,"Island Gift Shop","Zelia Green Multipurpose Liquid Detergent 1L","Income","Zelia Multipurpose Liquid Soap",,"Undeposited Funds","",282.00,566540.06
,"Sales Receipt","31-05-2024","1976",,"Cash Sales","Zelia Green Multipurpose Liquid Detergent 5L","Income","Zelia Multipurpose Liquid Soap",,"Undeposited Funds",0.00,"",566540.06
,"Sales Receipt","03-06-2024","2399",,"Cash Sales","Zelia Green Multipurpose Liquid Detergent 500ML","Income","Zelia Multipurpose Liquid Soap",,"Undeposited Funds","",74.00,566614.06
,"Sales Receipt","03-06-2024","1974",,"Cash Sales","Zelia Green Multipurpose Liquid Detergent 5L","Income","Zelia Multipurpose Liquid Soap",,"Undeposited Funds","",470.00,567084.06
,"Sales Receipt","03-06-2024","1978",,"Cash Sales","Zelia Green Multipurpose Liquid Detergent 5L","Income","Zelia Multipurpose Liquid Soap",,"Undeposited Funds","",455.00,567539.06
,"Sales Receipt","03-06-2024","1979",,"Cash Sales","Zelia Green Multipurpose Liquid Detergent 5L","Income","Zelia Multipurpose Liquid Soap",,"Undeposited Funds","",455.00,567994.06
,"Sales Receipt","03-06-2024","1984",,"Cash Sales","Zelia Green Multipurpose Liquid Detergent 1L","Income","Zelia Multipurpose Liquid Soap",,"Undeposited Funds","",125.00,568119.06
,"Sales Receipt","03-06-2024","1983",,"Marris Mini mart","Zelia Green Multipurpose Liquid Detergent 500ML","Income","Zelia Multipurpose Liquid Soap",,"Undeposited Funds","",504.00,568623.06
,"Sales Receipt","05-06-2024","1989",,"Cash Sales","Zelia Green Multipurpose Liquid Detergent 5L","Income","Zelia Multipurpose Liquid Soap",,"Undeposited Funds","",455.00,569078.06
,"Sales Receipt","06-06-2024","2401",,"Cash Sales","Zelia Green Multipurpose Liquid Detergent 5L","Income","Zelia Multipurpose Liquid Soap",,"Undeposited Funds","",2200.00,571278.06
,"Sales Receipt","06-06-2024","1990",,"Cash Sales","Zelia Green Multipurpose Liquid Detergent 5L","Income","Zelia Multipurpose Liquid Soap",,"Undeposited Funds","",455.00,571733.06
,"Sales Receipt","06-06-2024","2424",,"Bethel Store","Zelia Green Multipurpose Liquid Detergent 500ML","Income","Zelia Multipurpose Liquid Soap",,"Undeposited Funds","",504.00,572237.06
,"Sales Receipt","06-06-2024","2423",,"Ekai moke wholesale","Zelia Green Multipurpose Liquid Detergent 500ML","Income","Zelia Multipurpose Liquid Soap",,"Undeposited Funds","",504.00,572741.06
,"Sales Receipt","07-06-2024","1992",,"Cash Sales","Zelia Green Multipurpose Liquid Detergent 5L","Income","Zelia Multipurpose Liquid Soap",,"Undeposited Funds","",455.00,573196.06
,"Sales Receipt","07-06-2024","1996",,"Cash Sales","Zelia Green Multipurpose Liquid Detergent 1L","Income","Zelia Multipurpose Liquid Soap",,"Undeposited Funds","",378.00,573574.06
,"Sales Receipt","07-06-2024","2426",,"Cash Sales","Zelia Green Multipurpose Liquid Detergent 5L","Income","Zelia Multipurpose Liquid Soap",,"Undeposited Funds","",1830.00,575404.06
,"Sales Receipt","07-06-2024","2430",,"Cash Sales","Zelia Green Multipurpose Liquid Detergent 5L","Income","Zelia Multipurpose Liquid Soap",,"Undeposited Funds","",600.00,576004.06
,"Sales Receipt","08-06-2024","2431",,"Cash Sales","Zelia Green Multipurpose Liquid Detergent 5L","Income","Zelia Multipurpose Liquid Soap",,"Undeposited Funds","",3054.00,579058.06
,"Sales Receipt","08-06-2024","2432",,"Cash Sales","Zelia Green Multipurpose Liquid Detergent 500ML","Income","Zelia Multipurpose Liquid Soap",,"Undeposited Funds","",450.00,579508.06
,"Sales Receipt","10-06-2024","1997",,"Cash Sales","Zelia Green Multipurpose Liquid Detergent 5L","Income","Zelia Multipurpose Liquid Soap",,"Undeposited Funds","",455.00,579963.06
,"Sales Receipt","10-06-2024","1998",,"Cash Sales","Zelia Green Multipurpose Liquid Detergent 5L","Income","Zelia Multipurpose Liquid Soap",,"Undeposited Funds","",455.00,580418.06
,"Sales Receipt","10-06-2024","2433",,"Cash Sales","Zelia Green Multipurpose Liquid Detergent 1L","Income","Zelia Multipurpose Liquid Soap",,"Undeposited Funds","",126.00,580544.06
,"Sales Receipt","10-06-2024","2434",,"Cash Sales","Zelia Green Multipurpose Liquid Detergent 1L","Income","Zelia Multipurpose Liquid Soap",,"Undeposited Funds","",340.00,580884.06
,"Invoice","11-06-2024","MC05810",,"KIRINYAGA FLOUR MILLS LIMITED","Zelia Green Multipurpose Liquid Detergent 20L","Income","Zelia Multipurpose Liquid Soap",,"Accounts Receivable","",1896.55,582780.61
,"Invoice","11-06-2024","MC05815",,"MADINA SUPERMARKET LIMITED","Zelia Green Multipurpose Liquid Detergent 500ML","Income","Zelia Multipurpose Liquid Soap",,"Accounts Receivable","",501.72,583282.33
,"Sales Receipt","11-06-2024","2439",,"Cash Sales","Zelia Green Multipurpose Liquid Detergent 1L","Income","Zelia Multipurpose Liquid Soap",,"Undeposited Funds","",125.00,583407.33
,"Sales Receipt","11-06-2024","2440",,"Cash Sales","Zelia Green Multipurpose Liquid Detergent 5L","Income","Zelia Multipurpose Liquid Soap",,"Undeposited Funds","",510.00,583917.33
,"Sales Receipt","11-06-2024","2445",,"Cash Sales","Zelia Green Multipurpose Liquid Detergent 5L","Income","Zelia Multipurpose Liquid Soap",,"Undeposited Funds","",600.00,584517.33
,"Sales Receipt","11-06-2024","2447",,"Cash Sales","Zelia Green Multipurpose Liquid Detergent 5L","Income","Zelia Multipurpose Liquid Soap",,"Undeposited Funds","",550.00,585067.33
,"Invoice","12-06-2024","MC05818",,"KIRINYAGA FLOUR MILLS LIMITED","Zelia Green Multipurpose Liquid Detergent 20L","Income","Zelia Multipurpose Liquid Soap",,"Accounts Receivable","",1896.55,586963.88
,"Invoice","12-06-2024","MC05819",,"INTEGRAL MEDIA LIMITED","Zelia Green Multipurpose Liquid Detergent 1L","Income","Zelia Multipurpose Liquid Soap",,"Accounts Receivable","",1686.21,588650.09
,"Sales Receipt","12-06-2024","2450",,"Cash Sales","Zelia Green Multipurpose Liquid Detergent 5L","Income","Zelia Multipurpose Liquid Soap",,"Undeposited Funds",0.00,"",588650.09
,"Sales Receipt","12-06-2024","2449",,"Cash Sales","Zelia Green Multipurpose Liquid Detergent 1L","Income","Zelia Multipurpose Liquid Soap",,"Undeposited Funds","",150.00,588800.09
,"Sales Receipt","12-06-2024","2451",,"Cash Sales","Zelia Green Multipurpose Liquid Detergent 5L","Income","Zelia Multipurpose Liquid Soap",,"Undeposited Funds","",1200.00,590000.09
,"Sales Receipt","12-06-2024","2452",,"Cash Sales","Zelia Green Multipurpose Liquid Detergent 5L","Income","Zelia Multipurpose Liquid Soap",,"Undeposited Funds","",1200.00,591200.09
,"Sales Receipt","12-06-2024","2453",,"Cash Sales","-MULTIPLE-","Income","Zelia Multipurpose Liquid Soap",,"Undeposited Funds","",4900.00,596100.09
,"Sales Receipt","12-06-2024","2454",,"Cash Sales","Zelia Green Multipurpose Liquid Detergent 5L","Income","Zelia Multipurpose Liquid Soap",,"Undeposited Funds","",478.00,596578.09
,"Sales Receipt","13-06-2024","2469",,"Cash Sales","Zelia Green Multipurpose Liquid Detergent 5L","Income","Zelia Multipurpose Liquid Soap",,"Undeposited Funds","",455.00,597033.09
,"Sales Receipt","13-06-2024","2471",,"Cash Sales","Zelia Green Multipurpose Liquid Detergent 5L","Income","Zelia Multipurpose Liquid Soap",,"Undeposited Funds","",1100.00,598133.09
,"Sales Receipt","13-06-2024","2473",,"Horn of Africa","Zelia Green Multipurpose Liquid Detergent 500ML","Income","Zelia Multipurpose Liquid Soap",,"Undeposited Funds","",1008.00,599141.09
,"Sales Receipt","14-06-2024","2475",,"Cash Sales","Zelia Green Multipurpose Liquid Detergent 1L","Income","Zelia Multipurpose Liquid Soap",,"Undeposited Funds","",375.00,599516.09
,"Sales Receipt","14-06-2024","2476",,"Cash Sales","Zelia Green Multipurpose Liquid Detergent 1L","Income","Zelia Multipurpose Liquid Soap",,"Undeposited Funds","",125.00,599641.09
,"Sales Receipt","14-06-2024","2477",,"Cash Sales","Zelia Green Multipurpose Liquid Detergent 1L","Income","Zelia Multipurpose Liquid Soap",,"Undeposited Funds","",252.00,599893.09
,"Sales Receipt","14-06-2024","2478",,"Cash Sales","Zelia Green Multipurpose Liquid Detergent 5L","Income","Zelia Multipurpose Liquid Soap",,"Undeposited Funds","",1200.00,601093.09
,"Sales Receipt","14-06-2024","2479",,"Cash Sales","Zelia Green Multipurpose Liquid Detergent 5L","Income","Zelia Multipurpose Liquid Soap",,"Undeposited Funds","",455.00,601548.09
,"Sales Receipt","14-06-2024","2480",,"Cash Sales","Zelia Green Multipurpose Liquid Detergent 5L","Income","Zelia Multipurpose Liquid Soap",,"Undeposited Funds","",455.00,602003.09
,"Sales Receipt","14-06-2024","2481",,"Cash Sales","Zelia Green Multipurpose Liquid Detergent 1L","Income","Zelia Multipurpose Liquid Soap",,"Undeposited Funds","",140.00,602143.09
,"Sales Receipt","14-06-2024","2482",,"Cash Sales","Zelia Green Multipurpose Liquid Detergent 5L","Income","Zelia Multipurpose Liquid Soap",,"Undeposited Funds","",455.00,602598.09
,"Sales Receipt","14-06-2024","2710",,"tRIPPLE M","Zelia Green Multipurpose Liquid Detergent 500ML","Income","Zelia Multipurpose Liquid Soap",,"Undeposited Funds","",504.00,603102.09
,"Invoice","18-06-2024","MC05827",,"THE REAL IPM COMPANY (KENYA)LIMITED","Zelia Green Multipurpose Liquid Detergent 20L","Income","Zelia Multipurpose Liquid Soap",,"Accounts Receivable","",9600.00,612702.09
,"Sales Receipt","18-06-2024","2703",,"Cash Sales","Zelia Green Multipurpose Liquid Detergent 5L","Income","Zelia Multipurpose Liquid Soap",,"Undeposited Funds",0.00,"",612702.09
,"Sales Receipt","18-06-2024","2702",,"Cash Sales","Zelia Green Multipurpose Liquid Detergent 5L","Income","Zelia Multipurpose Liquid Soap",,"Undeposited Funds","",536.00,613238.09
,"Sales Receipt","18-06-2024","2712",,"Cash Sales","Zelia Green Multipurpose Liquid Detergent 500ML","Income","Zelia Multipurpose Liquid Soap",,"Undeposited Funds","",88.00,613326.09
,"Sales Receipt","18-06-2024","2705",,"Freshtake wholesalers","-MULTIPLE-","Income","Zelia Multipurpose Liquid Soap",,"Undeposited Funds","",2700.00,616026.09
,"Sales Receipt","19-06-2024","2483",,"Cash Sales","Zelia Green Multipurpose Liquid Detergent 500ML","Income","Zelia Multipurpose Liquid Soap",,"Undeposited Funds","",90.00,616116.09
,"Sales Receipt","19-06-2024","2488",,"Cash Sales","Zelia Green Multipurpose Liquid Detergent 5L","Income","Zelia Multipurpose Liquid Soap",,"Undeposited Funds",0.00,"",616116.09
,"Sales Receipt","19-06-2024","2484",,"Cash Sales","Zelia Green Multipurpose Liquid Detergent 5L","Income","Zelia Multipurpose Liquid Soap",,"Undeposited Funds","",1200.00,617316.09
,"Sales Receipt","19-06-2024","2485",,"Cash Sales","Zelia Green Multipurpose Liquid Detergent 5L","Income","Zelia Multipurpose Liquid Soap",,"Undeposited Funds","",455.00,617771.09
,"Invoice","20-06-2024","MC05842",,"HOPEMART SELF SERVICES LTD","Zelia Green Multipurpose Liquid Detergent 500ML","Income","Zelia Multipurpose Liquid Soap",,"Accounts Receivable","",501.72,618272.81
,"Invoice","20-06-2024","MC05845",,"Azaavi Collections Limited","Zelia 5L Green Multipurpose Liquid Detergent","Income","Zelia Multipurpose Liquid Soap",,"Accounts Receivable","",536.00,618808.81
,"Sales Receipt","20-06-2024","2493",,"Cash Sales","Zelia Green Multipurpose Liquid Detergent 1L","Income","Zelia Multipurpose Liquid Soap",,"Undeposited Funds",0.00,"",618808.81
,"Sales Receipt","20-06-2024","AT197",,"Cash Sales","-MULTIPLE-","Income","Zelia Multipurpose Liquid Soap",,"Undeposited Funds","",5779.69,624588.50
,"Sales Receipt","21-06-2024","2716",,"Cash Sales","Zelia Green Multipurpose Liquid Detergent 5L","Income","Zelia Multipurpose Liquid Soap",,"Undeposited Funds","",610.00,625198.50
,"Sales Receipt","21-06-2024","2721",,"Home Soko Minimart","Zelia Green Multipurpose Liquid Detergent 500ML","Income","Zelia Multipurpose Liquid Soap",,"Undeposited Funds","",504.00,625702.50
,"Sales Receipt","22-06-2024","2131",,"Ekai moke wholesale","Zelia Green Multipurpose Liquid Detergent 500ML","Income","Zelia Multipurpose Liquid Soap",,"Undeposited Funds","",1008.00,626710.50
,"Sales Receipt","24-06-2024","2719",,"Cash Sales","Zelia Green Multipurpose Liquid Detergent 5L","Income","Zelia Multipurpose Liquid Soap",,"Undeposited Funds","",509.00,627219.50
,"Sales Receipt","24-06-2024","2729",,"Natala Shop","Zelia Green Multipurpose Liquid Detergent 500ML","Income","Zelia Multipurpose Liquid Soap",,"Undeposited Funds","",1008.00,628227.50
,"Sales Receipt","24-06-2024","8960",,"Pambazuka Mart (K) Limited","-MULTIPLE-","Income","Zelia Multipurpose Liquid Soap",,"Undeposited Funds","",5216.00,633443.50
,"Invoice","26-06-2024","MC05866",,"DISII TRADERS LTD","Zelia Green Multipurpose Liquid Detergent 500ML","Income","Zelia Multipurpose Liquid Soap",,"Accounts Receivable","",501.72,633945.22
,"Sales Receipt","27-06-2024","2736",,"Cash Sales","Zelia Green Multipurpose Liquid Detergent 20L","Income","Zelia Multipurpose Liquid Soap",,"Undeposited Funds","",2000.00,635945.22
,"Sales Receipt","28-06-2024","2737",,"Cash Sales","Zelia Green Multipurpose Liquid Detergent 500ML","Income","Zelia Multipurpose Liquid Soap",,"Undeposited Funds",0.00,"",635945.22
,"Sales Receipt","28-06-2024","2739",,"Cash Sales","Zelia Green Multipurpose Liquid Detergent 5L","Income","Zelia Multipurpose Liquid Soap",,"Undeposited Funds","",510.00,636455.22
,"Sales Receipt","28-06-2024","2744",,"Cash Sales","Zelia Green Multipurpose Liquid Detergent 5L","Income","Zelia Multipurpose Liquid Soap",,"Undeposited Funds","",910.00,637365.22
,"Sales Receipt","28-06-2024","2745",,"Cash Sales","Zelia Green Multipurpose Liquid Detergent 5L","Income","Zelia Multipurpose Liquid Soap",,"Undeposited Funds","",510.00,637875.22
,"Sales Receipt","28-06-2024","AT199",,"Cash Sales","Zelia Green Multipurpose Liquid Detergent 5L","Income","Zelia Multipurpose Liquid Soap",,"Undeposited Funds","",6240.00,644115.22
,"Sales Receipt","01-07-2024","2746",,"Cash Sales","Zelia Green Multipurpose Liquid Detergent 5L","Income","Zelia Multipurpose Liquid Soap",,"Undeposited Funds","",455.00,644570.22
,"Sales Receipt","01-07-2024","2764",,"Golden Save","Zelia Green Multipurpose Liquid Detergent 5L","Income","Zelia Multipurpose Liquid Soap",,"Undeposited Funds","",10180.00,654750.22
,"Invoice","02-07-2024","MC05874",,"THE REAL IPM COMPANY (KENYA)LIMITED","Zelia Green Multipurpose Liquid Detergent 20L","Income","Zelia Multipurpose Liquid Soap",,"Accounts Receivable","",12000.00,666750.22
,"Sales Receipt","02-07-2024","2757",,"Cash Sales","Zelia Green Multipurpose Liquid Detergent 5L","Income","Zelia Multipurpose Liquid Soap",,"Undeposited Funds","",500.00,667250.22
,"Sales Receipt","02-07-2024","2760",,"Cash Sales","Zelia Green Multipurpose Liquid Detergent 1L","Income","Zelia Multipurpose Liquid Soap",,"Undeposited Funds","",125.00,667375.22
,"Sales Receipt","02-07-2024","2554",,"RichMind Property","Zelia Green Multipurpose Liquid Detergent 5L","Income","Zelia Multipurpose Liquid Soap",,"Undeposited Funds","",509.00,667884.22
,"Sales Receipt","03-07-2024","2761",,"Cash Sales","Zelia Green Multipurpose Liquid Detergent 500ML","Income","Zelia Multipurpose Liquid Soap",,"Undeposited Funds",0.00,"",667884.22
,"Sales Receipt","03-07-2024","2767",,"Cash Sales","Zelia Green Multipurpose Liquid Detergent 1L","Income","Zelia Multipurpose Liquid Soap",,"Undeposited Funds","",125.00,668009.22
,"Sales Receipt","03-07-2024","2781",,"New shopWholesale","-MULTIPLE-","Income","Zelia Multipurpose Liquid Soap",,"Undeposited Funds","",7416.00,675425.22
,"Sales Receipt","03-07-2024","2769",,"Asfa Shop","Zelia Green Multipurpose Liquid Detergent 500ML","Income","Zelia Multipurpose Liquid Soap",,"Undeposited Funds","",504.00,675929.22
,"Sales Receipt","04-07-2024","2785",,"Cash Sales","Zelia Green Multipurpose Liquid Detergent 5L","Income","Zelia Multipurpose Liquid Soap",,"Undeposited Funds","",610.00,676539.22
,"Sales Receipt","04-07-2024","2787",,"Cash Sales","Zelia Green Multipurpose Liquid Detergent 5L","Income","Zelia Multipurpose Liquid Soap",,"Undeposited Funds",0.00,"",676539.22
,"Sales Receipt","04-07-2024","2788",,"Cash Sales","Zelia Green Multipurpose Liquid Detergent 5L","Income","Zelia Multipurpose Liquid Soap",,"Undeposited Funds","",455.00,676994.22
,"Sales Receipt","04-07-2024","2789",,"Cash Sales","Zelia Green Multipurpose Liquid Detergent 1L","Income","Zelia Multipurpose Liquid Soap",,"Undeposited Funds","",125.00,677119.22
,"Sales Receipt","04-07-2024","2529",,"Al manaan","Zelia Green Multipurpose Liquid Detergent 5L","Income","Zelia Multipurpose Liquid Soap",,"Undeposited Funds","",2036.00,679155.22
,"Sales Receipt","05-07-2024","2790",,"Cash Sales","Zelia Green Multipurpose Liquid Detergent 5L","Income","Zelia Multipurpose Liquid Soap",,"Undeposited Funds","",610.00,679765.22
,"Sales Receipt","05-07-2024","2791",,"Cash Sales","Zelia Green Multipurpose Liquid Detergent 5L","Income","Zelia Multipurpose Liquid Soap",,"Undeposited Funds","",600.00,680365.22
,"Sales Receipt","05-07-2024","2797",,"Afro Drip LTD","Zelia Green Multipurpose Liquid Detergent 5L","Income","Zelia Multipurpose Liquid Soap",,"Undeposited Funds","",2545.00,682910.22
,"Sales Receipt","05-07-2024","2800",,"Arqam minimart","Zelia Green Multipurpose Liquid Detergent 1L","Income","Zelia Multipurpose Liquid Soap",,"Undeposited Funds","",1692.00,684602.22
,"Sales Receipt","06-07-2024","2501",,"Cash Sales","Zelia Green Multipurpose Liquid Detergent 5L","Income","Zelia Multipurpose Liquid Soap",,"Undeposited Funds","",1200.00,685802.22
,"Sales Receipt","06-07-2024","2502",,"Cash Sales","Zelia Green Multipurpose Liquid Detergent 5L","Income","Zelia Multipurpose Liquid Soap",,"Undeposited Funds","",600.00,686402.22
,"Sales Receipt","06-07-2024","2516",,"Baraka Cerials","Zelia Green Multipurpose Liquid Detergent 500ML","Income","Zelia Multipurpose Liquid Soap",,"Undeposited Funds","",504.00,686906.22
,"Sales Receipt","08-07-2024","2504",,"Cash Sales","Zelia Green Multipurpose Liquid Detergent 5L","Income","Zelia Multipurpose Liquid Soap",,"Undeposited Funds","",600.00,687506.22
,"Sales Receipt","08-07-2024","2507",,"Cash Sales","Zelia Green Multipurpose Liquid Detergent 5L","Income","Zelia Multipurpose Liquid Soap",,"Undeposited Funds","",455.00,687961.22
,"Sales Receipt","08-07-2024","2528",,"Afro Drip LTD","Zelia Green Multipurpose Liquid Detergent 1L","Income","Zelia Multipurpose Liquid Soap",,"Undeposited Funds","",282.00,688243.22
,"Sales Receipt","08-07-2024","1519",,"Gure Yare Shop","Zelia Green Multipurpose Liquid Detergent 5L","Income","Zelia Multipurpose Liquid Soap",,"Undeposited Funds","",10180.00,698423.22
,"Sales Receipt","09-07-2024","2525",,"Cash Sales","-MULTIPLE-","Income","Zelia Multipurpose Liquid Soap",,"Undeposited Funds","",4110.00,702533.22
,"Sales Receipt","09-07-2024","2523",,"Mama Amina","-MULTIPLE-","Income","Zelia Multipurpose Liquid Soap",,"Undeposited Funds","",2700.00,705233.22
,"Invoice","11-07-2024","MC05910",,"Khetshi Dharamshi And Company Limited","Zelia Green Multipurpose Liquid Detergent Lite 20L","Income","Zelia Multipurpose Liquid Soap",,"Accounts Receivable","",9600.00,714833.22
,"Sales Receipt","11-07-2024","2535",,"Cash Sales","Zelia Green Multipurpose Liquid Detergent 5L","Income","Zelia Multipurpose Liquid Soap",,"Undeposited Funds","",610.00,715443.22
,"Sales Receipt","11-07-2024","2536",,"Cash Sales","Zelia Green Multipurpose Liquid Detergent 5L","Income","Zelia Multipurpose Liquid Soap",,"Undeposited Funds","",610.00,716053.22
,"Sales Receipt","12-07-2024","2537",,"Cash Sales","Zelia Green Multipurpose Liquid Detergent 1L","Income","Zelia Multipurpose Liquid Soap",,"Undeposited Funds","",126.00,716179.22
,"Sales Receipt","13-07-2024","2654",,"Damim Mart","Zelia Green Multipurpose Liquid Detergent 500ML","Income","Zelia Multipurpose Liquid Soap",,"Undeposited Funds","",504.00,716683.22
,"Invoice","15-07-2024","MC05921",,"OFFSHORE GLOBAL LOGISTICS LIMITED","-MULTIPLE-","Income","Zelia Multipurpose Liquid Soap",,"Accounts Receivable","",3150.00,719833.22
,"Invoice","15-07-2024","MC05924",,"Azaavi Collections Limited","Zelia 5L Green Multipurpose Liquid Detergent","Income","Zelia Multipurpose Liquid Soap",,"Accounts Receivable","",1072.00,720905.22
,"Invoice","15-07-2024","MC05931",,"KASAMAT INVESTMENTS LTD","-MULTIPLE-","Income","Zelia Multipurpose Liquid Soap",,"Accounts Receivable","",685.34,721590.56
,"Invoice","15-07-2024","MC05933",,"MUHINDI MWEUSI SUPERMARKET LIMITED","Zelia Green Multipurpose Liquid Detergent 1L","Income","Zelia Multipurpose Liquid Soap",,"Accounts Receivable","",1686.21,723276.77
,"Sales Receipt","15-07-2024","2540",,"Cash Sales","Zelia Green Multipurpose Liquid Detergent 20L","Income","Zelia Multipurpose Liquid Soap",,"Undeposited Funds","",2300.00,725576.77
,"Sales Receipt","15-07-2024","2541",,"Cash Sales","Zelia Green Multipurpose Liquid Detergent 5L","Income","Zelia Multipurpose Liquid Soap",,"Undeposited Funds","",1200.00,726776.77
,"Sales Receipt","15-07-2024","2543",,"Cash Sales","Zelia Green Multipurpose Liquid Detergent 5L","Income","Zelia Multipurpose Liquid Soap",,"Undeposited Funds","",478.00,727254.77
,"Sales Receipt","15-07-2024","2544",,"Cash Sales","Zelia Green Multipurpose Liquid Detergent 500ML","Income","Zelia Multipurpose Liquid Soap",,"Undeposited Funds","",79.00,727333.77
,"Sales Receipt","15-07-2024","2548",,"Downtown Wholesalers","-MULTIPLE-","Income","Zelia Multipurpose Liquid Soap",,"Undeposited Funds","",2700.00,730033.77
,"Invoice","17-07-2024","MC05938",,"DISII TRADERS LTD","Zelia Green Multipurpose Liquid Detergent 500ML","Income","Zelia Multipurpose Liquid Soap",,"Accounts Receivable","",2006.90,732040.67
,"Sales Receipt","18-07-2024","2565",,"Cash Sales","Zelia Green Multipurpose Liquid Detergent 5L","Income","Zelia Multipurpose Liquid Soap",,"Undeposited Funds","",610.00,732650.67
,"Invoice","22-07-2024","MC05957",,"THE REAL IPM COMPANY (KENYA)LIMITED","Zelia Green Multipurpose Liquid Detergent 20L","Income","Zelia Multipurpose Liquid Soap",,"Accounts Receivable","",12000.00,744650.67
,"Sales Receipt","22-07-2024","2574",,"Cash Sales","Zelia Green Multipurpose Liquid Detergent 5L","Income","Zelia Multipurpose Liquid Soap",,"Undeposited Funds",0.00,"",744650.67
,"Sales Receipt","22-07-2024","2570",,"Cash Sales","Zelia Green Multipurpose Liquid Detergent 500ML","Income","Zelia Multipurpose Liquid Soap",,"Undeposited Funds",0.00,"",744650.67
,"Sales Receipt","23-07-2024","2582",,"Cash Sales","Zelia Green Multipurpose Liquid Detergent 1L","Income","Zelia Multipurpose Liquid Soap",,"Undeposited Funds","",126.00,744776.67
,"Sales Receipt","23-07-2024","2583",,"Cash Sales","Zelia Green Multipurpose Liquid Detergent 5L","Income","Zelia Multipurpose Liquid Soap",,"Undeposited Funds","",478.00,745254.67
,"Sales Receipt","23-07-2024","2585",,"Cash Sales","Zelia Green Multipurpose Liquid Detergent 5L","Income","Zelia Multipurpose Liquid Soap",,"Undeposited Funds","",478.00,745732.67
,"Sales Receipt","23-07-2024","2590",,"Cash Sales","Zelia Green Multipurpose Liquid Detergent 5L","Income","Zelia Multipurpose Liquid Soap",,"Undeposited Funds","",478.00,746210.67
,"Sales Receipt","23-07-2024","2591",,"Cash Sales","Zelia Green Multipurpose Liquid Detergent 5L","Income","Zelia Multipurpose Liquid Soap",,"Undeposited Funds","",610.00,746820.67
,"Sales Receipt","23-07-2024","2581",,"Cash Sales","Zelia Green Multipurpose Liquid Detergent 500ML","Income","Zelia Multipurpose Liquid Soap",,"Undeposited Funds",0.00,"",746820.67
,"Sales Receipt","23-07-2024","2607",,"Juli Mart","Zelia Green Multipurpose Liquid Detergent 500ML","Income","Zelia Multipurpose Liquid Soap",,"Undeposited Funds","",252.00,747072.67
,"Sales Receipt","24-07-2024","2588",,"Cash Sales","Zelia Green Multipurpose Liquid Detergent 5L","Income","Zelia Multipurpose Liquid Soap",,"Undeposited Funds","",610.00,747682.67
,"Sales Receipt","24-07-2024","2589",,"Cash Sales","Zelia Green Multipurpose Liquid Detergent 5L","Income","Zelia Multipurpose Liquid Soap",,"Undeposited Funds","",610.00,748292.67
,"Sales Receipt","24-07-2024","2608",,"Capital Halal","Zelia Green Multipurpose Liquid Detergent 500ML","Income","Zelia Multipurpose Liquid Soap",,"Undeposited Funds","",504.00,748796.67
,"Sales Receipt","26-07-2024","2690",,"Amani Store","Zelia Green Multipurpose Liquid Detergent 500ML","Income","Zelia Multipurpose Liquid Soap",,"Undeposited Funds","",1008.00,749804.67
,"Invoice","29-07-2024","MC05984",,"Mumsha Supamat","Zelia Green Multipurpose Liquid Detergent 1L","Income","Zelia Multipurpose Liquid Soap",,"Accounts Receivable","",843.10,750647.77
,"Sales Receipt","29-07-2024","2613",,"Cash Sales","Zelia Green Multipurpose Liquid Detergent 5L","Income","Zelia Multipurpose Liquid Soap",,"Undeposited Funds","",478.00,751125.77
,"Sales Receipt","29-07-2024","2616",,"Hidika Shop","Zelia Green Multipurpose Liquid Detergent 500ML","Income","Zelia Multipurpose Liquid Soap",,"Undeposited Funds","",1008.00,752133.77
,"Sales Receipt","30-07-2024","2618",,"Cash Sales","Zelia Green Multipurpose Liquid Detergent 5L","Income","Zelia Multipurpose Liquid Soap",,"Undeposited Funds","",478.00,752611.77
,"Sales Receipt","30-07-2024","2619",,"Cash Sales","Zelia Green Multipurpose Liquid Detergent 1L","Income","Zelia Multipurpose Liquid Soap",,"Undeposited Funds","",150.00,752761.77
,"Sales Receipt","30-07-2024","2620",,"Cash Sales","Zelia Green Multipurpose Liquid Detergent 1L","Income","Zelia Multipurpose Liquid Soap",,"Undeposited Funds","",300.00,753061.77
,"Sales Receipt","30-07-2024","2625",,"Cash Sales","Zelia Green Multipurpose Liquid Detergent 20L","Income","Zelia Multipurpose Liquid Soap",,"Undeposited Funds","",2330.00,755391.77
,"Sales Receipt","30-07-2024","2629",,"Cash Sales","Zelia Green Multipurpose Liquid Detergent 5L","Income","Zelia Multipurpose Liquid Soap",,"Undeposited Funds","",610.00,756001.77
,"Sales Receipt","30-07-2024","2622",,"Infinity Lines","Zelia Green Multipurpose Liquid Detergent 5L","Income","Zelia Multipurpose Liquid Soap",,"Undeposited Funds","",1018.00,757019.77
,"Sales Receipt","31-07-2024","AT200",,"Cash Sales","-MULTIPLE-","Income","Zelia Multipurpose Liquid Soap",,"Undeposited Funds","",20400.00,777419.77
,"Sales Receipt","31-07-2024","2630",,"Cash Sales","Zelia Green Multipurpose Liquid Detergent 20L","Income","Zelia Multipurpose Liquid Soap",,"Undeposited Funds","",10400.00,787819.77
,"Sales Receipt","31-07-2024","2631",,"Cash Sales","Zelia Green Multipurpose Liquid Detergent 5L","Income","Zelia Multipurpose Liquid Soap",,"Undeposited Funds",0.00,"",787819.77
,"Sales Receipt","31-07-2024","2635",,"Cash Sales","Zelia Green Multipurpose Liquid Detergent 5L","Income","Zelia Multipurpose Liquid Soap",,"Undeposited Funds",0.00,"",787819.77
,"Invoice","01-08-2024","MC05990",,"THE REAL IPM COMPANY (KENYA)LIMITED","Zelia Green Multipurpose Liquid Detergent 20L","Income","Zelia Multipurpose Liquid Soap",,"Accounts Receivable","",12000.00,799819.77
,"Sales Receipt","01-08-2024","2691",,"Ubwere Store","Zelia Green Multipurpose Liquid Detergent 500ML","Income","Zelia Multipurpose Liquid Soap",,"Undeposited Funds","",1056.00,800875.77
,"Sales Receipt","02-08-2024","2643",,"Cash Sales","Zelia Green Multipurpose Liquid Detergent 5L","Income","Zelia Multipurpose Liquid Soap",,"Undeposited Funds","",1950.00,802825.77
,"Sales Receipt","02-08-2024","2646",,"Cash Sales","-MULTIPLE-","Income","Zelia Multipurpose Liquid Soap",,"Undeposited Funds","",630.00,803455.77
,"Sales Receipt","02-08-2024","2650",,"Cash Sales","Zelia Green Multipurpose Liquid Detergent 1L","Income","Zelia Multipurpose Liquid Soap",,"Undeposited Funds","",274.00,803729.77
,"Sales Receipt","05-08-2024","2658",,"Cash Sales","Zelia Green Multipurpose Liquid Detergent 5L","Income","Zelia Multipurpose Liquid Soap",,"Undeposited Funds","",660.00,804389.77
,"Sales Receipt","05-08-2024","2679",,"Golden Save","Zelia Green Multipurpose Liquid Detergent 5L","Income","Zelia Multipurpose Liquid Soap",,"Undeposited Funds","",10180.00,814569.77
,"Invoice","06-08-2024","MC06004",,"HAPPY VIEW SUPERMARKET LIMITED","Zelia Green Multipurpose Liquid Detergent 500ML","Income","Zelia Multipurpose Liquid Soap",,"Accounts Receivable","",501.72,815071.49
,"Sales Receipt","06-08-2024","2659",,"Cash Sales","Zelia Green Multipurpose Liquid Detergent 5L","Income","Zelia Multipurpose Liquid Soap",,"Undeposited Funds","",660.00,815731.49
,"Sales Receipt","06-08-2024","2680",,"Juja Minimart","-MULTIPLE-","Income","Zelia Multipurpose Liquid Soap",,"Undeposited Funds","",3708.00,819439.49
,"Invoice","07-08-2024","MC06006",,"NASRI MART LIMITED","Zelia Green Multipurpose Liquid Detergent 500ML","Income","Zelia Multipurpose Liquid Soap",,"Accounts Receivable","",501.72,819941.21
,"Sales Receipt","07-08-2024","2684",,"Cash Sales","Zelia Green Multipurpose Liquid Detergent 5L","Income","Zelia Multipurpose Liquid Soap",,"Undeposited Funds","",610.00,820551.21
,"Invoice","08-08-2024","MC06016",,"DISII TRADERS LTD","Zelia Green Multipurpose Liquid Detergent 500ML","Income","Zelia Multipurpose Liquid Soap",,"Accounts Receivable","",1003.45,821554.66
,"Invoice","08-08-2024","MC06018",,"OFFSHORE GLOBAL LOGISTICS LIMITED","-MULTIPLE-","Income","Zelia Multipurpose Liquid Soap",,"Accounts Receivable","",2810.00,824364.66
,"Sales Receipt","08-08-2024","2672",,"Cash Sales","Zelia Green Multipurpose Liquid Detergent 1L","Income","Zelia Multipurpose Liquid Soap",,"Undeposited Funds","",548.00,824912.66
,"Invoice","09-08-2024","MC06020",,"DALLAS SHOPRITE LTD","Zelia Green Multipurpose Liquid Detergent 500ML","Income","Zelia Multipurpose Liquid Soap",,"Accounts Receivable","",1055.17,825967.83
,"Sales Receipt","09-08-2024","2695",,"Cash Sales","Zelia Green Multipurpose Liquid Detergent 5L","Income","Zelia Multipurpose Liquid Soap",,"Undeposited Funds","",650.00,826617.83
,"Sales Receipt","09-08-2024","2698",,"Cash Sales","Zelia Green Multipurpose Liquid Detergent 5L","Income","Zelia Multipurpose Liquid Soap",,"Undeposited Funds","",490.00,827107.83
,"Sales Receipt","09-08-2024","2699",,"Cash Sales","Zelia Green Multipurpose Liquid Detergent 1L","Income","Zelia Multipurpose Liquid Soap",,"Undeposited Funds","",125.00,827232.83
,"Invoice","12-08-2024","MC06031",,"KAVYA SUPERMARKET LIMITED","Zelia Green Multipurpose Liquid Detergent 500ML","Income","Zelia Multipurpose Liquid Soap",,"Accounts Receivable","",2400.00,829632.83
,"Sales Receipt","12-08-2024","2813",,"Mamken Minimart","-MULTIPLE-","Income","Zelia Multipurpose Liquid Soap",,"Undeposited Funds","",1350.00,830982.83
,"Sales Receipt","12-08-2024","2814",,"Asfa Shop","Zelia Green Multipurpose Liquid Detergent 500ML","Income","Zelia Multipurpose Liquid Soap",,"Undeposited Funds","",504.00,831486.83
,"Sales Receipt","12-08-2024","2815",,"Kibibi Wasai Store","-MULTIPLE-","Income","Zelia Multipurpose Liquid Soap",,"Undeposited Funds","",3728.00,835214.83
,"Sales Receipt","12-08-2024","2812",,"Bethel Store","Zelia Green Multipurpose Liquid Detergent 5L","Income","Zelia Multipurpose Liquid Soap",,"Undeposited Funds","",1142.00,836356.83
,"Sales Receipt","12-08-2024","2817",,"Gargar Foodstuffs","Zelia Green Multipurpose Liquid Detergent 5L","Income","Zelia Multipurpose Liquid Soap",,"Undeposited Funds","",10180.00,846536.83
,"Sales Receipt","13-08-2024","2820",,"Cash Sales","Zelia Green Multipurpose Liquid Detergent 5L","Income","Zelia Multipurpose Liquid Soap",,"Undeposited Funds","",493.00,847029.83
,"Sales Receipt","13-08-2024","2819",,"Tawakal Shop","Zelia Green Multipurpose Liquid Detergent 5L","Income","Zelia Multipurpose Liquid Soap",,"Undeposited Funds","",509.00,847538.83
,"Sales Receipt","14-08-2024","2823",,"Cash Sales","Zelia Green Multipurpose Liquid Detergent 1L","Income","Zelia Multipurpose Liquid Soap",,"Undeposited Funds","",274.00,847812.83
,"Sales Receipt","14-08-2024","2834",,"Milimani Store","Zelia Green Multipurpose Liquid Detergent 500ML","Income","Zelia Multipurpose Liquid Soap",,"Undeposited Funds","",504.00,848316.83
,"Sales Receipt","14-08-2024","2832",,"Qudus Shop","Zelia Green Multipurpose Liquid Detergent 500ML","Income","Zelia Multipurpose Liquid Soap",,"Undeposited Funds","",1008.00,849324.83
,"Sales Receipt","15-08-2024","2824",,"Cash Sales","Zelia Green Multipurpose Liquid Detergent 5L","Income","Zelia Multipurpose Liquid Soap",,"Undeposited Funds","",984.00,850308.83
,"Sales Receipt","16-08-2024","2851",,"Tahila Enterprises","-MULTIPLE-","Income","Zelia Multipurpose Liquid Soap",,"Undeposited Funds","",675.00,850983.83
,"Invoice","19-08-2024","MC06050",,"Azaavi Collections Limited","Zelia 5L Green Multipurpose Liquid Detergent","Income","Zelia Multipurpose Liquid Soap",,"Accounts Receivable","",536.00,851519.83
,"Sales Receipt","19-08-2024","2836",,"Cash Sales","Zelia Green Multipurpose Liquid Detergent 500ML","Income","Zelia Multipurpose Liquid Soap",,"Undeposited Funds","",168.00,851687.83
,"Sales Receipt","19-08-2024","2839",,"Cash Sales","Zelia Green Multipurpose Liquid Detergent 500ML","Income","Zelia Multipurpose Liquid Soap",,"Undeposited Funds",0.00,"",851687.83
,"Sales Receipt","20-08-2024","2905",,"Cash Sales","Zelia Green Multipurpose Liquid Detergent 5L","Income","Zelia Multipurpose Liquid Soap",,"Undeposited Funds","",493.00,852180.83
,"Sales Receipt","20-08-2024","2858",,"Home Soko Minimart","Zelia Green Multipurpose Liquid Detergent 5L","Income","Zelia Multipurpose Liquid Soap",,"Undeposited Funds","",990.00,853170.83
,"Sales Receipt","20-08-2024","2859",,"Nzuri Supermarket","Zelia Green Multipurpose Liquid Detergent 5L","Income","Zelia Multipurpose Liquid Soap",,"Undeposited Funds","",495.00,853665.83
,"Invoice","21-08-2024","MC06054",,"Khetshi Dharamshi And Company Limited","Zelia Green Multipurpose Liquid Detergent Lite 20L","Income","Zelia Multipurpose Liquid Soap",,"Accounts Receivable","",9600.00,863265.83
,"Invoice","21-08-2024","MC06065",,"Muhaya & Rukundo Holdings Ltd","0001.12.00 Zelia Green Multipurpose Liquid Detergent 24X500ML","Income","Zelia Multipurpose Liquid Soap",,"Accounts Receivable","",5000.00,868265.83
,"Sales Receipt","21-08-2024","MC06054",,"Cash Sales","Zelia Green Multipurpose Liquid Detergent Lite 20L","Income","Zelia Multipurpose Liquid Soap",,"Undeposited Funds","",9600.00,877865.83
,"Sales Receipt","21-08-2024","MC06071",,"Cash Sales","Zelia Green Multipurpose Liquid Detergent 20L","Income","Zelia Multipurpose Liquid Soap",,"Undeposited Funds","",1982.00,879847.83
,"Sales Receipt","21-08-2024","2906",,"Cash Sales","Zelia Green Multipurpose Liquid Detergent 5L","Income","Zelia Multipurpose Liquid Soap",,"Undeposited Funds","",493.00,880340.83
,"Sales Receipt","21-08-2024","2853",,"Cash Sales","Zelia Green Multipurpose Liquid Detergent 1L","Income","Zelia Multipurpose Liquid Soap",,"Undeposited Funds","",180.00,880520.83
,"Sales Receipt","21-08-2024","2863",,"alhamdulilah shop","-MULTIPLE-","Income","Zelia Multipurpose Liquid Soap",,"Undeposited Funds","",2952.00,883472.83
,"Sales Receipt","21-08-2024","2855",,"Homecare Enterprise","Zelia Green Multipurpose Liquid Detergent 5L","Income","Zelia Multipurpose Liquid Soap",,"Undeposited Funds","",571.00,884043.83
,"Invoice","22-08-2024","MC06066",,"Cash Sales","Zelia Green Multipurpose Liquid Detergent 5L","Income","Zelia Multipurpose Liquid Soap",,"Accounts Receivable","",500.00,884543.83
,"Invoice","22-08-2024","MC06067",,"Cash Sales","Zelia Green Multipurpose Liquid Detergent 5L","Income","Zelia Multipurpose Liquid Soap",,"Accounts Receivable","",1000.00,885543.83
,"Credit Note","22-08-2024","CN01065",,"Cash Sales","Zelia Green Multipurpose Liquid Detergent 5L","Income","Zelia Multipurpose Liquid Soap",,"Accounts Receivable",500.00,"",885043.83
,"Credit Note","22-08-2024","CN01066",,"Cash Sales","Zelia Green Multipurpose Liquid Detergent 5L","Income","Zelia Multipurpose Liquid Soap",,"Accounts Receivable",1000.00,"",884043.83
,"Sales Receipt","22-08-2024","2868",,"Cash Sales","Zelia Green Multipurpose Liquid Detergent 5L","Income","Zelia Multipurpose Liquid Soap",,"Undeposited Funds","",650.00,884693.83
,"Sales Receipt","22-08-2024","2867",,"Sultan Iman Shop","Zelia Green Multipurpose Liquid Detergent 1L","Income","Zelia Multipurpose Liquid Soap",,"Undeposited Funds","",3384.00,888077.83
,"Invoice","23-08-2024","MC06071",,"KIRINYAGA FLOUR MILLS LIMITED","Zelia Green Multipurpose Liquid Detergent 20L","Income","Zelia Multipurpose Liquid Soap",,"Accounts Receivable","",1982.76,890060.59
,"Sales Receipt","23-08-2024","2877",,"Cash Sales","Zelia Green Multipurpose Liquid Detergent 1L","Income","Zelia Multipurpose Liquid Soap",,"Undeposited Funds","",150.00,890210.59
,"Sales Receipt","23-08-2024","2880",,"Cash Sales","Zelia Green Multipurpose Liquid Detergent 5L","Income","Zelia Multipurpose Liquid Soap",,"Undeposited Funds","",490.00,890700.59
,"Sales Receipt","23-08-2024","2881",,"Cash Sales","Zelia Green Multipurpose Liquid Detergent 5L","Income","Zelia Multipurpose Liquid Soap",,"Undeposited Funds","",986.00,891686.59
,"Sales Receipt","23-08-2024","2921",,"Cash Sales","Zelia Green Multipurpose Liquid Detergent 5L","Income","Zelia Multipurpose Liquid Soap",,"Undeposited Funds",0.00,"",891686.59
,"Sales Receipt","24-08-2024","2887",,"Brightfood Nasra","Zelia Green Multipurpose Liquid Detergent 500ML","Income","Zelia Multipurpose Liquid Soap",,"Undeposited Funds","",528.00,892214.59
,"Invoice","26-08-2024","MC06081",,"THE REAL IPM COMPANY (KENYA)LIMITED","Zelia Green Multipurpose Liquid Detergent 20L","Income","Zelia Multipurpose Liquid Soap",,"Accounts Receivable","",12000.00,904214.59
,"Sales Receipt","26-08-2024","2865",,"Cash Sales","Zelia Green Multipurpose Liquid Detergent 1L","Income","Zelia Multipurpose Liquid Soap",,"Undeposited Funds","",276.00,904490.59
,"Sales Receipt","26-08-2024","2883",,"Cash Sales","Zelia Green Multipurpose Liquid Detergent 5L","Income","Zelia Multipurpose Liquid Soap",,"Undeposited Funds","",1300.00,905790.59
,"Sales Receipt","26-08-2024","2884",,"Cash Sales","Zelia Green Multipurpose Liquid Detergent 5L","Income","Zelia Multipurpose Liquid Soap",,"Undeposited Funds","",2124.00,907914.59
,"Sales Receipt","26-08-2024","2888",,"Asfa Shop","Zelia Green Multipurpose Liquid Detergent 5L","Income","Zelia Multipurpose Liquid Soap",,"Undeposited Funds","",1140.00,909054.59
,"Sales Receipt","27-08-2024","2894",,"Cash Sales","Zelia Green Multipurpose Liquid Detergent 5L","Income","Zelia Multipurpose Liquid Soap",,"Undeposited Funds","",1142.00,910196.59
,"Sales Receipt","28-08-2024","2911",,"Infinity Lines","Zelia Green Multipurpose Liquid Detergent 5L","Income","Zelia Multipurpose Liquid Soap",,"Undeposited Funds","",1710.00,911906.59
,"Sales Receipt","29-08-2024","AT201",,"Cash Sales","Zelia Green Multipurpose Liquid Detergent 5L","Income","Zelia Multipurpose Liquid Soap",,"Undeposited Funds","",6600.00,918506.59
,"Sales Receipt","29-08-2024","965",,"Mombasa Velvet","Zelia Green Multipurpose Liquid Detergent 5L","Income","Zelia Multipurpose Liquid Soap",,"Undeposited Funds","",570.00,919076.59
,"Sales Receipt","30-08-2024","2922",,"Cash Sales","Zelia Green Multipurpose Liquid Detergent 5L","Income","Zelia Multipurpose Liquid Soap",,"Undeposited Funds","",493.00,919569.59
,"Sales Receipt","02-09-2024","3225",,"Purity Shop","Zelia Green Multipurpose Liquid 24X500ML","Income","Zelia Multipurpose Liquid Soap",,"Undeposited Funds","",88.00,919657.59
,"Sales Receipt","02-09-2024","2923",,"Blossom Beauty","Zelia Green Multipurpose Liquid 24X500ML","Income","Zelia Multipurpose Liquid Soap",,"Undeposited Funds","",528.00,920185.59
,"Sales Receipt","02-09-2024","2928",,"Beta Traders","Zelia Green Multipurpose Liquid 24X500ML","Income","Zelia Multipurpose Liquid Soap",,"Undeposited Funds","",1056.00,921241.59
,"Sales Receipt","02-09-2024","2972",,"Muleshe Wholesallers","Zelia Green Multipurpose Liquid 4X5L","Income","Zelia Multipurpose Liquid Soap",,"Undeposited Funds","",4464.00,925705.59
,"Sales Receipt","02-09-2024","3004",,"Cash Sales","Zelia Green Multipurpose Liquid 4X5L","Income","Zelia Multipurpose Liquid Soap",,"Undeposited Funds","",571.00,926276.59
,"Sales Receipt","02-09-2024","3005",,"Cash Sales","Zelia Green Multipurpose Liquid 4X5L","Income","Zelia Multipurpose Liquid Soap",,"Undeposited Funds","",650.00,926926.59
,"Sales Receipt","02-09-2024","3006",,"Cash Sales","Zelia Green Multipurpose Liquid 20L","Income","Zelia Multipurpose Liquid Soap",,"Undeposited Funds","",2480.00,929406.59
,"Sales Receipt","02-09-2024","3008",,"Cash Sales","Zelia Green Multipurpose Liquid 4X5L","Income","Zelia Multipurpose Liquid Soap",,"Undeposited Funds","",493.00,929899.59
,"Sales Receipt","02-09-2024","3010",,"Cash Sales","Zelia Green Multipurpose Liquid 12X1L","Income","Zelia Multipurpose Liquid Soap",,"Undeposited Funds","",272.01,930171.60
,"Sales Receipt","03-09-2024","2922",,"Cash Sales","Zelia Green Multipurpose Liquid 12X1L","Income","Zelia Multipurpose Liquid Soap",,"Undeposited Funds",0.00,"",930171.60
,"Sales Receipt","04-09-2024","2932",,"Cash Sales","Zelia Green Multipurpose Liquid 4X5L","Income","Zelia Multipurpose Liquid Soap",,"Undeposited Funds","",650.00,930821.60
,"Sales Receipt","04-09-2024","2933",,"Cash Sales","Zelia Green Multipurpose Liquid 4X5L","Income","Zelia Multipurpose Liquid Soap",,"Undeposited Funds","",650.00,931471.60
,"Sales Receipt","05-09-2024","2944",,"Cash Sales","-MULTIPLE-","Income","Zelia Multipurpose Liquid Soap",,"Undeposited Funds","",3130.00,934601.60
,"Sales Receipt","05-09-2024","2949",,"Cash Sales","Zelia Green Multipurpose Liquid 12X1L","Income","Zelia Multipurpose Liquid Soap",,"Undeposited Funds","",135.99,934737.59
,"Sales Receipt","05-09-2024","2950",,"Cash Sales","Zelia Green Multipurpose Liquid 12X1L","Income","Zelia Multipurpose Liquid Soap",,"Undeposited Funds","",274.01,935011.60
,"Sales Receipt","05-09-2024","2954",,"Cash Sales","Zelia Green Multipurpose Liquid 4X5L","Income","Zelia Multipurpose Liquid Soap",,"Undeposited Funds","",493.00,935504.60
,"Sales Receipt","05-09-2024","2955",,"Cash Sales","Zelia Green Multipurpose Liquid 4X5L","Income","Zelia Multipurpose Liquid Soap",,"Undeposited Funds","",571.00,936075.60
,"Sales Receipt","06-09-2024","2957",,"Cash Sales","Zelia Green Multipurpose Liquid 4X5L","Income","Zelia Multipurpose Liquid Soap",,"Undeposited Funds","",493.00,936568.60
,"Sales Receipt","09-09-2024","2969",,"Elwak mart","Zelia Green Multipurpose Liquid 4X5L","Income","Zelia Multipurpose Liquid Soap",,"Undeposited Funds","",2232.00,938800.60
,"Sales Receipt","09-09-2024","2960",,"Mizpa Minimart","Zelia Green Multipurpose Liquid 12X1L","Income","Zelia Multipurpose Liquid Soap",,"Undeposited Funds","",158.00,938958.60
,"Sales Receipt","09-09-2024","2986",,"Pambazuka Mart (K) Limited","-MULTIPLE-","Income","Zelia Multipurpose Liquid Soap",,"Undeposited Funds","",5692.00,944650.60
,"Sales Receipt","10-09-2024","2992",,"Axis Lounge","Zelia Green Multipurpose Liquid 20L","Income","Zelia Multipurpose Liquid Soap",,"Undeposited Funds","",2176.00,946826.60
,"Sales Receipt","10-09-2024","2973",,"Cash Sales","Zelia Green Multipurpose Liquid 20L","Income","Zelia Multipurpose Liquid Soap",,"Undeposited Funds","",2480.00,949306.60
,"Sales Receipt","10-09-2024","2975",,"Cash Sales","Zelia Green Multipurpose Liquid 12X1L","Income","Zelia Multipurpose Liquid Soap",,"Undeposited Funds","",599.99,949906.59
,"Sales Receipt","10-09-2024","2977",,"Cash Sales","Zelia Green Multipurpose Liquid 24X500ML","Income","Zelia Multipurpose Liquid Soap",,"Undeposited Funds","",76.01,949982.60
,"Sales Receipt","10-09-2024","2979",,"Cash Sales","Zelia Green Multipurpose Liquid 4X5L","Income","Zelia Multipurpose Liquid Soap",,"Undeposited Funds","",493.00,950475.60
,"Sales Receipt","10-09-2024","3015",,"Cash Sales","Zelia Green Multipurpose Liquid 12X1L","Income","Zelia Multipurpose Liquid Soap",,"Undeposited Funds","",179.99,950655.59
,"Sales Receipt","10-09-2024","2976",,"Cash Sales","Zelia Green Multipurpose Liquid 12X1L","Income","Zelia Multipurpose Liquid Soap",,"Undeposited Funds",0.00,"",950655.59
,"Sales Receipt","10-09-2024","3237",,"Cash Sales","Zelia Green Multipurpose Liquid 12X1L","Income","Zelia Multipurpose Liquid Soap",,"Undeposited Funds",0.00,"",950655.59
,"Invoice","11-09-2024","MC06136",,"THE REAL IPM COMPANY (KENYA)LIMITED","Zelia Green Multipurpose Liquid Detergent 20L","Income","Zelia Multipurpose Liquid Soap",,"Accounts Receivable","",12000.00,962655.59
,"Sales Receipt","11-09-2024","2985",,"Cash Sales","Zelia Green Multipurpose Liquid 4X5L","Income","Zelia Multipurpose Liquid Soap",,"Undeposited Funds","",493.00,963148.59
,"Sales Receipt","12-09-2024","2987",,"Cash Sales","Zelia Green Multipurpose Liquid 4X5L","Income","Zelia Multipurpose Liquid Soap",,"Undeposited Funds","",300.00,963448.59
,"Sales Receipt","12-09-2024","3019",,"Cash Sales","Zelia Green Multipurpose Liquid 12X1L","Income","Zelia Multipurpose Liquid Soap",,"Undeposited Funds","",149.99,963598.58
,"Sales Receipt","12-09-2024","3023",,"Cash Sales","Zelia Green Multipurpose Liquid 12X1L","Income","Zelia Multipurpose Liquid Soap",,"Undeposited Funds","",135.99,963734.57
,"Sales Receipt","13-09-2024","3030",,"Cash Sales","Zelia Green Multipurpose Liquid 4X5L","Income","Zelia Multipurpose Liquid Soap",,"Undeposited Funds","",493.00,964227.57
,"Sales Receipt","13-09-2024","3032",,"Cash Sales","Zelia Green Multipurpose Liquid 4X5L","Income","Zelia Multipurpose Liquid Soap",,"Undeposited Funds","",571.00,964798.57
,"Sales Receipt","13-09-2024","3033",,"Cash Sales","Zelia Green Multipurpose Liquid 4X5L","Income","Zelia Multipurpose Liquid Soap",,"Undeposited Funds","",1060.00,965858.57
,"Sales Receipt","13-09-2024","3036",,"Cash Sales","Zelia Green Multipurpose Liquid 4X5L","Income","Zelia Multipurpose Liquid Soap",,"Undeposited Funds","",493.00,966351.57
,"Sales Receipt","14-09-2024","3043",,"Gladys Wholesalers","Zelia Green Multipurpose Liquid 12X1L","Income","Zelia Multipurpose Liquid Soap",,"Undeposited Funds","",302.00,966653.57
,"Sales Receipt","16-09-2024","3044",,"Afro Drip LTD","Zelia Green Multipurpose Liquid 4X5L","Income","Zelia Multipurpose Liquid Soap",,"Undeposited Funds","",1710.00,968363.57
,"Sales Receipt","16-09-2024","3045",,"Afro Drip LTD Reception","Zelia Green Multipurpose Liquid 12X1L","Income","Zelia Multipurpose Liquid Soap",,"Undeposited Funds","",316.00,968679.57
,"Sales Receipt","16-09-2024","3037",,"Cash Sales","Zelia Green Multipurpose Liquid 4X5L","Income","Zelia Multipurpose Liquid Soap",,"Undeposited Funds","",610.00,969289.57
,"Sales Receipt","16-09-2024","3038",,"Cash Sales","Zelia Green Multipurpose Liquid 12X1L","Income","Zelia Multipurpose Liquid Soap",,"Undeposited Funds","",316.01,969605.58
,"Sales Receipt","16-09-2024","3039",,"Cash Sales","Zelia Green Multipurpose Liquid 4X5L","Income","Zelia Multipurpose Liquid Soap",,"Undeposited Funds","",650.00,970255.58
,"Sales Receipt","17-09-2024","3048",,"Cash Sales","Zelia Green Multipurpose Liquid 4X5L","Income","Zelia Multipurpose Liquid Soap",,"Undeposited Funds","",498.00,970753.58
,"Sales Receipt","17-09-2024","3049",,"Cash Sales","Zelia Green Multipurpose Liquid 4X5L","Income","Zelia Multipurpose Liquid Soap",,"Undeposited Funds",0.00,"",970753.58
,"Sales Receipt","17-09-2024","3051",,"Cash Sales","Zelia Green Multipurpose Liquid 4X5L","Income","Zelia Multipurpose Liquid Soap",,"Undeposited Funds","",493.00,971246.58
,"Sales Receipt","18-09-2024","3057",,"Jimos Wholesalers","-MULTIPLE-","Income","Zelia Multipurpose Liquid Soap",,"Undeposited Funds","",1668.00,972914.58
,"Sales Receipt","18-09-2024","3056",,"Cash Sales","Zelia Green Multipurpose Liquid 12X1L","Income","Zelia Multipurpose Liquid Soap",,"Undeposited Funds","",179.99,973094.57
,"Sales Receipt","19-09-2024","570",,"Revs Spares","Zelia Green Multipurpose Liquid 4X5L","Income","Zelia Multipurpose Liquid Soap",,"Undeposited Funds","",570.00,973664.57
,"Invoice","20-09-2024","MC06179",,"OFFSHORE GLOBAL LOGISTICS LIMITED","Zelia Green Multipurpose Liquid Detergent 20L","Income","Zelia Multipurpose Liquid Soap",,"Accounts Receivable","",2565.00,976229.57
,"Sales Receipt","20-09-2024","3069",,"Cash Sales","Zelia Green Multipurpose Liquid 4X5L","Income","Zelia Multipurpose Liquid Soap",,"Undeposited Funds","",570.00,976799.57
,"Sales Receipt","21-09-2024","3077",,"Horn of Africa","Zelia Green Multipurpose Liquid 24X500ML","Income","Zelia Multipurpose Liquid Soap",,"Undeposited Funds","",2112.00,978911.57
,"Sales Receipt","23-09-2024","3087",,"Himilo General Store","-MULTIPLE-","Income","Zelia Multipurpose Liquid Soap",,"Undeposited Funds","",2952.00,981863.57
,"Sales Receipt","23-09-2024","3072",,"Cash Sales","Zelia Green Multipurpose Liquid 12X1L","Income","Zelia Multipurpose Liquid Soap",,"Undeposited Funds","",136.99,982000.56
,"Sales Receipt","24-09-2024","3234",,"Gifted Hands","Zelia Green Multipurpose Liquid 24X500ML","Income","Zelia Multipurpose Liquid Soap",,"Undeposited Funds","",285.00,982285.56
,"Sales Receipt","24-09-2024","3083",,"Kibibi Wasai Store","Zelia Green Multipurpose Liquid 24X500ML","Income","Zelia Multipurpose Liquid Soap",,"Undeposited Funds","",528.00,982813.56
,"Sales Receipt","24-09-2024","3078",,"Cash Sales","Zelia Green Multipurpose Liquid 4X5L","Income","Zelia Multipurpose Liquid Soap",,"Undeposited Funds","",493.00,983306.56
,"Sales Receipt","24-09-2024","3079",,"Cash Sales","Zelia Green Multipurpose Liquid 4X5L","Income","Zelia Multipurpose Liquid Soap",,"Undeposited Funds","",1479.00,984785.56
,"Sales Receipt","24-09-2024","3080",,"Cash Sales","Zelia Green Multipurpose Liquid 12X1L","Income","Zelia Multipurpose Liquid Soap",,"Undeposited Funds","",149.99,984935.55
,"Invoice","25-09-2024","MC06197",,"Khetshi Dharamshi And Company Limited","Zelia Green Multipurpose Liquid Detergent Lite 20L","Income","Zelia Multipurpose Liquid Soap",,"Accounts Receivable","",9600.00,994535.55
,"Sales Receipt","25-09-2024","3095",,"Cash Sales","Zelia Green Multipurpose Liquid 4X5L","Income","Zelia Multipurpose Liquid Soap",,"Undeposited Funds","",493.00,995028.55
,"Invoice","26-09-2024","MC06205",,"OFFSHORE GLOBAL LOGISTICS LIMITED","-MULTIPLE-","Income","Zelia Multipurpose Liquid Soap",,"Accounts Receivable","",3100.00,998128.55
,"Sales Receipt","26-09-2024","3209",,"Cash Sales","Zelia Green Multipurpose Liquid 4X5L","Income","Zelia Multipurpose Liquid Soap",,"Undeposited Funds","",493.00,998621.55
,"Invoice","27-09-2024","MC06216",,"QUALITYMART SUPERMARKET LIMITED","-MULTIPLE-","Income","Zelia Multipurpose Liquid Soap",,"Accounts Receivable","",1484.48,1000106.03
,"Sales Receipt","27-09-2024","3215",,"Supaa Mart","-MULTIPLE-","Income","Zelia Multipurpose Liquid Soap",,"Undeposited Funds","",1476.00,1001582.03
,"Sales Receipt","27-09-2024","3211",,"Cash Sales","Zelia Green Multipurpose Liquid 4X5L","Income","Zelia Multipurpose Liquid Soap",,"Undeposited Funds",0.00,"",1001582.03
,"Sales Receipt","27-09-2024","3212",,"Cash Sales","Zelia Green Multipurpose Liquid 12X1L","Income","Zelia Multipurpose Liquid Soap",,"Undeposited Funds","",136.99,1001719.02
,"Sales Receipt","27-09-2024","3216",,"Cash Sales","Zelia Green Multipurpose Liquid 4X5L","Income","Zelia Multipurpose Liquid Soap",,"Undeposited Funds","",1140.00,1002859.02
,"Sales Receipt","01-10-2024","3224",,"Cash Sales","Zelia Green Multipurpose Liquid 12X1L","Income","Zelia Multipurpose Liquid Soap",,"Undeposited Funds","",179.99,1003039.01
,"Sales Receipt","01-10-2024","3224",,"Cash Sales","Zelia Green Multipurpose Liquid 12X1L","Income","Zelia Multipurpose Liquid Soap",,"Undeposited Funds","",180.00,1003219.01
,"Sales Receipt","02-10-2024","3225",,"Cash Sales","Zelia Green Multipurpose Liquid Detergent 500ML","Income","Zelia Multipurpose Liquid Soap",,"Undeposited Funds","",152.00,1003371.01
,"Sales Receipt","02-10-2024","3225",,"Cash Sales","Zelia Green Multipurpose Liquid 24X500ML","Income","Zelia Multipurpose Liquid Soap",,"Undeposited Funds","",152.00,1003523.01
,"Sales Receipt","02-10-2024","3226",,"Cash Sales","Zelia Green Multipurpose Liquid 4X5L","Income","Zelia Multipurpose Liquid Soap",,"Undeposited Funds","",610.00,1004133.01
,"Sales Receipt","02-10-2024","3227",,"Cash Sales","Zelia Green Multipurpose Liquid 4X5L","Income","Zelia Multipurpose Liquid Soap",,"Undeposited Funds","",550.00,1004683.01
,"Sales Receipt","02-10-2024","3228",,"Cash Sales","Zelia Green Multipurpose Liquid 12X1L","Income","Zelia Multipurpose Liquid Soap",,"Undeposited Funds","",720.00,1005403.01
,"Invoice","03-10-2024","MC06224",,"THE REAL IPM COMPANY (KENYA)LIMITED","Zelia Green Multipurpose Liquid Detergent 20L","Income","Zelia Multipurpose Liquid Soap",,"Accounts Receivable","",12000.00,1017403.01
,"Sales Receipt","03-10-2024","3241",,"Cash Sales","Zelia Green Multipurpose Liquid 4X5L","Income","Zelia Multipurpose Liquid Soap",,"Undeposited Funds","",550.00,1017953.01
,"Sales Receipt","03-10-2024","3243",,"Cash Sales","Zelia Green Multipurpose Liquid 4X5L","Income","Zelia Multipurpose Liquid Soap",,"Undeposited Funds","",493.00,1018446.01
,"Sales Receipt","04-10-2024","3253",,"Cash Sales","Zelia Green Multipurpose Liquid 12X1L","Income","Zelia Multipurpose Liquid Soap",,"Undeposited Funds","",136.00,1018582.01
,"Sales Receipt","06-10-2024","3184",,"Precious Mart","Zelia Green Multipurpose Liquid 24X500ML","Income","Zelia Multipurpose Liquid Soap",,"Undeposited Funds","",282.00,1018864.01
,"Sales Receipt","06-10-2024","3422",,"Mikara Shop","Zelia Green Multipurpose Liquid 12X1L","Income","Zelia Multipurpose Liquid Soap",,"Undeposited Funds","",316.00,1019180.01
,"Sales Receipt","06-10-2024","3423",,"Jikweri Minimart","Zelia Green Multipurpose Liquid 24X500ML","Income","Zelia Multipurpose Liquid Soap",,"Undeposited Funds","",188.00,1019368.01
,"Sales Receipt","07-10-2024","3255",,"Cash Sales","Zelia Green Multipurpose Liquid 4X5L","Income","Zelia Multipurpose Liquid Soap",,"Undeposited Funds","",1950.00,1021318.01
,"Sales Receipt","08-10-2024","3261",,"Cash Sales","Zelia Green Multipurpose Liquid 4X5L","Income","Zelia Multipurpose Liquid Soap",,"Undeposited Funds","",1300.00,1022618.01
,"Sales Receipt","08-10-2024","3263",,"Cash Sales","Zelia Green Multipurpose Liquid 4X5L","Income","Zelia Multipurpose Liquid Soap",,"Undeposited Funds","",1240.00,1023858.01
,"Sales Receipt","08-10-2024","3264",,"Cash Sales","Zelia Green Multipurpose Liquid 4X5L","Income","Zelia Multipurpose Liquid Soap",,"Undeposited Funds","",650.00,1024508.01
,"Sales Receipt","08-10-2024","3267",,"Cash Sales","Zelia Green Multipurpose Liquid 4X5L","Income","Zelia Multipurpose Liquid Soap",,"Undeposited Funds","",493.00,1025001.01
,"Sales Receipt","08-10-2024","3270",,"Cash Sales","Zelia Green Multipurpose Liquid 24X500ML","Income","Zelia Multipurpose Liquid Soap",,"Undeposited Funds","",75.01,1025076.02
,"Sales Receipt","09-10-2024","3274",,"Cash Sales","Zelia Green Multipurpose Liquid 4X5L","Income","Zelia Multipurpose Liquid Soap",,"Undeposited Funds",0.00,"",1025076.02
,"Sales Receipt","09-10-2024","3275",,"Cash Sales","Zelia Green Multipurpose Liquid 4X5L","Income","Zelia Multipurpose Liquid Soap",,"Undeposited Funds","",650.00,1025726.02
,"Sales Receipt","09-10-2024","3276",,"Cash Sales","Zelia Green Multipurpose Liquid 12X1L","Income","Zelia Multipurpose Liquid Soap",,"Undeposited Funds",0.00,"",1025726.02
,"Sales Receipt","09-10-2024","3279",,"Cash Sales","Zelia Green Multipurpose Liquid 4X5L","Income","Zelia Multipurpose Liquid Soap",,"Undeposited Funds","",500.00,1026226.02
,"Invoice","11-10-2024","MC06251",,"HOPEMART SELF SERVICES LTD","Zelia Green Multipurpose Liquid 12X1L  6 Pieces @183.28","Income","Zelia Multipurpose Liquid Soap",,"Accounts Receivable","",948.00,1027174.02
,"Sales Receipt","11-10-2024","3289",,"Cash Sales","Zelia Green Multipurpose Liquid 4X5L","Income","Zelia Multipurpose Liquid Soap",,"Undeposited Funds","",650.00,1027824.02
,"Sales Receipt","11-10-2024","3291",,"Cash Sales","Zelia Green Multipurpose Liquid 12X1L","Income","Zelia Multipurpose Liquid Soap",,"Undeposited Funds","",274.01,1028098.03
,"Sales Receipt","12-10-2024","3294",,"Afrodrip JKIA","Zelia Green Multipurpose Liquid 4X5L","Income","Zelia Multipurpose Liquid Soap",,"Undeposited Funds","",2232.00,1030330.03
,"Sales Receipt","14-10-2024","3297",,"Cash Sales","Zelia Green Multipurpose Liquid 4X5L","Income","Zelia Multipurpose Liquid Soap",,"Undeposited Funds","",1200.00,1031530.03
,"Sales Receipt","14-10-2024","3102",,"Cash Sales","Zelia Green Multipurpose Liquid 12X1L","Income","Zelia Multipurpose Liquid Soap",,"Undeposited Funds","",136.99,1031667.02
,"Sales Receipt","14-10-2024","3103",,"Cash Sales","Zelia Green Multipurpose Liquid 4X5L","Income","Zelia Multipurpose Liquid Soap",,"Undeposited Funds","",493.00,1032160.02
,"Sales Receipt","14-10-2024","3178",,"Adam Mart","Zelia Green Multipurpose Liquid 24X500ML","Income","Zelia Multipurpose Liquid Soap",,"Undeposited Funds","",1140.00,1033300.02
,"Sales Receipt","15-10-2024","3187",,"Big Fish Minimart","Zelia Green Multipurpose Liquid 12X1L","Income","Zelia Multipurpose Liquid Soap",,"Undeposited Funds","",453.00,1033753.02
,"Sales Receipt","16-10-2024","3109",,"Cash Sales","Zelia Green Multipurpose Liquid 4X5L","Income","Zelia Multipurpose Liquid Soap",,"Undeposited Funds","",650.00,1034403.02
,"Sales Receipt","16-10-2024","3114",,"Bismillahi Shop","Zelia Green Multipurpose Liquid 24X500ML","Income","Zelia Multipurpose Liquid Soap",,"Undeposited Funds","",1056.00,1035459.02
,"Invoice","17-10-2024","MC06269",,"MUHINDI MWEUSI SUPERMARKET LIMITED","-MULTIPLE-","Income","Zelia Multipurpose Liquid Soap",,"Accounts Receivable","",2952.00,1038411.02
,"Sales Receipt","17-10-2024","3116",,"Cash Sales","Zelia Green Multipurpose Liquid 24X500ML","Income","Zelia Multipurpose Liquid Soap",,"Undeposited Funds","",151.99,1038563.01
,"Sales Receipt","17-10-2024","3120",,"Cash Sales","Zelia Green Multipurpose Liquid 24X500ML","Income","Zelia Multipurpose Liquid Soap",,"Undeposited Funds",0.00,"",1038563.01
,"Sales Receipt","18-10-2024","3121",,"Cash Sales","Zelia Green Multipurpose Liquid 4X5L","Income","Zelia Multipurpose Liquid Soap",,"Undeposited Funds","",660.00,1039223.01
,"Sales Receipt","18-10-2024","3125",,"Cash Sales","Zelia Green Multipurpose Liquid 12X1L","Income","Zelia Multipurpose Liquid Soap",,"Undeposited Funds","",149.99,1039373.00
,"Sales Receipt","18-10-2024","3129",,"Cash Sales","Zelia Green Multipurpose Liquid 4X5L","Income","Zelia Multipurpose Liquid Soap",,"Undeposited Funds","",600.00,1039973.00
,"Sales Receipt","19-10-2024","3179",,"Kweli Shop","-MULTIPLE-","Income","Zelia Multipurpose Liquid Soap",,"Undeposited Funds","",1317.50,1041290.50
,"Sales Receipt","22-10-2024","3131",,"Cash Sales","Zelia Green Multipurpose Liquid 4X5L","Income","Zelia Multipurpose Liquid Soap",,"Undeposited Funds","",650.00,1041940.50
,"Sales Receipt","23-10-2024","3136",,"Cash Sales","Zelia Green Multipurpose Liquid 4X5L","Income","Zelia Multipurpose Liquid Soap",,"Undeposited Funds","",650.00,1042590.50
,"Sales Receipt","23-10-2024","3138",,"Cash Sales","Zelia Green Multipurpose Liquid 4X5L","Income","Zelia Multipurpose Liquid Soap",,"Undeposited Funds","",650.00,1043240.50
,"Sales Receipt","23-10-2024","3142",,"Cash Sales","Zelia Green Multipurpose Liquid 12X1L","Income","Zelia Multipurpose Liquid Soap",,"Undeposited Funds","",149.99,1043390.49
,"Sales Receipt","23-10-2024","3144",,"Cash Sales","Zelia Green Multipurpose Liquid 12X1L","Income","Zelia Multipurpose Liquid Soap",,"Undeposited Funds","",136.99,1043527.48
,"Sales Receipt","23-10-2024","3145",,"Cash Sales","Zelia Green Multipurpose Liquid 24X500ML","Income","Zelia Multipurpose Liquid Soap",,"Undeposited Funds","",76.01,1043603.49
,"Sales Receipt","23-10-2024","3141",,"Kibibi Wasai Store","Zelia Green Multipurpose Liquid 12X1L","Income","Zelia Multipurpose Liquid Soap",,"Undeposited Funds","",3666.00,1047269.49
,"Invoice","24-10-2024","MC06290",,"THE REAL IPM COMPANY (KENYA)LIMITED","Zelia Green Multipurpose Liquid Detergent 20L","Income","Zelia Multipurpose Liquid Soap",,"Accounts Receivable","",12000.00,1059269.49
,"Sales Receipt","24-10-2024","3147",,"Cash Sales","Zelia Green Multipurpose Liquid 4X5L","Income","Zelia Multipurpose Liquid Soap",,"Undeposited Funds","",650.00,1059919.49
,"Sales Receipt","24-10-2024","3148",,"Cash Sales","Zelia Green Multipurpose Liquid 4X5L","Income","Zelia Multipurpose Liquid Soap",,"Undeposited Funds","",660.00,1060579.49
,"Sales Receipt","24-10-2024","3165",,"Mombasa Velvet","Zelia Green Multipurpose Liquid 4X5L","Income","Zelia Multipurpose Liquid Soap",,"Undeposited Funds","",571.00,1061150.49
,"Sales Receipt","24-10-2024","3153",,"Golden Store","Zelia Green Multipurpose Liquid 12X1L","Income","Zelia Multipurpose Liquid Soap",,"Undeposited Funds","",3792.00,1064942.49
,"Invoice","25-10-2024","MC06300",,"HAPPY VIEW SUPERMARKET LIMITED","Zelia Green Multipurpose Liquid 24X500ML  6Pcs @102","Income","Zelia Multipurpose Liquid Soap",,"Accounts Receivable","",527.59,1065470.08
,"Sales Receipt","25-10-2024","3159",,"Marris Mini mart","Zelia Green Multipurpose Liquid 24X500ML","Income","Zelia Multipurpose Liquid Soap",,"Undeposited Funds","",264.00,1065734.08
,"Sales Receipt","26-10-2024","3161",,"Cash Sales","Zelia Green Multipurpose Liquid 4X5L","Income","Zelia Multipurpose Liquid Soap",,"Undeposited Funds","",650.00,1066384.08
,"Invoice","28-10-2024","MC06313",,"MUHINDI MWEUSI SUPERMARKET LIMITED","-MULTIPLE-","Income","Zelia Multipurpose Liquid Soap",,"Accounts Receivable","",2968.97,1069353.05
,"Sales Receipt","28-10-2024","3166",,"Cash Sales","Zelia Green Multipurpose Liquid 4X5L","Income","Zelia Multipurpose Liquid Soap",,"Undeposited Funds","",493.00,1069846.05
,"Sales Receipt","28-10-2024","3181",,"Mahitaji Store","Zelia Green Multipurpose Liquid 12X1L","Income","Zelia Multipurpose Liquid Soap",,"Undeposited Funds","",755.00,1070601.05
,"Sales Receipt","29-10-2024","3169",,"Cash Sales","Zelia Green Multipurpose Liquid 4X5L","Income","Zelia Multipurpose Liquid Soap",,"Undeposited Funds","",493.00,1071094.05
,"Sales Receipt","29-10-2024","3170",,"Cash Sales","Zelia Green Multipurpose Liquid 12X1L","Income","Zelia Multipurpose Liquid Soap",,"Undeposited Funds","",136.99,1071231.04
,"Sales Receipt","29-10-2024","3704",,"Home Soko Minimart","-MULTIPLE-","Income","Zelia Multipurpose Liquid Soap",,"Undeposited Funds","",1233.00,1072464.04
,"Invoice","30-10-2024","MC06322",,"OFFSHORE GLOBAL LOGISTICS LIMITED","-MULTIPLE-","Income","Zelia Multipurpose Liquid Soap",,"Accounts Receivable","",3100.00,1075564.04
,"Sales Receipt","31-10-2024","3192",,"Cash Sales","Zelia Green Multipurpose Liquid 4X5L","Income","Zelia Multipurpose Liquid Soap",,"Undeposited Funds","",1710.00,1077274.04
,"Sales Receipt","01-11-2024","3417",,"Cash Sales","Zelia Green Multipurpose Liquid 4X5L","Income","Zelia Multipurpose Liquid Soap",,"Undeposited Funds","",1950.00,1079224.04
,"Sales Receipt","04-11-2024","3708",,"Gure Yare Shop","Zelia Green Multipurpose Liquid 4X5L","Income","Zelia Multipurpose Liquid Soap",,"Undeposited Funds","",5940.00,1085164.04
,"Sales Receipt","04-11-2024","3453",,"Zambia Shopping Centre","Zelia Green Multipurpose Liquid 24X500ML","Income","Zelia Multipurpose Liquid Soap",,"Undeposited Funds","",1056.00,1086220.04
,"Sales Receipt","05-11-2024","3714",,"Marris Mini mart","Zelia Green Multipurpose Liquid 24X500ML","Income","Zelia Multipurpose Liquid Soap",,"Undeposited Funds","",264.00,1086484.04
,"Invoice","06-11-2024","MC06335",,"Guard Mart Supermarket Limited","-MULTIPLE-","Income","Zelia Multipurpose Liquid Soap",,"Accounts Receivable","",259.00,1086743.04
,"Sales Receipt","06-11-2024","3199",,"Cash Sales","Zelia Green Multipurpose Liquid 12X1L","Income","Zelia Multipurpose Liquid Soap",,"Undeposited Funds","",272.01,1087015.05
,"Sales Receipt","06-11-2024","3402",,"Cash Sales","-MULTIPLE-","Income","Zelia Multipurpose Liquid Soap",,"Undeposited Funds","",1099.00,1088114.05
,"Sales Receipt","06-11-2024","3715",,"Mama Amina","Zelia Green Multipurpose Liquid 12X1L","Income","Zelia Multipurpose Liquid Soap",,"Undeposited Funds","",1896.00,1090010.05
,"Invoice","07-11-2024","MC06338",,"Khetshi Dharamshi And Company Limited","Zelia Green Multipurpose Liquid Detergent Lite 20L","Income","Zelia Multipurpose Liquid Soap",,"Accounts Receivable","",9600.00,1099610.05
,"Sales Receipt","07-11-2024","3406",,"Cash Sales","Zelia Green Multipurpose Liquid 4X5L","Income","Zelia Multipurpose Liquid Soap",,"Undeposited Funds","",493.00,1100103.05
,"Sales Receipt","07-11-2024","3239",,"Cash Sales","Zelia Green Multipurpose Liquid 4X5L","Income","Zelia Multipurpose Liquid Soap",,"Undeposited Funds",0.00,"",1100103.05
,"Sales Receipt","07-11-2024","3457",,"Dylyn Enterprise","Zelia Green Multipurpose Liquid 12X1L","Income","Zelia Multipurpose Liquid Soap",,"Undeposited Funds","",604.00,1100707.05
,"Invoice","08-11-2024","MC06346",,"KIRINYAGA FLOUR MILLS LIMITED","Zelia Green Multipurpose Liquid Detergent 20L","Income","Zelia Multipurpose Liquid Soap",,"Accounts Receivable","",1982.76,1102689.81
,"Sales Receipt","08-11-2024","3408",,"Cash Sales","Zelia Green Multipurpose Liquid 4X5L","Income","Zelia Multipurpose Liquid Soap",,"Undeposited Funds","",493.00,1103182.81
,"Sales Receipt","08-11-2024","3409",,"Cash Sales","Zelia Green Multipurpose Liquid 4X5L","Income","Zelia Multipurpose Liquid Soap",,"Undeposited Funds","",1300.00,1104482.81
,"Sales Receipt","08-11-2024","3410",,"Cash Sales","Zelia Green Multipurpose Liquid 4X5L","Income","Zelia Multipurpose Liquid Soap",,"Undeposited Funds","",2124.00,1106606.81
,"Sales Receipt","08-11-2024","3458",,"Mama Sam Shop","Zelia Green Multipurpose Liquid 24X500ML","Income","Zelia Multipurpose Liquid Soap",,"Undeposited Funds","",755.00,1107361.81
,"Sales Receipt","11-11-2024","3420",,"Cash Sales","Zelia Green Multipurpose Liquid 20L","Income","Zelia Multipurpose Liquid Soap",,"Undeposited Funds","",2300.00,1109661.81
,"Sales Receipt","11-11-2024","3456",,"RichMind Property","Zelia Green Multipurpose Liquid 4X5L","Income","Zelia Multipurpose Liquid Soap",,"Undeposited Funds","",571.00,1110232.81
,"Sales Receipt","12-11-2024","3431",,"Cash Sales","-MULTIPLE-","Income","Zelia Multipurpose Liquid Soap",,"Undeposited Funds","",36350.00,1146582.81
,"Invoice","13-11-2024","MC06356",,"Mumsha Supamat","Zelia Green Multipurpose Liquid 24X500ML  6Pieces @105","Income","Zelia Multipurpose Liquid Soap",,"Accounts Receivable","",543.10,1147125.91
,"Sales Receipt","13-11-2024","3434",,"Cash Sales","Zelia Green Multipurpose Liquid 4X5L","Income","Zelia Multipurpose Liquid Soap",,"Undeposited Funds","",1300.00,1148425.91
,"Sales Receipt","15-11-2024","3448",,"Cash Sales","Zelia Green Multipurpose Liquid 4X5L","Income","Zelia Multipurpose Liquid Soap",,"Undeposited Funds","",650.00,1149075.91
,"Sales Receipt","15-11-2024","3732",,"Cash Sales","Zelia Green Multipurpose Liquid 4X5L","Income","Zelia Multipurpose Liquid Soap",,"Undeposited Funds","",493.00,1149568.91
,"Invoice","18-11-2024","MC06372",,"Guard Mart Supermarket Limited","-MULTIPLE-","Income","Zelia Multipurpose Liquid Soap",,"Accounts Receivable","",4236.00,1153804.91
,"Credit Note","18-11-2024","CN01073",,"Guard Mart Supermarket Limited","-MULTIPLE-","Income","Zelia Multipurpose Liquid Soap",,"Accounts Receivable",259.00,"",1153545.91
,"Sales Receipt","18-11-2024","AT200",,"Cash Sales","Zelia Green Multipurpose Liquid 20L","Income","Zelia Multipurpose Liquid Soap",,"Undeposited Funds","",10000.00,1163545.91
,"Sales Receipt","18-11-2024","3451",,"Cash Sales","Zelia Green Multipurpose Liquid 12X1L","Income","Zelia Multipurpose Liquid Soap",,"Undeposited Funds","",158.00,1163703.91
,"Sales Receipt","18-11-2024","3468",,"Cash Sales","Zelia Green Multipurpose Liquid 4X5L","Income","Zelia Multipurpose Liquid Soap",,"Undeposited Funds","",1300.00,1165003.91
,"Sales Receipt","18-11-2024","3469",,"Cash Sales","Zelia Green Multipurpose Liquid 24X500ML","Income","Zelia Multipurpose Liquid Soap",,"Undeposited Funds","",78.00,1165081.91
,"Sales Receipt","18-11-2024","3472",,"Cash Sales","Zelia Green Multipurpose Liquid 4X5L","Income","Zelia Multipurpose Liquid Soap",,"Undeposited Funds",0.00,"",1165081.91
,"Sales Receipt","18-11-2024","3473",,"Cash Sales","Zelia Green Multipurpose Liquid 24X500ML","Income","Zelia Multipurpose Liquid Soap",,"Undeposited Funds",0.00,"",1165081.91
,"Sales Receipt","18-11-2024","3495",,"Murume Shop","-MULTIPLE-","Income","Zelia Multipurpose Liquid Soap",,"Undeposited Funds","",738.00,1165819.91
,"Sales Receipt","18-11-2024","3463",,"Gifted Shop","Zelia Green Multipurpose Liquid 12X1L","Income","Zelia Multipurpose Liquid Soap",,"Undeposited Funds","",600.00,1166419.91
,"Invoice","19-11-2024","MC06377",,"THE REAL IPM COMPANY (KENYA)LIMITED","Zelia Green Multipurpose Liquid Detergent 20L","Income","Zelia Multipurpose Liquid Soap",,"Accounts Receivable","",12000.00,1178419.91
,"Sales Receipt","20-11-2024","3477",,"Cash Sales","Zelia Green Multipurpose Liquid 24X500ML","Income","Zelia Multipurpose Liquid Soap",,"Undeposited Funds",0.00,"",1178419.91
,"Sales Receipt","21-11-2024","3483",,"Cash Sales","Zelia Green Multipurpose Liquid 4X5L","Income","Zelia Multipurpose Liquid Soap",,"Undeposited Funds","",493.00,1178912.91
,"Sales Receipt","21-11-2024","3496",,"infinity Store","Zelia Green Multipurpose Liquid 4X5L","Income","Zelia Multipurpose Liquid Soap",,"Undeposited Funds","",1713.00,1180625.91
,"Sales Receipt","22-11-2024","3484",,"Cash Sales","Zelia Green Multipurpose Liquid 4X5L","Income","Zelia Multipurpose Liquid Soap",,"Undeposited Funds","",650.00,1181275.91
,"Sales Receipt","22-11-2024","3486",,"Cash Sales","Zelia Green Multipurpose Liquid 12X1L","Income","Zelia Multipurpose Liquid Soap",,"Undeposited Funds","",150.00,1181425.91
,"Sales Receipt","22-11-2024","3488",,"Cash Sales","Zelia Green Multipurpose Liquid 24X500ML","Income","Zelia Multipurpose Liquid Soap",,"Undeposited Funds","",540.00,1181965.91
,"Sales Receipt","22-11-2024","3499",,"Cash Sales","Zelia Green Multipurpose Liquid 4X5L","Income","Zelia Multipurpose Liquid Soap",,"Undeposited Funds","",1200.00,1183165.91
,"Sales Receipt","22-11-2024","3302",,"Cash Sales","Zelia Green Multipurpose Liquid 12X1L","Income","Zelia Multipurpose Liquid Soap",,"Undeposited Funds","",180.00,1183345.91
,"Sales Receipt","22-11-2024","3734",,"Cash Sales","Zelia Green Multipurpose Liquid 24X500ML","Income","Zelia Multipurpose Liquid Soap",,"Undeposited Funds","",84.00,1183429.91
,"Sales Receipt","22-11-2024","3735",,"Cash Sales","Zelia Green Multipurpose Liquid 4X5L","Income","Zelia Multipurpose Liquid Soap",,"Undeposited Funds","",493.00,1183922.91
,"Sales Receipt","22-11-2024","3494",,"Asfa Shop","-MULTIPLE-","Income","Zelia Multipurpose Liquid Soap",,"Undeposited Funds","",738.00,1184660.91
,"Sales Receipt","25-11-2024","3763",,"Domie Shop","Zelia Green Multipurpose Liquid 24X500ML","Income","Zelia Multipurpose Liquid Soap",,"Undeposited Funds","",604.00,1185264.91
,"Sales Receipt","26-11-2024","3737",,"Cash Sales","Zelia Green Multipurpose Liquid 4X5L","Income","Zelia Multipurpose Liquid Soap",,"Undeposited Funds","",610.00,1185874.91
,"Sales Receipt","26-11-2024","3500",,"Cash Sales","Zelia Green Multipurpose Liquid 4X5L","Income","Zelia Multipurpose Liquid Soap",,"Undeposited Funds","",531.00,1186405.91
,"Sales Receipt","26-11-2024","3740",,"Afrodrip JKIA","Zelia Green Multipurpose Liquid 4X5L","Income","Zelia Multipurpose Liquid Soap",,"Undeposited Funds","",2855.00,1189260.91
,"Sales Receipt","27-11-2024","3742",,"Cash Sales","Zelia Green Multipurpose Liquid 4X5L","Income","Zelia Multipurpose Liquid Soap",,"Undeposited Funds",0.00,"",1189260.91
,"Sales Receipt","27-11-2024","3739",,"Eugombe Enterprises","Zelia Green Multipurpose Liquid 24X500ML","Income","Zelia Multipurpose Liquid Soap",,"Undeposited Funds","",2160.00,1191420.91
,"Sales Receipt","28-11-2024","3750",,"Cash Sales","Zelia Green Multipurpose Liquid 4X5L","Income","Zelia Multipurpose Liquid Soap",,"Undeposited Funds","",1300.00,1192720.91
,"Invoice","29-11-2024","MC06427",,"THE REAL IPM COMPANY (KENYA)LIMITED","Zelia Green Multipurpose Liquid Detergent 20L","Income","Zelia Multipurpose Liquid Soap",,"Accounts Receivable","",12000.00,1204720.91
,"Sales Receipt","29-11-2024","3754",,"Cash Sales","Zelia Green Multipurpose Liquid 12X1L","Income","Zelia Multipurpose Liquid Soap",,"Undeposited Funds","",170.00,1204890.91
,"Sales Receipt","29-11-2024","3755",,"Cash Sales","Zelia Green Multipurpose Liquid 4X5L","Income","Zelia Multipurpose Liquid Soap",,"Undeposited Funds","",571.00,1205461.91
,"Sales Receipt","29-11-2024","3757",,"Cash Sales","Zelia Green Multipurpose Liquid 4X5L","Income","Zelia Multipurpose Liquid Soap",,"Undeposited Funds","",493.00,1205954.91
,"Sales Receipt","29-11-2024","3758",,"Cash Sales","Zelia Green Multipurpose Liquid 20L","Income","Zelia Multipurpose Liquid Soap",,"Undeposited Funds","",2000.00,1207954.91
,"Sales Receipt","29-11-2024","3789",,"Ubwete Shop","-MULTIPLE-","Income","Zelia Multipurpose Liquid Soap",,"Undeposited Funds","",1476.00,1209430.91
,"Sales Receipt","30-11-2024","3760",,"Cash Sales","Zelia Green Multipurpose Liquid 12X1L","Income","Zelia Multipurpose Liquid Soap",,"Undeposited Funds","",320.00,1209750.91
,"Sales Receipt","30-11-2024","AT203",,"Cash Sales","Zelia Green Multipurpose Liquid 4X5L","Income","Zelia Multipurpose Liquid Soap",,"Undeposited Funds","",13200.00,1222950.91
,"Sales Receipt","02-12-2024","3761",,"Cash Sales","Zelia Green Multipurpose Liquid 4X5L","Income","Zelia Multipurpose Liquid Soap",,"Undeposited Funds","",610.00,1223560.91
,"Sales Receipt","02-12-2024","3767",,"Cash Sales","Zelia Green Multipurpose Liquid 4X5L","Income","Zelia Multipurpose Liquid Soap",,"Undeposited Funds","",650.00,1224210.91
,"Sales Receipt","02-12-2024","3778",,"Cash Sales","Zelia Green Multipurpose Liquid 4X5L","Income","Zelia Multipurpose Liquid Soap",,"Undeposited Funds","",493.00,1224703.91
,"Invoice","03-12-2024","MC06435",,"KIRINYAGA FLOUR MILLS LIMITED","Zelia Green Multipurpose Liquid Detergent 20L","Income","Zelia Multipurpose Liquid Soap",,"Accounts Receivable","",1982.76,1226686.67
,"Invoice","05-12-2024","MC06447",,"NASRI MART LIMITED","Zelia Green Multipurpose Liquid 24X500Ml  6Pcs@116","Income","Zelia Multipurpose Liquid Soap",,"Accounts Receivable","",600.00,1227286.67
,"Invoice","09-12-2024","MC06452",,"DISII TRADERS LTD","Zelia Green Multipurpose Liquid 24X500ML  12Pcs @102","Income","Zelia Multipurpose Liquid Soap",,"Accounts Receivable","",1055.17,1228341.84
,"Invoice","09-12-2024","MC06454",,"THE REAL IPM COMPANY (KENYA)LIMITED","Zelia Green Multipurpose Liquid Detergent 20L","Income","Zelia Multipurpose Liquid Soap",,"Accounts Receivable","",12000.00,1240341.84
,"Invoice","09-12-2024","MC06456",,"OFFSHORE GLOBAL LOGISTICS LIMITED","-MULTIPLE-","Income","Zelia Multipurpose Liquid Soap",,"Accounts Receivable","",3100.00,1243441.84
,"Sales Receipt","09-12-2024","3313",,"Cash Sales","Zelia Green Multipurpose Liquid 4X5L","Income","Zelia Multipurpose Liquid Soap",,"Undeposited Funds","",1300.00,1244741.84
,"Sales Receipt","09-12-2024","3316",,"Cash Sales","Zelia Green Multipurpose Liquid 4X5L","Income","Zelia Multipurpose Liquid Soap",,"Undeposited Funds","",571.00,1245312.84
,"Sales Receipt","09-12-2024","3317",,"Cash Sales","Zelia Green Multipurpose Liquid 12X1L","Income","Zelia Multipurpose Liquid Soap",,"Undeposited Funds","",150.00,1245462.84
,"Sales Receipt","09-12-2024","3318",,"Cash Sales","Zelia Green Multipurpose Liquid 4X5L","Income","Zelia Multipurpose Liquid Soap",,"Undeposited Funds","",1142.00,1246604.84
,"Sales Receipt","09-12-2024","3315",,"Shop 5","-MULTIPLE-","Income","Zelia Multipurpose Liquid Soap",,"Undeposited Funds","",4008.00,1250612.84
,"Sales Receipt","10-12-2024","3347",,"Beta Traders","Zelia Green Multipurpose Liquid 24X500ML","Income","Zelia Multipurpose Liquid Soap",,"Undeposited Funds","",1056.00,1251668.84
,"Sales Receipt","12-12-2024","3337",,"Mombasa Velvet","Zelia Green Multipurpose Liquid 4X5L","Income","Zelia Multipurpose Liquid Soap",,"Undeposited Funds","",1142.00,1252810.84
,"Sales Receipt","13-12-2024","3340",,"Cash Sales","Zelia Green Multipurpose Liquid 4X5L","Income","Zelia Multipurpose Liquid Soap",,"Undeposited Funds","",660.00,1253470.84
,"Sales Receipt","14-12-2024","3378",,"Egesa Shop","Zelia Green Multipurpose Liquid 12X1L","Income","Zelia Multipurpose Liquid Soap",,"Undeposited Funds","",510.00,1253980.84
,"Sales Receipt","16-12-2024","3342",,"Cash Sales","Zelia Green Multipurpose Liquid 12X1L","Income","Zelia Multipurpose Liquid Soap",,"Undeposited Funds","",180.00,1254160.84
,"Sales Receipt","16-12-2024","3345",,"Cash Sales","-MULTIPLE-","Income","Zelia Multipurpose Liquid Soap",,"Undeposited Funds","",760.00,1254920.84
,"Sales Receipt","16-12-2024","3348",,"Cash Sales","Zelia Green Multipurpose Liquid 4X5L","Income","Zelia Multipurpose Liquid Soap",,"Undeposited Funds","",650.00,1255570.84
,"Sales Receipt","16-12-2024","3353",,"Cash Sales","Zelia Green Multipurpose Liquid 4X5L","Income","Zelia Multipurpose Liquid Soap",,"Undeposited Funds","",986.00,1256556.84
,"Invoice","17-12-2024","MC06476",,"MUHINDI MWEUSI SUPERMARKET LIMITED","-MULTIPLE-","Income","Zelia Multipurpose Liquid Soap",,"Accounts Receivable","",2968.96,1259525.80
,"Invoice","17-12-2024","MC06477",,"OFFSHORE GLOBAL LOGISTICS LIMITED","Zelia Green Multipurpose Liquid 4X5L","Income","Zelia Multipurpose Liquid Soap",,"Accounts Receivable","",1300.00,1260825.80
,"Sales Receipt","18-12-2024","3360",,"Cash Sales","Zelia Green Multipurpose Liquid 4X5L","Income","Zelia Multipurpose Liquid Soap",,"Undeposited Funds","",509.00,1261334.80
,"Sales Receipt","18-12-2024","3361",,"Cash Sales","Zelia Green Multipurpose Liquid 4X5L","Income","Zelia Multipurpose Liquid Soap",,"Undeposited Funds","",493.00,1261827.80
,"Sales Receipt","18-12-2024","3362",,"Cash Sales","Zelia Green Multipurpose Liquid 4X5L","Income","Zelia Multipurpose Liquid Soap",,"Undeposited Funds","",493.00,1262320.80
,"Sales Receipt","18-12-2024","3363",,"Cash Sales","Zelia Green Multipurpose Liquid 12X1L","Income","Zelia Multipurpose Liquid Soap",,"Undeposited Funds","",408.00,1262728.80
,"Sales Receipt","18-12-2024","3372",,"Cash Sales","Zelia Green Multipurpose Liquid 4X5L","Income","Zelia Multipurpose Liquid Soap",,"Undeposited Funds","",17400.00,1280128.80
,"Sales Receipt","18-12-2024","3364",,"Gold mart Supermarket","Zelia Green Multipurpose Liquid 24X500ML","Income","Zelia Multipurpose Liquid Soap",,"Undeposited Funds","",528.00,1280656.80
,"Sales Receipt","19-12-2024","3373",,"Cash Sales","Zelia Green Multipurpose Liquid 4X5L","Income","Zelia Multipurpose Liquid Soap",,"Undeposited Funds",0.00,"",1280656.80
,"Sales Receipt","20-12-2024","3376",,"Cash Sales","Zelia Green Multipurpose Liquid 4X5L","Income","Zelia Multipurpose Liquid Soap",,"Undeposited Funds","",650.00,1281306.80
,"Invoice","21-12-2024","MC06496",,"KIRINYAGA FLOUR MILLS LIMITED","Zelia Green Multipurpose Liquid Detergent 20L","Income","Zelia Multipurpose Liquid Soap",,"Accounts Receivable","",1982.76,1283289.56
,"Invoice","23-12-2024","MC06497",,"KIRINYAGA FLOUR MILLS LIMITED","Zelia Green Multipurpose Liquid Detergent 20L","Income","Zelia Multipurpose Liquid Soap",,"Accounts Receivable","",1982.76,1285272.32
,"Invoice","31-12-2024","MC06517",,"THE REAL IPM COMPANY (KENYA)LIMITED","Zelia Green Multipurpose Liquid Detergent 20L","Income","Zelia Multipurpose Liquid Soap",,"Accounts Receivable","",12000.00,1297272.32
"Total Zelia Multipurpose Liquid Soap",,,,,,,,,,,3548.65,1300820.97,1297272.32
"Zelia Dishwashing Paste",,,,,,,,,,,,,""
,"Sales Receipt","03-01-2024","1592",,"Cash Sales","Zelia Dishwashing Paste 400g","Income","Zelia Dishwashing Paste",,"Undeposited Funds","",300.00,300.00
,"Sales Receipt","03-01-2024","1594",,"ROYAL SEALS SUPERMARKET","Zelia Dishwashing Paste 400g","Income","Zelia Dishwashing Paste",,"Undeposited Funds","",1476.00,1776.00
,"Sales Receipt","03-01-2024","1595",,"Restoration Traders","Zelia Dishwashing Paste 400g","Income","Zelia Dishwashing Paste",,"Undeposited Funds","",2952.00,4728.00
,"Sales Receipt","03-01-2024","1596",,"Cash Sales","Zelia Dishwashing Paste 400g","Income","Zelia Dishwashing Paste",,"Undeposited Funds",0.00,"",4728.00
,"Sales Receipt","03-01-2024","1599",,"Cash Sales","Zelia Dishwashing Paste 400g","Income","Zelia Dishwashing Paste",,"Undeposited Funds","",220.00,4948.00
,"Sales Receipt","04-01-2024","1704",,"Cash Sales","Zelia Dishwashing Paste 400g","Income","Zelia Dishwashing Paste",,"Undeposited Funds",0.00,"",4948.00
,"Sales Receipt","04-01-2024","1706",,"Tawakal Wholesale Eastleigh","Zelia Dishwashing Paste 400g","Income","Zelia Dishwashing Paste",,"Undeposited Funds","",8856.00,13804.00
,"Sales Receipt","04-01-2024","1710",,"Sahal General Stores","Zelia Dishwashing Paste 400g","Income","Zelia Dishwashing Paste",,"Undeposited Funds","",2952.00,16756.00
,"Invoice","05-01-2024","MC05272",,"Mumsha Supamat","Zelia Dishwashing Paste 400g","Income","Zelia Dishwashing Paste",,"Accounts Receivable","",739.65,17495.65
,"Sales Receipt","05-01-2024","1600",,"Cash Sales","Zelia Dishwashing Paste 400g","Income","Zelia Dishwashing Paste",,"Undeposited Funds","",900.00,18395.65
,"Sales Receipt","05-01-2024","1711",,"Summer Outlets","Zelia Dishwashing Paste 400g","Income","Zelia Dishwashing Paste",,"Undeposited Funds","",1476.00,19871.65
,"Sales Receipt","08-01-2024","1715",,"Cash Sales","Zelia Dishwashing Paste 400g","Income","Zelia Dishwashing Paste",,"Undeposited Funds","",600.00,20471.65
,"Sales Receipt","09-01-2024","1717",,"Cash Sales","Zelia Dishwashing Paste 400g","Income","Zelia Dishwashing Paste",,"Undeposited Funds","",600.00,21071.65
,"Sales Receipt","09-01-2024","1720",,"Kwiksave supermarket","Zelia Dishwashing Paste 400g","Income","Zelia Dishwashing Paste",,"Undeposited Funds","",2952.00,24023.65
,"Sales Receipt","10-01-2024","1718",,"Memos Supermarket","Zelia Dishwashing Paste 400g","Income","Zelia Dishwashing Paste",,"Undeposited Funds","",1476.00,25499.65
,"Sales Receipt","10-01-2024","1722",,"Cash Sales","Zelia Dishwashing Paste 400g","Income","Zelia Dishwashing Paste",,"Undeposited Funds","",300.00,25799.65
,"Sales Receipt","11-01-2024","1723",,"Cash Sales","Zelia Dishwashing Paste 400g","Income","Zelia Dishwashing Paste",,"Undeposited Funds","",300.00,26099.65
,"Sales Receipt","11-01-2024","1724",,"Mashallah Foodstuffs","Zelia Dishwashing Paste 400g","Income","Zelia Dishwashing Paste",,"Undeposited Funds","",2952.00,29051.65
,"Invoice","12-01-2024","MC05298",,"MUHINDI MWEUSI SUPERMARKET LIMITED","Zelia Dishwashing Paste 400g","Income","Zelia Dishwashing Paste",,"Accounts Receivable","",5917.24,34968.89
,"Invoice","12-01-2024","MC05299",,"MUHINDI MWEUSI SUPERMARKET LIMITED","Zelia Dishwashing Paste 400g","Income","Zelia Dishwashing Paste",,"Accounts Receivable","",2958.62,37927.51
,"Invoice","12-01-2024","MC05300",,"MUHINDI MWEUSI SUPERMARKET LIMITED","Zelia Dishwashing Paste 400g","Income","Zelia Dishwashing Paste",,"Accounts Receivable","",2958.62,40886.13
,"Invoice","12-01-2024","MC05301",,"MUHINDI MWEUSI SUPERMARKET LIMITED","Zelia Dishwashing Paste 400g","Income","Zelia Dishwashing Paste",,"Accounts Receivable","",1479.31,42365.44
,"Invoice","12-01-2024","MC05302",,"MUHINDI MWEUSI SUPERMARKET LIMITED","Zelia Dishwashing Paste 400g","Income","Zelia Dishwashing Paste",,"Accounts Receivable","",1479.31,43844.75
,"Invoice","12-01-2024","MC05306",,"Azaavi Collections Limited","Zelia Dishwashing Paste 400g","Income","Zelia Dishwashing Paste",,"Accounts Receivable","",246.55,44091.30
,"Sales Receipt","12-01-2024","1725",,"Cash Sales","Zelia Dishwashing Paste 400g","Income","Zelia Dishwashing Paste",,"Undeposited Funds","",3360.00,47451.30
,"Sales Receipt","12-01-2024","1733",,"Cash Sales","Zelia Dishwashing Paste 400g","Income","Zelia Dishwashing Paste",,"Undeposited Funds","",450.00,47901.30
,"Invoice","15-01-2024","MC05308",,"MUHINDI MWEUSI SUPERMARKET LIMITED","Zelia Dishwashing Paste 400g","Income","Zelia Dishwashing Paste",,"Accounts Receivable","",2958.62,50859.92
,"Invoice","15-01-2024","MC05309",,"MUHINDI MWEUSI SUPERMARKET LIMITED","Zelia Dishwashing Paste 400g","Income","Zelia Dishwashing Paste",,"Accounts Receivable","",1479.31,52339.23
,"Invoice","15-01-2024","MC05310",,"MUHINDI MWEUSI SUPERMARKET LIMITED","Zelia Dishwashing Paste 400g","Income","Zelia Dishwashing Paste",,"Accounts Receivable","",1479.31,53818.54
,"Invoice","15-01-2024","MC05311",,"Seasons lane Mart","Zelia Dishwashing Paste 400g","Income","Zelia Dishwashing Paste",,"Accounts Receivable","",1479.31,55297.85
,"Invoice","15-01-2024","MC05312",,"KASAMAT INVESTMENTS LTD","Zelia Dishwashing Paste 400g","Income","Zelia Dishwashing Paste",,"Accounts Receivable","",739.65,56037.50
,"Invoice","15-01-2024","MC05315",,"MUHINDI MWEUSI SUPERMARKET LIMITED","Zelia Dishwashing Paste 400g","Income","Zelia Dishwashing Paste",,"Accounts Receivable","",2958.62,58996.12
,"Sales Receipt","15-01-2024","1729",,"Cash Sales","Zelia Dishwashing Paste 400g","Income","Zelia Dishwashing Paste",,"Undeposited Funds","",220.00,59216.12
,"Sales Receipt","15-01-2024","1730",,"tRIPPLE M","Zelia Dishwashing Paste 400g","Income","Zelia Dishwashing Paste",,"Undeposited Funds","",738.00,59954.12
,"Sales Receipt","16-01-2024","1740",,"Cash Sales","Zelia Dishwashing Paste 400g","Income","Zelia Dishwashing Paste",,"Undeposited Funds","",281.00,60235.12
,"Sales Receipt","17-01-2024","1735",,"B Shop","Zelia Dishwashing Paste 400g","Income","Zelia Dishwashing Paste",,"Undeposited Funds","",2952.00,63187.12
,"Sales Receipt","17-01-2024","1737",,"Mumtaz Shop","Zelia Dishwashing Paste 400g","Income","Zelia Dishwashing Paste",,"Undeposited Funds","",1476.00,64663.12
,"Sales Receipt","17-01-2024","1748",,"Yasin Shop","Zelia Dishwashing Paste 400g","Income","Zelia Dishwashing Paste",,"Undeposited Funds","",369.00,65032.12
,"Sales Receipt","18-01-2024","1738",,"Cash Sales","Zelia Dishwashing Paste 400g","Income","Zelia Dishwashing Paste",,"Undeposited Funds","",300.00,65332.12
,"Sales Receipt","18-01-2024","1741",,"Newclear Minimart Fedha","Zelia Dishwashing Paste 400g","Income","Zelia Dishwashing Paste",,"Undeposited Funds","",369.00,65701.12
,"Sales Receipt","19-01-2024","1739",,"Cash Sales","Zelia Dishwashing Paste 400g","Income","Zelia Dishwashing Paste",,"Undeposited Funds",0.00,"",65701.12
,"Sales Receipt","19-01-2024","1744",,"Cash Sales","Zelia Dishwashing Paste 400g","Income","Zelia Dishwashing Paste",,"Undeposited Funds","",2952.00,68653.12
,"Sales Receipt","19-01-2024","1745",,"Cash Sales","Zelia Dishwashing Paste 400g","Income","Zelia Dishwashing Paste",,"Undeposited Funds","",660.00,69313.12
,"Sales Receipt","21-01-2024","AT186",,"Cash Sales","Zelia Dishwashing Paste 400g","Income","Zelia Dishwashing Paste",,"Undeposited Funds","",2880.00,72193.12
,"Invoice","23-01-2024","MC05343",,"MUHINDI MWEUSI SUPERMARKET LIMITED","Zelia Dishwashing Paste 400g","Income","Zelia Dishwashing Paste",,"Accounts Receivable","",1479.31,73672.43
,"Sales Receipt","23-01-2024","1750",,"Mumtaz Shop","Zelia Dishwashing Paste 400g","Income","Zelia Dishwashing Paste",,"Undeposited Funds","",2952.00,76624.43
,"Sales Receipt","23-01-2024","1751",,"Cash Sales","Zelia Dishwashing Paste 400g","Income","Zelia Dishwashing Paste",,"Undeposited Funds","",300.00,76924.43
,"Sales Receipt","23-01-2024","1752",,"Cash Sales","Zelia Dishwashing Paste 400g","Income","Zelia Dishwashing Paste",,"Undeposited Funds","",220.00,77144.43
,"Invoice","24-01-2024","MC05346",,"Qways Supermarket","Zelia Dishwashing Paste 400g","Income","Zelia Dishwashing Paste",,"Accounts Receivable","",1479.31,78623.74
,"Invoice","24-01-2024","MC05347",,"MUHINDI MWEUSI SUPERMARKET LIMITED","Zelia Dishwashing Paste 400g","Income","Zelia Dishwashing Paste",,"Accounts Receivable","",2958.62,81582.36
,"Invoice","24-01-2024","MC05348",,"MUHINDI MWEUSI SUPERMARKET LIMITED","Zelia Dishwashing Paste 400g","Income","Zelia Dishwashing Paste",,"Accounts Receivable","",2958.62,84540.98
,"Sales Receipt","24-01-2024","1755",,"Alma Mart","Zelia Dishwashing Paste 400g","Income","Zelia Dishwashing Paste",,"Undeposited Funds","",1476.00,86016.98
,"Sales Receipt","24-01-2024","1756",,"Cash Sales","Zelia Dishwashing Paste 400g","Income","Zelia Dishwashing Paste",,"Undeposited Funds","",450.00,86466.98
,"Sales Receipt","24-01-2024","1757",,"Cash Sales","Zelia Dishwashing Paste 400g","Income","Zelia Dishwashing Paste",,"Undeposited Funds","",110.00,86576.98
,"Sales Receipt","29-01-2024","1762",,"Cash Sales","Zelia Dishwashing Paste 400g","Income","Zelia Dishwashing Paste",,"Undeposited Funds","",738.00,87314.98
,"Sales Receipt","29-01-2024","1763",,"Cash Sales","Zelia Dishwashing Paste 400g","Income","Zelia Dishwashing Paste",,"Undeposited Funds","",150.00,87464.98
,"Sales Receipt","29-01-2024","1764",,"Restoration Traders","Zelia Dishwashing Paste 400g","Income","Zelia Dishwashing Paste",,"Undeposited Funds","",2952.00,90416.98
,"Sales Receipt","29-01-2024","1769",,"Cash Sales","Zelia Dishwashing Paste 400g","Income","Zelia Dishwashing Paste",,"Undeposited Funds",0.00,"",90416.98
,"Sales Receipt","30-01-2024","1766",,"Cash Sales","Zelia Dishwashing Paste 400g","Income","Zelia Dishwashing Paste",,"Undeposited Funds","",520.00,90936.98
,"Sales Receipt","30-01-2024","1768",,"Cash Sales","Zelia Dishwashing Paste 400g","Income","Zelia Dishwashing Paste",,"Undeposited Funds","",150.00,91086.98
,"Sales Receipt","30-01-2024","1771",,"Arqam Savanna","Zelia Dishwashing Paste 400g","Income","Zelia Dishwashing Paste",,"Undeposited Funds","",2952.00,94038.98
,"Sales Receipt","30-01-2024","1772",,"Amina Shop","Zelia Dishwashing Paste 400g","Income","Zelia Dishwashing Paste",,"Undeposited Funds","",1476.00,95514.98
,"Sales Receipt","31-01-2024","1773",,"Cash Sales","Zelia Dishwashing Paste 400g","Income","Zelia Dishwashing Paste",,"Undeposited Funds",0.00,"",95514.98
,"Sales Receipt","31-01-2024","1774",,"Cash Sales","Zelia Dishwashing Paste 400g","Income","Zelia Dishwashing Paste",,"Undeposited Funds","",110.00,95624.98
,"Sales Receipt","31-01-2024","1778",,"Cash Sales","Zelia Dishwashing Paste 400g","Income","Zelia Dishwashing Paste",,"Undeposited Funds","",330.00,95954.98
,"Invoice","01-02-2024","MC05373",,"THE M-PESA ACADEMY","Zelia Dishwashing Paste 400g","Income","Zelia Dishwashing Paste",,"Accounts Receivable","",18720.00,114674.98
,"Sales Receipt","01-02-2024","1779",,"Cash Sales","Zelia Dishwashing Paste 400g","Income","Zelia Dishwashing Paste",,"Undeposited Funds",0.00,"",114674.98
,"Sales Receipt","01-02-2024","1780",,"Cash Sales","Zelia Dishwashing Paste 400g","Income","Zelia Dishwashing Paste",,"Undeposited Funds","",450.00,115124.98
,"Sales Receipt","01-02-2024","1789",,"Cash Sales","Zelia Dishwashing Paste 400g","Income","Zelia Dishwashing Paste",,"Undeposited Funds","",2952.00,118076.98
,"Invoice","02-02-2024","MC05378",,"MZOORI STORE LIMITED","Zelia Dishwashing Paste 400g","Income","Zelia Dishwashing Paste",,"Accounts Receivable","",1479.31,119556.29
,"Sales Receipt","02-02-2024","1782",,"Cash Sales","Zelia Dishwashing Paste 400g","Income","Zelia Dishwashing Paste",,"Undeposited Funds","",110.00,119666.29
,"Sales Receipt","02-02-2024","1783",,"Cheche Minimart","Zelia Dishwashing Paste 400g","Income","Zelia Dishwashing Paste",,"Undeposited Funds","",738.00,120404.29
,"Sales Receipt","02-02-2024","1784",,"Kandara minimart","Zelia Dishwashing Paste 400g","Income","Zelia Dishwashing Paste",,"Undeposited Funds","",738.00,121142.29
,"Sales Receipt","05-02-2024","1787",,"Cash Sales","Zelia Dishwashing Paste 400g","Income","Zelia Dishwashing Paste",,"Undeposited Funds",0.00,"",121142.29
,"Sales Receipt","05-02-2024","1788",,"Cash Sales","Zelia Dishwashing Paste 400g","Income","Zelia Dishwashing Paste",,"Undeposited Funds","",115.00,121257.29
,"Sales Receipt","05-02-2024","1794",,"Cash Sales","Zelia Dishwashing Paste 400g","Income","Zelia Dishwashing Paste",,"Undeposited Funds","",300.00,121557.29
,"Sales Receipt","06-02-2024","1800",,"Mama Amina","Zelia Dishwashing Paste 400g","Income","Zelia Dishwashing Paste",,"Undeposited Funds","",2952.00,124509.29
,"Sales Receipt","06-02-2024","1805",,"Tawakal Wholesale Eastleigh","Zelia Dishwashing Paste 400g","Income","Zelia Dishwashing Paste",,"Undeposited Funds","",5904.00,130413.29
,"Sales Receipt","06-02-2024","1807",,"Perfect Enterprise","Zelia Dishwashing Paste 400g","Income","Zelia Dishwashing Paste",,"Undeposited Funds","",1476.00,131889.29
,"Sales Receipt","06-02-2024","1808",,"Cash Sales","Zelia Dishwashing Paste 400g","Income","Zelia Dishwashing Paste",,"Undeposited Funds","",115.00,132004.29
,"Sales Receipt","07-02-2024","1810",,"Cash Sales","Zelia Dishwashing Paste 400g","Income","Zelia Dishwashing Paste",,"Undeposited Funds","",220.00,132224.29
,"Sales Receipt","07-02-2024","1812",,"Cash Sales","Zelia Dishwashing Paste 400g","Income","Zelia Dishwashing Paste",,"Undeposited Funds","",1800.00,134024.29
,"Sales Receipt","08-02-2024","1814",,"Cash Sales","Zelia Dishwashing Paste 400g","Income","Zelia Dishwashing Paste",,"Undeposited Funds",0.00,"",134024.29
,"Sales Receipt","08-02-2024","1815",,"Cash Sales","Zelia Dishwashing Paste 400g","Income","Zelia Dishwashing Paste",,"Undeposited Funds",0.00,"",134024.29
,"Sales Receipt","09-02-2024","1818",,"Cash Sales","Zelia Dishwashing Paste 400g","Income","Zelia Dishwashing Paste",,"Undeposited Funds","",228.00,134252.29
,"Sales Receipt","10-02-2024","1821",,"Alma Mart","Zelia Dishwashing Paste 400g","Income","Zelia Dishwashing Paste",,"Undeposited Funds","",738.00,134990.29
,"Invoice","12-02-2024","MC05395",,"THE M-PESA ACADEMY","Zelia Dishwashing Paste 400g","Income","Zelia Dishwashing Paste",,"Accounts Receivable","",16137.93,151128.22
,"Credit Note","12-02-2024","CN01056",,"THE M-PESA ACADEMY","Zelia Dishwashing Paste 400g","Income","Zelia Dishwashing Paste",,"Accounts Receivable",18720.00,"",132408.22
,"Invoice","12-02-2024","MC05400",,"KASAMAT INVESTMENTS LTD","Zelia Dishwashing Paste 400g","Income","Zelia Dishwashing Paste",,"Accounts Receivable","",739.66,133147.88
,"Sales Receipt","13-02-2024","1832",,"Cash Sales","Zelia Dishwashing Paste 400g","Income","Zelia Dishwashing Paste",,"Undeposited Funds","",230.00,133377.88
,"Sales Receipt","13-02-2024","1833",,"Cash Sales","Zelia Dishwashing Paste 400g","Income","Zelia Dishwashing Paste",,"Undeposited Funds","",115.00,133492.88
,"Invoice","14-02-2024","MC05405",,"MUHINDI MWEUSI SUPERMARKET LIMITED","Zelia Dishwashing Paste 400g","Income","Zelia Dishwashing Paste",,"Accounts Receivable","",1479.31,134972.19
,"Invoice","14-02-2024","MC05407",,"Qways Supermarket","Zelia Dishwashing Paste 400g","Income","Zelia Dishwashing Paste",,"Accounts Receivable","",1479.31,136451.50
,"Sales Receipt","14-02-2024","1836",,"Cheaper Cheap","Zelia Dishwashing Paste 400g","Income","Zelia Dishwashing Paste",,"Undeposited Funds","",2952.00,139403.50
,"Sales Receipt","15-02-2024","1841",,"Al Naim store","Zelia Dishwashing Paste 400g","Income","Zelia Dishwashing Paste",,"Undeposited Funds","",2952.00,142355.50
,"Sales Receipt","15-02-2024","1843",,"DHAGAXFUR WHOLESALE","Zelia Dishwashing Paste 400g","Income","Zelia Dishwashing Paste",,"Undeposited Funds","",2952.00,145307.50
,"Sales Receipt","15-02-2024","1844",,"Salman Shop","Zelia Dishwashing Paste 400g","Income","Zelia Dishwashing Paste",,"Undeposited Funds","",2952.00,148259.50
,"Sales Receipt","16-02-2024","1845",,"Cash Sales","Zelia Dishwashing Paste 400g","Income","Zelia Dishwashing Paste",,"Undeposited Funds",0.00,"",148259.50
,"Sales Receipt","16-02-2024","1847",,"Gidesh Supermarket","Zelia Dishwashing Paste 400g","Income","Zelia Dishwashing Paste",,"Undeposited Funds","",738.00,148997.50
,"Sales Receipt","16-02-2024","1852",,"Nuclear Supermarket","Zelia Dishwashing Paste 400g","Income","Zelia Dishwashing Paste",,"Undeposited Funds","",738.00,149735.50
,"Sales Receipt","17-02-2024","1851",,"MumsCereal and General Stores","Zelia Dishwashing Paste 400g","Income","Zelia Dishwashing Paste",,"Undeposited Funds","",369.00,150104.50
,"Sales Receipt","20-02-2024","1857",,"RAZAQ AIRWAYS","Zelia Dishwashing Paste 400g","Income","Zelia Dishwashing Paste",,"Undeposited Funds","",2952.00,153056.50
,"Invoice","21-02-2024","MC05422",,"THE M-PESA ACADEMY","Zelia Dishwashing Paste 400g","Income","Zelia Dishwashing Paste",,"Accounts Receivable","",8068.97,161125.47
,"Sales Receipt","21-02-2024","1855",,"Cash Sales","Zelia Dishwashing Paste 400g","Income","Zelia Dishwashing Paste",,"Undeposited Funds","",145.00,161270.47
,"Sales Receipt","21-02-2024","1859",,"Cash Sales","Zelia Dishwashing Paste 400g","Income","Zelia Dishwashing Paste",,"Undeposited Funds","",246.00,161516.47
,"Sales Receipt","21-02-2024","1860",,"Cash Sales","Zelia Dishwashing Paste 400g","Income","Zelia Dishwashing Paste",,"Undeposited Funds","",369.00,161885.47
,"Invoice","22-02-2024","MC05434",,"NASRI MART LIMITED","Zelia Dishwashing Paste 400g","Income","Zelia Dishwashing Paste",,"Accounts Receivable","",616.38,162501.85
,"Sales Receipt","22-02-2024","1865",,"Cash Sales","Zelia Dishwashing Paste 400g","Income","Zelia Dishwashing Paste",,"Undeposited Funds",0.00,"",162501.85
,"Sales Receipt","22-02-2024","1867",,"Corner Shop","Zelia Dishwashing Paste 400g","Income","Zelia Dishwashing Paste",,"Undeposited Funds","",2952.00,165453.85
,"Invoice","23-02-2024","MC05443",,"DAILY CHAMPIONS MINI SUPERMARKET LIMITED","Zelia Dishwashing Paste 400g","Income","Zelia Dishwashing Paste",,"Accounts Receivable","",1479.31,166933.16
,"Sales Receipt","23-02-2024","1870",,"Home Cell Minimart","Zelia Dishwashing Paste 400g","Income","Zelia Dishwashing Paste",,"Undeposited Funds","",738.00,167671.16
,"Invoice","26-02-2024","MC05444",,"The Joymai Blessed Stores Limited","Zelia Dishwashing Paste 400g","Income","Zelia Dishwashing Paste",,"Accounts Receivable","",739.66,168410.82
,"Invoice","26-02-2024","MC05445",,"Mumsha Supamat","Zelia Dishwashing Paste 400g","Income","Zelia Dishwashing Paste",,"Accounts Receivable","",1479.31,169890.13
,"Sales Receipt","26-02-2024","1872",,"Jombs wholesalers","Zelia Dishwashing Paste 400g","Income","Zelia Dishwashing Paste",,"Undeposited Funds","",492.00,170382.13
,"Sales Receipt","26-02-2024","1873",,"mamkon minimart","Zelia Dishwashing Paste 400g","Income","Zelia Dishwashing Paste",,"Undeposited Funds","",246.00,170628.13
,"Sales Receipt","26-02-2024","1874",,"Cash Sales","Zelia Dishwashing Paste 400g","Income","Zelia Dishwashing Paste",,"Undeposited Funds","",369.00,170997.13
,"Sales Receipt","26-02-2024","1877",,"Cash Sales","Zelia Dishwashing Paste 400g","Income","Zelia Dishwashing Paste",,"Undeposited Funds","",115.00,171112.13
,"Sales Receipt","27-02-2024","1878",,"Cash Sales","Zelia Dishwashing Paste 400g","Income","Zelia Dishwashing Paste",,"Undeposited Funds","",900.00,172012.13
,"Sales Receipt","28-02-2024","1806",,"Beraccah Wholesallers","Zelia Dishwashing Paste 400g","Income","Zelia Dishwashing Paste",,"Undeposited Funds","",738.00,172750.13
,"Sales Receipt","28-02-2024","1884",,"Amir shop","Zelia Dishwashing Paste 400g","Income","Zelia Dishwashing Paste",,"Undeposited Funds","",1476.00,174226.13
,"Sales Receipt","28-02-2024","1885",,"Amulqura Shop","Zelia Dishwashing Paste 400g","Income","Zelia Dishwashing Paste",,"Undeposited Funds","",1476.00,175702.13
,"Sales Receipt","28-02-2024","1887",,"Adno shop","Zelia Dishwashing Paste 400g","Income","Zelia Dishwashing Paste",,"Undeposited Funds","",1476.00,177178.13
,"Sales Receipt","29-02-2024","1889",,"Cash Sales","Zelia Dishwashing Paste 400g","Income","Zelia Dishwashing Paste",,"Undeposited Funds","",115.00,177293.13
,"Sales Receipt","29-02-2024","1890",,"Cash Sales","Zelia Dishwashing Paste 400g","Income","Zelia Dishwashing Paste",,"Undeposited Funds","",5250.00,182543.13
,"Sales Receipt","04-03-2024","1894",,"Cash Sales","Zelia Dishwashing Paste 400g","Income","Zelia Dishwashing Paste",,"Undeposited Funds","",150.00,182693.13
,"Sales Receipt","04-03-2024","1896",,"Cash Sales","Zelia Dishwashing Paste 400g","Income","Zelia Dishwashing Paste",,"Undeposited Funds","",240.00,182933.13
,"Sales Receipt","04-03-2024","2003",,"Cash Sales","Zelia Dishwashing Paste 400g","Income","Zelia Dishwashing Paste",,"Undeposited Funds","",342.00,183275.13
,"Sales Receipt","04-03-2024","2004",,"Cash Sales","Zelia Dishwashing Paste 400g","Income","Zelia Dishwashing Paste",,"Undeposited Funds","",300.00,183575.13
,"Invoice","05-03-2024","MC05469",,"MUHINDI MWEUSI SUPERMARKET LIMITED","Zelia Dishwashing Paste 400g","Income","Zelia Dishwashing Paste",,"Accounts Receivable","",2958.62,186533.75
,"Invoice","05-03-2024","MC05470",,"MUHINDI MWEUSI SUPERMARKET LIMITED","Zelia Dishwashing Paste 400g","Income","Zelia Dishwashing Paste",,"Accounts Receivable","",2958.62,189492.37
,"Sales Receipt","05-03-2024","2008",,"Cash Sales","Zelia Dishwashing Paste 400g","Income","Zelia Dishwashing Paste",,"Undeposited Funds","",150.00,189642.37
,"Sales Receipt","05-03-2024","2012",,"Cash Sales","Zelia Dishwashing Paste 400g","Income","Zelia Dishwashing Paste",,"Undeposited Funds","",140.00,189782.37
,"Sales Receipt","06-03-2024","2021",,"Farhan Wholesellers","Zelia Dishwashing Paste 400g","Income","Zelia Dishwashing Paste",,"Undeposited Funds","",2952.00,192734.37
,"Sales Receipt","06-03-2024","2023",,"Kenafa Wholesalers","Zelia Dishwashing Paste 400g","Income","Zelia Dishwashing Paste",,"Undeposited Funds","",1476.00,194210.37
,"Sales Receipt","06-03-2024","2025",,"Wadajir Wholesallers","Zelia Dishwashing Paste 400g","Income","Zelia Dishwashing Paste",,"Undeposited Funds","",28800.00,223010.37
,"Sales Receipt","06-03-2024","2025",,"Wadajir Wholesallers","Zelia Dishwashing Paste 400g","Income","Zelia Dishwashing Paste",,"Undeposited Funds",0.00,"",223010.37
,"Sales Receipt","06-03-2024","2027",,"Khalifa Shop","Zelia Dishwashing Paste 400g","Income","Zelia Dishwashing Paste",,"Undeposited Funds","",1476.00,224486.37
,"Sales Receipt","06-03-2024","2035",,"Cash Sales","Zelia Dishwashing Paste 400g","Income","Zelia Dishwashing Paste",,"Undeposited Funds","",456.00,224942.37
,"Sales Receipt","07-03-2024","2028",,"Cash Sales","Zelia Dishwashing Paste 400g","Income","Zelia Dishwashing Paste",,"Undeposited Funds","",1800.00,226742.37
,"Sales Receipt","07-03-2024","2029",,"Cash Sales","Zelia Dishwashing Paste 400g","Income","Zelia Dishwashing Paste",,"Undeposited Funds","",114.00,226856.37
,"Sales Receipt","07-03-2024","2031",,"Cash Sales","Zelia Dishwashing Paste 400g","Income","Zelia Dishwashing Paste",,"Undeposited Funds","",450.00,227306.37
,"Sales Receipt","07-03-2024","2032",,"Cash Sales","Zelia Dishwashing Paste 400g","Income","Zelia Dishwashing Paste",,"Undeposited Funds","",300.00,227606.37
,"Sales Receipt","07-03-2024","2037",,"Cash Sales","Zelia Dishwashing Paste 400g","Income","Zelia Dishwashing Paste",,"Undeposited Funds","",75.00,227681.37
,"Sales Receipt","08-03-2024","2044",,"Cash Sales","Zelia Dishwashing Paste 400g","Income","Zelia Dishwashing Paste",,"Undeposited Funds","",246.00,227927.37
,"Sales Receipt","09-03-2024","2051",,"Ebenezer  Minimart","Zelia Dishwashing Paste 400g","Income","Zelia Dishwashing Paste",,"Undeposited Funds","",738.00,228665.37
,"Invoice","11-03-2024","MC05484",,"MUHINDI MWEUSI SUPERMARKET LIMITED","Zelia Dishwashing Paste 400g","Income","Zelia Dishwashing Paste",,"Accounts Receivable","",2958.62,231623.99
,"Sales Receipt","11-03-2024","2055",,"Beta Traders","Zelia Dishwashing Paste 400g","Income","Zelia Dishwashing Paste",,"Undeposited Funds","",738.00,232361.99
,"Sales Receipt","11-03-2024","2056",,"Nasib Wholesallers","Zelia Dishwashing Paste 400g","Income","Zelia Dishwashing Paste",,"Undeposited Funds","",2952.00,235313.99
,"Invoice","12-03-2024","MC05492",,"DALLAS SHOPRITE LTD","Zelia Dishwashing Paste 400g","Income","Zelia Dishwashing Paste",,"Accounts Receivable","",739.65,236053.64
,"Sales Receipt","13-03-2024","2059",,"Cash Sales","Zelia Dishwashing Paste 400g","Income","Zelia Dishwashing Paste",,"Undeposited Funds","",123.00,236176.64
,"Sales Receipt","13-03-2024","2060",,"Cash Sales","Zelia Dishwashing Paste 400g","Income","Zelia Dishwashing Paste",,"Undeposited Funds","",125.00,236301.64
,"Sales Receipt","13-03-2024","2062",,"Mama Shukri","Zelia Dishwashing Paste 400g","Income","Zelia Dishwashing Paste",,"Undeposited Funds","",1476.00,237777.64
,"Sales Receipt","14-03-2024","2063",,"Cash Sales","Zelia Dishwashing Paste 400g","Income","Zelia Dishwashing Paste",,"Undeposited Funds","",130.00,237907.64
,"Sales Receipt","14-03-2024","2066",,"Soimo Minimart","Zelia Dishwashing Paste 400g","Income","Zelia Dishwashing Paste",,"Undeposited Funds","",1476.00,239383.64
,"Sales Receipt","15-03-2024","2069",,"Cash Sales","Zelia Dishwashing Paste 400g","Income","Zelia Dishwashing Paste",,"Undeposited Funds","",615.00,239998.64
,"Sales Receipt","15-03-2024","2070",,"Cash Sales","Zelia Dishwashing Paste 400g","Income","Zelia Dishwashing Paste",,"Undeposited Funds","",300.00,240298.64
,"Sales Receipt","18-03-2024","2071",,"Simester General Stores","Zelia Dishwashing Paste 400g","Income","Zelia Dishwashing Paste",,"Undeposited Funds","",615.00,240913.64
,"Sales Receipt","18-03-2024","2072",,"Cash Sales","Zelia Dishwashing Paste 400g","Income","Zelia Dishwashing Paste",,"Undeposited Funds",0.00,"",240913.64
,"Sales Receipt","18-03-2024","2074",,"Cash Sales","Zelia Dishwashing Paste 400g","Income","Zelia Dishwashing Paste",,"Undeposited Funds","",450.00,241363.64
,"Sales Receipt","18-03-2024","2075",,"Cash Sales","Zelia Dishwashing Paste 400g","Income","Zelia Dishwashing Paste",,"Undeposited Funds","",120.00,241483.64
,"Invoice","19-03-2024","MC05499",,"EASEBYYTTE SUPERMARKET LIMITED","Zelia Dishwashing Paste 400g","Income","Zelia Dishwashing Paste",,"Accounts Receivable","",1479.31,242962.95
,"Invoice","19-03-2024","MC05501",,"MUHINDI MWEUSI SUPERMARKET LIMITED","Zelia Dishwashing Paste 400g","Income","Zelia Dishwashing Paste",,"Accounts Receivable","",2958.62,245921.57
,"Invoice","19-03-2024","MC05502",,"Tupo Mart Limited","Zelia Dishwashing Paste 400g","Income","Zelia Dishwashing Paste",,"Accounts Receivable","",739.66,246661.23
,"Invoice","19-03-2024","MC05503",,"LUCKY MART SUPERMARKET LIMITED","Zelia Dishwashing Paste 400g","Income","Zelia Dishwashing Paste",,"Accounts Receivable","",739.66,247400.89
,"Invoice","20-03-2024","MC05507",,"DAILY CHAMPIONS MINI SUPERMARKET LIMITED","Zelia Dishwashing Paste 400g","Income","Zelia Dishwashing Paste",,"Accounts Receivable","",739.66,248140.55
,"Sales Receipt","20-03-2024","2085",,"Cash Sales","Zelia Dishwashing Paste 400g","Income","Zelia Dishwashing Paste",,"Undeposited Funds","",130.00,248270.55
,"Sales Receipt","20-03-2024","2087",,"Pambazuka Mart (K) Limited","Zelia Dishwashing Paste 400g","Income","Zelia Dishwashing Paste",,"Undeposited Funds","",2952.00,251222.55
,"Sales Receipt","20-03-2024","2089",,"Restoration Traders","Zelia Dishwashing Paste 400g","Income","Zelia Dishwashing Paste",,"Undeposited Funds","",2952.00,254174.55
,"Sales Receipt","21-03-2024","2091",,"Mama Amina","Zelia Dishwashing Paste 400g","Income","Zelia Dishwashing Paste",,"Undeposited Funds","",2952.00,257126.55
,"Sales Receipt","21-03-2024","2092",,"Norham Groceries","Zelia Dishwashing Paste 400g","Income","Zelia Dishwashing Paste",,"Undeposited Funds","",738.00,257864.55
,"Sales Receipt","21-03-2024","2101",,"Raymart Minimart","Zelia Dishwashing Paste 400g","Income","Zelia Dishwashing Paste",,"Undeposited Funds","",738.00,258602.55
,"Sales Receipt","21-03-2024","2102",,"Umushan Shop","Zelia Dishwashing Paste 400g","Income","Zelia Dishwashing Paste",,"Undeposited Funds","",1476.00,260078.55
,"Sales Receipt","21-03-2024","2103",,"Ilyes Gas and Water ltd","Zelia Dishwashing Paste 400g","Income","Zelia Dishwashing Paste",,"Undeposited Funds","",1476.00,261554.55
,"Sales Receipt","21-03-2024","2104",,"Nuclear Supermarket","Zelia Dishwashing Paste 400g","Income","Zelia Dishwashing Paste",,"Undeposited Funds","",1476.00,263030.55
,"Sales Receipt","25-03-2024","2094",,"Instanbul Shop","Zelia Dishwashing Paste 400g","Income","Zelia Dishwashing Paste",,"Undeposited Funds","",1476.00,264506.55
,"Invoice","27-03-2024","MC05542",,"BLUEMART SUPERMARKET LIMITED","Zelia Dishwashing Paste 400g","Income","Zelia Dishwashing Paste",,"Accounts Receivable","",739.66,265246.21
,"Sales Receipt","27-03-2024","2110",,"Toyokom Wholesallers","Zelia Dishwashing Paste 400g","Income","Zelia Dishwashing Paste",,"Undeposited Funds","",2952.00,268198.21
,"Sales Receipt","27-03-2024","2116",,"Cash Sales","Zelia Dishwashing Paste 400g","Income","Zelia Dishwashing Paste",,"Undeposited Funds","",130.00,268328.21
,"Sales Receipt","28-03-2024","2118",,"Cash Sales","Zelia Dishwashing Paste 400g","Income","Zelia Dishwashing Paste",,"Undeposited Funds","",480.00,268808.21
,"Sales Receipt","28-03-2024","2119",,"Moonlight Wholesallers","Zelia Dishwashing Paste 400g","Income","Zelia Dishwashing Paste",,"Undeposited Funds","",2952.00,271760.21
,"Sales Receipt","28-03-2024","2120",,"Warfa Wholesallers","Zelia Dishwashing Paste 400g","Income","Zelia Dishwashing Paste",,"Undeposited Funds","",5904.00,277664.21
,"Sales Receipt","28-03-2024","2127",,"Cash Sales","Zelia Dishwashing Paste 400g","Income","Zelia Dishwashing Paste",,"Undeposited Funds",0.00,"",277664.21
,"Sales Receipt","28-03-2024","2129",,"Cash Sales","Zelia Dishwashing Paste 400g","Income","Zelia Dishwashing Paste",,"Undeposited Funds","",525.00,278189.21
,"Sales Receipt","02-04-2024","2131",,"Q-mart Minimart","Zelia Dishwashing Paste 400g","Income","Zelia Dishwashing Paste",,"Undeposited Funds","",738.00,278927.21
,"Sales Receipt","02-04-2024","2133",,"Cash Sales","Zelia Dishwashing Paste 400g","Income","Zelia Dishwashing Paste",,"Undeposited Funds","",770.00,279697.21
,"Sales Receipt","02-04-2024","2134",,"Cash Sales","Zelia Dishwashing Paste 400g","Income","Zelia Dishwashing Paste",,"Undeposited Funds","",220.00,279917.21
,"Sales Receipt","03-04-2024","2135",,"Walalaha Wholesale","Zelia Dishwashing Paste 400g","Income","Zelia Dishwashing Paste",,"Undeposited Funds","",2952.00,282869.21
,"Sales Receipt","03-04-2024","2139",,"Tawakal Wholesale Eastleigh","Zelia Dishwashing Paste 400g","Income","Zelia Dishwashing Paste",,"Undeposited Funds","",5904.00,288773.21
,"Sales Receipt","03-04-2024","2140",,"Dacaad Wholesalers","Zelia Dishwashing Paste 400g","Income","Zelia Dishwashing Paste",,"Undeposited Funds","",2640.00,291413.21
,"Sales Receipt","03-04-2024","2148",,"Cash Sales","Zelia Dishwashing Paste 400g","Income","Zelia Dishwashing Paste",,"Undeposited Funds","",900.00,292313.21
,"Invoice","04-04-2024","MC05564",,"Azaavi Collections Limited","Zelia Dishwashing Paste 400g","Income","Zelia Dishwashing Paste",,"Accounts Receivable","",123.00,292436.21
,"Sales Receipt","04-04-2024","2143",,"Jubilee Candy  Shop","Zelia Dishwashing Paste 400g","Income","Zelia Dishwashing Paste",,"Undeposited Funds","",550.00,292986.21
,"Sales Receipt","04-04-2024","2150",,"Strawberry Minimart","Zelia Dishwashing Paste 400g","Income","Zelia Dishwashing Paste",,"Undeposited Funds","",1157.89,294144.10
,"Sales Receipt","04-04-2024","2151",,"Sahal General Stores","Zelia Dishwashing Paste 400g","Income","Zelia Dishwashing Paste",,"Undeposited Funds","",2640.00,296784.10
,"Sales Receipt","04-04-2024","2153",,"Budget Store","Zelia Dishwashing Paste 400g","Income","Zelia Dishwashing Paste",,"Undeposited Funds","",660.00,297444.10
,"Sales Receipt","05-04-2024","2156",,"D -Madina Enterprise","Zelia Dishwashing Paste 400g","Income","Zelia Dishwashing Paste",,"Undeposited Funds","",2640.00,300084.10
,"Sales Receipt","05-04-2024","2157",,"Cash Sales","Zelia Dishwashing Paste 400g","Income","Zelia Dishwashing Paste",,"Undeposited Funds","",330.00,300414.10
,"Sales Receipt","05-04-2024","2158",,"Cash Sales","Zelia Dishwashing Paste 400g","Income","Zelia Dishwashing Paste",,"Undeposited Funds","",123.00,300537.10
,"Sales Receipt","05-04-2024","2160",,"Cash Sales","Zelia Dishwashing Paste 400g","Income","Zelia Dishwashing Paste",,"Undeposited Funds","",300.00,300837.10
,"Sales Receipt","05-04-2024","2161",,"Cash Sales","Zelia Dishwashing Paste 400g","Income","Zelia Dishwashing Paste",,"Undeposited Funds","",110.00,300947.10
,"Sales Receipt","05-04-2024","AT 193",,"JUDY USENGE","Zelia Dishwashing Paste 400g","Income","Zelia Dishwashing Paste",,"Undeposited Funds","",15840.00,316787.10
,"Invoice","05-04-2024","MC05577",,"MUHINDI MWEUSI SUPERMARKET LIMITED","Zelia Dishwashing Paste 400g","Income","Zelia Dishwashing Paste",,"Accounts Receivable","",1479.31,318266.41
,"Invoice","05-04-2024","MC05578",,"MUHINDI MWEUSI SUPERMARKET LIMITED","Zelia Dishwashing Paste 400g","Income","Zelia Dishwashing Paste",,"Accounts Receivable","",1479.31,319745.72
,"Sales Receipt","08-04-2024","2162",,"Alma Stores","Zelia Dishwashing Paste 400g","Income","Zelia Dishwashing Paste",,"Undeposited Funds","",1320.00,321065.72
,"Sales Receipt","08-04-2024","2163",,"Deeps General Shop","Zelia Dishwashing Paste 400g","Income","Zelia Dishwashing Paste",,"Undeposited Funds","",110.00,321175.72
,"Sales Receipt","08-04-2024","2164",,"Kangundo Briolly Bookshop","Zelia Dishwashing Paste 400g","Income","Zelia Dishwashing Paste",,"Undeposited Funds","",110.00,321285.72
,"Sales Receipt","08-04-2024","2166",,"Cash Sales","Zelia Dishwashing Paste 400g","Income","Zelia Dishwashing Paste",,"Undeposited Funds","",450.00,321735.72
,"Sales Receipt","08-04-2024","2167",,"Cash Sales","Zelia Dishwashing Paste 400g","Income","Zelia Dishwashing Paste",,"Undeposited Funds","",750.00,322485.72
,"Sales Receipt","08-04-2024","2170",,"Antic Wholesallers","Zelia Dishwashing Paste 400g","Income","Zelia Dishwashing Paste",,"Undeposited Funds","",10560.00,333045.72
,"Sales Receipt","08-04-2024","2171",,"Raage mart","Zelia Dishwashing Paste 400g","Income","Zelia Dishwashing Paste",,"Undeposited Funds","",13200.00,346245.72
,"Sales Receipt","09-04-2024","2172",,"Cash Sales","Zelia Dishwashing Paste 400g","Income","Zelia Dishwashing Paste",,"Undeposited Funds","",110.00,346355.72
,"Sales Receipt","12-04-2024","2175",,"Tekonstruct LTD","Zelia Dishwashing Paste 400g","Income","Zelia Dishwashing Paste",,"Undeposited Funds","",220.00,346575.72
,"Sales Receipt","12-04-2024","2177",,"Cash Sales","Zelia Dishwashing Paste 400g","Income","Zelia Dishwashing Paste",,"Undeposited Funds","",220.00,346795.72
,"Sales Receipt","12-04-2024","2179",,"Cash Sales","Zelia Dishwashing Paste 400g","Income","Zelia Dishwashing Paste",,"Undeposited Funds","",105.00,346900.72
,"Sales Receipt","12-04-2024","2180",,"Elwak Stores Ltd","Zelia Dishwashing Paste 400g","Income","Zelia Dishwashing Paste",,"Undeposited Funds","",2640.00,349540.72
,"Sales Receipt","12-04-2024","2182",,"Cheaper Cheap","Zelia Dishwashing Paste 400g","Income","Zelia Dishwashing Paste",,"Undeposited Funds","",2640.00,352180.72
,"Sales Receipt","12-04-2024","2184",,"First Choice Shop","Zelia Dishwashing Paste 400g","Income","Zelia Dishwashing Paste",,"Undeposited Funds","",1320.00,353500.72
,"Sales Receipt","12-04-2024","2185",,"Mamken Minimart","Zelia Dishwashing Paste 400g","Income","Zelia Dishwashing Paste",,"Undeposited Funds","",660.00,354160.72
,"Sales Receipt","12-04-2024","2186",,"Kandara minimart","Zelia Dishwashing Paste 400g","Income","Zelia Dishwashing Paste",,"Undeposited Funds","",660.00,354820.72
,"Sales Receipt","12-04-2024","2187",,"Kikamart Minimart","Zelia Dishwashing Paste 400g","Income","Zelia Dishwashing Paste",,"Undeposited Funds","",660.00,355480.72
,"Sales Receipt","12-04-2024","2211",,"Cash Sales","Zelia Dishwashing Paste 400g","Income","Zelia Dishwashing Paste",,"Undeposited Funds","",600.00,356080.72
,"Sales Receipt","12-04-2024","2246",,"Skype Traders","Zelia Dishwashing Paste 400g","Income","Zelia Dishwashing Paste",,"Undeposited Funds","",5280.00,361360.72
,"Sales Receipt","15-04-2024","2188",,"Delta Mart","Zelia Dishwashing Paste 400g","Income","Zelia Dishwashing Paste",,"Undeposited Funds","",660.00,362020.72
,"Sales Receipt","15-04-2024","2193",,"Diaspora Diaries","Zelia Dishwashing Paste 400g","Income","Zelia Dishwashing Paste",,"Undeposited Funds","",330.00,362350.72
,"Sales Receipt","15-04-2024","2194",,"Marwan Shop","Zelia Dishwashing Paste 400g","Income","Zelia Dishwashing Paste",,"Undeposited Funds","",1320.00,363670.72
,"Sales Receipt","15-04-2024","2196",,"Ebenezer  Minimart","Zelia Dishwashing Paste 400g","Income","Zelia Dishwashing Paste",,"Undeposited Funds","",660.00,364330.72
,"Sales Receipt","15-04-2024","2197",,"Lekima Royal Merchants","Zelia Dishwashing Paste 400g","Income","Zelia Dishwashing Paste",,"Undeposited Funds","",660.00,364990.72
,"Sales Receipt","16-04-2024","2212",,"Cash Sales","Zelia Dishwashing Paste 400g","Income","Zelia Dishwashing Paste",,"Undeposited Funds","",150.00,365140.72
,"Sales Receipt","17-04-2024","2215",,"Best Ratino Stores","Zelia Dishwashing Paste 400g","Income","Zelia Dishwashing Paste",,"Undeposited Funds","",5280.00,370420.72
,"Sales Receipt","17-04-2024","2218",,"Maida Minimart","Zelia Dishwashing Paste 400g","Income","Zelia Dishwashing Paste",,"Undeposited Funds","",660.00,371080.72
,"Sales Receipt","17-04-2024","2219",,"Memos Supermarket","Zelia Dishwashing Paste 400g","Income","Zelia Dishwashing Paste",,"Undeposited Funds","",1320.00,372400.72
,"Sales Receipt","18-04-2024","2220",,"Towba General Store","Zelia Dishwashing Paste 400g","Income","Zelia Dishwashing Paste",,"Undeposited Funds","",5280.00,377680.72
,"Sales Receipt","18-04-2024","2221",,"Baraka Shop","Zelia Dishwashing Paste 400g","Income","Zelia Dishwashing Paste",,"Undeposited Funds","",1320.00,379000.72
,"Sales Receipt","18-04-2024","2222",,"Amin Wholesalers","Zelia Dishwashing Paste 400g","Income","Zelia Dishwashing Paste",,"Undeposited Funds","",2640.00,381640.72
,"Sales Receipt","18-04-2024","2225",,"Cash Sales","Zelia Dishwashing Paste 400g","Income","Zelia Dishwashing Paste",,"Undeposited Funds","",105.00,381745.72
,"Sales Receipt","18-04-2024","2226",,"Zambia Shopping Centre","Zelia Dishwashing Paste 400g","Income","Zelia Dishwashing Paste",,"Undeposited Funds","",660.00,382405.72
,"Sales Receipt","18-04-2024","2227",,"El Magina Store","Zelia Dishwashing Paste 400g","Income","Zelia Dishwashing Paste",,"Undeposited Funds","",660.00,383065.72
,"Sales Receipt","18-04-2024","2228",,"Gods Favour","Zelia Dishwashing Paste 400g","Income","Zelia Dishwashing Paste",,"Undeposited Funds","",1320.00,384385.72
,"Sales Receipt","18-04-2024","2230",,"Ngomei Shop","Zelia Dishwashing Paste 400g","Income","Zelia Dishwashing Paste",,"Undeposited Funds","",1320.00,385705.72
,"Invoice","19-04-2024","MC05610",,"DISII TRADERS LTD","Zelia Dishwashing Paste 400g","Income","Zelia Dishwashing Paste",,"Accounts Receivable","",1324.14,387029.86
,"Invoice","19-04-2024","MC05613",,"HAPPY VIEW SUPERMARKET LIMITED","Zelia Dishwashing Paste 400g","Income","Zelia Dishwashing Paste",,"Accounts Receivable","",662.07,387691.93
,"Invoice","19-04-2024","MC05614",,"MUHINDI MWEUSI SUPERMARKET LIMITED","Zelia Dishwashing Paste 400g","Income","Zelia Dishwashing Paste",,"Accounts Receivable","",2958.62,390650.55
,"Invoice","19-04-2024","MC05615",,"BIN GINAAB HOUSEHOLD","Zelia Dishwashing Paste 400g","Income","Zelia Dishwashing Paste",,"Accounts Receivable","",1324.14,391974.69
,"Sales Receipt","19-04-2024","2231",,"Cash Sales","Zelia Dishwashing Paste 400g","Income","Zelia Dishwashing Paste",,"Undeposited Funds","",375.00,392349.69
,"Sales Receipt","19-04-2024","2237",,"Garumo Wholesallers","Zelia Dishwashing Paste 400g","Income","Zelia Dishwashing Paste",,"Undeposited Funds","",1320.00,393669.69
,"Sales Receipt","20-04-2024","2243",,"Horn of Africa","Zelia Dishwashing Paste 400g","Income","Zelia Dishwashing Paste",,"Undeposited Funds","",1320.00,394989.69
,"Invoice","22-04-2024","MC05622",,"KASAMAT INVESTMENTS LTD","Zelia Dishwashing Paste 400g","Income","Zelia Dishwashing Paste",,"Accounts Receivable","",662.07,395651.76
,"Invoice","22-04-2024","MC05623",,"MUHINDI MWEUSI SUPERMARKET LIMITED","Zelia Dishwashing Paste 400g","Income","Zelia Dishwashing Paste",,"Accounts Receivable","",2958.62,398610.38
,"Sales Receipt","22-04-2024","2241",,"Cash Sales","Zelia Dishwashing Paste 400g","Income","Zelia Dishwashing Paste",,"Undeposited Funds","",98.00,398708.38
,"Sales Receipt","22-04-2024","2244",,"MWASPART AIRWAYS","Zelia Dishwashing Paste 400g","Income","Zelia Dishwashing Paste",,"Undeposited Funds","",660.00,399368.38
,"Sales Receipt","23-04-2024","2251",,"Cash Sales","Zelia Dishwashing Paste 400g","Income","Zelia Dishwashing Paste",,"Undeposited Funds","",125.00,399493.38
,"Sales Receipt","23-04-2024","2254",,"Cash Sales","Zelia Dishwashing Paste 400g","Income","Zelia Dishwashing Paste",,"Undeposited Funds",0.00,"",399493.38
,"Invoice","24-04-2024","MC05631",,"PRICE CHOPPER STORES LIMITED","Zelia Dishwashing Paste 400g","Income","Zelia Dishwashing Paste",,"Accounts Receivable","",1324.14,400817.52
,"Invoice","24-04-2024","MC05636",,"Maji Asili Limited","Zelia Dishwashing Paste 400g","Income","Zelia Dishwashing Paste",,"Accounts Receivable","",7944.83,408762.35
,"Sales Receipt","24-04-2024","2255",,"Cash Sales","Zelia Dishwashing Paste 400g","Income","Zelia Dishwashing Paste",,"Undeposited Funds","",110.00,408872.35
,"Sales Receipt","24-04-2024","2256",,"Kimathi Store","Zelia Dishwashing Paste 400g","Income","Zelia Dishwashing Paste",,"Undeposited Funds","",110.00,408982.35
,"Sales Receipt","24-04-2024","2257",,"Cash Sales","Zelia Dishwashing Paste 400g","Income","Zelia Dishwashing Paste",,"Undeposited Funds","",97.00,409079.35
,"Sales Receipt","24-04-2024","2259",,"Muleshe Wholesallers","Zelia Dishwashing Paste 400g","Income","Zelia Dishwashing Paste",,"Undeposited Funds","",5280.00,414359.35
,"Sales Receipt","25-04-2024","2261",,"Teyamo Enterprises","Zelia Dishwashing Paste 400g","Income","Zelia Dishwashing Paste",,"Undeposited Funds","",330.00,414689.35
,"Sales Receipt","25-04-2024","2263",,"Cash Sales","Zelia Dishwashing Paste 400g","Income","Zelia Dishwashing Paste",,"Undeposited Funds","",150.00,414839.35
,"Sales Receipt","25-04-2024","2265",,"Strawberry Minimart","Zelia Dishwashing Paste 400g","Income","Zelia Dishwashing Paste",,"Undeposited Funds","",1320.00,416159.35
,"Sales Receipt","25-04-2024","2266",,"Goldmart Supermarket","Zelia Dishwashing Paste 400g","Income","Zelia Dishwashing Paste",,"Undeposited Funds","",1320.00,417479.35
,"Sales Receipt","29-04-2024","2271",,"Cash Sales","Zelia Dishwashing Paste 400g","Income","Zelia Dishwashing Paste",,"Undeposited Funds","",220.00,417699.35
,"Sales Receipt","29-04-2024","2272",,"Mabruk","Zelia Dishwashing Paste 400g","Income","Zelia Dishwashing Paste",,"Undeposited Funds","",660.00,418359.35
,"Sales Receipt","29-04-2024","2273",,"Blessed Shop","Zelia Dishwashing Paste 400g","Income","Zelia Dishwashing Paste",,"Undeposited Funds","",220.00,418579.35
,"Sales Receipt","29-04-2024","2275",,"Cash Sales","Zelia Dishwashing Paste 400g","Income","Zelia Dishwashing Paste",,"Undeposited Funds","",220.00,418799.35
,"Invoice","29-04-2024","MC05650",,"MUHINDI MWEUSI SUPERMARKET LIMITED","Zelia Dishwashing Paste 400g","Income","Zelia Dishwashing Paste",,"Accounts Receivable","",2958.62,421757.97
,"Sales Receipt","29-04-2024","2277",,"Cash Sales","Zelia Dishwashing Paste 400g","Income","Zelia Dishwashing Paste",,"Undeposited Funds","",1500.00,423257.97
,"Sales Receipt","29-04-2024","2278",,"Hidika Shop","Zelia Dishwashing Paste 400g","Income","Zelia Dishwashing Paste",,"Undeposited Funds","",1320.00,424577.97
,"Sales Receipt","29-04-2024","2279",,"Cash Sales","Zelia Dishwashing Paste 400g","Income","Zelia Dishwashing Paste",,"Undeposited Funds","",300.00,424877.97
,"Sales Receipt","30-04-2024","2281",,"Cash Sales","Zelia Dishwashing Paste 400g","Income","Zelia Dishwashing Paste",,"Undeposited Funds","",300.00,425177.97
,"Sales Receipt","30-04-2024","2286",,"Homecare Enterprise","Zelia Dishwashing Paste 400g","Income","Zelia Dishwashing Paste",,"Undeposited Funds","",660.00,425837.97
,"Sales Receipt","30-04-2024","2288",,"Simester General Stores","Zelia Dishwashing Paste 400g","Income","Zelia Dishwashing Paste",,"Undeposited Funds","",660.00,426497.97
,"Sales Receipt","02-05-2024","2289",,"Al Naim store","Zelia Dishwashing Paste 400g","Income","Zelia Dishwashing Paste",,"Undeposited Funds","",5280.00,431777.97
,"Sales Receipt","02-05-2024","2291",,"Mama Hamdi","Zelia Dishwashing Paste 400g","Income","Zelia Dishwashing Paste",,"Undeposited Funds","",2315.79,434093.76
,"Sales Receipt","02-05-2024","2292",,"Jamilas Store","Zelia Dishwashing Paste 400g","Income","Zelia Dishwashing Paste",,"Undeposited Funds","",1320.00,435413.76
,"Sales Receipt","03-05-2024","2300",,"Cash Sales","Zelia Dishwashing Paste 400g","Income","Zelia Dishwashing Paste",,"Undeposited Funds",0.00,"",435413.76
,"Sales Receipt","03-05-2024","2301",,"Cash Sales","Zelia Dishwashing Paste 400g","Income","Zelia Dishwashing Paste",,"Undeposited Funds","",125.00,435538.76
,"Sales Receipt","03-05-2024","2303",,"Cash Sales","Zelia Dishwashing Paste 400g","Income","Zelia Dishwashing Paste",,"Undeposited Funds","",98.00,435636.76
,"Sales Receipt","03-05-2024","2306",,"Cash Sales","Zelia Dishwashing Paste 400g","Income","Zelia Dishwashing Paste",,"Undeposited Funds","",97.00,435733.76
,"Sales Receipt","05-05-2024","2308",,"Cash Sales","Zelia Dishwashing Paste 400g","Income","Zelia Dishwashing Paste",,"Undeposited Funds","",360.00,436093.76
,"Sales Receipt","06-05-2024","2307",,"Cash Sales","Zelia Dishwashing Paste 400g","Income","Zelia Dishwashing Paste",,"Undeposited Funds","",240.00,436333.76
,"Sales Receipt","06-05-2024","2309",,"Jackys Shop","Zelia Dishwashing Paste 400g","Income","Zelia Dishwashing Paste",,"Undeposited Funds","",110.00,436443.76
,"Sales Receipt","06-05-2024","2310",,"Razia Wholesalers","Zelia Dishwashing Paste 400g","Income","Zelia Dishwashing Paste",,"Undeposited Funds","",550.00,436993.76
,"Sales Receipt","06-05-2024","2313",,"Hidika Shop","Zelia Dishwashing Paste 400g","Income","Zelia Dishwashing Paste",,"Undeposited Funds","",1320.00,438313.76
,"Sales Receipt","08-05-2024","2317",,"Pambazuka Mart (K) Limited","Zelia Dishwashing Paste 400g","Income","Zelia Dishwashing Paste",,"Undeposited Funds","",1320.00,439633.76
,"Sales Receipt","08-05-2024","2318",,"Adurus Wholesallers","Zelia Dishwashing Paste 400g","Income","Zelia Dishwashing Paste",,"Undeposited Funds","",2640.00,442273.76
,"Sales Receipt","08-05-2024","2320",,"Johns Shop","Zelia Dishwashing Paste 400g","Income","Zelia Dishwashing Paste",,"Undeposited Funds","",1320.00,443593.76
,"Sales Receipt","08-05-2024","2321",,"Cash Sales","Zelia Dishwashing Paste 400g","Income","Zelia Dishwashing Paste",,"Undeposited Funds","",260.00,443853.76
,"Sales Receipt","08-05-2024","2323",,"Cash Sales","Zelia Dishwashing Paste 400g","Income","Zelia Dishwashing Paste",,"Undeposited Funds","",440.00,444293.76
,"Sales Receipt","08-05-2024","2325",,"Mama Amina","Zelia Dishwashing Paste 400g","Income","Zelia Dishwashing Paste",,"Undeposited Funds","",2640.00,446933.76
,"Sales Receipt","08-05-2024","2327",,"Shahrazaad Wholesalers","Zelia Dishwashing Paste 400g","Income","Zelia Dishwashing Paste",,"Undeposited Funds","",2640.00,449573.76
,"Sales Receipt","08-05-2024","2328",,"safa general store","Zelia Dishwashing Paste 400g","Income","Zelia Dishwashing Paste",,"Undeposited Funds","",2640.00,452213.76
,"Sales Receipt","08-05-2024","2329",,"Al Baraka Shop","Zelia Dishwashing Paste 400g","Income","Zelia Dishwashing Paste",,"Undeposited Funds","",1320.00,453533.76
,"Sales Receipt","08-05-2024","2330",,"Neema Bei Nafuu Shop","Zelia Dishwashing Paste 400g","Income","Zelia Dishwashing Paste",,"Undeposited Funds","",1320.00,454853.76
,"Sales Receipt","08-05-2024","2331",,"Amir shop","Zelia Dishwashing Paste 400g","Income","Zelia Dishwashing Paste",,"Undeposited Funds","",2640.00,457493.76
,"Sales Receipt","09-05-2024","2332",,"Gitonga Store","Zelia Dishwashing Paste 400g","Income","Zelia Dishwashing Paste",,"Undeposited Funds","",6600.00,464093.76
,"Sales Receipt","09-05-2024","2336",,"Donation","Zelia Dishwashing Paste 400g","Income","Zelia Dishwashing Paste",,"Undeposited Funds",0.00,"",464093.76
,"Sales Receipt","09-05-2024","2339",,"Cash Sales","Zelia Dishwashing Paste 400g","Income","Zelia Dishwashing Paste",,"Undeposited Funds","",291.00,464384.76
,"Sales Receipt","09-05-2024","2341",,"Cash Sales","Zelia Dishwashing Paste 400g","Income","Zelia Dishwashing Paste",,"Undeposited Funds","",220.00,464604.76
,"Sales Receipt","09-05-2024","2342",,"Cash Sales","Zelia Dishwashing Paste 400g","Income","Zelia Dishwashing Paste",,"Undeposited Funds","",1800.00,466404.76
,"Sales Receipt","10-05-2024","1919",,"Cash Sales","Zelia Dishwashing Paste 400g","Income","Zelia Dishwashing Paste",,"Undeposited Funds","",97.00,466501.76
,"Sales Receipt","13-05-2024","2345",,"Katani Foodstore","Zelia Dishwashing Paste 400g","Income","Zelia Dishwashing Paste",,"Undeposited Funds","",660.00,467161.76
,"Sales Receipt","13-05-2024","2348",,"Gargar Foodstuffs","Zelia Dishwashing Paste 400g","Income","Zelia Dishwashing Paste",,"Undeposited Funds","",2640.00,469801.76
,"Sales Receipt","13-05-2024","2350",,"Aymat Wholesalers","Zelia Dishwashing Paste 400g","Income","Zelia Dishwashing Paste",,"Undeposited Funds","",1320.00,471121.76
,"Sales Receipt","13-05-2024","2356",,"The Hub Minimart","Zelia Dishwashing Paste 400g","Income","Zelia Dishwashing Paste",,"Undeposited Funds","",660.00,471781.76
,"Sales Receipt","13-05-2024","1921",,"Cash Sales","Zelia Dishwashing Paste 400g","Income","Zelia Dishwashing Paste",,"Undeposited Funds","",440.00,472221.76
,"Sales Receipt","14-05-2024","2355",,"Beraccah Wholesallers","Zelia Dishwashing Paste 400g","Income","Zelia Dishwashing Paste",,"Undeposited Funds","",1320.00,473541.76
,"Invoice","15-05-2024","MC05701",,"MUHINDI MWEUSI SUPERMARKET LIMITED","Zelia Dishwashing Paste 400g","Income","Zelia Dishwashing Paste",,"Accounts Receivable","",2958.62,476500.38
,"Invoice","15-05-2024","MC05703",,"MUHINDI MWEUSI SUPERMARKET LIMITED","Zelia Dishwashing Paste 400g","Income","Zelia Dishwashing Paste",,"Accounts Receivable","",2958.62,479459.00
,"Sales Receipt","15-05-2024","1928",,"Cash Sales","Zelia Dishwashing Paste 400g","Income","Zelia Dishwashing Paste",,"Undeposited Funds","",98.00,479557.00
,"Sales Receipt","16-05-2024","2365",,"Salma Shop","Zelia Dishwashing Paste 400g","Income","Zelia Dishwashing Paste",,"Undeposited Funds","",2640.00,482197.00
,"Sales Receipt","16-05-2024","2366",,"Tusma Wholesale Eastleigh","Zelia Dishwashing Paste 400g","Income","Zelia Dishwashing Paste",,"Undeposited Funds","",2640.00,484837.00
,"Sales Receipt","16-05-2024","1930",,"Cash Sales","Zelia Dishwashing Paste 400g","Income","Zelia Dishwashing Paste",,"Undeposited Funds","",520.00,485357.00
,"Invoice","17-05-2024","MC05713",,"DISII TRADERS LTD","Zelia Dishwashing Paste 400g","Income","Zelia Dishwashing Paste",,"Accounts Receivable","",1324.14,486681.14
,"Sales Receipt","17-05-2024","2372",,"Danaba Wholesalers","Zelia Dishwashing Paste 400g","Income","Zelia Dishwashing Paste",,"Undeposited Funds","",2640.00,489321.14
,"Sales Receipt","17-05-2024","1933",,"Cash Sales","Zelia Dishwashing Paste 400g","Income","Zelia Dishwashing Paste",,"Undeposited Funds",0.00,"",489321.14
,"Sales Receipt","17-05-2024","1935",,"Cash Sales","Zelia Dishwashing Paste 400g","Income","Zelia Dishwashing Paste",,"Undeposited Funds","",300.00,489621.14
,"Sales Receipt","20-05-2024","1938",,"Gitonga Store","Zelia Dishwashing Paste 400g","Income","Zelia Dishwashing Paste",,"Undeposited Funds","",7920.00,497541.14
,"Sales Receipt","21-05-2024","1943",,"Smart Choice","Zelia Dishwashing Paste 400g","Income","Zelia Dishwashing Paste",,"Undeposited Funds","",1320.00,498861.14
,"Sales Receipt","21-05-2024","1946",,"Moyale Shop","Zelia Dishwashing Paste 400g","Income","Zelia Dishwashing Paste",,"Undeposited Funds","",1320.00,500181.14
,"Sales Receipt","21-05-2024","1947",,"Minara Shop","Zelia Dishwashing Paste 400g","Income","Zelia Dishwashing Paste",,"Undeposited Funds","",2640.00,502821.14
,"Sales Receipt","21-05-2024","1949",,"Cash Sales","Zelia Dishwashing Paste 400g","Income","Zelia Dishwashing Paste",,"Undeposited Funds","",97.00,502918.14
,"Sales Receipt","21-05-2024","1951",,"Gidesh Supermarket","Zelia Dishwashing Paste 400g","Income","Zelia Dishwashing Paste",,"Undeposited Funds","",1320.00,504238.14
,"Sales Receipt","22-05-2024","2375",,"Visina Ltd","Zelia Dishwashing Paste 400g","Income","Zelia Dishwashing Paste",,"Undeposited Funds","",2640.00,506878.14
,"Sales Receipt","22-05-2024","2376",,"Towfiqq Shop","Zelia Dishwashing Paste 400g","Income","Zelia Dishwashing Paste",,"Undeposited Funds","",660.00,507538.14
,"Sales Receipt","23-05-2024","1953",,"Cash Sales","Zelia Dishwashing Paste 400g","Income","Zelia Dishwashing Paste",,"Undeposited Funds","",200.00,507738.14
,"Sales Receipt","23-05-2024","1954",,"Cash Sales","Zelia Dishwashing Paste 400g","Income","Zelia Dishwashing Paste",,"Undeposited Funds","",97.00,507835.14
,"Sales Receipt","23-05-2024","1957",,"Cash Sales","Zelia Dishwashing Paste 400g","Income","Zelia Dishwashing Paste",,"Undeposited Funds","",300.00,508135.14
,"Sales Receipt","23-05-2024","1961",,"Ilyas Retail Shop","Zelia Dishwashing Paste 400g","Income","Zelia Dishwashing Paste",,"Undeposited Funds","",1320.00,509455.14
,"Sales Receipt","23-05-2024","1965",,"Marris Minimart","Zelia Dishwashing Paste 400g","Income","Zelia Dishwashing Paste",,"Undeposited Funds","",660.00,510115.14
,"Sales Receipt","23-05-2024","1967",,"Mina Wholesalers","Zelia Dishwashing Paste 400g","Income","Zelia Dishwashing Paste",,"Undeposited Funds","",1320.00,511435.14
,"Sales Receipt","23-05-2024","1968",,"Moonlight Wholesallers","Zelia Dishwashing Paste 400g","Income","Zelia Dishwashing Paste",,"Undeposited Funds","",13200.00,524635.14
,"Sales Receipt","23-05-2024","1969",,"Bahati Super Star Limited","Zelia Dishwashing Paste 400g","Income","Zelia Dishwashing Paste",,"Undeposited Funds","",7920.00,532555.14
,"Invoice","24-05-2024","MC05739",,"MUHINDI MWEUSI SUPERMARKET LIMITED","Zelia Dishwashing Paste 400g","Income","Zelia Dishwashing Paste",,"Accounts Receivable","",2648.28,535203.42
,"Invoice","24-05-2024","MC05746",,"MUHINDI MWEUSI SUPERMARKET LIMITED","Zelia Dishwashing Paste 400g","Income","Zelia Dishwashing Paste",,"Accounts Receivable","",1324.14,536527.56
,"Invoice","24-05-2024","MC05748",,"MUHINDI MWEUSI SUPERMARKET LIMITED","Zelia Dishwashing Paste 400g","Income","Zelia Dishwashing Paste",,"Accounts Receivable","",2648.27,539175.83
,"Invoice","24-05-2024","MC05749",,"Ck Upscales Limited","Zelia Dishwashing Paste 400g","Income","Zelia Dishwashing Paste",,"Accounts Receivable","",5296.55,544472.38
,"Invoice","24-05-2024","MC05750",,"MUHINDI MWEUSI SUPERMARKET LIMITED","Zelia Dishwashing Paste 400g","Income","Zelia Dishwashing Paste",,"Accounts Receivable","",2648.28,547120.66
,"Sales Receipt","24-05-2024","2380",,"Cash Sales","Zelia Dishwashing Paste 400g","Income","Zelia Dishwashing Paste",,"Undeposited Funds","",1500.00,548620.66
,"Invoice","28-05-2024","MC05761",,"MUHINDI MWEUSI SUPERMARKET LIMITED","Zelia Dishwashing Paste 400g","Income","Zelia Dishwashing Paste",,"Accounts Receivable","",1324.14,549944.80
,"Invoice","28-05-2024","MC05762",,"MUHINDI MWEUSI SUPERMARKET LIMITED","Zelia Dishwashing Paste 400g","Income","Zelia Dishwashing Paste",,"Accounts Receivable","",2648.28,552593.08
,"Invoice","28-05-2024","MC05764",,"DALLAS SHOPRITE LTD","Zelia Dishwashing Paste 400g","Income","Zelia Dishwashing Paste",,"Accounts Receivable","",656.90,553249.98
,"Invoice","28-05-2024","MC05765",,"TAWALA SUPERMARKET LIMITED","Zelia Dishwashing Paste 400g","Income","Zelia Dishwashing Paste",,"Accounts Receivable","",1313.80,554563.78
,"Sales Receipt","28-05-2024","2389",,"Restoration Traders","Zelia Dishwashing Paste 400g","Income","Zelia Dishwashing Paste",,"Undeposited Funds","",2640.00,557203.78
,"Sales Receipt","29-05-2024","2390",,"Cash Sales","Zelia Dishwashing Paste 400g","Income","Zelia Dishwashing Paste",,"Undeposited Funds","",388.00,557591.78
,"Sales Receipt","29-05-2024","2391",,"Cash Sales","Zelia Dishwashing Paste 400g","Income","Zelia Dishwashing Paste",,"Undeposited Funds","",300.00,557891.78
,"Sales Receipt","29-05-2024","1971",,"Freshfinds Wholesale","Zelia Dishwashing Paste 400g","Income","Zelia Dishwashing Paste",,"Undeposited Funds","",660.00,558551.78
,"Sales Receipt","30-05-2024","2394",,"Gure Yare Shop Nasra","Zelia Dishwashing Paste 400g","Income","Zelia Dishwashing Paste",,"Undeposited Funds","",13200.00,571751.78
,"Sales Receipt","31-05-2024","2369",,"Golden Store","Zelia Dishwashing Paste 400g","Income","Zelia Dishwashing Paste",,"Undeposited Funds","",2640.00,574391.78
,"Sales Receipt","31-05-2024","1937",,"Island Gift Shop","Zelia Dishwashing Paste 400g","Income","Zelia Dishwashing Paste",,"Undeposited Funds","",440.00,574831.78
,"Sales Receipt","31-05-2024","1975",,"Cash Sales","Zelia Dishwashing Paste 400g","Income","Zelia Dishwashing Paste",,"Undeposited Funds","",300.00,575131.78
,"Sales Receipt","31-05-2024","1977",,"Cash Sales","Zelia Dishwashing Paste 400g","Income","Zelia Dishwashing Paste",,"Undeposited Funds","",300.00,575431.78
,"Sales Receipt","03-06-2024","2396",,"Cash Sales","Zelia Dishwashing Paste 400g","Income","Zelia Dishwashing Paste",,"Undeposited Funds","",194.00,575625.78
,"Sales Receipt","03-06-2024","2398",,"Cash Sales","Zelia Dishwashing Paste 400g","Income","Zelia Dishwashing Paste",,"Undeposited Funds","",97.00,575722.78
,"Sales Receipt","03-06-2024","2399",,"Cash Sales","Zelia Dishwashing Paste 400g","Income","Zelia Dishwashing Paste",,"Undeposited Funds","",97.00,575819.78
,"Sales Receipt","03-06-2024","1975",,"Cash Sales","Zelia Dishwashing Paste 400g","Income","Zelia Dishwashing Paste",,"Undeposited Funds","",300.00,576119.78
,"Sales Receipt","03-06-2024","1977",,"Cash Sales","Zelia Dishwashing Paste 400g","Income","Zelia Dishwashing Paste",,"Undeposited Funds","",300.00,576419.78
,"Sales Receipt","04-06-2024","2413",,"Horn of Africa","Zelia Dishwashing Paste 400g","Income","Zelia Dishwashing Paste",,"Undeposited Funds","",1320.00,577739.78
,"Sales Receipt","04-06-2024","1986",,"Kiembeni Grocery","Zelia Dishwashing Paste 400g","Income","Zelia Dishwashing Paste",,"Undeposited Funds","",2640.00,580379.78
,"Sales Receipt","04-06-2024","2742",,"Arwa Wholesale","Zelia Dishwashing Paste 400g","Income","Zelia Dishwashing Paste",,"Undeposited Funds","",1320.00,581699.78
,"Sales Receipt","04-06-2024","2741",,"Sasa Wholesalers","Zelia Dishwashing Paste 400g","Income","Zelia Dishwashing Paste",,"Undeposited Funds","",2640.00,584339.78
,"Sales Receipt","05-06-2024","2416",,"Amir shop","Zelia Dishwashing Paste 400g","Income","Zelia Dishwashing Paste",,"Undeposited Funds","",1320.00,585659.78
,"Sales Receipt","05-06-2024","2417",,"D-Madina Enterprise","Zelia Dishwashing Paste 400g","Income","Zelia Dishwashing Paste",,"Undeposited Funds","",2640.00,588299.78
,"Sales Receipt","05-06-2024","2419",,"Publix Supermarket","Zelia Dishwashing Paste 400g","Income","Zelia Dishwashing Paste",,"Undeposited Funds","",1320.00,589619.78
,"Invoice","06-06-2024","MC05790",,"Karia Supermarkets Limited","Zelia Dishwashing Paste 400g","Income","Zelia Dishwashing Paste",,"Accounts Receivable","",2648.28,592268.06
,"Sales Receipt","06-06-2024","2429",,"Cash Sales","Zelia Dishwashing Paste 400g","Income","Zelia Dishwashing Paste",,"Undeposited Funds",0.00,"",592268.06
,"Sales Receipt","06-06-2024","1991",,"Cash Sales","Zelia Dishwashing Paste 400g","Income","Zelia Dishwashing Paste",,"Undeposited Funds","",1800.00,594068.06
,"Sales Receipt","06-06-2024","2425",,"Soimo Minimart","Zelia Dishwashing Paste 400g","Income","Zelia Dishwashing Paste",,"Undeposited Funds","",1320.00,595388.06
,"Sales Receipt","06-06-2024","2423",,"Ekai moke wholesale","Zelia Dishwashing Paste 400g","Income","Zelia Dishwashing Paste",,"Undeposited Funds","",1320.00,596708.06
,"Sales Receipt","06-06-2024","2421",,"Feng Sheng Supermarket","Zelia Dishwashing Paste 400g","Income","Zelia Dishwashing Paste",,"Undeposited Funds","",2640.00,599348.06
,"Sales Receipt","07-06-2024","1992",,"Cash Sales","Zelia Dishwashing Paste 400g","Income","Zelia Dishwashing Paste",,"Undeposited Funds","",291.00,599639.06
,"Sales Receipt","07-06-2024","2428",,"Nabcom Stores","Zelia Dishwashing Paste 400g","Income","Zelia Dishwashing Paste",,"Undeposited Funds","",1320.00,600959.06
,"Sales Receipt","10-06-2024","2434",,"Cash Sales","Zelia Dishwashing Paste 400g","Income","Zelia Dishwashing Paste",,"Undeposited Funds","",290.00,601249.06
,"Invoice","11-06-2024","MC05815",,"MADINA SUPERMARKET LIMITED","Zelia Dishwashing Paste 400g","Income","Zelia Dishwashing Paste",,"Accounts Receivable","",656.90,601905.96
,"Sales Receipt","11-06-2024","2439",,"Cash Sales","Zelia Dishwashing Paste 400g","Income","Zelia Dishwashing Paste",,"Undeposited Funds","",97.00,602002.96
,"Sales Receipt","11-06-2024","2440",,"Cash Sales","Zelia Dishwashing Paste 400g","Income","Zelia Dishwashing Paste",,"Undeposited Funds","",280.00,602282.96
,"Sales Receipt","11-06-2024","2446",,"Cash Sales","Zelia Dishwashing Paste 400g","Income","Zelia Dishwashing Paste",,"Undeposited Funds","",300.00,602582.96
,"Sales Receipt","11-06-2024","2715",,"Asfa Shop","Zelia Dishwashing Paste 400g","Income","Zelia Dishwashing Paste",,"Undeposited Funds","",1320.00,603902.96
,"Sales Receipt","11-06-2024","2448",,"Farmwell Enterprises","Zelia Dishwashing Paste 400g","Income","Zelia Dishwashing Paste",,"Undeposited Funds","",330.00,604232.96
,"Sales Receipt","12-06-2024","2449",,"Cash Sales","Zelia Dishwashing Paste 400g","Income","Zelia Dishwashing Paste",,"Undeposited Funds","",130.00,604362.96
,"Sales Receipt","12-06-2024","2451",,"Cash Sales","Zelia Dishwashing Paste 400g","Income","Zelia Dishwashing Paste",,"Undeposited Funds","",300.00,604662.96
,"Sales Receipt","12-06-2024","2452",,"Cash Sales","Zelia Dishwashing Paste 400g","Income","Zelia Dishwashing Paste",,"Undeposited Funds","",240.00,604902.96
,"Sales Receipt","12-06-2024","2453",,"Cash Sales","Zelia Dishwashing Paste 400g","Income","Zelia Dishwashing Paste",,"Undeposited Funds","",7500.00,612402.96
,"Sales Receipt","12-06-2024","2461",,"Cash Sales","Zelia Dishwashing Paste 400g","Income","Zelia Dishwashing Paste",,"Undeposited Funds","",150.00,612552.96
,"Sales Receipt","12-06-2024","2458",,"Sahal Wholesale","Zelia Dishwashing Paste 400g","Income","Zelia Dishwashing Paste",,"Undeposited Funds","",2640.00,615192.96
,"Sales Receipt","12-06-2024","2463",,"Raja Foodstuffs","Zelia Dishwashing Paste 400g","Income","Zelia Dishwashing Paste",,"Undeposited Funds","",5280.00,620472.96
,"Invoice","13-06-2024","MC05820",,"ZAIN SUPERMARKET LIMITED","Zelia Dishwashing Paste 400g","Income","Zelia Dishwashing Paste",,"Accounts Receivable","",656.90,621129.86
,"Sales Receipt","13-06-2024","2464",,"Cash Sales","Zelia Dishwashing Paste 400g","Income","Zelia Dishwashing Paste",,"Undeposited Funds","",130.00,621259.86
,"Sales Receipt","13-06-2024","2471",,"Cash Sales","Zelia Dishwashing Paste 400g","Income","Zelia Dishwashing Paste",,"Undeposited Funds","",240.00,621499.86
,"Sales Receipt","13-06-2024","2474",,"Fahma Qali","Zelia Dishwashing Paste 400g","Income","Zelia Dishwashing Paste",,"Undeposited Funds","",1320.00,622819.86
,"Sales Receipt","14-06-2024","2475",,"Cash Sales","Zelia Dishwashing Paste 400g","Income","Zelia Dishwashing Paste",,"Undeposited Funds","",582.00,623401.86
,"Sales Receipt","14-06-2024","2714",,"Damuda Mart","Zelia Dishwashing Paste 400g","Income","Zelia Dishwashing Paste",,"Undeposited Funds","",2640.00,626041.86
,"Sales Receipt","14-06-2024","2710",,"tRIPPLE M","Zelia Dishwashing Paste 400g","Income","Zelia Dishwashing Paste",,"Undeposited Funds","",440.00,626481.86
,"Sales Receipt","14-06-2024","2709",,"mwaspart","Zelia Dishwashing Paste 400g","Income","Zelia Dishwashing Paste",,"Undeposited Funds","",660.00,627141.86
,"Invoice","18-06-2024","MC05828",,"MUHINDI MWEUSI SUPERMARKET LIMITED","Zelia Dishwashing Paste 400g","Income","Zelia Dishwashing Paste",,"Accounts Receivable","",1324.14,628466.00
,"Invoice","18-06-2024","MC05829",,"MUHINDI MWEUSI SUPERMARKET LIMITED","Zelia Dishwashing Paste 400g","Income","Zelia Dishwashing Paste",,"Accounts Receivable","",1324.14,629790.14
,"Invoice","18-06-2024","MC05830",,"MUHINDI MWEUSI SUPERMARKET LIMITED","Zelia Dishwashing Paste 400g","Income","Zelia Dishwashing Paste",,"Accounts Receivable","",2648.28,632438.42
,"Invoice","18-06-2024","MC05831",,"MUHINDI MWEUSI SUPERMARKET LIMITED","Zelia Dishwashing Paste 400g","Income","Zelia Dishwashing Paste",,"Accounts Receivable","",1324.14,633762.56
,"Invoice","18-06-2024","MC05832",,"MUHINDI MWEUSI SUPERMARKET LIMITED","Zelia Dishwashing Paste 400g","Income","Zelia Dishwashing Paste",,"Accounts Receivable","",2648.28,636410.84
,"Sales Receipt","18-06-2024","2703",,"Cash Sales","Zelia Dishwashing Paste 400g","Income","Zelia Dishwashing Paste",,"Undeposited Funds",0.00,"",636410.84
,"Sales Receipt","18-06-2024","2701",,"Cash Sales","Zelia Dishwashing Paste 400g","Income","Zelia Dishwashing Paste",,"Undeposited Funds","",1440.00,637850.84
,"Sales Receipt","18-06-2024","2711",,"Cash Sales","Zelia Dishwashing Paste 400g","Income","Zelia Dishwashing Paste",,"Undeposited Funds","",97.00,637947.84
,"Sales Receipt","18-06-2024","2708",,"Downtown Wholesalers","Zelia Dishwashing Paste 400g","Income","Zelia Dishwashing Paste",,"Undeposited Funds","",2640.00,640587.84
,"Sales Receipt","18-06-2024","2500",,"Al Hamdu shop","Zelia Dishwashing Paste 400g","Income","Zelia Dishwashing Paste",,"Undeposited Funds","",660.00,641247.84
,"Sales Receipt","18-06-2024","2707",,"Beta Traders","Zelia Dishwashing Paste 400g","Income","Zelia Dishwashing Paste",,"Undeposited Funds","",2640.00,643887.84
,"Sales Receipt","18-06-2024","2706",,"Hidika Shop","Zelia Dishwashing Paste 400g","Income","Zelia Dishwashing Paste",,"Undeposited Funds","",1320.00,645207.84
,"Sales Receipt","18-06-2024","2748",,"Mabini store","Zelia Dishwashing Paste 400g","Income","Zelia Dishwashing Paste",,"Undeposited Funds","",660.00,645867.84
,"Sales Receipt","19-06-2024","2484",,"Cash Sales","Zelia Dishwashing Paste 400g","Income","Zelia Dishwashing Paste",,"Undeposited Funds","",480.00,646347.84
,"Sales Receipt","19-06-2024","2491",,"D-Madina Enterprise","Zelia Dishwashing Paste 400g","Income","Zelia Dishwashing Paste",,"Undeposited Funds","",2640.00,648987.84
,"Invoice","20-06-2024","MC05842",,"HOPEMART SELF SERVICES LTD","Zelia Dishwashing Paste 400g","Income","Zelia Dishwashing Paste",,"Accounts Receivable","",551.72,649539.56
,"Invoice","20-06-2024","MC05843",,"MUHINDI MWEUSI SUPERMARKET LIMITED","Zelia Dishwashing Paste 400g","Income","Zelia Dishwashing Paste",,"Accounts Receivable","",2648.28,652187.84
,"Sales Receipt","20-06-2024","2493",,"Cash Sales","Zelia Dishwashing Paste 400g","Income","Zelia Dishwashing Paste",,"Undeposited Funds",0.00,"",652187.84
,"Sales Receipt","20-06-2024","AT197",,"Cash Sales","Zelia Dishwashing Paste 400g","Income","Zelia Dishwashing Paste",,"Undeposited Funds","",1316.64,653504.48
,"Sales Receipt","20-06-2024","2498",,"Mamken Minimart","Zelia Dishwashing Paste 400g","Income","Zelia Dishwashing Paste",,"Undeposited Funds","",660.00,654164.48
,"Sales Receipt","21-06-2024","2716",,"Cash Sales","Zelia Dishwashing Paste 400g","Income","Zelia Dishwashing Paste",,"Undeposited Funds","",520.00,654684.48
,"Sales Receipt","21-06-2024","2721",,"Home Soko Minimart","Zelia Dishwashing Paste 400g","Income","Zelia Dishwashing Paste",,"Undeposited Funds","",1320.00,656004.48
,"Sales Receipt","21-06-2024","2722",,"Kika Mart","Zelia Dishwashing Paste 400g","Income","Zelia Dishwashing Paste",,"Undeposited Funds","",660.00,656664.48
,"Sales Receipt","23-06-2024","2907",,"Cash Sales","Zelia Dishwashing Paste 400g","Income","Zelia Dishwashing Paste",,"Undeposited Funds","",300.00,656964.48
,"Sales Receipt","24-06-2024","2729",,"Natala Shop","Zelia Dishwashing Paste 400g","Income","Zelia Dishwashing Paste",,"Undeposited Funds","",1320.00,658284.48
,"Invoice","26-06-2024","MC05862",,"LUCKY MART SUPERMARKET LIMITED","Zelia Dishwashing Paste 400g","Income","Zelia Dishwashing Paste",,"Accounts Receivable","",656.90,658941.38
,"Sales Receipt","26-06-2024","2732",,"Instanbul Shop","Zelia Dishwashing Paste 400g","Income","Zelia Dishwashing Paste",,"Undeposited Funds","",1320.00,660261.38
,"Sales Receipt","26-06-2024","2733",,"Mumtaz Shop","Zelia Dishwashing Paste 400g","Income","Zelia Dishwashing Paste",,"Undeposited Funds","",2640.00,662901.38
,"Sales Receipt","26-06-2024","2734",,"Wadajir Wholesalers","Zelia Dishwashing Paste 400g","Income","Zelia Dishwashing Paste",,"Undeposited Funds","",26400.00,689301.38
,"Sales Receipt","28-06-2024","2737",,"Cash Sales","Zelia Dishwashing Paste 400g","Income","Zelia Dishwashing Paste",,"Undeposited Funds",0.00,"",689301.38
,"Sales Receipt","28-06-2024","2738",,"Cash Sales","Zelia Dishwashing Paste 400g","Income","Zelia Dishwashing Paste",,"Undeposited Funds","",388.00,689689.38
,"Sales Receipt","28-06-2024","2743",,"Cash Sales","Zelia Dishwashing Paste 400g","Income","Zelia Dishwashing Paste",,"Undeposited Funds","",388.00,690077.38
,"Sales Receipt","28-06-2024","AT199",,"Cash Sales","Zelia Dishwashing Paste 400g","Income","Zelia Dishwashing Paste",,"Undeposited Funds","",2640.00,692717.38
,"Sales Receipt","01-07-2024","2749",,"Mama Amina","Zelia Dishwashing Paste 400g","Income","Zelia Dishwashing Paste",,"Undeposited Funds","",2640.00,695357.38
,"Sales Receipt","01-07-2024","2750",,"Adurus Wholesallers","Zelia Dishwashing Paste 400g","Income","Zelia Dishwashing Paste",,"Undeposited Funds","",5280.00,700637.38
,"Sales Receipt","01-07-2024","2752",,"Elwak Stores","Zelia Dishwashing Paste 400g","Income","Zelia Dishwashing Paste",,"Undeposited Funds","",2640.00,703277.38
,"Sales Receipt","01-07-2024","2753",,"Sharma Shop","Zelia Dishwashing Paste 400g","Income","Zelia Dishwashing Paste",,"Undeposited Funds","",2640.00,705917.38
,"Sales Receipt","01-07-2024","2553",,"Soko Store","Zelia Dishwashing Paste 400g","Income","Zelia Dishwashing Paste",,"Undeposited Funds","",660.00,706577.38
,"Sales Receipt","02-07-2024","2755",,"Cash Sales","Zelia Dishwashing Paste 400g","Income","Zelia Dishwashing Paste",,"Undeposited Funds","",240.00,706817.38
,"Sales Receipt","02-07-2024","2759",,"Cash Sales","Zelia Dishwashing Paste 400g","Income","Zelia Dishwashing Paste",,"Undeposited Funds","",300.00,707117.38
,"Sales Receipt","02-07-2024","2760",,"Cash Sales","Zelia Dishwashing Paste 400g","Income","Zelia Dishwashing Paste",,"Undeposited Funds","",194.00,707311.38
,"Invoice","03-07-2024","MC05880",,"SECUTOR LIMITED","Zelia Dishwashing Paste 400g","Income","Zelia Dishwashing Paste",,"Accounts Receivable","",120.00,707431.38
,"Sales Receipt","03-07-2024","2761",,"Cash Sales","Zelia Dishwashing Paste 400g","Income","Zelia Dishwashing Paste",,"Undeposited Funds",0.00,"",707431.38
,"Sales Receipt","03-07-2024","2767",,"Cash Sales","Zelia Dishwashing Paste 400g","Income","Zelia Dishwashing Paste",,"Undeposited Funds","",194.00,707625.38
,"Sales Receipt","03-07-2024","2779",,"Cash Sales","Zelia Dishwashing Paste 400g","Income","Zelia Dishwashing Paste",,"Undeposited Funds","",300.00,707925.38
,"Sales Receipt","03-07-2024","2772",,"Ahlam Shop","Zelia Dishwashing Paste 400g","Income","Zelia Dishwashing Paste",,"Undeposited Funds","",2640.00,710565.38
,"Sales Receipt","03-07-2024","2775",,"Tawakal","Zelia Dishwashing Paste 400g","Income","Zelia Dishwashing Paste",,"Undeposited Funds","",7920.00,718485.38
,"Sales Receipt","03-07-2024","2776",,"Aaraka Shop","Zelia Dishwashing Paste 400g","Income","Zelia Dishwashing Paste",,"Undeposited Funds","",1320.00,719805.38
,"Sales Receipt","03-07-2024","2783",,"Cheaper Cheap","Zelia Dishwashing Paste 400g","Income","Zelia Dishwashing Paste",,"Undeposited Funds","",2640.00,722445.38
,"Sales Receipt","03-07-2024","2796",,"Madina  Mombasa Supamat","Zelia Dishwashing Paste 400g","Income","Zelia Dishwashing Paste",,"Undeposited Funds","",2640.00,725085.38
,"Sales Receipt","03-07-2024","2766",,"Anns Shop","Zelia Dishwashing Paste 400g","Income","Zelia Dishwashing Paste",,"Undeposited Funds","",660.00,725745.38
,"Sales Receipt","03-07-2024","2770",,"Tayamo Wholesalers","Zelia Dishwashing Paste 400g","Income","Zelia Dishwashing Paste",,"Undeposited Funds","",110.00,725855.38
,"Invoice","04-07-2024","MC05884",,"PRICE CHOPPER STORES LIMITED","Zelia Dishwashing Paste 400g","Income","Zelia Dishwashing Paste",,"Accounts Receivable","",1313.79,727169.17
,"Invoice","04-07-2024","MC05885",,"The Joymai Blessed Stores Limited","Zelia Dishwashing Paste 400g","Income","Zelia Dishwashing Paste",,"Accounts Receivable","",1324.14,728493.31
,"Sales Receipt","04-07-2024","2789",,"Cash Sales","Zelia Dishwashing Paste 400g","Income","Zelia Dishwashing Paste",,"Undeposited Funds","",97.00,728590.31
,"Sales Receipt","05-07-2024","2791",,"Cash Sales","Zelia Dishwashing Paste 500g","Income","Zelia Dishwashing Paste",,"Undeposited Funds","",150.00,728740.31
,"Sales Receipt","05-07-2024","2797",,"Afro Drip LTD","Zelia Dishwashing Paste 400g","Income","Zelia Dishwashing Paste",,"Undeposited Funds","",110.00,728850.31
,"Sales Receipt","05-07-2024","2798",,"Two Boys Shop","Zelia Dishwashing Paste 400g","Income","Zelia Dishwashing Paste",,"Undeposited Funds","",660.00,729510.31
,"Sales Receipt","05-07-2024","2799",,"Milimani Store","Zelia Dishwashing Paste 400g","Income","Zelia Dishwashing Paste",,"Undeposited Funds","",660.00,730170.31
,"Sales Receipt","05-07-2024","2800",,"Arqam minimart","Zelia Dishwashing Paste 400g","Income","Zelia Dishwashing Paste",,"Undeposited Funds","",2640.00,732810.31
,"Sales Receipt","05-07-2024","2513",,"Homecare Enterprise","Zelia Dishwashing Paste 400g","Income","Zelia Dishwashing Paste",,"Undeposited Funds","",1320.00,734130.31
,"Sales Receipt","06-07-2024","2515",,"Horn of Africa","Zelia Dishwashing Paste 400g","Income","Zelia Dishwashing Paste",,"Undeposited Funds","",2640.00,736770.31
,"Sales Receipt","06-07-2024","2516",,"Baraka Cerials","Zelia Dishwashing Paste 400g","Income","Zelia Dishwashing Paste",,"Undeposited Funds","",660.00,737430.31
,"Sales Receipt","08-07-2024","2527",,"Afro Drip LTD","Zelia Dishwashing Paste 400g","Income","Zelia Dishwashing Paste",,"Undeposited Funds","",220.00,737650.31
,"Sales Receipt","08-07-2024","2517",,"Hidika Shop","Zelia Dishwashing Paste 400g","Income","Zelia Dishwashing Paste",,"Undeposited Funds","",2640.00,740290.31
,"Sales Receipt","09-07-2024","2509",,"Cash Sales","Zelia Dishwashing Paste 400g","Income","Zelia Dishwashing Paste",,"Undeposited Funds","",120.00,740410.31
,"Sales Receipt","09-07-2024","2512",,"Cash Sales","Zelia Dishwashing Paste 400g","Income","Zelia Dishwashing Paste",,"Undeposited Funds","",300.00,740710.31
,"Sales Receipt","09-07-2024","2525",,"Cash Sales","Zelia Dishwashing Paste 400g","Income","Zelia Dishwashing Paste",,"Undeposited Funds","",1320.00,742030.31
,"Sales Receipt","09-07-2024","2526",,"Cash Sales","Zelia Dishwashing Paste 400g","Income","Zelia Dishwashing Paste",,"Undeposited Funds",0.00,"",742030.31
,"Sales Receipt","09-07-2024","2524",,"Towba general stores Parkroad","Zelia Dishwashing Paste 400g","Income","Zelia Dishwashing Paste",,"Undeposited Funds","",2640.00,744670.31
,"Sales Receipt","10-07-2024","2556",,"Ekai moke wholesale","Zelia Dishwashing Paste 400g","Income","Zelia Dishwashing Paste",,"Undeposited Funds","",2640.00,747310.31
,"Sales Receipt","10-07-2024","2532",,"Norhani Groceries","Zelia Dishwashing Paste 400g","Income","Zelia Dishwashing Paste",,"Undeposited Funds","",1320.00,748630.31
,"Sales Receipt","10-07-2024","2533",,"Mega Shop","Zelia Dishwashing Paste 400g","Income","Zelia Dishwashing Paste",,"Undeposited Funds","",2640.00,751270.31
,"Sales Receipt","10-07-2024","2534",,"Dhagaxtuur","Zelia Dishwashing Paste 400g","Income","Zelia Dishwashing Paste",,"Undeposited Funds","",5280.00,756550.31
,"Sales Receipt","12-07-2024","2537",,"Cash Sales","Zelia Dishwashing Paste 400g","Income","Zelia Dishwashing Paste",,"Undeposited Funds","",900.00,757450.31
,"Sales Receipt","12-07-2024","2538",,"Cash Sales","Zelia Dishwashing Paste 400g","Income","Zelia Dishwashing Paste",,"Undeposited Funds","",300.00,757750.31
,"Sales Receipt","12-07-2024","2539",,"Cash Sales","Zelia Dishwashing Paste 400g","Income","Zelia Dishwashing Paste",,"Undeposited Funds","",300.00,758050.31
,"Sales Receipt","13-07-2024","2654",,"Damim Mart","Zelia Dishwashing Paste 400g","Income","Zelia Dishwashing Paste",,"Undeposited Funds","",3300.00,761350.31
,"Invoice","15-07-2024","MC05921",,"OFFSHORE GLOBAL LOGISTICS LIMITED","Zelia Dishwashing Paste 400g","Income","Zelia Dishwashing Paste",,"Accounts Receivable","",220.69,761571.00
,"Invoice","15-07-2024","MC05924",,"Azaavi Collections Limited","Zelia Dishwashing Paste 400g","Income","Zelia Dishwashing Paste",,"Accounts Receivable","",128.00,761699.00
,"Invoice","15-07-2024","MC05931",,"KASAMAT INVESTMENTS LTD","Zelia Dishwashing Paste 400g","Income","Zelia Dishwashing Paste",,"Accounts Receivable","",656.90,762355.90
,"Invoice","15-07-2024","MC05932",,"ROYMATT SUPERMARKET LIMITED","Zelia Dishwashing Paste 400g","Income","Zelia Dishwashing Paste",,"Accounts Receivable","",656.90,763012.80
,"Sales Receipt","15-07-2024","2543",,"Cash Sales","Zelia Dishwashing Paste 400g","Income","Zelia Dishwashing Paste",,"Undeposited Funds","",97.00,763109.80
,"Sales Receipt","15-07-2024","2546",,"Brinso Foodstufs","Zelia Dishwashing Paste 400g","Income","Zelia Dishwashing Paste",,"Undeposited Funds","",2640.00,765749.80
,"Sales Receipt","15-07-2024","2545",,"Taam Wholesalers","Zelia Dishwashing Paste 400g","Income","Zelia Dishwashing Paste",,"Undeposited Funds","",13200.00,778949.80
,"Sales Receipt","16-07-2024","2557",,"Somo 1 Mowlem","Zelia Dishwashing Paste 400g","Income","Zelia Dishwashing Paste",,"Undeposited Funds","",1320.00,780269.80
,"Sales Receipt","16-07-2024","2558",,"Somo Supermarket","Zelia Dishwashing Paste 400g","Income","Zelia Dishwashing Paste",,"Undeposited Funds","",1320.00,781589.80
,"Invoice","17-07-2024","MC05941",,"Ck Upscales Limited","Zelia Dishwashing Paste 400g","Income","Zelia Dishwashing Paste",,"Accounts Receivable","",2648.27,784238.07
,"Invoice","17-07-2024","MC05939",,"DISII TRADERS LTD","Zelia Dishwashing Paste 400g","Income","Zelia Dishwashing Paste",,"Accounts Receivable","",2648.28,786886.35
,"Sales Receipt","17-07-2024","2552",,"Cash Sales","Zelia Dishwashing Paste 400g","Income","Zelia Dishwashing Paste",,"Undeposited Funds",0.00,"",786886.35
,"Sales Receipt","17-07-2024","2562",,"Fresh Finds Mart","Zelia Dishwashing Paste 400g","Income","Zelia Dishwashing Paste",,"Undeposited Funds","",1320.00,788206.35
,"Sales Receipt","17-07-2024","2560",,"Beraccah Syokimau","Zelia Dishwashing Paste 400g","Income","Zelia Dishwashing Paste",,"Undeposited Funds","",1320.00,789526.35
,"Sales Receipt","18-07-2024","2564",,"Cash Sales","Zelia Dishwashing Paste 400g","Income","Zelia Dishwashing Paste",,"Undeposited Funds","",194.00,789720.35
,"Sales Receipt","18-07-2024","2566",,"Cash Sales","Zelia Dishwashing Paste 400g","Income","Zelia Dishwashing Paste",,"Undeposited Funds","",300.00,790020.35
,"Sales Receipt","18-07-2024","2576",,"Mizpa Minimart","Zelia Dishwashing Paste 400g","Income","Zelia Dishwashing Paste",,"Undeposited Funds","",660.00,790680.35
,"Sales Receipt","19-07-2024","2567",,"Cash Sales","Zelia Dishwashing Paste 400g","Income","Zelia Dishwashing Paste",,"Undeposited Funds","",110.00,790790.35
,"Sales Receipt","19-07-2024","2568",,"Cash Sales","Zelia Dishwashing Paste 400g","Income","Zelia Dishwashing Paste",,"Undeposited Funds","",300.00,791090.35
,"Sales Receipt","19-07-2024","2605",,"Restoration Traders","Zelia Dishwashing Paste 400g","Income","Zelia Dishwashing Paste",,"Undeposited Funds","",5280.00,796370.35
,"Sales Receipt","20-07-2024","2577",,"Rosemary Store","Zelia Dishwashing Paste 400g","Income","Zelia Dishwashing Paste",,"Undeposited Funds","",1100.00,797470.35
,"Sales Receipt","20-07-2024","2579",,"Kilimanjaro Store","Zelia Dishwashing Paste 400g","Income","Zelia Dishwashing Paste",,"Undeposited Funds","",2640.00,800110.35
,"Sales Receipt","22-07-2024","2573",,"Cash Sales","Zelia Dishwashing Paste 400g","Income","Zelia Dishwashing Paste",,"Undeposited Funds","",97.00,800207.35
,"Sales Receipt","22-07-2024","2575",,"Cash Sales","Zelia Dishwashing Paste 400g","Income","Zelia Dishwashing Paste",,"Undeposited Funds","",2640.00,802847.35
,"Sales Receipt","22-07-2024","2570",,"Cash Sales","Zelia Dishwashing Paste 400g","Income","Zelia Dishwashing Paste",,"Undeposited Funds",0.00,"",802847.35
,"Sales Receipt","22-07-2024","2606",,"Skype Traders","Zelia Dishwashing Paste 400g","Income","Zelia Dishwashing Paste",,"Undeposited Funds","",5280.00,808127.35
,"Sales Receipt","23-07-2024","2582",,"Cash Sales","Zelia Dishwashing Paste 400g","Income","Zelia Dishwashing Paste",,"Undeposited Funds","",392.00,808519.35
,"Sales Receipt","23-07-2024","2586",,"Cash Sales","Zelia Dishwashing Paste 400g","Income","Zelia Dishwashing Paste",,"Undeposited Funds","",97.00,808616.35
,"Sales Receipt","23-07-2024","2581",,"Cash Sales","Zelia Dishwashing Paste 400g","Income","Zelia Dishwashing Paste",,"Undeposited Funds",0.00,"",808616.35
,"Sales Receipt","24-07-2024","2588",,"Cash Sales","Zelia Dishwashing Paste 400g","Income","Zelia Dishwashing Paste",,"Undeposited Funds","",780.00,809396.35
,"Sales Receipt","24-07-2024","2589",,"Cash Sales","Zelia Dishwashing Paste 400g","Income","Zelia Dishwashing Paste",,"Undeposited Funds","",300.00,809696.35
,"Sales Receipt","24-07-2024","2593",,"Cash Sales","Zelia Dishwashing Paste 400g","Income","Zelia Dishwashing Paste",,"Undeposited Funds",0.00,"",809696.35
,"Sales Receipt","24-07-2024","2598",,"Zonal Minimart","Zelia Dishwashing Paste 400g","Income","Zelia Dishwashing Paste",,"Undeposited Funds","",1320.00,811016.35
,"Sales Receipt","24-07-2024","2608",,"Capital Halal","Zelia Dishwashing Paste 400g","Income","Zelia Dishwashing Paste",,"Undeposited Funds","",660.00,811676.35
,"Sales Receipt","24-07-2024","2599",,"Goldmart Supermarket","Zelia Dishwashing Paste 400g","Income","Zelia Dishwashing Paste",,"Undeposited Funds","",1320.00,812996.35
,"Sales Receipt","25-07-2024","2609",,"Zebra Minimart","Zelia Dishwashing Paste 400g","Income","Zelia Dishwashing Paste",,"Undeposited Funds","",880.00,813876.35
,"Sales Receipt","26-07-2024","2595",,"Cash Sales","Zelia Dishwashing Paste 400g","Income","Zelia Dishwashing Paste",,"Undeposited Funds","",300.00,814176.35
,"Sales Receipt","27-07-2024","2601",,"Cash Sales","Zelia Dishwashing Paste 400g","Income","Zelia Dishwashing Paste",,"Undeposited Funds","",194.00,814370.35
,"Sales Receipt","27-07-2024","2653",,"Danaba Wholesallers","Zelia Dishwashing Paste 400g","Income","Zelia Dishwashing Paste",,"Undeposited Funds","",2640.00,817010.35
,"Sales Receipt","27-07-2024","2652",,"Mash-B Wholesale","Zelia Dishwashing Paste 400g","Income","Zelia Dishwashing Paste",,"Undeposited Funds","",1320.00,818330.35
,"Sales Receipt","27-07-2024","2655",,"Towfique Shop","Zelia Dishwashing Paste 400g","Income","Zelia Dishwashing Paste",,"Undeposited Funds","",1320.00,819650.35
,"Invoice","29-07-2024","MC05983",,"Muhaya & Rukundo Holdings Ltd","0001.12.00 Zelia Dishwashing Paste 24X400g","Income","Zelia Dishwashing Paste",,"Accounts Receivable","",2544.00,822194.35
,"Sales Receipt","29-07-2024","2602",,"Cash Sales","Zelia Dishwashing Paste 400g","Income","Zelia Dishwashing Paste",,"Undeposited Funds",0.00,"",822194.35
,"Sales Receipt","29-07-2024","2603",,"Cash Sales","Zelia Dishwashing Paste 400g","Income","Zelia Dishwashing Paste",,"Undeposited Funds",0.00,"",822194.35
,"Sales Receipt","29-07-2024","2617",,"Mama G shop","Zelia Dishwashing Paste 400g","Income","Zelia Dishwashing Paste",,"Undeposited Funds","",2640.00,824834.35
,"Sales Receipt","29-07-2024","2922",,"Muhaya & Rukundo Holdings Ltd","Zelia Dishwashing Paste 24X400g","Income","Zelia Dishwashing Paste",,"Undeposited Funds","",5088.00,829922.35
,"Invoice","30-07-2024","MC05985",,"LUCKY MART SUPERMARKET LIMITED","Zelia Dishwashing Paste 400g","Income","Zelia Dishwashing Paste",,"Accounts Receivable","",656.90,830579.25
,"Sales Receipt","30-07-2024","2620",,"Cash Sales","Zelia Dishwashing Paste 400g","Income","Zelia Dishwashing Paste",,"Undeposited Funds","",130.00,830709.25
,"Sales Receipt","30-07-2024","2629",,"Cash Sales","Zelia Dishwashing Paste 400g","Income","Zelia Dishwashing Paste",,"Undeposited Funds","",150.00,830859.25
,"Sales Receipt","30-07-2024","2621",,"Moyale Shop","Zelia Dishwashing Paste 400g","Income","Zelia Dishwashing Paste",,"Undeposited Funds","",2640.00,833499.25
,"Sales Receipt","30-07-2024","2623",,"Smart Choice","Zelia Dishwashing Paste 400g","Income","Zelia Dishwashing Paste",,"Undeposited Funds","",1320.00,834819.25
,"Sales Receipt","30-07-2024","2627",,"Elliane Wholesalers","Zelia Dishwashing Paste 400g","Income","Zelia Dishwashing Paste",,"Undeposited Funds","",660.00,835479.25
,"Sales Receipt","30-07-2024","2689",,"Mt Kenya  mart","Zelia Dishwashing Paste 400g","Income","Zelia Dishwashing Paste",,"Undeposited Funds","",1320.00,836799.25
,"Sales Receipt","31-07-2024","2632",,"Al Naim Stores","Zelia Dishwashing Paste 400g","Income","Zelia Dishwashing Paste",,"Undeposited Funds","",2640.00,839439.25
,"Sales Receipt","01-08-2024","2637",,"Burhani Shop","Zelia Dishwashing Paste 400g","Income","Zelia Dishwashing Paste",,"Undeposited Funds","",1536.00,840975.25
,"Sales Receipt","01-08-2024","2691",,"Ubwere Store","-MULTIPLE-","Income","Zelia Dishwashing Paste",,"Undeposited Funds","",3960.00,844935.25
,"Sales Receipt","01-08-2024","2664",,"Mkulima Supermarket","Zelia Dishwashing Paste 400g","Income","Zelia Dishwashing Paste",,"Undeposited Funds","",1320.00,846255.25
,"Sales Receipt","02-08-2024","2644",,"Cash Sales","Zelia Dishwashing Paste 500g","Income","Zelia Dishwashing Paste",,"Undeposited Funds","",150.00,846405.25
,"Sales Receipt","02-08-2024","2645",,"Cash Sales","Zelia Dishwashing Paste 800g","Income","Zelia Dishwashing Paste",,"Undeposited Funds","",190.00,846595.25
,"Sales Receipt","02-08-2024","2648",,"Cash Sales","Zelia Dishwashing Paste 400g","Income","Zelia Dishwashing Paste",,"Undeposited Funds","",300.00,846895.25
,"Sales Receipt","02-08-2024","2649",,"Cash Sales","Zelia Dishwashing Paste 400g","Income","Zelia Dishwashing Paste",,"Undeposited Funds","",204.00,847099.25
,"Sales Receipt","02-08-2024","2650",,"Cash Sales","Zelia Dishwashing Paste 400g","Income","Zelia Dishwashing Paste",,"Undeposited Funds","",300.00,847399.25
,"Sales Receipt","02-08-2024","2667",,"Safa Mart Wholesalers","Zelia Dishwashing Paste 400g","Income","Zelia Dishwashing Paste",,"Undeposited Funds","",2640.00,850039.25
,"Sales Receipt","03-08-2024","2668",,"Freshtake wholesalers","Zelia Dishwashing Paste 400g","Income","Zelia Dishwashing Paste",,"Undeposited Funds","",1320.00,851359.25
,"Sales Receipt","05-08-2024","2673",,"Gure Yare Shop","-MULTIPLE-","Income","Zelia Dishwashing Paste",,"Undeposited Funds","",10656.00,862015.25
,"Sales Receipt","05-08-2024","2675",,"Adurus Wholesallers","Zelia Dishwashing Paste 400g","Income","Zelia Dishwashing Paste",,"Undeposited Funds","",2688.00,864703.25
,"Invoice","06-08-2024","MC06004",,"HAPPY VIEW SUPERMARKET LIMITED","Zelia Dishwashing Paste 400g","Income","Zelia Dishwashing Paste",,"Accounts Receivable","",662.07,865365.32
,"Sales Receipt","06-08-2024","2659",,"Cash Sales","Zelia Dishwashing Paste 400g","Income","Zelia Dishwashing Paste",,"Undeposited Funds","",600.00,865965.32
,"Sales Receipt","06-08-2024","2663",,"Cash Sales","Zelia Dishwashing Paste 400g","Income","Zelia Dishwashing Paste",,"Undeposited Funds","",300.00,866265.32
,"Sales Receipt","06-08-2024","2676",,"Warfa Wholesale","Zelia Dishwashing Paste 800g","Income","Zelia Dishwashing Paste",,"Undeposited Funds","",5280.00,871545.32
,"Sales Receipt","06-08-2024","2678",,"Farhan Wholesallers","-MULTIPLE-","Income","Zelia Dishwashing Paste",,"Undeposited Funds","",7920.00,879465.32
,"Sales Receipt","06-08-2024","2665",,"Kenafa Wholesalers","Zelia Dishwashing Paste 400g","Income","Zelia Dishwashing Paste",,"Undeposited Funds","",2640.00,882105.32
,"Sales Receipt","06-08-2024","2680",,"Juja Minimart","-MULTIPLE-","Income","Zelia Dishwashing Paste",,"Undeposited Funds","",7920.00,890025.32
,"Sales Receipt","06-08-2024","2681",,"Adam Boss","Zelia Dishwashing Paste 800g","Income","Zelia Dishwashing Paste",,"Undeposited Funds","",5280.00,895305.32
,"Invoice","07-08-2024","MC06006",,"NASRI MART LIMITED","Zelia Dishwashing Paste 400g","Income","Zelia Dishwashing Paste",,"Accounts Receivable","",662.07,895967.39
,"Sales Receipt","07-08-2024","2686",,"Soimo Minimart","Zelia Dishwashing Paste 400g","Income","Zelia Dishwashing Paste",,"Undeposited Funds","",1344.00,897311.39
,"Invoice","08-08-2024","MC06015",,"Burhani Private Mart Limited","Zelia Dishwashing Paste 400g","Income","Zelia Dishwashing Paste",,"Accounts Receivable","",1324.14,898635.53
,"Invoice","08-08-2024","MC06016",,"DISII TRADERS LTD","Zelia Dishwashing Paste 400g","Income","Zelia Dishwashing Paste",,"Accounts Receivable","",1324.14,899959.67
,"Invoice","08-08-2024","MC06018",,"OFFSHORE GLOBAL LOGISTICS LIMITED","Zelia Dishwashing Paste 400g","Income","Zelia Dishwashing Paste",,"Accounts Receivable","",360.00,900319.67
,"Sales Receipt","08-08-2024","2672",,"Cash Sales","Zelia Dishwashing Paste 400g","Income","Zelia Dishwashing Paste",,"Undeposited Funds","",388.00,900707.67
,"Sales Receipt","09-08-2024","2692",,"Cash Sales","Zelia Dishwashing Paste 400g","Income","Zelia Dishwashing Paste",,"Undeposited Funds","",300.00,901007.67
,"Sales Receipt","09-08-2024","2695",,"Cash Sales","Zelia Dishwashing Paste 400g","Income","Zelia Dishwashing Paste",,"Undeposited Funds","",300.00,901307.67
,"Invoice","12-08-2024","MC06031",,"KAVYA SUPERMARKET LIMITED","Zelia Dishwashing Paste 400g","Income","Zelia Dishwashing Paste",,"Accounts Receivable","",2896.55,904204.22
,"Sales Receipt","12-08-2024","2810",,"Cash Sales","Zelia Dishwashing Paste 400g","Income","Zelia Dishwashing Paste",,"Undeposited Funds","",300.00,904504.22
,"Sales Receipt","12-08-2024","2813",,"Mamken Minimart","Zelia Dishwashing Paste 400g","Income","Zelia Dishwashing Paste",,"Undeposited Funds","",582.00,905086.22
,"Sales Receipt","12-08-2024","2815",,"Kibibi Wasai Store","Zelia Dishwashing Paste 400g","Income","Zelia Dishwashing Paste",,"Undeposited Funds","",660.00,905746.22
,"Sales Receipt","12-08-2024","2818",,"Rumi Wholesalers","Zelia Dishwashing Paste 400g","Income","Zelia Dishwashing Paste",,"Undeposited Funds","",5280.00,911026.22
,"Sales Receipt","13-08-2024","2848",,"Discount Traders","Zelia Dishwashing Paste 400g","Income","Zelia Dishwashing Paste",,"Undeposited Funds","",2640.00,913666.22
,"Sales Receipt","13-08-2024","2819",,"Tawakal Shop","Zelia Dishwashing Paste 400g","Income","Zelia Dishwashing Paste",,"Undeposited Funds","",2640.00,916306.22
,"Sales Receipt","14-08-2024","2833",,"Mama Hamdi","Zelia Dishwashing Paste 400g","Income","Zelia Dishwashing Paste",,"Undeposited Funds","",2640.00,918946.22
,"Sales Receipt","14-08-2024","2831",,"Jamilas Store","Zelia Dishwashing Paste 400g","Income","Zelia Dishwashing Paste",,"Undeposited Funds","",2640.00,921586.22
,"Sales Receipt","14-08-2024","2830",,"Hussein Soko Store","Zelia Dishwashing Paste 400g","Income","Zelia Dishwashing Paste",,"Undeposited Funds","",660.00,922246.22
,"Sales Receipt","14-08-2024","2829",,"First Choice","Zelia Dishwashing Paste 400g","Income","Zelia Dishwashing Paste",,"Undeposited Funds","",2640.00,924886.22
,"Sales Receipt","15-08-2024","2824",,"Cash Sales","Zelia Dishwashing Paste 800g","Income","Zelia Dishwashing Paste",,"Undeposited Funds","",570.00,925456.22
,"Sales Receipt","15-08-2024","2825",,"Cash Sales","Zelia Dishwashing Paste 400g","Income","Zelia Dishwashing Paste",,"Undeposited Funds","",300.00,925756.22
,"Sales Receipt","15-08-2024","2826",,"Cash Sales","Zelia Dishwashing Paste 400g","Income","Zelia Dishwashing Paste",,"Undeposited Funds","",900.00,926656.22
,"Sales Receipt","15-08-2024","2828",,"Nabcom Wholesalers","Zelia Dishwashing Paste 400g","Income","Zelia Dishwashing Paste",,"Undeposited Funds","",1320.00,927976.22
,"Sales Receipt","15-08-2024","2892",,"Makueni Store","Zelia Dishwashing Paste 400g","Income","Zelia Dishwashing Paste",,"Undeposited Funds","",110.00,928086.22
,"Sales Receipt","15-08-2024","2846",,"Hogol Wholesale","-MULTIPLE-","Income","Zelia Dishwashing Paste",,"Undeposited Funds","",21120.00,949206.22
,"Sales Receipt","15-08-2024","2845",,"Rajah Foodstuffs","Zelia Dishwashing Paste 800g","Income","Zelia Dishwashing Paste",,"Undeposited Funds","",5280.00,954486.22
,"Sales Receipt","15-08-2024","2844",,"Tusma Wholesale","-MULTIPLE-","Income","Zelia Dishwashing Paste",,"Undeposited Funds","",5280.00,959766.22
,"Sales Receipt","16-08-2024","2850",,"Hawkers Paradise","Zelia Dishwashing Paste 400g","Income","Zelia Dishwashing Paste",,"Undeposited Funds","",660.00,960426.22
,"Sales Receipt","16-08-2024","2851",,"Tahila Enterprises","Zelia Dishwashing Paste 400g","Income","Zelia Dishwashing Paste",,"Undeposited Funds","",660.00,961086.22
,"Sales Receipt","16-08-2024","2852",,"032 Mart","-MULTIPLE-","Income","Zelia Dishwashing Paste",,"Undeposited Funds","",990.00,962076.22
,"Invoice","19-08-2024","MC06050",,"Azaavi Collections Limited","Zelia Dishwashing Paste 400g","Income","Zelia Dishwashing Paste",,"Accounts Receivable","",128.00,962204.22
,"Sales Receipt","19-08-2024","2838",,"Cash Sales","Zelia Dishwashing Paste 400g","Income","Zelia Dishwashing Paste",,"Undeposited Funds",0.00,"",962204.22
,"Sales Receipt","19-08-2024","2839",,"Cash Sales","Zelia Dishwashing Paste 400g","Income","Zelia Dishwashing Paste",,"Undeposited Funds",0.00,"",962204.22
,"Sales Receipt","19-08-2024","2840",,"Cash Sales","Zelia Dishwashing Paste 400g","Income","Zelia Dishwashing Paste",,"Undeposited Funds","",97.00,962301.22
,"Sales Receipt","19-08-2024","2841",,"Cash Sales","Zelia Dishwashing Paste 400g","Income","Zelia Dishwashing Paste",,"Undeposited Funds","",75.00,962376.22
,"Sales Receipt","20-08-2024","2858",,"Home Soko Minimart","Zelia Dishwashing Paste 400g","Income","Zelia Dishwashing Paste",,"Undeposited Funds","",1344.00,963720.22
,"Sales Receipt","20-08-2024","2859",,"Nzuri Supermarket","Zelia Dishwashing Paste 400g","Income","Zelia Dishwashing Paste",,"Undeposited Funds","",672.00,964392.22
,"Credit Note","21-08-2024","CN01064",,"Muhaya & Rukundo Holdings Ltd","0001.12.00 Zelia Dishwashing Paste 24X400g","Income","Zelia Dishwashing Paste",,"Accounts Receivable",2544.00,"",961848.22
,"Invoice","21-08-2024","MC06061",,"Muhaya & Rukundo Holdings Ltd","-MULTIPLE-","Income","Zelia Dishwashing Paste",,"Accounts Receivable","",149460.00,1111308.22
,"Invoice","21-08-2024","MC06062",,"Muhaya & Rukundo Holdings Ltd","0001.12.00 Outer Zelia Paste 12x800g/24x400g","Income","Zelia Dishwashing Paste",,"Accounts Receivable","",336.10,1111644.32
,"Sales Receipt","21-08-2024","2853",,"Cash Sales","Zelia Dishwashing Paste 400g","Income","Zelia Dishwashing Paste",,"Undeposited Funds","",600.00,1112244.32
,"Sales Receipt","21-08-2024","2861",,"Al Towba Shop","Zelia Dishwashing Paste 800g","Income","Zelia Dishwashing Paste",,"Undeposited Funds","",2640.00,1114884.32
,"Sales Receipt","21-08-2024","2862",,"Salma Shop","Zelia Dishwashing Paste 400g","Income","Zelia Dishwashing Paste",,"Undeposited Funds","",2688.00,1117572.32
,"Invoice","22-08-2024","MC06066",,"Cash Sales","Zelia Dishwashing Paste 800g","Income","Zelia Dishwashing Paste",,"Accounts Receivable","",198.28,1117770.60
,"Invoice","22-08-2024","MC06067",,"Cash Sales","Zelia Dishwashing Paste 800g","Income","Zelia Dishwashing Paste",,"Accounts Receivable","",198.28,1117968.88
,"Credit Note","22-08-2024","CN01065",,"Cash Sales","Zelia Dishwashing Paste 800g","Income","Zelia Dishwashing Paste",,"Accounts Receivable",198.28,"",1117770.60
,"Credit Note","22-08-2024","CN01066",,"Cash Sales","Zelia Dishwashing Paste 800g","Income","Zelia Dishwashing Paste",,"Accounts Receivable",198.28,"",1117572.32
,"Invoice","22-08-2024","MC06070",,"LUCKY MART SUPERMARKET LIMITED","Zelia Dishwashing Paste 400g","Income","Zelia Dishwashing Paste",,"Accounts Receivable","",672.42,1118244.74
,"Sales Receipt","22-08-2024","2867",,"Sultan Iman Shop","Zelia Dishwashing Paste 400g","Income","Zelia Dishwashing Paste",,"Undeposited Funds","",2640.00,1120884.74
,"Sales Receipt","22-08-2024","2875",,"Maida Minimart","Zelia Dishwashing Paste 400g","Income","Zelia Dishwashing Paste",,"Undeposited Funds","",672.00,1121556.74
,"Sales Receipt","22-08-2024","2897",,"Hayan Wholesalers","-MULTIPLE-","Income","Zelia Dishwashing Paste",,"Undeposited Funds","",5328.00,1126884.74
,"Sales Receipt","22-08-2024","1135",,"Ebenezer Minimart","Zelia Dishwashing Paste 400g","Income","Zelia Dishwashing Paste",,"Undeposited Funds","",672.00,1127556.74
,"Sales Receipt","22-08-2024","1206",,"Tangents Minimart","Zelia Dishwashing Paste 400g","Income","Zelia Dishwashing Paste",,"Undeposited Funds","",360.00,1127916.74
,"Sales Receipt","23-08-2024","2872",,"Cash Sales","Zelia Dishwashing Paste 400g","Income","Zelia Dishwashing Paste",,"Undeposited Funds","",300.00,1128216.74
,"Sales Receipt","23-08-2024","2877",,"Cash Sales","Zelia Dishwashing Paste 800g","Income","Zelia Dishwashing Paste",,"Undeposited Funds","",190.00,1128406.74
,"Sales Receipt","23-08-2024","2880",,"Cash Sales","Zelia Dishwashing Paste 800g","Income","Zelia Dishwashing Paste",,"Undeposited Funds","",193.00,1128599.74
,"Sales Receipt","23-08-2024","2881",,"Cash Sales","Zelia Dishwashing Paste 800g","Income","Zelia Dishwashing Paste",,"Undeposited Funds","",193.00,1128792.74
,"Sales Receipt","23-08-2024","2874",,"Amir shop","Zelia Dishwashing Paste 400g","Income","Zelia Dishwashing Paste",,"Undeposited Funds","",2688.00,1131480.74
,"Sales Receipt","24-08-2024","2887",,"Brightfood Nasra","Zelia Dishwashing Paste 400g","Income","Zelia Dishwashing Paste",,"Undeposited Funds","",672.00,1132152.74
,"Sales Receipt","26-08-2024","2882",,"Cash Sales","Zelia Dishwashing Paste 800g","Income","Zelia Dishwashing Paste",,"Undeposited Funds","",250.00,1132402.74
,"Sales Receipt","26-08-2024","2883",,"Cash Sales","Zelia Dishwashing Paste 400g","Income","Zelia Dishwashing Paste",,"Undeposited Funds","",450.00,1132852.74
,"Sales Receipt","26-08-2024","2886",,"Cash Sales","Zelia Dishwashing Paste 800g","Income","Zelia Dishwashing Paste",,"Undeposited Funds","",500.00,1133352.74
,"Sales Receipt","27-08-2024","2895",,"Cash Sales","Zelia Dishwashing Paste 800g","Income","Zelia Dishwashing Paste",,"Undeposited Funds","",190.00,1133542.74
,"Sales Receipt","28-08-2024","2913",,"Gods Favour","Zelia Dishwashing Paste 400g","Income","Zelia Dishwashing Paste",,"Undeposited Funds","",1344.00,1134886.74
,"Sales Receipt","29-08-2024","AT201",,"Cash Sales","-MULTIPLE-","Income","Zelia Dishwashing Paste",,"Undeposited Funds","",3984.00,1138870.74
,"Sales Receipt","29-08-2024","965",,"Mombasa Velvet","Zelia Dishwashing Paste 400g","Income","Zelia Dishwashing Paste",,"Undeposited Funds","",660.00,1139530.74
,"Sales Receipt","31-08-2024","1151",,"Hussein Soko Store","Zelia Dishwashing Paste 400g","Income","Zelia Dishwashing Paste",,"Undeposited Funds","",672.00,1140202.74
,"Sales Receipt","02-09-2024","3225",,"Purity Shop","Zelia Dishwashing Paste 24X400g","Income","Zelia Dishwashing Paste",,"Undeposited Funds","",448.00,1140650.74
,"Sales Receipt","02-09-2024","2923",,"Blossom Beauty","Zelia Dishwashing Paste 24X400g","Income","Zelia Dishwashing Paste",,"Undeposited Funds","",672.00,1141322.74
,"Sales Receipt","02-09-2024","2924",,"Rio Deli Wholesalers","-MULTIPLE-","Income","Zelia Dishwashing Paste",,"Undeposited Funds","",5328.00,1146650.74
,"Sales Receipt","02-09-2024","3008",,"Cash Sales","-MULTIPLE-","Income","Zelia Dishwashing Paste",,"Undeposited Funds","",381.98,1147032.72
,"Sales Receipt","02-09-2024","3010",,"Cash Sales","-MULTIPLE-","Income","Zelia Dishwashing Paste",,"Undeposited Funds","",668.01,1147700.73
,"Sales Receipt","02-09-2024","2920",,"Cash Sales","Zelia Dishwashing Paste 24X400g","Income","Zelia Dishwashing Paste",,"Undeposited Funds","",599.99,1148300.72
,"Sales Receipt","03-09-2024","2936",,"Jumaira Wholesale","-MULTIPLE-","Income","Zelia Dishwashing Paste",,"Undeposited Funds","",10656.00,1158956.72
,"Sales Receipt","03-09-2024","2927",,"Cash Sales","Zelia Dishwashing Paste 12X800g","Income","Zelia Dishwashing Paste",,"Undeposited Funds","",189.99,1159146.71
,"Sales Receipt","03-09-2024","2922",,"Cash Sales","Zelia Dishwashing Paste 24X400g","Income","Zelia Dishwashing Paste",,"Undeposited Funds",0.00,"",1159146.71
,"Invoice","04-09-2024","MC06107",,"Tupo Mart Limited","Zelia Dishwashing Paste 400g New","Income","Zelia Dishwashing Paste",,"Accounts Receivable","",672.41,1159819.12
,"Invoice","04-09-2024","MC06108",,"PRICE CHOPPER STORES LIMITED","Zelia Dishwashing Paste 400g New","Income","Zelia Dishwashing Paste",,"Accounts Receivable","",656.90,1160476.02
,"Invoice","04-09-2024","MC06109",,"ROYMATT SUPERMARKET LIMITED","Zelia Dishwashing Paste 400g New","Income","Zelia Dishwashing Paste",,"Accounts Receivable","",784.48,1161260.50
,"Sales Receipt","04-09-2024","2940",,"Kenafa Wholesalers","Zelia Dishwashing Paste 24X400g","Income","Zelia Dishwashing Paste",,"Undeposited Funds","",2640.00,1163900.50
,"Sales Receipt","04-09-2024","2941",,"BCB Shop","Zelia Dishwashing Paste 12X800g","Income","Zelia Dishwashing Paste",,"Undeposited Funds","",2640.00,1166540.50
,"Sales Receipt","04-09-2024","2942",,"SK Groceries","Zelia Dishwashing Paste 24X400g","Income","Zelia Dishwashing Paste",,"Undeposited Funds","",2688.00,1169228.50
,"Sales Receipt","04-09-2024","2932",,"Cash Sales","Zelia Dishwashing Paste 12X800g","Income","Zelia Dishwashing Paste",,"Undeposited Funds","",279.99,1169508.49
,"Sales Receipt","04-09-2024","2933",,"Cash Sales","Zelia Dishwashing Paste 12X800g","Income","Zelia Dishwashing Paste",,"Undeposited Funds","",279.99,1169788.48
,"Invoice","05-09-2024","MC06120",,"ROYMATT SUPERMARKET LIMITED","Zelia Dishwashing Paste 400g New","Income","Zelia Dishwashing Paste",,"Accounts Receivable","",560.34,1170348.82
,"Sales Receipt","05-09-2024","2946",,"Ilyas Wholesale","Zelia Dishwashing Paste 24X400g","Income","Zelia Dishwashing Paste",,"Undeposited Funds","",2688.00,1173036.82
,"Sales Receipt","05-09-2024","2948",,"Jam Tower Shop","-MULTIPLE-","Income","Zelia Dishwashing Paste",,"Undeposited Funds","",3984.00,1177020.82
,"Sales Receipt","05-09-2024","2967",,"Freshtake wholesalers","Zelia Dishwashing Paste 12X800g","Income","Zelia Dishwashing Paste",,"Undeposited Funds","",1320.00,1178340.82
,"Sales Receipt","05-09-2024","2944",,"Cash Sales","-MULTIPLE-","Income","Zelia Dishwashing Paste",,"Undeposited Funds","",579.98,1178920.80
,"Sales Receipt","05-09-2024","2950",,"Cash Sales","Zelia Dishwashing Paste 24X400g","Income","Zelia Dishwashing Paste",,"Undeposited Funds","",388.01,1179308.81
,"Sales Receipt","05-09-2024","2951",,"Cash Sales","Zelia Dishwashing Paste 24X400g","Income","Zelia Dishwashing Paste",,"Undeposited Funds","",97.01,1179405.82
,"Sales Receipt","05-09-2024","2953",,"Cash Sales","Zelia Dishwashing Paste 24X400g","Income","Zelia Dishwashing Paste",,"Undeposited Funds","",291.00,1179696.82
,"Sales Receipt","05-09-2024","2955",,"Cash Sales","Zelia Dishwashing Paste 12X800g","Income","Zelia Dishwashing Paste",,"Undeposited Funds","",440.01,1180136.83
,"Sales Receipt","05-09-2024","2952",,"Cash Sales","Zelia Dishwashing Paste 24X400g","Income","Zelia Dishwashing Paste",,"Undeposited Funds",0.00,"",1180136.83
,"Sales Receipt","06-09-2024","2963",,"Nabcom Stores","Zelia Dishwashing Paste 12X800g","Income","Zelia Dishwashing Paste",,"Undeposited Funds","",2640.00,1182776.83
,"Sales Receipt","06-09-2024","2957",,"Cash Sales","Zelia Dishwashing Paste 12X800g","Income","Zelia Dishwashing Paste",,"Undeposited Funds","",189.99,1182966.82
,"Sales Receipt","06-09-2024","2958",,"Cash Sales","Zelia Dishwashing Paste 12X800g","Income","Zelia Dishwashing Paste",,"Undeposited Funds","",189.99,1183156.81
,"Sales Receipt","08-09-2024","3227",,"Visina Stores","Zelia Dishwashing Paste 24X400g","Income","Zelia Dishwashing Paste",,"Undeposited Funds","",15680.00,1198836.81
,"Sales Receipt","09-09-2024","2968",,"Hidika Shop","Zelia Dishwashing Paste 24X400g","Income","Zelia Dishwashing Paste",,"Undeposited Funds","",1344.00,1200180.81
,"Sales Receipt","09-09-2024","2960",,"Mizpa Minimart","Zelia Dishwashing Paste 12X800g","Income","Zelia Dishwashing Paste",,"Undeposited Funds","",220.00,1200400.81
,"Sales Receipt","09-09-2024","2986",,"Pambazuka Mart (K) Limited","-MULTIPLE-","Income","Zelia Dishwashing Paste",,"Undeposited Funds","",3984.00,1204384.81
,"Sales Receipt","10-09-2024","2984",,"Al manaan","-MULTIPLE-","Income","Zelia Dishwashing Paste",,"Undeposited Funds","",7968.00,1212352.81
,"Sales Receipt","10-09-2024","2991",,"Nuclear Supermarket","Zelia Dishwashing Paste 24X400g","Income","Zelia Dishwashing Paste",,"Undeposited Funds","",600.00,1212952.81
,"Sales Receipt","10-09-2024","2973",,"Cash Sales","Zelia Dishwashing Paste 12X800g","Income","Zelia Dishwashing Paste",,"Undeposited Funds","",289.99,1213242.80
,"Sales Receipt","10-09-2024","2975",,"Cash Sales","Zelia Dishwashing Paste 24X400g","Income","Zelia Dishwashing Paste",,"Undeposited Funds","",420.01,1213662.81
,"Sales Receipt","10-09-2024","3015",,"Cash Sales","Zelia Dishwashing Paste 12X800g","Income","Zelia Dishwashing Paste",,"Undeposited Funds","",199.99,1213862.80
,"Sales Receipt","10-09-2024","2976",,"Cash Sales","Zelia Dishwashing Paste 24X400g","Income","Zelia Dishwashing Paste",,"Undeposited Funds",0.00,"",1213862.80
,"Sales Receipt","10-09-2024","3237",,"Cash Sales","Zelia Dishwashing Paste 24X400g","Income","Zelia Dishwashing Paste",,"Undeposited Funds",0.00,"",1213862.80
,"Sales Receipt","11-09-2024","2994",,"Mutawakal Stores","-MULTIPLE-","Income","Zelia Dishwashing Paste",,"Undeposited Funds","",3984.00,1217846.80
,"Sales Receipt","11-09-2024","2995",,"Strawberry Minimart","Zelia Dishwashing Paste 12X800g","Income","Zelia Dishwashing Paste",,"Undeposited Funds","",2640.00,1220486.80
,"Sales Receipt","11-09-2024","2996",,"Freshfinds Mart","Zelia Dishwashing Paste 24X400g","Income","Zelia Dishwashing Paste",,"Undeposited Funds","",2688.00,1223174.80
,"Sales Receipt","11-09-2024","3011",,"Warfa Wholesale","Zelia Dishwashing Paste 12X800g","Income","Zelia Dishwashing Paste",,"Undeposited Funds","",7920.00,1231094.80
,"Sales Receipt","11-09-2024","3017",,"Alham Wholesalers","Zelia Dishwashing Paste 24X400g","Income","Zelia Dishwashing Paste",,"Undeposited Funds","",2688.00,1233782.80
,"Sales Receipt","11-09-2024","3018",,"Tawakal Wholesale","Zelia Dishwashing Paste 12X800g","Income","Zelia Dishwashing Paste",,"Undeposited Funds","",5280.00,1239062.80
,"Invoice","12-09-2024","MC06143",,"Karia Supermarkets Limited","Zelia Dishwashing Paste 24X400g","Income","Zelia Dishwashing Paste",,"Accounts Receivable","",1344.83,1240407.63
,"Invoice","12-09-2024","MC06144",,"DALLAS SHOPRITE LTD","Zelia Dishwashing Paste 24X400g","Income","Zelia Dishwashing Paste",,"Accounts Receivable","",1344.83,1241752.46
,"Invoice","12-09-2024","MC06147",,"ZAIN SUPERMARKET LIMITED","Zelia Dishwashing Paste 24X400g","Income","Zelia Dishwashing Paste",,"Accounts Receivable","",672.41,1242424.87
,"Invoice","12-09-2024","MC06149",,"Azaavi Collections Limited","Zelia Dishwashing Paste 12X800g","Income","Zelia Dishwashing Paste",,"Accounts Receivable","",440.01,1242864.88
,"Sales Receipt","12-09-2024","3055",,"Mubarak Shop","-MULTIPLE-","Income","Zelia Dishwashing Paste",,"Undeposited Funds","",3984.00,1246848.88
,"Sales Receipt","12-09-2024","2988",,"Kumlliye Shop","-MULTIPLE-","Income","Zelia Dishwashing Paste",,"Undeposited Funds","",26640.00,1273488.88
,"Sales Receipt","12-09-2024","1845",,"Daniel Shop","Zelia Dishwashing Paste 24X400g","Income","Zelia Dishwashing Paste",,"Undeposited Funds","",240.00,1273728.88
,"Sales Receipt","12-09-2024","2987",,"Cash Sales","-MULTIPLE-","Income","Zelia Dishwashing Paste",,"Undeposited Funds","",1010.01,1274738.89
,"Sales Receipt","12-09-2024","3019",,"Cash Sales","Zelia Dishwashing Paste 12X800g","Income","Zelia Dishwashing Paste",,"Undeposited Funds","",249.99,1274988.88
,"Sales Receipt","12-09-2024","3023",,"Cash Sales","Zelia Dishwashing Paste 24X400g","Income","Zelia Dishwashing Paste",,"Undeposited Funds","",582.00,1275570.88
,"Sales Receipt","13-09-2024","3035",,"Horn of Africa","Zelia Dishwashing Paste 24X400g","Income","Zelia Dishwashing Paste",,"Undeposited Funds","",2688.00,1278258.88
,"Sales Receipt","13-09-2024","3032",,"Cash Sales","Zelia Dishwashing Paste 12X800g","Income","Zelia Dishwashing Paste",,"Undeposited Funds","",189.99,1278448.87
,"Sales Receipt","14-09-2024","3042",,"mwaspart","Zelia Dishwashing Paste 24X400g","Income","Zelia Dishwashing Paste",,"Undeposited Funds","",1344.00,1279792.87
,"Sales Receipt","14-09-2024","3043",,"Gladys Wholesalers","Zelia Dishwashing Paste 24X400g","Income","Zelia Dishwashing Paste",,"Undeposited Funds","",720.00,1280512.87
,"Sales Receipt","16-09-2024","3046",,"Rumi Wholesalers","Zelia Dishwashing Paste 12X800g","Income","Zelia Dishwashing Paste",,"Undeposited Funds","",13200.00,1293712.87
,"Sales Receipt","16-09-2024","3037",,"Cash Sales","Zelia Dishwashing Paste 24X400g","Income","Zelia Dishwashing Paste",,"Undeposited Funds","",150.01,1293862.88
,"Sales Receipt","17-09-2024","3050",,"Cash Sales","Zelia Dishwashing Paste 24X400g","Income","Zelia Dishwashing Paste",,"Undeposited Funds","",489.99,1294352.87
,"Invoice","18-09-2024","MC06163",,"MKULIMA WANGIGE SUPERMARKET","-MULTIPLE-","Income","Zelia Dishwashing Paste",,"Accounts Receivable","",2663.79,1297016.66
,"Invoice","18-09-2024","MC06164",,"MKULIMA WANGIGE SUPERMARKET","Zelia Dishwashing Paste 24X400g","Income","Zelia Dishwashing Paste",,"Accounts Receivable","",672.41,1297689.07
,"Invoice","18-09-2024","MC06165",,"MKULIMA MUCHATHA","Zelia Dishwashing Paste 24X400g","Income","Zelia Dishwashing Paste",,"Accounts Receivable","",672.41,1298361.48
,"Sales Receipt","18-09-2024","3057",,"Jimos Wholesalers","Zelia Dishwashing Paste 24X400g","Income","Zelia Dishwashing Paste",,"Undeposited Funds","",672.00,1299033.48
,"Sales Receipt","18-09-2024","3059",,"Farhan Shop","-MULTIPLE-","Income","Zelia Dishwashing Paste",,"Undeposited Funds","",3984.00,1303017.48
,"Sales Receipt","18-09-2024","3062",,"Mama Amina","Zelia Dishwashing Paste 24X400g","Income","Zelia Dishwashing Paste",,"Undeposited Funds","",2688.00,1305705.48
,"Sales Receipt","18-09-2024","3052",,"Cash Sales","Zelia Dishwashing Paste 12X800g","Income","Zelia Dishwashing Paste",,"Undeposited Funds","",400.01,1306105.49
,"Sales Receipt","18-09-2024","3056",,"Cash Sales","Zelia Dishwashing Paste 12X800g","Income","Zelia Dishwashing Paste",,"Undeposited Funds","",199.99,1306305.48
,"Sales Receipt","19-09-2024","3063",,"Gold mart","-MULTIPLE-","Income","Zelia Dishwashing Paste",,"Undeposited Funds","",2664.00,1308969.48
,"Sales Receipt","20-09-2024","3094",,"Duto Rumo Store","Zelia Dishwashing Paste 24X400g","Income","Zelia Dishwashing Paste",,"Undeposited Funds","",240.00,1309209.48
,"Sales Receipt","21-09-2024","2917",,"Jubilee Candy Shop","-MULTIPLE-","Income","Zelia Dishwashing Paste",,"Undeposited Funds","",888.00,1310097.48
,"Sales Receipt","23-09-2024","3084",,"Dollar Sign Traders","-MULTIPLE-","Income","Zelia Dishwashing Paste",,"Undeposited Funds","",7968.00,1318065.48
,"Sales Receipt","23-09-2024","3086",,"Brinso Foodstufs","-MULTIPLE-","Income","Zelia Dishwashing Paste",,"Undeposited Funds","",7968.00,1326033.48
,"Sales Receipt","23-09-2024","3071",,"Cash Sales","Zelia Dishwashing Paste 12X800g","Income","Zelia Dishwashing Paste",,"Undeposited Funds","",219.99,1326253.47
,"Sales Receipt","23-09-2024","3073",,"Cash Sales","Zelia Dishwashing Paste 12X800g","Income","Zelia Dishwashing Paste",,"Undeposited Funds","",189.99,1326443.46
,"Sales Receipt","24-09-2024","3090",,"Elliane Wholesalers","Zelia Dishwashing Paste 24X400g","Income","Zelia Dishwashing Paste",,"Undeposited Funds","",672.00,1327115.46
,"Sales Receipt","24-09-2024","3234",,"Gifted Hands","Zelia Dishwashing Paste 24X400g","Income","Zelia Dishwashing Paste",,"Undeposited Funds","",240.00,1327355.46
,"Sales Receipt","24-09-2024","3081",,"Kibibi Wasai Store","-MULTIPLE-","Income","Zelia Dishwashing Paste",,"Undeposited Funds","",5328.00,1332683.46
,"Sales Receipt","24-09-2024","3078",,"Cash Sales","Zelia Dishwashing Paste 12X800g","Income","Zelia Dishwashing Paste",,"Undeposited Funds","",189.99,1332873.45
,"Sales Receipt","24-09-2024","3079",,"Cash Sales","Zelia Dishwashing Paste 12X800g","Income","Zelia Dishwashing Paste",,"Undeposited Funds","",759.99,1333633.44
,"Sales Receipt","24-09-2024","3080",,"Cash Sales","Zelia Dishwashing Paste 12X800g","Income","Zelia Dishwashing Paste",,"Undeposited Funds","",189.99,1333823.43
,"Sales Receipt","24-09-2024","3089",,"Cash Sales","Zelia Dishwashing Paste 12X800g","Income","Zelia Dishwashing Paste",,"Undeposited Funds","",189.99,1334013.42
,"Sales Receipt","24-09-2024","3091",,"Cash Sales","Zelia Dishwashing Paste 12X800g","Income","Zelia Dishwashing Paste",,"Undeposited Funds","",189.99,1334203.41
,"Sales Receipt","25-09-2024","3097",,"Sunar Wholesalers","Zelia Dishwashing Paste 12X800g","Income","Zelia Dishwashing Paste",,"Undeposited Funds","",13200.00,1347403.41
,"Sales Receipt","25-09-2024","3098",,"D-Madina Enterprise","Zelia Dishwashing Paste 24X400g","Income","Zelia Dishwashing Paste",,"Undeposited Funds","",2688.00,1350091.41
,"Sales Receipt","25-09-2024","3095",,"Cash Sales","Zelia Dishwashing Paste 12X800g","Income","Zelia Dishwashing Paste",,"Undeposited Funds","",199.99,1350291.40
,"Sales Receipt","25-09-2024","3202",,"Cash Sales","Zelia Dishwashing Paste 24X400g","Income","Zelia Dishwashing Paste",,"Undeposited Funds","",98.01,1350389.41
,"Sales Receipt","26-09-2024","3206",,"Cash Sales","-MULTIPLE-","Income","Zelia Dishwashing Paste",,"Undeposited Funds","",674.01,1351063.42
,"Sales Receipt","26-09-2024","3208",,"Cash Sales","Zelia Dishwashing Paste 24X400g","Income","Zelia Dishwashing Paste",,"Undeposited Funds","",392.01,1351455.43
,"Sales Receipt","26-09-2024","3209",,"Cash Sales","Zelia Dishwashing Paste 12X800g","Income","Zelia Dishwashing Paste",,"Undeposited Funds","",189.99,1351645.42
,"Credit Note","27-09-2024","CN01070",,"ROYMATT SUPERMARKET LIMITED","Zelia Dishwashing Paste 400g New","Income","Zelia Dishwashing Paste",,"Accounts Receivable",784.48,"",1350860.94
,"Credit Note","27-09-2024","CN01071",,"ROYMATT SUPERMARKET LIMITED","Zelia Dishwashing Paste 400g New","Income","Zelia Dishwashing Paste",,"Accounts Receivable",560.34,"",1350300.60
,"Invoice","27-09-2024","MC06216",,"QUALITYMART SUPERMARKET LIMITED","Zelia Dishwashing Paste 24X400g","Income","Zelia Dishwashing Paste",,"Accounts Receivable","",1344.83,1351645.43
,"Invoice","27-09-2024","MC06217",,"Mumsha Supamat","Zelia Dishwashing Paste 24X400g","Income","Zelia Dishwashing Paste",,"Accounts Receivable","",672.41,1352317.84
,"Sales Receipt","27-09-2024","3215",,"Supaa Mart","-MULTIPLE-","Income","Zelia Dishwashing Paste",,"Undeposited Funds","",1992.00,1354309.84
,"Sales Receipt","27-09-2024","3211",,"Cash Sales","Zelia Dishwashing Paste 24X400g","Income","Zelia Dishwashing Paste",,"Undeposited Funds","",2688.00,1356997.84
,"Sales Receipt","27-09-2024","3211",,"Cash Sales","Zelia Dishwashing Paste 24X400g","Income","Zelia Dishwashing Paste",,"Undeposited Funds",0.00,"",1356997.84
,"Sales Receipt","27-09-2024","3216",,"Cash Sales","Zelia Dishwashing Paste 12X800g","Income","Zelia Dishwashing Paste",,"Undeposited Funds","",879.99,1357877.83
,"Sales Receipt","30-09-2024","3223",,"Brightfood Nasra","Zelia Dishwashing Paste 24X400g","Income","Zelia Dishwashing Paste",,"Undeposited Funds","",1344.00,1359221.83
,"Sales Receipt","01-10-2024","3220",,"Cash Sales","Zelia Dishwashing Paste 24X400g","Income","Zelia Dishwashing Paste",,"Undeposited Funds","",196.00,1359417.83
,"Sales Receipt","02-10-2024","3225",,"Cash Sales","-MULTIPLE-","Income","Zelia Dishwashing Paste",,"Undeposited Funds","",386.00,1359803.83
,"Sales Receipt","02-10-2024","3225",,"Cash Sales","-MULTIPLE-","Income","Zelia Dishwashing Paste",,"Undeposited Funds","",386.00,1360189.83
,"Sales Receipt","02-10-2024","3228",,"Cash Sales","Zelia Dishwashing Paste 24X400g","Income","Zelia Dishwashing Paste",,"Undeposited Funds","",120.00,1360309.83
,"Sales Receipt","02-10-2024","3229",,"Towba general stores Parkroad","Zelia Dishwashing Paste 12X800g","Income","Zelia Dishwashing Paste",,"Undeposited Funds","",5280.00,1365589.83
,"Sales Receipt","02-10-2024","3235",,"Dhaxatuur Wholesalers","Zelia Dishwashing Paste 24X400g","Income","Zelia Dishwashing Paste",,"Undeposited Funds","",5376.00,1370965.83
,"Sales Receipt","02-10-2024","3236",,"Bahati Super Stores","Zelia Dishwashing Paste 12X800g","Income","Zelia Dishwashing Paste",,"Undeposited Funds","",13200.00,1384165.83
,"Sales Receipt","03-10-2024","3240",,"Cash Sales","Zelia Dishwashing Paste 24X400g","Income","Zelia Dishwashing Paste",,"Undeposited Funds","",150.00,1384315.83
,"Sales Receipt","03-10-2024","3243",,"Cash Sales","Zelia Dishwashing Paste 12X800g","Income","Zelia Dishwashing Paste",,"Undeposited Funds","",190.00,1384505.83
,"Sales Receipt","03-10-2024","3249",,"Cash Sales","Zelia Dishwashing Paste 12X800g","Income","Zelia Dishwashing Paste",,"Undeposited Funds","",190.00,1384695.83
,"Sales Receipt","03-10-2024","3245",,"Freshtake wholesalers","-MULTIPLE-","Income","Zelia Dishwashing Paste",,"Undeposited Funds","",7968.00,1392663.83
,"Sales Receipt","03-10-2024","3246",,"Fahan Foodstuff","Zelia Dishwashing Paste 12X800g","Income","Zelia Dishwashing Paste",,"Undeposited Funds","",13200.00,1405863.83
,"Sales Receipt","03-10-2024","3248",,"Elwak Stores","Zelia Dishwashing Paste 24X400g","Income","Zelia Dishwashing Paste",,"Undeposited Funds","",2688.00,1408551.83
,"Sales Receipt","03-10-2024","3233",,"Mabruk Wholesalers","Zelia Dishwashing Paste 24X400g","Income","Zelia Dishwashing Paste",,"Undeposited Funds","",1344.00,1409895.83
,"Sales Receipt","05-10-2024","3420",,"Danaba Wholesallers","-MULTIPLE-","Income","Zelia Dishwashing Paste",,"Undeposited Funds","",6624.00,1416519.83
,"Sales Receipt","06-10-2024","3421",,"Raage mart","Zelia Dishwashing Paste 12X800g","Income","Zelia Dishwashing Paste",,"Undeposited Funds","",5280.00,1421799.83
,"Sales Receipt","06-10-2024","3184",,"Precious Mart","Zelia Dishwashing Paste 24X400g","Income","Zelia Dishwashing Paste",,"Undeposited Funds","",360.00,1422159.83
,"Sales Receipt","06-10-2024","3422",,"Mikara Shop","Zelia Dishwashing Paste 12X800g","Income","Zelia Dishwashing Paste",,"Undeposited Funds","",440.00,1422599.83
,"Sales Receipt","06-10-2024","3423",,"Jikweri Minimart","-MULTIPLE-","Income","Zelia Dishwashing Paste",,"Undeposited Funds","",1410.00,1424009.83
,"Sales Receipt","07-10-2024","3254",,"Cash Sales","Zelia Dishwashing Paste 12X800g","Income","Zelia Dishwashing Paste",,"Undeposited Funds","",189.99,1424199.82
,"Sales Receipt","07-10-2024","3260",,"Sharma Shop","Zelia Dishwashing Paste 24X400g","Income","Zelia Dishwashing Paste",,"Undeposited Funds","",2688.00,1426887.82
,"Sales Receipt","07-10-2024","3288",,"Adurus Wholesallers","-MULTIPLE-","Income","Zelia Dishwashing Paste",,"Undeposited Funds","",5328.00,1432215.82
,"Sales Receipt","07-10-2024","3258",,"Fatah Wholesalers","Zelia Dishwashing Paste 12X800g","Income","Zelia Dishwashing Paste",,"Undeposited Funds","",13200.00,1445415.82
,"Sales Receipt","08-10-2024","3261",,"Cash Sales","Zelia Dishwashing Paste 12X800g","Income","Zelia Dishwashing Paste",,"Undeposited Funds","",500.01,1445915.83
,"Sales Receipt","08-10-2024","3264",,"Cash Sales","Zelia Dishwashing Paste 24X400g","Income","Zelia Dishwashing Paste",,"Undeposited Funds","",600.01,1446515.84
,"Sales Receipt","08-10-2024","3266",,"Cash Sales","Zelia Dishwashing Paste 12X800g","Income","Zelia Dishwashing Paste",,"Undeposited Funds","",189.99,1446705.83
,"Sales Receipt","08-10-2024","3268",,"Cash Sales","Zelia Dishwashing Paste 24X400g","Income","Zelia Dishwashing Paste",,"Undeposited Funds","",98.01,1446803.84
,"Sales Receipt","08-10-2024","3269",,"Cash Sales","Zelia Dishwashing Paste 24X400g","Income","Zelia Dishwashing Paste",,"Undeposited Funds","",98.01,1446901.85
,"Sales Receipt","09-10-2024","3275",,"Cash Sales","Zelia Dishwashing Paste 12X800g","Income","Zelia Dishwashing Paste",,"Undeposited Funds","",840.00,1447741.85
,"Sales Receipt","09-10-2024","3276",,"Cash Sales","Zelia Dishwashing Paste 24X400g","Income","Zelia Dishwashing Paste",,"Undeposited Funds",0.00,"",1447741.85
,"Sales Receipt","09-10-2024","3279",,"Cash Sales","Zelia Dishwashing Paste 12X800g","Income","Zelia Dishwashing Paste",,"Undeposited Funds","",199.99,1447941.84
,"Sales Receipt","09-10-2024","3282",,"Cash Sales","Zelia Dishwashing Paste 12X800g","Income","Zelia Dishwashing Paste",,"Undeposited Funds","",189.99,1448131.83
,"Sales Receipt","09-10-2024","3283",,"Cash Sales","Zelia Dishwashing Paste 12X800g","Income","Zelia Dishwashing Paste",,"Undeposited Funds","",189.99,1448321.82
,"Sales Receipt","09-10-2024","3285",,"Strawberry Minimart","-MULTIPLE-","Income","Zelia Dishwashing Paste",,"Undeposited Funds","",3984.00,1452305.82
,"Sales Receipt","09-10-2024","3284",,"Mina Wholesalers","-MULTIPLE-","Income","Zelia Dishwashing Paste",,"Undeposited Funds","",5328.00,1457633.82
,"Invoice","11-10-2024","MC06251",,"HOPEMART SELF SERVICES LTD","-MULTIPLE-","Income","Zelia Dishwashing Paste",,"Accounts Receivable","",2664.00,1460297.82
,"Sales Receipt","11-10-2024","3289",,"Cash Sales","Zelia Dishwashing Paste 24X400g","Income","Zelia Dishwashing Paste",,"Undeposited Funds","",299.99,1460597.81
,"Sales Receipt","11-10-2024","3291",,"Cash Sales","Zelia Dishwashing Paste 24X400g","Income","Zelia Dishwashing Paste",,"Undeposited Funds","",392.01,1460989.82
,"Sales Receipt","11-10-2024","3292",,"Cash Sales","Zelia Dishwashing Paste 12X800g","Income","Zelia Dishwashing Paste",,"Undeposited Funds","",380.01,1461369.83
,"Sales Receipt","11-10-2024","3296",,"Restoration Traders","Zelia Dishwashing Paste 24X400g","Income","Zelia Dishwashing Paste",,"Undeposited Funds","",2688.00,1464057.83
,"Sales Receipt","12-10-2024","3295",,"Alma Wholesale","-MULTIPLE-","Income","Zelia Dishwashing Paste",,"Undeposited Funds","",2224.00,1466281.83
,"Sales Receipt","15-10-2024","3107",,"Cash Sales","Zelia Dishwashing Paste 24X400g","Income","Zelia Dishwashing Paste",,"Undeposited Funds","",195.99,1466477.82
,"Sales Receipt","15-10-2024","3187",,"Big Fish Minimart","Zelia Dishwashing Paste 12X800g","Income","Zelia Dishwashing Paste",,"Undeposited Funds","",690.00,1467167.82
,"Sales Receipt","16-10-2024","3109",,"Cash Sales","Zelia Dishwashing Paste 12X800g","Income","Zelia Dishwashing Paste",,"Undeposited Funds","",560.01,1467727.83
,"Sales Receipt","16-10-2024","3110",,"Cash Sales","Zelia Dishwashing Paste 24X400g","Income","Zelia Dishwashing Paste",,"Undeposited Funds","",294.00,1468021.83
,"Invoice","17-10-2024","MC06269",,"MUHINDI MWEUSI SUPERMARKET LIMITED","Zelia Dishwashing Paste 24X400g  12 Pieces @129.92","Income","Zelia Dishwashing Paste",,"Accounts Receivable","",1344.00,1469365.83
,"Sales Receipt","17-10-2024","3116",,"Cash Sales","Zelia Dishwashing Paste 12X800g","Income","Zelia Dishwashing Paste",,"Undeposited Funds","",189.99,1469555.82
,"Sales Receipt","17-10-2024","3115",,"Corner Shop","Zelia Dishwashing Paste 24X400g","Income","Zelia Dishwashing Paste",,"Undeposited Funds","",2688.00,1472243.82
,"Sales Receipt","17-10-2024","3117",,"Freshtake wholesalers","Zelia Dishwashing Paste 24X400g","Income","Zelia Dishwashing Paste",,"Undeposited Funds","",1344.00,1473587.82
,"Sales Receipt","18-10-2024","3122",,"Cash Sales","-MULTIPLE-","Income","Zelia Dishwashing Paste",,"Undeposited Funds","",610.00,1474197.82
,"Sales Receipt","18-10-2024","3126",,"Cash Sales","Zelia Dishwashing Paste 24X400g","Income","Zelia Dishwashing Paste",,"Undeposited Funds","",98.01,1474295.83
,"Sales Receipt","18-10-2024","3127",,"Cash Sales","-MULTIPLE-","Income","Zelia Dishwashing Paste",,"Undeposited Funds","",385.98,1474681.81
,"Sales Receipt","18-10-2024","3128",,"Cash Sales","Zelia Dishwashing Paste 12X800g","Income","Zelia Dishwashing Paste",,"Undeposited Funds","",380.01,1475061.82
,"Sales Receipt","19-10-2024","3180",,"Witgad Shop","Zelia Dishwashing Paste 24X400g","Income","Zelia Dishwashing Paste",,"Undeposited Funds","",480.00,1475541.82
,"Sales Receipt","22-10-2024","3130",,"Cash Sales","Zelia Dishwashing Paste 24X400g","Income","Zelia Dishwashing Paste",,"Undeposited Funds","",98.01,1475639.83
,"Sales Receipt","22-10-2024","3131",,"Cash Sales","Zelia Dishwashing Paste 24X400g","Income","Zelia Dishwashing Paste",,"Undeposited Funds","",299.99,1475939.82
,"Sales Receipt","22-10-2024","3133",,"tRIPPLE M","Zelia Dishwashing Paste 24X400g","Income","Zelia Dishwashing Paste",,"Undeposited Funds","",672.00,1476611.82
,"Sales Receipt","23-10-2024","3138",,"Cash Sales","Zelia Dishwashing Paste 24X400g","Income","Zelia Dishwashing Paste",,"Undeposited Funds","",299.99,1476911.81
,"Sales Receipt","23-10-2024","3139",,"Cash Sales","Zelia Dishwashing Paste 24X400g","Income","Zelia Dishwashing Paste",,"Undeposited Funds","",150.01,1477061.82
,"Sales Receipt","23-10-2024","3142",,"Cash Sales","Zelia Dishwashing Paste 24X400g","Income","Zelia Dishwashing Paste",,"Undeposited Funds","",96.01,1477157.83
,"Sales Receipt","23-10-2024","3144",,"Cash Sales","Zelia Dishwashing Paste 24X400g","Income","Zelia Dishwashing Paste",,"Undeposited Funds","",195.99,1477353.82
,"Sales Receipt","23-10-2024","3141",,"Kibibi Wasai Store","-MULTIPLE-","Income","Zelia Dishwashing Paste",,"Undeposited Funds","",15840.00,1493193.82
,"Sales Receipt","24-10-2024","3147",,"Cash Sales","Zelia Dishwashing Paste 24X400g","Income","Zelia Dishwashing Paste",,"Undeposited Funds","",600.01,1493793.83
,"Sales Receipt","24-10-2024","3148",,"Cash Sales","Zelia Dishwashing Paste 12X800g","Income","Zelia Dishwashing Paste",,"Undeposited Funds","",279.99,1494073.82
,"Sales Receipt","24-10-2024","3154",,"Horn of Africa","Zelia Dishwashing Paste 24X400g","Income","Zelia Dishwashing Paste",,"Undeposited Funds","",1344.00,1495417.82
,"Sales Receipt","24-10-2024","3701",,"One Stop Minimart","-MULTIPLE-","Income","Zelia Dishwashing Paste",,"Undeposited Funds","",5328.00,1500745.82
,"Invoice","25-10-2024","MC06300",,"HAPPY VIEW SUPERMARKET LIMITED","Zelia Dishwashing Paste 24X400g  6Pcs @130","Income","Zelia Dishwashing Paste",,"Accounts Receivable","",672.41,1501418.23
,"Sales Receipt","25-10-2024","3156",,"Cash Sales","Zelia Dishwashing Paste 12X800g","Income","Zelia Dishwashing Paste",,"Undeposited Funds","",199.99,1501618.22
,"Sales Receipt","25-10-2024","3160",,"Hussein Soko Store","Zelia Dishwashing Paste 24X400g","Income","Zelia Dishwashing Paste",,"Undeposited Funds","",1120.00,1502738.22
,"Sales Receipt","26-10-2024","3193",,"032 minimart","Zelia Dishwashing Paste 24X400g","Income","Zelia Dishwashing Paste",,"Undeposited Funds","",672.00,1503410.22
,"Invoice","28-10-2024","MC06308",,"MUHINDI MWEUSI SUPERMARKET LIMITED","Zelia Dishwashing Paste 24X400g","Income","Zelia Dishwashing Paste",,"Accounts Receivable","",2689.66,1506099.88
,"Invoice","28-10-2024","MC06310",,"MUHINDI MWEUSI SUPERMARKET LIMITED","Zelia Dishwashing Paste 24X400g","Income","Zelia Dishwashing Paste",,"Accounts Receivable","",2689.66,1508789.54
,"Invoice","28-10-2024","MC06311",,"MUHINDI MWEUSI SUPERMARKET LIMITED","Zelia Dishwashing Paste 24X400g","Income","Zelia Dishwashing Paste",,"Accounts Receivable","",2689.65,1511479.19
,"Invoice","28-10-2024","MC06312",,"MUHINDI MWEUSI SUPERMARKET LIMITED","Zelia Dishwashing Paste 24X400g","Income","Zelia Dishwashing Paste",,"Accounts Receivable","",2689.65,1514168.84
,"Invoice","28-10-2024","MC06313",,"MUHINDI MWEUSI SUPERMARKET LIMITED","Zelia Dishwashing Paste 24X400g","Income","Zelia Dishwashing Paste",,"Accounts Receivable","",2689.65,1516858.49
,"Sales Receipt","28-10-2024","3164",,"Cash Sales","Zelia Dishwashing Paste 24X400g","Income","Zelia Dishwashing Paste",,"Undeposited Funds","",2688.00,1519546.49
,"Sales Receipt","28-10-2024","3173",,"Nasra Super stores","-MULTIPLE-","Income","Zelia Dishwashing Paste",,"Undeposited Funds","",1992.00,1521538.49
,"Credit Note","29-10-2024","CN01072",,"Karia Supermarkets Limited","Zelia Dishwashing Paste 24X400g  7pcs @ 130","Income","Zelia Dishwashing Paste",,"Accounts Receivable",784.49,"",1520754.00
,"Sales Receipt","29-10-2024","3167",,"Cash Sales","Zelia Dishwashing Paste 24X400g","Income","Zelia Dishwashing Paste",,"Undeposited Funds","",96.01,1520850.01
,"Sales Receipt","29-10-2024","3168",,"Cash Sales","Zelia Dishwashing Paste 24X400g","Income","Zelia Dishwashing Paste",,"Undeposited Funds","",98.01,1520948.02
,"Sales Receipt","29-10-2024","3704",,"Home Soko Minimart","-MULTIPLE-","Income","Zelia Dishwashing Paste",,"Undeposited Funds","",2664.00,1523612.02
,"Sales Receipt","29-10-2024","3705",,"Elliane Wholesalers","Zelia Dishwashing Paste 24X400g","Income","Zelia Dishwashing Paste",,"Undeposited Funds","",1344.00,1524956.02
,"Sales Receipt","30-10-2024","3171",,"Cash Sales","Zelia Dishwashing Paste 12X800g","Income","Zelia Dishwashing Paste",,"Undeposited Funds","",840.00,1525796.02
,"Sales Receipt","30-10-2024","3190",,"Hidika Shop","Zelia Dishwashing Paste 24X400g","Income","Zelia Dishwashing Paste",,"Undeposited Funds","",2688.00,1528484.02
,"Sales Receipt","30-10-2024","3189",,"Bahati Super Stores","Zelia Dishwashing Paste 12X800g","Income","Zelia Dishwashing Paste",,"Undeposited Funds","",13200.00,1541684.02
,"Sales Receipt","30-10-2024","3725",,"Safa Groceries","-MULTIPLE-","Income","Zelia Dishwashing Paste",,"Undeposited Funds","",3984.00,1545668.02
,"Sales Receipt","31-10-2024","3194",,"Cash Sales","Zelia Dishwashing Paste 12X800g","Income","Zelia Dishwashing Paste",,"Undeposited Funds","",759.99,1546428.01
,"Sales Receipt","02-11-2024","3706",,"Warfa Wholesale","-MULTIPLE-","Income","Zelia Dishwashing Paste",,"Undeposited Funds","",13296.00,1559724.01
,"Sales Receipt","04-11-2024","3430",,"Mabini Minimart","Zelia Dishwashing Paste 24X400g","Income","Zelia Dishwashing Paste",,"Undeposited Funds","",672.00,1560396.01
,"Sales Receipt","04-11-2024","3708",,"Gure Yare Shop","-MULTIPLE-","Income","Zelia Dishwashing Paste",,"Undeposited Funds","",13296.00,1573692.01
,"Sales Receipt","05-11-2024","3198",,"Cash Sales","Zelia Dishwashing Paste 24X400g","Income","Zelia Dishwashing Paste",,"Undeposited Funds","",291.00,1573983.01
,"Invoice","06-11-2024","MC06333",,"MUHINDI MWEUSI SUPERMARKET LIMITED","Zelia Dishwashing Paste 24X400g  24Pcs @130","Income","Zelia Dishwashing Paste",,"Accounts Receivable","",2689.65,1576672.66
,"Invoice","06-11-2024","MC06334",,"MUHINDI MWEUSI SUPERMARKET LIMITED","Zelia Dishwashing Paste 24X400g  12Pcs @130","Income","Zelia Dishwashing Paste",,"Accounts Receivable","",1344.83,1578017.49
,"Invoice","06-11-2024","MC06335",,"Guard Mart Supermarket Limited","-MULTIPLE-","Income","Zelia Dishwashing Paste",,"Accounts Receivable","",344.00,1578361.49
,"Sales Receipt","06-11-2024","3199",,"Cash Sales","Zelia Dishwashing Paste 24X400g","Income","Zelia Dishwashing Paste",,"Undeposited Funds","",576.00,1578937.49
,"Sales Receipt","06-11-2024","3200",,"Cash Sales","Zelia Dishwashing Paste 12X800g","Income","Zelia Dishwashing Paste",,"Undeposited Funds","",189.99,1579127.48
,"Sales Receipt","06-11-2024","3402",,"Cash Sales","Zelia Dishwashing Paste 12X800g","Income","Zelia Dishwashing Paste",,"Undeposited Funds","",219.99,1579347.47
,"Sales Receipt","06-11-2024","3403",,"Cash Sales","Zelia Dishwashing Paste 24X400g","Income","Zelia Dishwashing Paste",,"Undeposited Funds","",98.01,1579445.48
,"Sales Receipt","06-11-2024","3404",,"Cash Sales","Zelia Dishwashing Paste 24X400g","Income","Zelia Dishwashing Paste",,"Undeposited Funds","",98.01,1579543.49
,"Sales Receipt","06-11-2024","3715",,"Mama Amina","Zelia Dishwashing Paste 24X400g","Income","Zelia Dishwashing Paste",,"Undeposited Funds","",2688.00,1582231.49
,"Sales Receipt","06-11-2024","3717",,"BCB Shop","Zelia Dishwashing Paste 12X800g","Income","Zelia Dishwashing Paste",,"Undeposited Funds","",2640.00,1584871.49
,"Sales Receipt","06-11-2024","3720",,"Amir shop","Zelia Dishwashing Paste 24X400g","Income","Zelia Dishwashing Paste",,"Undeposited Funds","",2688.00,1587559.49
,"Sales Receipt","07-11-2024","3407",,"Cash Sales","Zelia Dishwashing Paste 24X400g","Income","Zelia Dishwashing Paste",,"Undeposited Funds","",49.00,1587608.49
,"Sales Receipt","07-11-2024","2688",,"Sahra Shop","Zelia Dishwashing Paste 24X400g","Income","Zelia Dishwashing Paste",,"Undeposited Funds","",2688.00,1590296.49
,"Sales Receipt","07-11-2024","3457",,"Dylyn Enterprise","Zelia Dishwashing Paste 24X400g","Income","Zelia Dishwashing Paste",,"Undeposited Funds","",480.00,1590776.49
,"Sales Receipt","08-11-2024","3411",,"Cash Sales","Zelia Dishwashing Paste 24X400g","Income","Zelia Dishwashing Paste",,"Undeposited Funds","",98.01,1590874.50
,"Sales Receipt","08-11-2024","3412",,"Cash Sales","Zelia Dishwashing Paste 12X800g","Income","Zelia Dishwashing Paste",,"Undeposited Funds","",189.99,1591064.49
,"Sales Receipt","08-11-2024","3413",,"Cash Sales","-MULTIPLE-","Income","Zelia Dishwashing Paste",,"Undeposited Funds","",385.98,1591450.47
,"Sales Receipt","09-11-2024","3308",,"Rosemary Shop","Zelia Dishwashing Paste 24X400g","Income","Zelia Dishwashing Paste",,"Undeposited Funds","",1008.00,1592458.47
,"Sales Receipt","11-11-2024","3420",,"Cash Sales","Zelia Dishwashing Paste 12X800g","Income","Zelia Dishwashing Paste",,"Undeposited Funds","",280.00,1592738.47
,"Sales Receipt","11-11-2024","3456",,"RichMind Property","Zelia Dishwashing Paste 24X400g","Income","Zelia Dishwashing Paste",,"Undeposited Funds","",224.00,1592962.47
,"Sales Receipt","11-11-2024","3425",,"Dekh Wholesalers","-MULTIPLE-","Income","Zelia Dishwashing Paste",,"Undeposited Funds","",3312.00,1596274.47
,"Sales Receipt","11-11-2024","3428",,"Arqam minimart","-MULTIPLE-","Income","Zelia Dishwashing Paste",,"Undeposited Funds","",5328.00,1601602.47
,"Sales Receipt","12-11-2024","3431",,"Cash Sales","-MULTIPLE-","Income","Zelia Dishwashing Paste",,"Undeposited Funds","",18550.00,1620152.47
,"Sales Receipt","12-11-2024","3436",,"Horn of Africa","Zelia Dishwashing Paste 24X400g","Income","Zelia Dishwashing Paste",,"Undeposited Funds","",1344.00,1621496.47
,"Sales Receipt","12-11-2024","3437",,"Jombs wholesalers","Zelia Dishwashing Paste 24X400g","Income","Zelia Dishwashing Paste",,"Undeposited Funds","",672.00,1622168.47
,"Sales Receipt","12-11-2024","3439",,"Maida Minimart","Zelia Dishwashing Paste 24X400g","Income","Zelia Dishwashing Paste",,"Undeposited Funds","",672.00,1622840.47
,"Invoice","13-11-2024","MC06359",,"PRICE CHOPPER STORES LIMITED","Zelia Dishwashing Paste 24X400g  12Pieces@130","Income","Zelia Dishwashing Paste",,"Accounts Receivable","",1344.83,1624185.30
,"Sales Receipt","13-11-2024","3493",,"Mwambao Shop","Zelia Dishwashing Paste 24X400g","Income","Zelia Dishwashing Paste",,"Undeposited Funds","",448.00,1624633.30
,"Sales Receipt","13-11-2024","3443",,"Sunar Wholesalers","Zelia Dishwashing Paste 12X800g","Income","Zelia Dishwashing Paste",,"Undeposited Funds","",13200.00,1637833.30
,"Sales Receipt","14-11-2024","3447",,"Amir Wholesalers","Zelia Dishwashing Paste 24X400g","Income","Zelia Dishwashing Paste",,"Undeposited Funds","",1344.00,1639177.30
,"Sales Receipt","14-11-2024","3446",,"One Stop Minimart","-MULTIPLE-","Income","Zelia Dishwashing Paste",,"Undeposited Funds","",18624.00,1657801.30
,"Invoice","15-11-2024","MC06366",,"MUHINDI MWEUSI SUPERMARKET LIMITED","Zelia Dishwashing Paste 24X400g  12Pcs @130","Income","Zelia Dishwashing Paste",,"Accounts Receivable","",1344.83,1659146.13
,"Sales Receipt","15-11-2024","3730",,"Cash Sales","Zelia Dishwashing Paste 24X400g","Income","Zelia Dishwashing Paste",,"Undeposited Funds","",388.00,1659534.13
,"Sales Receipt","15-11-2024","3731",,"Cash Sales","Zelia Dishwashing Paste 24X400g","Income","Zelia Dishwashing Paste",,"Undeposited Funds","",76.00,1659610.13
,"Invoice","18-11-2024","MC06372",,"Guard Mart Supermarket Limited","-MULTIPLE-","Income","Zelia Dishwashing Paste",,"Accounts Receivable","",5544.00,1665154.13
,"Credit Note","18-11-2024","CN01073",,"Guard Mart Supermarket Limited","-MULTIPLE-","Income","Zelia Dishwashing Paste",,"Accounts Receivable",344.00,"",1664810.13
,"Sales Receipt","18-11-2024","3450",,"Cash Sales","Zelia Dishwashing Paste 24X400g","Income","Zelia Dishwashing Paste",,"Undeposited Funds","",98.00,1664908.13
,"Sales Receipt","18-11-2024","3468",,"Cash Sales","-MULTIPLE-","Income","Zelia Dishwashing Paste",,"Undeposited Funds","",950.00,1665858.13
,"Sales Receipt","18-11-2024","3470",,"Cash Sales","Zelia Dishwashing Paste 24X400g","Income","Zelia Dishwashing Paste",,"Undeposited Funds","",98.00,1665956.13
,"Sales Receipt","18-11-2024","3473",,"Cash Sales","Zelia Dishwashing Paste 24X400g","Income","Zelia Dishwashing Paste",,"Undeposited Funds",0.00,"",1665956.13
,"Sales Receipt","18-11-2024","3462",,"Nabcom Stores","-MULTIPLE-","Income","Zelia Dishwashing Paste",,"Undeposited Funds","",3984.00,1669940.13
,"Invoice","19-11-2024","MC06376",,"MUHINDI MWEUSI SUPERMARKET LIMITED","Zelia Dishwashing Paste 24X400g  24Pcs @130","Income","Zelia Dishwashing Paste",,"Accounts Receivable","",2689.65,1672629.78
,"Invoice","19-11-2024","MC06378",,"ROYMATT SUPERMARKET LIMITED","Zelia Dishwashing Paste 24X400g  12Pcs@130","Income","Zelia Dishwashing Paste",,"Accounts Receivable","",1344.83,1673974.61
,"Sales Receipt","20-11-2024","3477",,"Cash Sales","Zelia Dishwashing Paste 24X400g","Income","Zelia Dishwashing Paste",,"Undeposited Funds",0.00,"",1673974.61
,"Sales Receipt","20-11-2024","3497",,"032 minimart","Zelia Dishwashing Paste 24X400g","Income","Zelia Dishwashing Paste",,"Undeposited Funds","",672.00,1674646.61
,"Sales Receipt","20-11-2024","3481",,"Norhani Groceries","Zelia Dishwashing Paste 24X400g","Income","Zelia Dishwashing Paste",,"Undeposited Funds","",1344.00,1675990.61
,"Sales Receipt","20-11-2024","3480",,"Burhani Shop","Zelia Dishwashing Paste 12X800g","Income","Zelia Dishwashing Paste",,"Undeposited Funds","",5280.00,1681270.61
,"Sales Receipt","22-11-2024","3486",,"Cash Sales","Zelia Dishwashing Paste 12X800g","Income","Zelia Dishwashing Paste",,"Undeposited Funds","",190.00,1681460.61
,"Sales Receipt","22-11-2024","3488",,"Cash Sales","Zelia Dishwashing Paste 24X400g","Income","Zelia Dishwashing Paste",,"Undeposited Funds","",588.00,1682048.61
,"Sales Receipt","22-11-2024","3499",,"Cash Sales","Zelia Dishwashing Paste 24X400g","Income","Zelia Dishwashing Paste",,"Undeposited Funds","",1400.00,1683448.61
,"Sales Receipt","22-11-2024","3734",,"Cash Sales","Zelia Dishwashing Paste 24X400g","Income","Zelia Dishwashing Paste",,"Undeposited Funds","",98.00,1683546.61
,"Invoice","26-11-2024","MC06416",,"MUHINDI MWEUSI SUPERMARKET LIMITED","Zelia Dishwashing Paste 24X400g  12Pcs @130","Income","Zelia Dishwashing Paste",,"Accounts Receivable","",1344.83,1684891.44
,"Sales Receipt","26-11-2024","3736",,"Cash Sales","Zelia Dishwashing Paste 24X400g","Income","Zelia Dishwashing Paste",,"Undeposited Funds","",98.00,1684989.44
,"Sales Receipt","26-11-2024","3738",,"Garumo Wholesale","-MULTIPLE-","Income","Zelia Dishwashing Paste",,"Undeposited Funds","",5328.00,1690317.44
,"Sales Receipt","27-11-2024","3739",,"Eugombe Enterprises","Zelia Dishwashing Paste 24X400g","Income","Zelia Dishwashing Paste",,"Undeposited Funds","",2880.00,1693197.44
,"Sales Receipt","27-11-2024","3745",,"Al- Malik Wholesalers","Zelia Dishwashing Paste 12X800g","Income","Zelia Dishwashing Paste",,"Undeposited Funds","",2640.00,1695837.44
,"Sales Receipt","27-11-2024","3746",,"Tusma Wholesale","Zelia Dishwashing Paste 12X800g","Income","Zelia Dishwashing Paste",,"Undeposited Funds","",5280.00,1701117.44
,"Sales Receipt","27-11-2024","3747",,"Bahati Super Stores","Zelia Dishwashing Paste 12X800g","Income","Zelia Dishwashing Paste",,"Undeposited Funds","",26400.00,1727517.44
,"Sales Receipt","27-11-2024","3748",,"Dhaxatuur Wholesalers","Zelia Dishwashing Paste 12X800g","Income","Zelia Dishwashing Paste",,"Undeposited Funds","",5280.00,1732797.44
,"Sales Receipt","27-11-2024","3764",,"Molly Shop","Zelia Dishwashing Paste 24X400g","Income","Zelia Dishwashing Paste",,"Undeposited Funds","",720.00,1733517.44
,"Invoice","28-11-2024","MC06426",,"ZAIN SUPERMARKET LIMITED","-MULTIPLE-","Income","Zelia Dishwashing Paste",,"Accounts Receivable","",1996.55,1735513.99
,"Sales Receipt","28-11-2024","3750",,"Cash Sales","Zelia Dishwashing Paste 24X400g","Income","Zelia Dishwashing Paste",,"Undeposited Funds","",600.00,1736113.99
,"Sales Receipt","29-11-2024","3754",,"Cash Sales","Zelia Dishwashing Paste 24X400g","Income","Zelia Dishwashing Paste",,"Undeposited Funds","",145.00,1736258.99
,"Sales Receipt","29-11-2024","3756",,"Cash Sales","Zelia Dishwashing Paste 24X400g","Income","Zelia Dishwashing Paste",,"Undeposited Funds","",290.00,1736548.99
,"Sales Receipt","29-11-2024","3789",,"Ubwete Shop","Zelia Dishwashing Paste 24X400g","Income","Zelia Dishwashing Paste",,"Undeposited Funds","",672.00,1737220.99
,"Sales Receipt","30-11-2024","AT203",,"Cash Sales","-MULTIPLE-","Income","Zelia Dishwashing Paste",,"Undeposited Funds","",3984.00,1741204.99
,"Sales Receipt","30-11-2024","3766",,"Muga Shop","-MULTIPLE-","Income","Zelia Dishwashing Paste",,"Undeposited Funds","",6672.00,1747876.99
,"Sales Receipt","02-12-2024","3761",,"Cash Sales","Zelia Dishwashing Paste 24X400g","Income","Zelia Dishwashing Paste",,"Undeposited Funds","",150.00,1748026.99
,"Sales Receipt","02-12-2024","3777",,"Cash Sales","Zelia Dishwashing Paste 12X800g","Income","Zelia Dishwashing Paste",,"Undeposited Funds","",190.00,1748216.99
,"Sales Receipt","02-12-2024","3780",,"Cash Sales","Zelia Dishwashing Paste 12X800g","Income","Zelia Dishwashing Paste",,"Undeposited Funds","",190.00,1748406.99
,"Sales Receipt","02-12-2024","3776",,"Elwak Stores","-MULTIPLE-","Income","Zelia Dishwashing Paste",,"Undeposited Funds","",5328.00,1753734.99
,"Sales Receipt","04-12-2024","3785",,"Towba Parkroad","-MULTIPLE-","Income","Zelia Dishwashing Paste",,"Undeposited Funds","",7968.00,1761702.99
,"Sales Receipt","04-12-2024","3787",,"Top Quality Shop","-MULTIPLE-","Income","Zelia Dishwashing Paste",,"Undeposited Funds","",6624.00,1768326.99
,"Sales Receipt","04-12-2024","3791",,"Gold mart Supermarket","Zelia Dishwashing Paste 12X800g","Income","Zelia Dishwashing Paste",,"Undeposited Funds","",1320.00,1769646.99
,"Sales Receipt","05-12-2024","3309",,"Freshfinds Mart","Zelia Dishwashing Paste 24X400g","Income","Zelia Dishwashing Paste",,"Undeposited Funds","",672.00,1770318.99
,"Sales Receipt","05-12-2024","3793",,"BCB Shop","Zelia Dishwashing Paste 12X800g","Income","Zelia Dishwashing Paste",,"Undeposited Funds","",2640.00,1772958.99
,"Sales Receipt","05-12-2024","3794",,"Tawakal Eastleigh","Zelia Dishwashing Paste 24X400g","Income","Zelia Dishwashing Paste",,"Undeposited Funds","",2688.00,1775646.99
,"Sales Receipt","05-12-2024","3799",,"Hayan Wholesalers","Zelia Dishwashing Paste 12X800g","Income","Zelia Dishwashing Paste",,"Undeposited Funds","",2640.00,1778286.99
,"Invoice","09-12-2024","MC06452",,"DISII TRADERS LTD","Zelia Dishwashing Paste 24X400g  24Pcs@129","Income","Zelia Dishwashing Paste",,"Accounts Receivable","",2668.97,1780955.96
,"Invoice","09-12-2024","MC06453",,"Maji Asili Limited","Zelia Dishwashing Paste 24X400g  24Pcs@129","Income","Zelia Dishwashing Paste",,"Accounts Receivable","",2668.96,1783624.92
,"Sales Receipt","09-12-2024","3311",,"Cash Sales","Zelia Dishwashing Paste 12X800g","Income","Zelia Dishwashing Paste",,"Undeposited Funds","",200.00,1783824.92
,"Sales Receipt","09-12-2024","3312",,"Cash Sales","-MULTIPLE-","Income","Zelia Dishwashing Paste",,"Undeposited Funds","",582.00,1784406.92
,"Sales Receipt","09-12-2024","3314",,"Cash Sales","-MULTIPLE-","Income","Zelia Dishwashing Paste",,"Undeposited Funds","",288.00,1784694.92
,"Sales Receipt","09-12-2024","3316",,"Cash Sales","Zelia Dishwashing Paste 12X800g","Income","Zelia Dishwashing Paste",,"Undeposited Funds","",1000.00,1785694.92
,"Sales Receipt","09-12-2024","3317",,"Cash Sales","Zelia Dishwashing Paste 12X800g","Income","Zelia Dishwashing Paste",,"Undeposited Funds","",500.00,1786194.92
,"Sales Receipt","09-12-2024","3318",,"Cash Sales","Zelia Dishwashing Paste 12X800g","Income","Zelia Dishwashing Paste",,"Undeposited Funds","",500.00,1786694.92
,"Sales Receipt","09-12-2024","3320",,"Cash Sales","Zelia Dishwashing Paste 12X800g","Income","Zelia Dishwashing Paste",,"Undeposited Funds","",190.00,1786884.92
,"Sales Receipt","09-12-2024","3315",,"Shop 5","Zelia Dishwashing Paste 24X400g","Income","Zelia Dishwashing Paste",,"Undeposited Funds","",2688.00,1789572.92
,"Sales Receipt","10-12-2024","3328",,"Horn of Africa","Zelia Dishwashing Paste 24X400g","Income","Zelia Dishwashing Paste",,"Undeposited Funds","",2688.00,1792260.92
,"Sales Receipt","10-12-2024","3329",,"Soimo Mini mart","Zelia Dishwashing Paste 24X400g","Income","Zelia Dishwashing Paste",,"Undeposited Funds","",1344.00,1793604.92
,"Sales Receipt","10-12-2024","3330",,"Iqra Shop","Zelia Dishwashing Paste 24X400g","Income","Zelia Dishwashing Paste",,"Undeposited Funds","",2688.00,1796292.92
,"Sales Receipt","10-12-2024","3347",,"Beta Traders","Zelia Dishwashing Paste 24X400g","Income","Zelia Dishwashing Paste",,"Undeposited Funds","",2688.00,1798980.92
,"Sales Receipt","10-12-2024","3332",,"Amir Wholesalers","Zelia Dishwashing Paste 24X400g","Income","Zelia Dishwashing Paste",,"Undeposited Funds","",1344.00,1800324.92
,"Sales Receipt","11-12-2024","3333",,"Cash Sales","Zelia Dishwashing Paste 12X800g","Income","Zelia Dishwashing Paste",,"Undeposited Funds","",190.00,1800514.92
,"Sales Receipt","11-12-2024","3336",,"Cash Sales","Zelia Dishwashing Paste 12X800g","Income","Zelia Dishwashing Paste",,"Undeposited Funds","",380.00,1800894.92
,"Sales Receipt","11-12-2024","3339",,"Fahal Wholesalers","Zelia Dishwashing Paste 12X800g","Income","Zelia Dishwashing Paste",,"Undeposited Funds","",13200.00,1814094.92
,"Sales Receipt","13-12-2024","3350",,"Daru-Rahma","Zelia Dishwashing Paste 12X800g","Income","Zelia Dishwashing Paste",,"Undeposited Funds","",2640.00,1816734.92
,"Sales Receipt","14-12-2024","3378",,"Egesa Shop","-MULTIPLE-","Income","Zelia Dishwashing Paste",,"Undeposited Funds","",460.00,1817194.92
,"Sales Receipt","16-12-2024","3345",,"Cash Sales","Zelia Dishwashing Paste 12X800g","Income","Zelia Dishwashing Paste",,"Undeposited Funds","",500.00,1817694.92
,"Sales Receipt","16-12-2024","3346",,"Cash Sales","Zelia Dishwashing Paste 12X800g","Income","Zelia Dishwashing Paste",,"Undeposited Funds","",1000.00,1818694.92
,"Sales Receipt","16-12-2024","3348",,"Cash Sales","Zelia Dishwashing Paste 12X800g","Income","Zelia Dishwashing Paste",,"Undeposited Funds","",1000.00,1819694.92
,"Sales Receipt","16-12-2024","3352",,"Rayyan Shop","Zelia Dishwashing Paste 24X400g","Income","Zelia Dishwashing Paste",,"Undeposited Funds","",2688.00,1822382.92
,"Invoice","17-12-2024","MC06475",,"MUHINDI MWEUSI SUPERMARKET LIMITED","Zelia Dishwashing Paste 24X400g  12Pcs @130","Income","Zelia Dishwashing Paste",,"Accounts Receivable","",2689.65,1825072.57
,"Invoice","17-12-2024","MC06476",,"MUHINDI MWEUSI SUPERMARKET LIMITED","Zelia Dishwashing Paste 24X400g  12Pcs @130","Income","Zelia Dishwashing Paste",,"Accounts Receivable","",1344.83,1826417.40
,"Sales Receipt","17-12-2024","3354",,"Cash Sales","Zelia Dishwashing Paste 12X800g","Income","Zelia Dishwashing Paste",,"Undeposited Funds","",280.00,1826697.40
,"Sales Receipt","18-12-2024","3359",,"Cash Sales","Zelia Dishwashing Paste 24X400g","Income","Zelia Dishwashing Paste",,"Undeposited Funds","",196.00,1826893.40
,"Sales Receipt","18-12-2024","3360",,"Cash Sales","-MULTIPLE-","Income","Zelia Dishwashing Paste",,"Undeposited Funds","",1112.00,1828005.40
,"Sales Receipt","18-12-2024","3363",,"Cash Sales","Zelia Dishwashing Paste 24X400g","Income","Zelia Dishwashing Paste",,"Undeposited Funds","",980.00,1828985.40
,"Sales Receipt","18-12-2024","3369",,"Al-naim Store","Zelia Dishwashing Paste 24X400g","Income","Zelia Dishwashing Paste",,"Undeposited Funds","",2688.00,1831673.40
,"Sales Receipt","18-12-2024","3370",,"Adam Boss","Zelia Dishwashing Paste 12X800g","Income","Zelia Dishwashing Paste",,"Undeposited Funds","",2640.00,1834313.40
,"Sales Receipt","18-12-2024","3371",,"Freshfinds Mart","Zelia Dishwashing Paste 12X800g","Income","Zelia Dishwashing Paste",,"Undeposited Funds","",2640.00,1836953.40
,"Sales Receipt","19-12-2024","3373",,"Cash Sales","Zelia Dishwashing Paste 24X400g","Income","Zelia Dishwashing Paste",,"Undeposited Funds",0.00,"",1836953.40
,"Credit Note","20-12-2024","CN01076",,"Karia Supermarkets Limited","Zelia Dishwashing Paste 24X400g  5pcs @ 130","Income","Zelia Dishwashing Paste",,"Accounts Receivable",560.34,"",1836393.06
"Total Zelia Dishwashing Paste",,,,,,,,,,,24694.21,1861087.27,1836393.06
"Total Zelia",,,,,,,,,,,272866.96,7669587.86,7396720.90
"Sixin",,,,,,,,,,,,,""
,"Invoice","12-01-2024","MC05305",,"Unilever Kenya Ltd:Sixin","Sixin Sulphate Blend ZA Processing Fee","Income","Sixin",,"Accounts Receivable","",101850.00,101850.00
,"Invoice","04-03-2024","MC05462",,"Unilever Kenya Ltd:Sixin","Sixin Sulphate Blend ZA Processing Fee","Income","Sixin",,"Accounts Receivable","",67900.00,169750.00
,"Invoice","23-03-2024","MC05526",,"Unilever Kenya Ltd:Sixin","Sixin Sulphate Blend ZA Processing Fee","Income","Sixin",,"Accounts Receivable","",67900.00,237650.00
,"Invoice","04-04-2024","MC05567",,"Unilever Kenya Ltd:Sixin","Sixin Sulphate Blend ZA Processing Fee","Income","Sixin",,"Accounts Receivable","",67900.00,305550.00
,"Invoice","15-05-2024","MC05705",,"Unilever Kenya Ltd:Sixin","Sixin Sulphate Blend ZA Processing Fee","Income","Sixin",,"Accounts Receivable","",67900.00,373450.00
,"Invoice","30-05-2024","MC05773",,"Unilever Kenya Ltd:Sixin","Sixin Sulphate Blend ZA Processing Fee","Income","Sixin",,"Accounts Receivable","",67900.00,441350.00
,"Invoice","07-06-2024","MC05796",,"Unilever Kenya Ltd:Sixin","Sixin Sulphate Blend ZA Processing Fee","Income","Sixin",,"Accounts Receivable","",101850.00,543200.00
,"Invoice","24-06-2024","MC05853",,"Unilever Kenya Ltd:Sixin","Sixin Sulphate Blend ZA Processing Fee","Income","Sixin",,"Accounts Receivable","",101850.00,645050.00
,"Invoice","04-07-2024","MC05883",,"Unilever Kenya Ltd:Sixin","Sixin Sulphate Blend ZA Processing Fee","Income","Sixin",,"Accounts Receivable","",67900.00,712950.00
,"Invoice","15-08-2024","MC06038",,"Unilever Kenya Ltd:Sixin","Sixin Sulphate Blend ZA Processing Fee","Income","Sixin",,"Accounts Receivable","",67900.00,780850.00
,"Invoice","04-09-2024","MC06111",,"Unilever Kenya Ltd:Sixin","Sixin Sulphate Blend ZA Processing Fee","Income","Sixin",,"Accounts Receivable","",67900.00,848750.00
,"Invoice","25-09-2024","MC06198",,"Unilever Kenya Ltd:Sixin","Sixin Sulphate Blend ZA Processing Fee","Income","Sixin",,"Accounts Receivable","",67900.00,916650.00
,"Invoice","08-11-2024","MC06349",,"Unilever Kenya Ltd:Sixin","Sixin Sulphate Blend ZA Processing Fee","Income","Sixin",,"Accounts Receivable","",67900.00,984550.00
,"Invoice","21-11-2024","MC06393",,"Unilever Kenya Ltd:Sixin","Sixin Sulphate Blend ZA Processing Fee","Income","Sixin",,"Accounts Receivable","",67900.00,1052450.00
,"Invoice","04-12-2024","MC06442",,"Unilever Kenya Ltd:Sixin","Sixin Sulphate Blend ZA Processing Fee","Income","Sixin",,"Accounts Receivable","",67900.00,1120350.00
,"Invoice","17-12-2024","MC06482",,"Unilever Kenya Ltd:Sixin","Sixin Sulphate Blend ZA Processing Fee","Income","Sixin",,"Accounts Receivable","",67900.00,1188250.00
,"Invoice","23-12-2024","MC06501",,"Unilever Kenya Ltd","Sixin Sulphate Blend ZA Processing Fee","Income","Sixin",,"Accounts Receivable","",67900.00,1256150.00
"Total Sixin",,,,,,,,,,,0.00,1256150.00,1256150.00
"Date Coding",,,,,,,,,,,,,""
,"Invoice","04-01-2024","MC05268",,"Azaavi Collections Limited","Date Coding 850 Pcs Pouches","Income","Date Coding",,"Accounts Receivable","",1275.00,1275.00
,"Invoice","12-01-2024","MC05306",,"Azaavi Collections Limited","Date Coding 361 Pcs Pouches","Income","Date Coding",,"Accounts Receivable","",541.50,1816.50
,"Invoice","26-01-2024","MC05361",,"Akaya Consulting Limited","Date Coding 1,632 Pcs Pouches","Income","Date Coding",,"Accounts Receivable","",2448.00,4264.50
,"Invoice","22-02-2024","MC05428",,"Azaavi Collections Limited","Date Coding 1300 Pcs Pouches","Income","Date Coding",,"Accounts Receivable","",1950.00,6214.50
,"Invoice","05-03-2024","MC05463",,"Akaya Consulting Limited","Date Coding 1,530 Pcs Pouches","Income","Date Coding",,"Accounts Receivable","",2295.00,8509.50
,"Invoice","11-03-2024","MC05483",,"Azaavi Collections Limited","Date Coding 942 Pcs Pouches","Income","Date Coding",,"Accounts Receivable","",1413.00,9922.50
,"Invoice","25-03-2024","MC05529",,"Beautyland Ltd","Date Coding 21116 Pcs of Product","Income","Date Coding",,"Accounts Receivable","",40120.40,50042.90
,"Invoice","04-04-2024","MC05563",,"Sleek Kenya Ltd","Date Coding 27,297 Pcs of Product","Income","Date Coding",,"Accounts Receivable","",51864.30,101907.20
,"Invoice","04-04-2024","MC05564",,"Azaavi Collections Limited","Date Coding 940 Pcs Pouches","Income","Date Coding",,"Accounts Receivable","",1410.00,103317.20
,"Invoice","19-04-2024","MC05621",,"Akaya Consulting Limited","Date Coding 1,278 Pcs Pouches","Income","Date Coding",,"Accounts Receivable","",1917.00,105234.20
,"Invoice","30-04-2024","MC05653",,"Sleek Kenya Ltd","Date Coding 1,320 Pcs of Product","Income","Date Coding",,"Accounts Receivable","",2508.00,107742.20
,"Invoice","13-05-2024","MC05696",,"Blue Bubble Homecare Products Ltd","Date Coding 1000 Pcs Product","Income","Date Coding",,"Accounts Receivable","",1500.00,109242.20
,"Invoice","14-05-2024","MC05699",,"Sleek Kenya Ltd","Date Coding 2,520 Pcs of Product","Income","Date Coding",,"Accounts Receivable","",4788.00,114030.20
,"Invoice","20-05-2024","MC05718",,"Azaavi Collections Limited","Date Coding 997 Pcs Pouches","Income","Date Coding",,"Accounts Receivable","",1495.50,115525.70
,"Invoice","20-05-2024","MC05719",,"Akaya Consulting Limited","Date Coding 1,300 Pcs Pouches","Income","Date Coding",,"Accounts Receivable","",1950.00,117475.70
,"Invoice","07-06-2024","MC05803",,"Blue Bubble Homecare Products Ltd","Date Coding 7500 Pcs Product","Income","Date Coding",,"Accounts Receivable","",11250.00,128725.70
,"Invoice","07-06-2024","MC05804",,"Sleek Kenya Ltd","Date Coding 6024 Pcs of Product","Income","Date Coding",,"Accounts Receivable","",11445.60,140171.30
,"Invoice","20-06-2024","MC05844",,"Blue Bubble Homecare Products Ltd","Date Coding 18,000 Pcs Product","Income","Date Coding",,"Accounts Receivable","",27000.00,167171.30
,"Invoice","20-06-2024","MC05845",,"Azaavi Collections Limited","Date Coding 1326 Pcs Pouches","Income","Date Coding",,"Accounts Receivable","",1989.00,169160.30
,"Invoice","15-07-2024","MC05922",,"Akaya Consulting Limited","Date Coding 1,200 Pcs Pouches","Income","Date Coding",,"Accounts Receivable","",1800.00,170960.30
,"Invoice","15-07-2024","MC05923",,"Sleek Kenya Ltd","Date Coding 10,975 Pcs of Product","Income","Date Coding",,"Accounts Receivable","",20852.50,191812.80
,"Invoice","15-07-2024","MC05924",,"Azaavi Collections Limited","Date Coding 1093 Pcs Pouches","Income","Date Coding",,"Accounts Receivable","",1639.50,193452.30
,"Invoice","22-07-2024","MC05958",,"BLUEMART PRODUCTS EAST AFRICA LTD","Date Coding 12804 Pcs Product","Income","Date Coding",,"Accounts Receivable","",19206.00,212658.30
,"Invoice","09-08-2024","MC06021",,"BLUEMART PRODUCTS EAST AFRICA LTD","Date Coding 10,307 Pcs Product","Income","Date Coding",,"Accounts Receivable","",15460.50,228118.80
,"Invoice","09-08-2024","MC06022",,"Sleek Kenya Ltd","Date Coding 11,982 Pcs of Product","Income","Date Coding",,"Accounts Receivable","",22765.80,250884.60
,"Invoice","19-08-2024","MC06050",,"Azaavi Collections Limited","Date Coding 710 Pcs Pouches","Income","Date Coding",,"Accounts Receivable","",1065.00,251949.60
,"Invoice","12-09-2024","MC06145",,"Aurora Ventures Limited","Date coding 504 pcs of Product","Income","Date Coding",,"Accounts Receivable","",957.60,252907.20
,"Invoice","12-09-2024","MC06146",,"Aurora Ventures Limited","Date coding 16128 pcs of Product","Income","Date Coding",,"Accounts Receivable","",30643.20,283550.40
,"Invoice","12-09-2024","MC06149",,"Azaavi Collections Limited","Date Coding 1487 Pcs Pouches","Income","Date Coding",,"Accounts Receivable","",2230.50,285780.90
,"Invoice","20-09-2024","MC06178",,"Sleek Kenya Ltd","Date Coding 5615 Pcs of Product","Income","Date Coding",,"Accounts Receivable","",10668.50,296449.40
,"Invoice","08-10-2024","MC06238",,"Azaavi Collections Limited","Date Coding 1054 Pcs Pouches","Income","Date Coding",,"Accounts Receivable","",1581.00,298030.40
,"Invoice","08-10-2024","MC06240",,"Riverwest Company Limited","Date Coding 504 Pcs Pouches","Income","Date Coding",,"Accounts Receivable","",756.00,298786.40
,"Invoice","17-10-2024","MC06268",,"BLUEMART PRODUCTS EAST AFRICA LTD","Date Coding 11,084 Pcs Product","Income","Date Coding",,"Accounts Receivable","",16626.00,315412.40
,"Invoice","28-10-2024","MC06306",,"Sleek Kenya Ltd","Date Coding 4,800 Pcs of Product","Income","Date Coding",,"Accounts Receivable","",9120.00,324532.40
,"Invoice","13-11-2024","MC06352",,"BLUEMART PRODUCTS EAST AFRICA LTD","Date Coding 5,424 Pcs Product","Income","Date Coding",,"Accounts Receivable","",8136.00,332668.40
,"Invoice","22-11-2024","MC06399",,"Azaavi Collections Limited","Date Coding 1300 Pcs Pouches","Income","Date Coding",,"Accounts Receivable","",1950.00,334618.40
,"Invoice","22-11-2024","MC06400",,"Sleek Kenya Ltd","Date Coding 17560 Pcs of Product","Income","Date Coding",,"Accounts Receivable","",33364.00,367982.40
,"Invoice","26-11-2024","MC06415",,"BLUEMART PRODUCTS EAST AFRICA LTD","Date Coding 10,117 Pcs Product","Income","Date Coding",,"Accounts Receivable","",15175.50,383157.90
,"Invoice","09-12-2024","MC06455",,"Sleek Kenya Ltd","Date Coding 15840 Pcs of Product","Income","Date Coding",,"Accounts Receivable","",30096.00,413253.90
,"Invoice","13-12-2024","MC06463",,"Azaavi Collections Limited","Date Coding 759 Pcs Pouches","Income","Date Coding",,"Accounts Receivable","",1138.50,414392.40
"Total Date Coding",,,,,,,,,,,0.00,414392.40,414392.40
"Adjunct and Emit 4 & 6",,,,,,,,,,,,,""
,"Invoice","12-01-2024","MC05303",,"Unilever Kenya Ltd:Emit","Emit 6 Processing Fee","Income","Adjunct and Emit 4 & 6",,"Accounts Receivable","",160050.00,160050.00
,"Invoice","12-01-2024","MC05304",,"Unilever Kenya Ltd:Emit","Adjunct Emit Processing Fee","Income","Adjunct and Emit 4 & 6",,"Accounts Receivable","",96961.20,257011.20
,"Invoice","05-02-2024","MC05382",,"Unilever Kenya Ltd:Emit","Adjunct Emit Processing Fee","Income","Adjunct and Emit 4 & 6",,"Accounts Receivable","",145441.80,402453.00
,"Invoice","05-02-2024","MC05383",,"Unilever Kenya Ltd:Emit","Emit 6 Processing Fee","Income","Adjunct and Emit 4 & 6",,"Accounts Receivable","",208065.00,610518.00
,"Invoice","04-03-2024","MC05460",,"Unilever Kenya Ltd:Emit","Adjunct Emit Processing Fee","Income","Adjunct and Emit 4 & 6",,"Accounts Receivable","",80801.00,691319.00
,"Invoice","04-03-2024","MC05461",,"Unilever Kenya Ltd:Emit","Emit 6 Processing Fee","Income","Adjunct and Emit 4 & 6",,"Accounts Receivable","",208065.00,899384.00
,"Invoice","23-03-2024","MC05524",,"Unilever Kenya Ltd:Emit","Emit 6 Processing Fee","Income","Adjunct and Emit 4 & 6",,"Accounts Receivable","",176055.00,1075439.00
,"Invoice","23-03-2024","MC05525",,"Unilever Kenya Ltd:Emit","Adjunct Emit Processing Fee","Income","Adjunct and Emit 4 & 6",,"Accounts Receivable","",113121.40,1188560.40
,"Invoice","04-04-2024","MC05565",,"Unilever Kenya Ltd:Emit","Adjunct Emit Processing Fee","Income","Adjunct and Emit 4 & 6",,"Accounts Receivable","",80801.00,1269361.40
,"Invoice","04-04-2024","MC05566",,"Unilever Kenya Ltd:Emit","Emit 6 Processing Fee","Income","Adjunct and Emit 4 & 6",,"Accounts Receivable","",208065.00,1477426.40
,"Invoice","19-04-2024","MC05611",,"Unilever Kenya Ltd:Emit","Adjunct Emit Processing Fee","Income","Adjunct and Emit 4 & 6",,"Accounts Receivable","",145441.80,1622868.20
,"Invoice","19-04-2024","MC05612",,"Unilever Kenya Ltd:Emit","Emit 6 Processing Fee","Income","Adjunct and Emit 4 & 6",,"Accounts Receivable","",208065.00,1830933.20
,"Invoice","15-05-2024","MC05704",,"Unilever Kenya Ltd:Emit","Adjunct Emit Processing Fee","Income","Adjunct and Emit 4 & 6",,"Accounts Receivable","",80801.00,1911734.20
,"Invoice","15-05-2024","MC05706",,"Unilever Kenya Ltd:Emit","Emit 6 Processing Fee","Income","Adjunct and Emit 4 & 6",,"Accounts Receivable","",208065.00,2119799.20
,"Invoice","28-05-2024","MC05757",,"Unilever Kenya Ltd:Emit","Adjunct Emit Processing Fee","Income","Adjunct and Emit 4 & 6",,"Accounts Receivable","",48480.60,2168279.80
,"Invoice","30-05-2024","MC05772",,"Unilever Kenya Ltd:Emit","Adjunct Emit Processing Fee","Income","Adjunct and Emit 4 & 6",,"Accounts Receivable","",80801.00,2249080.80
,"Invoice","30-05-2024","MC05774",,"Unilever Kenya Ltd:Emit","Emit 6 Processing Fee","Income","Adjunct and Emit 4 & 6",,"Accounts Receivable","",208065.00,2457145.80
,"Invoice","07-06-2024","MC05795",,"Unilever Kenya Ltd:Emit","Adjunct Emit Processing Fee","Income","Adjunct and Emit 4 & 6",,"Accounts Receivable","",96961.20,2554107.00
,"Invoice","07-06-2024","MC05797",,"Unilever Kenya Ltd:Emit","Emit 6 Processing Fee","Income","Adjunct and Emit 4 & 6",,"Accounts Receivable","",144045.00,2698152.00
,"Invoice","24-06-2024","MC05852",,"Unilever Kenya Ltd:Emit","Adjunct Emit Processing Fee","Income","Adjunct and Emit 4 & 6",,"Accounts Receivable","",96961.20,2795113.20
,"Invoice","24-06-2024","MC05854",,"Unilever Kenya Ltd:Emit","Emit 6 Processing Fee","Income","Adjunct and Emit 4 & 6",,"Accounts Receivable","",144045.00,2939158.20
,"Invoice","04-07-2024","MC05881",,"Unilever Kenya Ltd:Emit","Adjunct Emit Processing Fee","Income","Adjunct and Emit 4 & 6",,"Accounts Receivable","",80801.00,3019959.20
,"Invoice","04-07-2024","MC05882",,"Unilever Kenya Ltd:Emit","Emit 6 Processing Fee","Income","Adjunct and Emit 4 & 6",,"Accounts Receivable","",208065.00,3228024.20
,"Invoice","18-07-2024","MC05946",,"Unilever Kenya Ltd:Emit","Emit 6 Processing Fee","Income","Adjunct and Emit 4 & 6",,"Accounts Receivable","",192060.00,3420084.20
,"Invoice","18-07-2024","MC05947",,"Unilever Kenya Ltd:Emit","Adjunct Emit Processing Fee","Income","Adjunct and Emit 4 & 6",,"Accounts Receivable","",161602.00,3581686.20
,"Invoice","02-08-2024","MC05996",,"Unilever Kenya Ltd:Emit","Adjunct Emit Processing Fee","Income","Adjunct and Emit 4 & 6",,"Accounts Receivable","",161602.00,3743288.20
,"Invoice","02-08-2024","MC05997",,"Unilever Kenya Ltd:Emit","Emit 6 Processing Fee","Income","Adjunct and Emit 4 & 6",,"Accounts Receivable","",192060.00,3935348.20
,"Invoice","15-08-2024","MC06037",,"Unilever Kenya Ltd:Emit","Adjunct Emit Processing Fee","Income","Adjunct and Emit 4 & 6",,"Accounts Receivable","",129281.60,4064629.80
,"Invoice","15-08-2024","MC06039",,"Unilever Kenya Ltd:Emit","Emit 6 Processing Fee","Income","Adjunct and Emit 4 & 6",,"Accounts Receivable","",160050.00,4224679.80
,"Invoice","04-09-2024","MC06110",,"Unilever Kenya Ltd:Emit","Adjunct Emit Processing Fee","Income","Adjunct and Emit 4 & 6",,"Accounts Receivable","",129281.60,4353961.40
,"Invoice","04-09-2024","MC06112",,"Unilever Kenya Ltd:Emit","Emit 6 Processing Fee","Income","Adjunct and Emit 4 & 6",,"Accounts Receivable","",160050.00,4514011.40
,"Invoice","18-09-2024","MC06161",,"Unilever Kenya Ltd:Emit","Adjunct Emit Processing Fee","Income","Adjunct and Emit 4 & 6",,"Accounts Receivable","",161602.00,4675613.40
,"Invoice","18-09-2024","MC06162",,"Unilever Kenya Ltd:Emit","Emit 6 Processing Fee","Income","Adjunct and Emit 4 & 6",,"Accounts Receivable","",192060.00,4867673.40
,"Invoice","25-09-2024","MC06199",,"Unilever Kenya Ltd:Emit","Emit 6 Processing Fee","Income","Adjunct and Emit 4 & 6",,"Accounts Receivable","",288090.00,5155763.40
,"Invoice","08-11-2024","MC06348",,"Unilever Kenya Ltd:Emit","Adjunct Emit Processing Fee","Income","Adjunct and Emit 4 & 6",,"Accounts Receivable","",80801.00,5236564.40
,"Invoice","08-11-2024","MC06350",,"Unilever Kenya Ltd:Emit","Emit 6 Processing Fee","Income","Adjunct and Emit 4 & 6",,"Accounts Receivable","",208065.00,5444629.40
,"Invoice","21-11-2024","MC06392",,"Unilever Kenya Ltd:Emit","Adjunct Emit Processing Fee","Income","Adjunct and Emit 4 & 6",,"Accounts Receivable","",80801.00,5525430.40
,"Invoice","21-11-2024","MC06394",,"Unilever Kenya Ltd:Emit","Emit 6 Processing Fee","Income","Adjunct and Emit 4 & 6",,"Accounts Receivable","",208065.00,5733495.40
,"Invoice","04-12-2024","MC06441",,"Unilever Kenya Ltd:Emit","Adjunct Emit Processing Fee","Income","Adjunct and Emit 4 & 6",,"Accounts Receivable","",80801.00,5814296.40
,"Invoice","04-12-2024","MC06443",,"Unilever Kenya Ltd:Emit","Emit 6 Processing Fee","Income","Adjunct and Emit 4 & 6",,"Accounts Receivable","",208065.00,6022361.40
,"Invoice","17-12-2024","MC06481",,"Unilever Kenya Ltd:Emit","Adjunct Emit Processing Fee","Income","Adjunct and Emit 4 & 6",,"Accounts Receivable","",80801.00,6103162.40
,"Invoice","17-12-2024","MC06483",,"Unilever Kenya Ltd:Emit","Emit 6 Processing Fee","Income","Adjunct and Emit 4 & 6",,"Accounts Receivable","",112035.00,6215197.40
,"Invoice","23-12-2024","MC06500",,"Unilever Kenya Ltd","Adjunct Emit Processing Fee","Income","Adjunct and Emit 4 & 6",,"Accounts Receivable","",113121.40,6328318.80
,"Invoice","23-12-2024","MC06502",,"Unilever Kenya Ltd","Emit 6 Processing Fee","Income","Adjunct and Emit 4 & 6",,"Accounts Receivable","",160050.00,6488368.80
"Total Adjunct and Emit 4 & 6",,,,,,,,,,,0.00,6488368.80,6488368.80
"Domestos Powder",,,,,,,,,,,,,""
"Domestos Canister 12x900g",,,,,,,,,,,,,""
,"Invoice","01-02-2024","MC05377",,"Unilever Kenya Ltd","Outer Domestos 12x900g","Income","Domestos Canister 12x900g",,"Accounts Receivable","",361.50,361.50
"Total Domestos Canister 12x900g",,,,,,,,,,,0.00,361.50,361.50
"Domestos Canister 24x450g",,,,,,,,,,,,,""
,"Invoice","05-01-2024","MC05275",,"Unilever Kenya Ltd:Domestos","Domestos Canister 24x450G","Income","Domestos Canister 24x450g",,"Accounts Receivable","",9979.65,9979.65
,"Invoice","05-01-2024","MC05276",,"Unilever Kenya Ltd:Domestos","Domestos Canister 12x900G","Income","Domestos Canister 24x450g",,"Accounts Receivable","",71782.20,81761.85
,"Invoice","08-01-2024","MC05278",,"Unilever Kenya Ltd:Domestos","Domestos Canister 12x900G","Income","Domestos Canister 24x450g",,"Accounts Receivable","",143564.40,225326.25
,"Invoice","08-01-2024","MC05282",,"Unilever Kenya Ltd:Domestos","Domestos Canister 24x450G","Income","Domestos Canister 24x450g",,"Accounts Receivable","",143041.65,368367.90
,"Invoice","10-01-2024","MC05290",,"Unilever Kenya Ltd:Domestos","Domestos Canister 24x450G","Income","Domestos Canister 24x450g",,"Accounts Receivable","",83163.75,451531.65
,"Invoice","19-01-2024","MC05334",,"Unilever Kenya Ltd:Domestos","Domestos Canister 12x900G","Income","Domestos Canister 24x450g",,"Accounts Receivable","",71782.20,523313.85
,"Invoice","19-01-2024","MC05337",,"Unilever Kenya Ltd:Domestos","Domestos Canister 24x450G","Income","Domestos Canister 24x450g",,"Accounts Receivable","",97578.80,620892.65
,"Invoice","22-01-2024","MC05339",,"Unilever Kenya Ltd:Domestos","Domestos Canister 24x450G","Income","Domestos Canister 24x450g",,"Accounts Receivable","",53224.80,674117.45
,"Invoice","22-01-2024","MC05340",,"Unilever Kenya Ltd:Domestos","Domestos Canister 12x900G","Income","Domestos Canister 24x450g",,"Accounts Receivable","",19483.74,693601.19
,"Invoice","26-01-2024","MC05358",,"Unilever Kenya Ltd:Domestos","Domestos Canister 12x900G","Income","Domestos Canister 24x450g",,"Accounts Receivable","",143564.40,837165.59
,"Invoice","30-01-2024","MC05371",,"Unilever Kenya Ltd:Domestos","Domestos Canister 24x450G","Income","Domestos Canister 24x450g",,"Accounts Receivable","",242838.15,1080003.74
,"Invoice","01-02-2024","MC05377",,"Unilever Kenya Ltd","Outer Domestos 24x450g","Income","Domestos Canister 24x450g",,"Accounts Receivable","",393.90,1080397.64
,"Invoice","07-02-2024","MC05390",,"Unilever Kenya Ltd:Domestos","Domestos Canister 12x900G","Income","Domestos Canister 24x450g",,"Accounts Receivable","",283026.96,1363424.60
,"Invoice","21-02-2024","MC05417",,"Unilever Kenya Ltd:Domestos","Domestos Canister 12x900G","Income","Domestos Canister 24x450g",,"Accounts Receivable","",71782.20,1435206.80
,"Invoice","21-02-2024","MC05421",,"Unilever Kenya Ltd:Domestos","Domestos Canister 24x450G","Income","Domestos Canister 24x450g",,"Accounts Receivable","",100905.35,1536112.15
,"Invoice","23-02-2024","MC05441",,"Unilever Kenya Ltd:Domestos","Domestos Canister 24x450G","Income","Domestos Canister 24x450g",,"Accounts Receivable","",47680.55,1583792.70
,"Invoice","28-02-2024","MC05453",,"Unilever Kenya Ltd:Domestos","Domestos Canister 12x900G","Income","Domestos Canister 24x450g",,"Accounts Receivable","",287128.80,1870921.50
,"Invoice","05-03-2024","MC05466",,"Unilever Kenya Ltd:Domestos","Domestos Canister 24x450G","Income","Domestos Canister 24x450g",,"Accounts Receivable","",319348.80,2190270.30
,"Invoice","05-03-2024","MC05467",,"Unilever Kenya Ltd:Domestos","Domestos Canister 12x900G","Income","Domestos Canister 24x450g",,"Accounts Receivable","",193811.94,2384082.24
,"Invoice","08-03-2024","MC05482",,"Unilever Kenya Ltd:Domestos","Domestos Canister 12x900G","Income","Domestos Canister 24x450g",,"Accounts Receivable","",113826.06,2497908.30
,"Invoice","14-03-2024","MC05495",,"Unilever Kenya Ltd:Domestos","Domestos Canister 12x900G","Income","Domestos Canister 24x450g",,"Accounts Receivable","",53323.92,2551232.22
,"Invoice","22-03-2024","MC05514",,"Unilever Kenya Ltd:Domestos","Domestos Canister 24x450G","Income","Domestos Canister 24x450g",,"Accounts Receivable","",19959.30,2571191.52
,"Invoice","26-03-2024","MC05536",,"Unilever Kenya Ltd:Domestos","Domestos Canister 24x450G","Income","Domestos Canister 24x450g",,"Accounts Receivable","",33265.50,2604457.02
,"Invoice","26-03-2024","MC05537",,"Unilever Kenya Ltd:Domestos","Domestos Canister 12x900G","Income","Domestos Canister 24x450g",,"Accounts Receivable","",315841.68,2920298.70
,"Invoice","26-03-2024","MC05540",,"Unilever Kenya Ltd:Domestos","Domestos Canister 24x450G","Income","Domestos Canister 24x450g",,"Accounts Receivable","",316022.25,3236320.95
,"Invoice","09-04-2024","MC05581",,"Unilever Kenya Ltd:Domestos","Domestos Canister 12x900G","Income","Domestos Canister 24x450g",,"Accounts Receivable","",239986.60,3476307.55
,"Invoice","11-04-2024","MC05587",,"Unilever Kenya Ltd:Domestos","Domestos Canister 24x450G","Income","Domestos Canister 24x450g",,"Accounts Receivable","",162260.64,3638568.19
,"Invoice","11-04-2024","MC05592",,"Unilever Kenya Ltd:Domestos","Domestos Canister 24x450G","Income","Domestos Canister 24x450g",,"Accounts Receivable","",175782.36,3814350.55
,"Invoice","11-04-2024","MC05593",,"Unilever Kenya Ltd:Domestos","Domestos Canister 12x900G","Income","Domestos Canister 24x450g",,"Accounts Receivable","",70952.56,3885303.11
,"Invoice","19-04-2024","MC05620",,"Unilever Kenya Ltd:Domestos","Domestos Canister 12x900G","Income","Domestos Canister 24x450g",,"Accounts Receivable","",73039.40,3958342.51
,"Invoice","23-04-2024","MC05628",,"Unilever Kenya Ltd:Domestos","Domestos Canister 12x900G","Income","Domestos Canister 24x450g",,"Accounts Receivable","",174251.14,4132593.65
,"Invoice","26-04-2024","MC05645",,"Unilever Kenya Ltd:Domestos","Domestos Canister 12x900G","Income","Domestos Canister 24x450g",,"Accounts Receivable","",104342.00,4236935.65
,"Invoice","30-04-2024","MC05656",,"Unilever Kenya Ltd:Domestos","Domestos Canister 24x450G","Income","Domestos Canister 24x450g",,"Accounts Receivable","",172401.93,4409337.58
,"Invoice","30-04-2024","MC05657",,"Unilever Kenya Ltd:Domestos","Domestos Canister 12x900G","Income","Domestos Canister 24x450g",,"Accounts Receivable","",276506.30,4685843.88
,"Invoice","06-05-2024","MC05672",,"Unilever Kenya Ltd:Domestos","Domestos Canister 24x450G","Income","Domestos Canister 24x450g",,"Accounts Receivable","",139724.44,4825568.32
,"Invoice","09-05-2024","MC05682",,"Unilever Kenya Ltd:Domestos","Domestos Canister 12x900G","Income","Domestos Canister 24x450g",,"Accounts Receivable","",292157.60,5117725.92
,"Invoice","13-05-2024","MC05694",,"Unilever Kenya Ltd:Domestos","Domestos Canister 24x450G","Income","Domestos Canister 24x450g",,"Accounts Receivable","",23663.01,5141388.93
,"Invoice","13-05-2024","MC05695",,"Unilever Kenya Ltd:Domestos","Domestos Canister 12x900G","Income","Domestos Canister 24x450g",,"Accounts Receivable","",20868.40,5162257.33
,"Invoice","17-05-2024","MC05716",,"Unilever Kenya Ltd:Domestos","Domestos Canister 24x450G","Income","Domestos Canister 24x450g",,"Accounts Receivable","",29297.06,5191554.39
,"Invoice","17-05-2024","MC05717",,"Unilever Kenya Ltd:Domestos","Domestos Canister 12x900G","Income","Domestos Canister 24x450g",,"Accounts Receivable","",35476.28,5227030.67
,"Invoice","20-05-2024","MC05722",,"Unilever Kenya Ltd:Domestos","Domestos Canister 24x450G","Income","Domestos Canister 24x450g",,"Accounts Receivable","",108173.76,5335204.43
,"Invoice","20-05-2024","MC05723",,"Unilever Kenya Ltd:Domestos","Domestos Canister 12x900G","Income","Domestos Canister 24x450g",,"Accounts Receivable","",25042.08,5360246.51
,"Invoice","30-05-2024","MC05782",,"Unilever Kenya Ltd:Domestos","Domestos Canister 12x900G","Income","Domestos Canister 24x450g",,"Accounts Receivable","",365197.00,5725443.51
,"Invoice","31-05-2024","MC05784",,"Unilever Kenya Ltd:Domestos","Domestos Canister 24x450G","Income","Domestos Canister 24x450g",,"Accounts Receivable","",94652.04,5820095.55
,"Invoice","31-05-2024","MC05785",,"Unilever Kenya Ltd:Domestos","Domestos Canister 12x900G","Income","Domestos Canister 24x450g",,"Accounts Receivable","",73039.40,5893134.95
,"Invoice","06-06-2024","MC05794",,"Unilever Kenya Ltd:Domestos","Domestos Canister 24x450G","Income","Domestos Canister 24x450g",,"Accounts Receivable","",162260.64,6055395.59
,"Invoice","10-06-2024","MC05808",,"Unilever Kenya Ltd:Domestos","Domestos Canister 24x450G","Income","Domestos Canister 24x450g",,"Accounts Receivable","",323394.47,6378790.06
,"Invoice","14-06-2024","MC05825",,"Unilever Kenya Ltd:Domestos","Domestos Canister 24x450G","Income","Domestos Canister 24x450g",,"Accounts Receivable","",162260.64,6541050.70
,"Invoice","18-06-2024","MC05834",,"Unilever Kenya Ltd:Domestos","Domestos Canister 12x900G","Income","Domestos Canister 24x450g",,"Accounts Receivable","",218074.78,6759125.48
,"Invoice","05-07-2024","MC05893",,"Unilever Kenya Ltd:Domestos","Domestos Canister 12x900G","Income","Domestos Canister 24x450g",,"Accounts Receivable","",286759.20,7045884.68
,"Invoice","12-07-2024","MC05918",,"Unilever Kenya Ltd:Domestos","Domestos Canister 24x450G","Income","Domestos Canister 24x450g",,"Accounts Receivable","",60914.15,7106798.83
,"Invoice","15-07-2024","MC05928",,"Unilever Kenya Ltd:Domestos","Domestos Canister 24x450G","Income","Domestos Canister 24x450g",,"Accounts Receivable","",265807.20,7372606.03
,"Invoice","15-07-2024","MC05929",,"Unilever Kenya Ltd:Domestos","Domestos Canister 12x900G","Income","Domestos Canister 24x450g",,"Accounts Receivable","",340014.48,7712620.51
,"Invoice","23-07-2024","MC05962",,"Unilever Kenya Ltd:Domestos","Domestos Canister 24x450G","Income","Domestos Canister 24x450g",,"Accounts Receivable","",93032.52,7805653.03
,"Invoice","23-07-2024","MC05967",,"Unilever Kenya Ltd:Domestos","Domestos Canister 12x900G","Income","Domestos Canister 24x450g",,"Accounts Receivable","",71689.80,7877342.83
,"Invoice","26-07-2024","MC05974",,"Unilever Kenya Ltd:Domestos","Domestos Canister 24x450G","Income","Domestos Canister 24x450g",,"Accounts Receivable","",53161.44,7930504.27
,"Invoice","31-07-2024","MC05988",,"Unilever Kenya Ltd:Domestos","Domestos Canister 12x900G","Income","Domestos Canister 24x450g",,"Accounts Receivable","",286759.20,8217263.47
,"Invoice","01-08-2024","MC05995",,"Unilever Kenya Ltd:Domestos","Domestos Canister 24x450G","Income","Domestos Canister 24x450g",,"Accounts Receivable","",106322.88,8323586.35
,"Invoice","08-08-2024","MC06009",,"Unilever Kenya Ltd:Domestos","Domestos Canister 24x450G","Income","Domestos Canister 24x450g",,"Accounts Receivable","",83064.75,8406651.10
,"Invoice","08-08-2024","MC06014",,"Unilever Kenya Ltd:Domestos","Domestos Canister 24x450G","Income","Domestos Canister 24x450g",,"Accounts Receivable","",53161.44,8459812.54
,"Invoice","12-08-2024","MC06034",,"Unilever Kenya Ltd:Domestos","Domestos Canister 24x450G","Income","Domestos Canister 24x450g",,"Accounts Receivable","",231473.77,8691286.31
,"Invoice","15-08-2024","MC06045",,"Unilever Kenya Ltd:Domestos","Domestos Canister 12x900G","Income","Domestos Canister 24x450g",,"Accounts Receivable","",23555.22,8714841.53
,"Invoice","26-08-2024","MC06080",,"Unilever Kenya Ltd:Domestos","Domestos Canister 12x900G","Income","Domestos Canister 24x450g",,"Accounts Receivable","",71689.80,8786531.33
,"Invoice","26-08-2024","MC06087",,"Unilever Kenya Ltd:Domestos","Domestos Canister 12x900G","Income","Domestos Canister 24x450g",,"Accounts Receivable","",71689.80,8858221.13
,"Invoice","27-08-2024","MC06092",,"Unilever Kenya Ltd:Domestos","Domestos Canister 12x900G","Income","Domestos Canister 24x450g",,"Accounts Receivable","",215069.40,9073290.53
,"Invoice","30-08-2024","MC06106",,"Unilever Kenya Ltd:Domestos","Domestos Canister 24x450G","Income","Domestos Canister 24x450g",,"Accounts Receivable","",99677.70,9172968.23
,"Invoice","10-09-2024","MC06134",,"Unilever Kenya Ltd:Domestos","Domestos Canister 12x900G","Income","Domestos Canister 24x450g",,"Accounts Receivable","",71689.80,9244658.03
,"Invoice","11-09-2024","MC06142",,"Unilever Kenya Ltd:Domestos","Domestos Canister 12x900G","Income","Domestos Canister 24x450g",,"Accounts Receivable","",215069.40,9459727.43
,"Invoice","13-09-2024","MC06153",,"Unilever Kenya Ltd:Domestos","Domestos Canister 24x450G","Income","Domestos Canister 24x450g",,"Accounts Receivable","",159484.32,9619211.75
,"Invoice","19-09-2024","MC06170",,"Unilever Kenya Ltd:Domestos","Domestos Canister 24x450G","Income","Domestos Canister 24x450g",,"Accounts Receivable","",106322.88,9725534.63
,"Invoice","19-09-2024","MC06171",,"Unilever Kenya Ltd:Domestos","Domestos Canister 12x900G","Income","Domestos Canister 24x450g",,"Accounts Receivable","",55303.56,9780838.19
,"Invoice","20-09-2024","MC06175",,"Unilever Kenya Ltd:Domestos","Domestos Canister 12x900G","Income","Domestos Canister 24x450g",,"Accounts Receivable","",143379.60,9924217.79
,"Invoice","24-09-2024","MC06193",,"Unilever Kenya Ltd:Domestos","Domestos Canister 12x900G","Income","Domestos Canister 24x450g",,"Accounts Receivable","",162838.26,10087056.05
,"Invoice","27-09-2024","MC06211",,"Unilever Kenya Ltd:Domestos","Domestos Canister 24x450G","Income","Domestos Canister 24x450g",,"Accounts Receivable","",106322.88,10193378.93
,"Invoice","03-10-2024","MC06228",,"Unilever Kenya Ltd:Domestos","Domestos Canister 24x450G","Income","Domestos Canister 24x450g",,"Accounts Receivable","",132309.87,10325688.80
,"Invoice","09-10-2024","MC06243",,"Unilever Kenya Ltd:Domestos","Domestos Canister 12x900G","Income","Domestos Canister 24x450g",,"Accounts Receivable","",70705.60,10396394.40
,"Invoice","09-10-2024","MC06249",,"Unilever Kenya Ltd:Domestos","Domestos Canister 12x900G","Income","Domestos Canister 24x450g",,"Accounts Receivable","",70705.60,10467100.00
,"Invoice","14-10-2024","MC06255",,"Unilever Kenya Ltd:Domestos","Domestos Canister 24x450G","Income","Domestos Canister 24x450g",,"Accounts Receivable","",103879.65,10570979.65
,"Invoice","14-10-2024","MC06256",,"Unilever Kenya Ltd:Domestos","Domestos Canister 12x900G","Income","Domestos Canister 24x450g",,"Accounts Receivable","",141411.20,10712390.85
,"Invoice","16-10-2024","MC06266",,"Unilever Kenya Ltd:Domestos","Domestos Canister 12x900G","Income","Domestos Canister 24x450g",,"Accounts Receivable","",39393.12,10751783.97
,"Invoice","17-10-2024","MC06273",,"Unilever Kenya Ltd:Domestos","Domestos Canister 24x450G","Income","Domestos Canister 24x450g",,"Accounts Receivable","",209946.24,10961730.21
,"Invoice","18-10-2024","MC06284",,"Unilever Kenya Ltd:Domestos","Domestos Canister 12x900G","Income","Domestos Canister 24x450g",,"Accounts Receivable","",192925.28,11154655.49
,"Invoice","22-10-2024","MC06286",,"Unilever Kenya Ltd:Domestos","Domestos Canister 24x450G","Income","Domestos Canister 24x450g",,"Accounts Receivable","",22962.87,11177618.36
,"Invoice","22-10-2024","MC06287",,"Unilever Kenya Ltd:Domestos","Domestos Canister 12x900G","Income","Domestos Canister 24x450g",,"Accounts Receivable","",141411.20,11319029.56
,"Invoice","29-10-2024","MC06317",,"Unilever Kenya Ltd:Domestos","Domestos Canister 24x450G","Income","Domestos Canister 24x450g",,"Accounts Receivable","",303984.66,11623014.22
,"Invoice","29-10-2024","MC06318",,"Unilever Kenya Ltd:Domestos","Domestos Canister 12x900G","Income","Domestos Canister 24x450g",,"Accounts Receivable","",255550.24,11878564.46
,"Invoice","07-11-2024","MC06343",,"Unilever Kenya Ltd:Domestos","Domestos Canister 24x450G","Income","Domestos Canister 24x450g",,"Accounts Receivable","",52486.56,11931051.02
,"Invoice","14-11-2024","MC06362",,"Unilever Kenya Ltd:Domestos","Domestos Canister 24x450G","Income","Domestos Canister 24x450g",,"Accounts Receivable","",323667.12,12254718.14
,"Invoice","14-11-2024","MC06363",,"Unilever Kenya Ltd:Domestos","Domestos Canister 12x900G","Income","Domestos Canister 24x450g",,"Accounts Receivable","",25252.00,12279970.14
,"Invoice","20-11-2024","MC06390",,"Unilever Kenya Ltd:Domestos","Domestos Canister 12x900G","Income","Domestos Canister 24x450g",,"Accounts Receivable","",271711.52,12551681.66
,"Invoice","28-11-2024","MC06420",,"Unilever Kenya Ltd:Domestos","Domestos Canister 12x900G","Income","Domestos Canister 24x450g",,"Accounts Receivable","",390900.96,12942582.62
,"Invoice","02-12-2024","MC06434",,"Unilever Kenya Ltd:Domestos","Domestos Canister 12x900G","Income","Domestos Canister 24x450g",,"Accounts Receivable","",70705.60,13013288.22
,"Invoice","04-12-2024","MC06437",,"Unilever Kenya Ltd:Domestos","Domestos Canister 12x900G","Income","Domestos Canister 24x450g",,"Accounts Receivable","",212116.80,13225405.02
,"Invoice","04-12-2024","MC06438",,"Unilever Kenya Ltd:Domestos","Domestos Canister 24x450G","Income","Domestos Canister 24x450g",,"Accounts Receivable","",282115.26,13507520.28
,"Invoice","17-12-2024","MC06479",,"Unilever Kenya Ltd:Domestos","Domestos Canister 12x900G","Income","Domestos Canister 24x450g",,"Accounts Receivable","",212116.80,13719637.08
,"Invoice","17-12-2024","MC06480",,"Unilever Kenya Ltd:Domestos","Domestos Canister 24x450G","Income","Domestos Canister 24x450g",,"Accounts Receivable","",149805.39,13869442.47
,"Invoice","18-12-2024","MC06485",,"Unilever Kenya Ltd:Domestos","Domestos Canister 12x900G","Income","Domestos Canister 24x450g",,"Accounts Receivable","",194945.44,14064387.91
,"Invoice","24-12-2024","MC06513",,"Unilever Kenya Ltd:Domestos","Domestos Canister 24x450G","Income","Domestos Canister 24x450g",,"Accounts Receivable","",171674.79,14236062.70
"Total Domestos Canister 24x450g",,,,,,,,,,,0.00,14236062.70,14236062.70
"Total Domestos Powder",,,,,,,,,,,0.00,14236424.20,14236424.20
"Sunlight Scouring Powder",,,,,,,,,,,,,""
"Sunlight Lavender",,,,,,,,,,,,,""
"Sunlight Scouring Powd Lav 1Kg",,,,,,,,,,,,,""
,"Invoice","01-02-2024","MC05377",,"Unilever Kenya Ltd","Outer Sunlight Lavender 12x1Kg","Income","Sunlight Scouring Powd Lav 1Kg",,"Accounts Receivable","",433.80,433.80
"Total Sunlight Scouring Powd Lav 1Kg",,,,,,,,,,,0.00,433.80,433.80
"Sunlight Scouring Powd Lav 500g",,,,,,,,,,,,,""
,"Invoice","09-01-2024","MC05284",,"Unilever Kenya Ltd:Sunlight Scouring Pwd","Sunlight Scouring Powd Lavender 12X1KG","Income","Sunlight Scouring Powd Lav 500g",,"Accounts Receivable","",61766.10,61766.10
,"Invoice","10-01-2024","MC05289",,"Unilever Kenya Ltd:Sunlight Scouring Pwd","Sunlight Scouring Powd Lavender 12X1KG","Income","Sunlight Scouring Powd Lav 500g",,"Accounts Receivable","",48040.30,109806.40
,"Invoice","11-01-2024","MC05292",,"Unilever Kenya Ltd:Sunlight Scouring Pwd","Sunlight Scouring Powd Lavender 12X1KG","Income","Sunlight Scouring Powd Lav 500g",,"Accounts Receivable","",48040.30,157846.70
,"Invoice","15-01-2024","MC05314",,"Unilever Kenya Ltd:Sunlight Scouring Pwd","Sunlight Scouring Powd Lavender 24X500G","Income","Sunlight Scouring Powd Lav 500g",,"Accounts Receivable","",151694.00,309540.70
,"Invoice","15-01-2024","MC05319",,"Unilever Kenya Ltd:Sunlight Scouring Pwd","Sunlight Scouring Powd Lavender 24X500G","Income","Sunlight Scouring Powd Lav 500g",,"Accounts Receivable","",36406.56,345947.26
,"Invoice","16-01-2024","MC05324",,"Unilever Kenya Ltd:Sunlight Scouring Pwd","Sunlight Scouring Powd Lavender 12X1KG","Income","Sunlight Scouring Powd Lav 500g",,"Accounts Receivable","",48040.30,393987.56
,"Invoice","17-01-2024","MC05330",,"Unilever Kenya Ltd:Sunlight Scouring Pwd","Sunlight Scouring Powd Lavender 24X500G","Income","Sunlight Scouring Powd Lav 500g",,"Accounts Receivable","",36406.56,430394.12
,"Invoice","26-01-2024","MC05353",,"Unilever Kenya Ltd:Sunlight Scouring Pwd","Sunlight Scouring Powd Lavender 12X1KG","Income","Sunlight Scouring Powd Lav 500g",,"Accounts Receivable","",13725.80,444119.92
,"Invoice","29-01-2024","MC05366",,"Unilever Kenya Ltd:Sunlight Scouring Pwd","Sunlight Scouring Powd Lavender 12X1KG","Income","Sunlight Scouring Powd Lav 500g",,"Accounts Receivable","",144120.90,588240.82
,"Invoice","29-01-2024","MC05367",,"Unilever Kenya Ltd:Sunlight Scouring Pwd","Sunlight Scouring Powd Lavender 24X500G","Income","Sunlight Scouring Powd Lav 500g",,"Accounts Receivable","",145626.24,733867.06
,"Invoice","01-02-2024","MC05377",,"Unilever Kenya Ltd","Outer Sunlight Lavender 24x500g","Income","Sunlight Scouring Powd Lav 500g",,"Accounts Receivable","",512.07,734379.13
,"Invoice","07-02-2024","MC05389",,"Unilever Kenya Ltd:Sunlight Scouring Pwd","Sunlight Scouring Powd Lavender 24X500G","Income","Sunlight Scouring Powd Lav 500g",,"Accounts Receivable","",62194.54,796573.67
,"Invoice","13-02-2024","MC05404",,"Unilever Kenya Ltd:Sunlight Scouring Pwd","Sunlight Scouring Powd Lavender 12X1KG","Income","Sunlight Scouring Powd Lav 500g",,"Accounts Receivable","",48040.30,844613.97
,"Invoice","19-02-2024","MC05413",,"Unilever Kenya Ltd:Sunlight Scouring Pwd","Sunlight Scouring Powd Lavender 24X500G","Income","Sunlight Scouring Powd Lav 500g",,"Accounts Receivable","",37923.50,882537.47
,"Invoice","21-02-2024","MC05416",,"Unilever Kenya Ltd:Sunlight Scouring Pwd","Sunlight Scouring Powd Lavender 12X1KG","Income","Sunlight Scouring Powd Lav 500g",,"Accounts Receivable","",54216.91,936754.38
,"Invoice","21-02-2024","MC05420",,"Unilever Kenya Ltd:Sunlight Scouring Pwd","Sunlight Scouring Powd Lavender 24X500G","Income","Sunlight Scouring Powd Lav 500g",,"Accounts Receivable","",145626.24,1082380.62
,"Invoice","23-02-2024","MC05440",,"Unilever Kenya Ltd:Sunlight Scouring Pwd","Sunlight Scouring Powd Lavender 24X500G","Income","Sunlight Scouring Powd Lav 500g",,"Accounts Receivable","",130456.84,1212837.46
,"Invoice","27-02-2024","MC05449",,"Unilever Kenya Ltd:Sunlight Scouring Pwd","Sunlight Scouring Powd Lavender 12X1KG","Income","Sunlight Scouring Powd Lav 500g",,"Accounts Receivable","",48040.30,1260877.76
,"Invoice","28-02-2024","MC05452",,"Unilever Kenya Ltd:Sunlight Scouring Pwd","Sunlight Scouring Powd Lavender 12X1KG","Income","Sunlight Scouring Powd Lav 500g",,"Accounts Receivable","",96080.60,1356958.36
,"Invoice","29-02-2024","MC05455",,"Unilever Kenya Ltd:Sunlight Scouring Pwd","Sunlight Scouring Powd Lavender 24X500G","Income","Sunlight Scouring Powd Lav 500g",,"Accounts Receivable","",327659.04,1684617.40
,"Invoice","11-03-2024","MC05486",,"Unilever Kenya Ltd:Sunlight Scouring Pwd","Sunlight Scouring Powd Lavender 24X500G","Income","Sunlight Scouring Powd Lav 500g",,"Accounts Receivable","",81914.76,1766532.16
,"Invoice","22-03-2024","MC05513",,"Unilever Kenya Ltd:Sunlight Scouring Pwd","Sunlight Scouring Powd Lavender 12X1KG","Income","Sunlight Scouring Powd Lav 500g",,"Accounts Receivable","",68629.00,1835161.16
,"Invoice","26-03-2024","MC05535",,"Unilever Kenya Ltd:Sunlight Scouring Pwd","Sunlight Scouring Powd Lavender 12X1KG","Income","Sunlight Scouring Powd Lav 500g",,"Accounts Receivable","",96080.60,1931241.76
,"Invoice","26-03-2024","MC05541",,"Unilever Kenya Ltd:Sunlight Scouring Pwd","Sunlight Scouring Powd Lavender 12X1KG","Income","Sunlight Scouring Powd Lav 500g",,"Accounts Receivable","",48040.30,1979282.06
,"Invoice","09-04-2024","MC05582",,"Unilever Kenya Ltd:Sunlight Scouring Pwd","Sunlight Scouring Powd Lavender 12X1KG","Income","Sunlight Scouring Powd Lav 500g",,"Accounts Receivable","",11787.97,1991070.03
,"Invoice","11-04-2024","MC05588",,"Unilever Kenya Ltd:Sunlight Scouring Pwd","Sunlight Scouring Powd Lavender 24X500G","Income","Sunlight Scouring Powd Lav 500g",,"Accounts Receivable","",121728.81,2112798.84
,"Invoice","11-04-2024","MC05590",,"Unilever Kenya Ltd:Sunlight Scouring Pwd","Sunlight Scouring Powd Lavender 12X1KG","Income","Sunlight Scouring Powd Lav 500g",,"Accounts Receivable","",216343.92,2329142.76
,"Invoice","11-04-2024","MC05591",,"Unilever Kenya Ltd:Sunlight Scouring Pwd","Sunlight Scouring Powd Lavender 24X500G","Income","Sunlight Scouring Powd Lav 500g",,"Accounts Receivable","",114072.91,2443215.67
,"Invoice","12-04-2024","MC05595",,"Unilever Kenya Ltd:Sunlight Scouring Pwd","Sunlight Scouring Powd Lavender 24X500G","Income","Sunlight Scouring Powd Lav 500g",,"Accounts Receivable","",110244.96,2553460.63
,"Invoice","06-05-2024","MC05671",,"Unilever Kenya Ltd:Sunlight Scouring Pwd","Sunlight Scouring Powd Lavender 12X1KG","Income","Sunlight Scouring Powd Lav 500g",,"Accounts Receivable","",145616.10,2699076.73
,"Invoice","21-05-2024","MC05728",,"Unilever Kenya Ltd:Sunlight Scouring Pwd","Sunlight Scouring Powd Lavender 12X1KG","Income","Sunlight Scouring Powd Lav 500g",,"Accounts Receivable","",48538.70,2747615.43
,"Invoice","23-05-2024","MC05734",,"Unilever Kenya Ltd:Sunlight Scouring Pwd","Sunlight Scouring Powd Lavender 12X1KG","Income","Sunlight Scouring Powd Lav 500g",,"Accounts Receivable","",13868.20,2761483.63
,"Invoice","23-05-2024","MC05735",,"Unilever Kenya Ltd:Sunlight Scouring Pwd","Sunlight Scouring Powd Lavender 24X500G","Income","Sunlight Scouring Powd Lav 500g",,"Accounts Receivable","",238864.08,3000347.71
,"Invoice","30-05-2024","MC05778",,"Unilever Kenya Ltd:Sunlight Scouring Pwd","Sunlight Scouring Powd Lavender 12X1KG","Income","Sunlight Scouring Powd Lav 500g",,"Accounts Receivable","",208716.41,3209064.12
,"Invoice","07-06-2024","MC05802",,"Unilever Kenya Ltd:Sunlight Scouring Pwd","Sunlight Scouring Powd Lavender 24X500G","Income","Sunlight Scouring Powd Lav 500g",,"Accounts Receivable","",110244.96,3319309.08
,"Invoice","18-06-2024","MC05835",,"Unilever Kenya Ltd:Sunlight Scouring Pwd","Sunlight Scouring Powd Lavender 24X500G","Income","Sunlight Scouring Powd Lav 500g",,"Accounts Receivable","",73496.64,3392805.72
,"Invoice","28-06-2024","MC05873",,"Unilever Kenya Ltd:Sunlight Scouring Pwd","Sunlight Scouring Powd Lavender 12X1KG","Income","Sunlight Scouring Powd Lav 500g",,"Accounts Receivable","",145616.10,3538421.82
,"Invoice","02-07-2024","MC05876",,"Unilever Kenya Ltd:Sunlight Scouring Pwd","Sunlight Scouring Powd Lavender 24X500G","Income","Sunlight Scouring Powd Lav 500g",,"Accounts Receivable","",154537.43,3692959.25
,"Invoice","04-07-2024","MC05890",,"Unilever Kenya Ltd:Sunlight Scouring Pwd","Sunlight Scouring Powd Lavender 24X500G","Income","Sunlight Scouring Powd Lav 500g",,"Accounts Receivable","",111826.08,3804785.33
,"Invoice","08-07-2024","MC05902",,"Unilever Kenya Ltd:Sunlight Scouring Pwd","Sunlight Scouring Powd Lavender 12X1KG","Income","Sunlight Scouring Powd Lav 500g",,"Accounts Receivable","",110589.23,3915374.56
,"Invoice","09-07-2024","MC05906",,"Unilever Kenya Ltd:Sunlight Scouring Pwd","Sunlight Scouring Powd Lavender 24X500G","Income","Sunlight Scouring Powd Lav 500g",,"Accounts Receivable","",10095.41,3925469.97
,"Invoice","12-07-2024","MC05913",,"Unilever Kenya Ltd:Sunlight Scouring Pwd","Sunlight Scouring Powd Lavender 24X500G","Income","Sunlight Scouring Powd Lav 500g",,"Accounts Receivable","",111826.08,4037296.05
,"Invoice","15-07-2024","MC05927",,"Unilever Kenya Ltd:Sunlight Scouring Pwd","Sunlight Scouring Powd Lavender 12X1KG","Income","Sunlight Scouring Powd Lav 500g",,"Accounts Receivable","",98614.60,4135910.65
,"Invoice","23-07-2024","MC05961",,"Unilever Kenya Ltd:Sunlight Scouring Pwd","Sunlight Scouring Powd Lavender 12X1KG","Income","Sunlight Scouring Powd Lav 500g",,"Accounts Receivable","",14087.80,4149998.45
,"Invoice","26-07-2024","MC05973",,"Unilever Kenya Ltd:Sunlight Scouring Pwd","Sunlight Scouring Powd Lavender 24X500G","Income","Sunlight Scouring Powd Lav 500g",,"Accounts Receivable","",156867.14,4306865.59
,"Invoice","01-08-2024","MC05993",,"Unilever Kenya Ltd:Sunlight Scouring Pwd","Sunlight Scouring Powd Lavender 24X500G","Income","Sunlight Scouring Powd Lav 500g",,"Accounts Receivable","",88528.98,4395394.57
,"Invoice","08-08-2024","MC06008",,"Unilever Kenya Ltd:Sunlight Scouring Pwd","Sunlight Scouring Powd Lavender 24X500G","Income","Sunlight Scouring Powd Lav 500g",,"Accounts Receivable","",149101.44,4544496.01
,"Invoice","08-08-2024","MC06013",,"Unilever Kenya Ltd:Sunlight Scouring Pwd","Sunlight Scouring Powd Lavender 12X1KG","Income","Sunlight Scouring Powd Lav 500g",,"Accounts Receivable","",49307.30,4593803.31
,"Invoice","09-08-2024","MC06026",,"Unilever Kenya Ltd:Sunlight Scouring Pwd","Sunlight Scouring Powd Lavender 12X1KG","Income","Sunlight Scouring Powd Lav 500g",,"Accounts Receivable","",113406.79,4707210.10
,"Invoice","15-08-2024","MC06044",,"Unilever Kenya Ltd:Sunlight Scouring Pwd","Sunlight Scouring Powd Lavender 24X500G","Income","Sunlight Scouring Powd Lav 500g",,"Accounts Receivable","",54359.90,4761570.00
,"Invoice","21-08-2024","MC06059",,"Unilever Kenya Ltd:Sunlight Scouring Pwd","Sunlight Scouring Powd Lavender 24X500G","Income","Sunlight Scouring Powd Lav 500g",,"Accounts Receivable","",31062.80,4792632.80
,"Invoice","29-08-2024","MC06101",,"Unilever Kenya Ltd:Sunlight Scouring Pwd","Sunlight Scouring Powd Lavender 12X1KG","Income","Sunlight Scouring Powd Lav 500g",,"Accounts Receivable","",49307.30,4841940.10
,"Invoice","30-08-2024","MC06105",,"Unilever Kenya Ltd:Sunlight Scouring Pwd","Sunlight Scouring Powd Lavender 24X500G","Income","Sunlight Scouring Powd Lav 500g",,"Accounts Receivable","",74550.72,4916490.82
,"Invoice","06-09-2024","MC06128",,"Unilever Kenya Ltd:Sunlight Scouring Pwd","Sunlight Scouring Powd Lavender 12X1KG","Income","Sunlight Scouring Powd Lav 500g",,"Accounts Receivable","",209203.83,5125694.65
,"Invoice","10-09-2024","MC06135",,"Unilever Kenya Ltd:Sunlight Scouring Pwd","Sunlight Scouring Powd Lavender 24X500G","Income","Sunlight Scouring Powd Lav 500g",,"Accounts Receivable","",7765.70,5133460.35
,"Invoice","13-09-2024","MC06152",,"Unilever Kenya Ltd:Sunlight Scouring Pwd","Sunlight Scouring Powd Lavender 24X500G","Income","Sunlight Scouring Powd Lav 500g",,"Accounts Receivable","",111826.08,5245286.43
,"Invoice","24-09-2024","MC06192",,"Unilever Kenya Ltd:Sunlight Scouring Pwd","Sunlight Scouring Powd Lavender 24X500G","Income","Sunlight Scouring Powd Lav 500g",,"Accounts Receivable","",111826.08,5357112.51
,"Invoice","27-09-2024","MC06210",,"Unilever Kenya Ltd:Sunlight Scouring Pwd","Sunlight Scouring Powd Lavender 12X1KG","Income","Sunlight Scouring Powd Lav 500g",,"Accounts Receivable","",98614.60,5455727.11
,"Invoice","03-10-2024","MC06226",,"Unilever Kenya Ltd:Sunlight Scouring Pwd","Sunlight Scouring Powd Lavender 24X500G","Income","Sunlight Scouring Powd Lav 500g",,"Accounts Receivable","",123901.19,5579628.30
,"Invoice","16-10-2024","MC06267",,"Unilever Kenya Ltd:Sunlight Scouring Pwd","Sunlight Scouring Powd Lavender 12X1KG","Income","Sunlight Scouring Powd Lav 500g",,"Accounts Receivable","",80490.15,5660118.45
,"Invoice","17-10-2024","MC06272",,"Unilever Kenya Ltd:Sunlight Scouring Pwd","Sunlight Scouring Powd Lavender 24X500G","Income","Sunlight Scouring Powd Lav 500g",,"Accounts Receivable","",109458.72,5769577.17
,"Invoice","18-10-2024","MC06283",,"Unilever Kenya Ltd:Sunlight Scouring Pwd","Sunlight Scouring Powd Lavender 12X1KG","Income","Sunlight Scouring Powd Lav 500g",,"Accounts Receivable","",72234.75,5841811.92
,"Invoice","25-10-2024","MC06298",,"Unilever Kenya Ltd:Sunlight Scouring Pwd","Sunlight Scouring Powd Lavender 24X500G","Income","Sunlight Scouring Powd Lav 500g",,"Accounts Receivable","",81333.91,5923145.83
,"Invoice","29-10-2024","MC06316",,"Unilever Kenya Ltd:Sunlight Scouring Pwd","Sunlight Scouring Powd Lavender 24X500G","Income","Sunlight Scouring Powd Lav 500g",,"Accounts Receivable","",72972.48,5996118.31
,"Invoice","31-10-2024","MC06326",,"Unilever Kenya Ltd:Sunlight Scouring Pwd","Sunlight Scouring Powd Lavender 12X1KG","Income","Sunlight Scouring Powd Lav 500g",,"Accounts Receivable","",192626.00,6188744.31
,"Invoice","07-11-2024","MC06342",,"Unilever Kenya Ltd:Sunlight Scouring Pwd","Sunlight Scouring Powd Lavender 12X1KG","Income","Sunlight Scouring Powd Lav 500g",,"Accounts Receivable","",15134.90,6203879.21
,"Invoice","18-11-2024","MC06371",,"Unilever Kenya Ltd:Sunlight Scouring Pwd","Sunlight Scouring Powd Lavender 24X500G","Income","Sunlight Scouring Powd Lav 500g",,"Accounts Receivable","",200674.32,6404553.53
,"Invoice","20-11-2024","MC06384",,"Unilever Kenya Ltd:Sunlight Scouring Pwd","Sunlight Scouring Powd Lavender 12X1KG","Income","Sunlight Scouring Powd Lav 500g",,"Accounts Receivable","",134838.20,6539391.73
,"Invoice","21-11-2024","MC06397",,"Unilever Kenya Ltd:Sunlight Scouring Pwd","Sunlight Scouring Powd Lavender 24X500G","Income","Sunlight Scouring Powd Lav 500g",,"Accounts Receivable","",105658.07,6645049.80
,"Invoice","23-11-2024","MC06408",,"Unilever Kenya Ltd:Sunlight Scouring Pwd","Sunlight Scouring Powd Lavender 12X1KG","Income","Sunlight Scouring Powd Lav 500g",,"Accounts Receivable","",114887.65,6759937.45
,"Invoice","28-11-2024","MC06425",,"Unilever Kenya Ltd:Sunlight Scouring Pwd","Sunlight Scouring Powd Lavender 24X500G","Income","Sunlight Scouring Powd Lav 500g",,"Accounts Receivable","",145944.96,6905882.41
,"Invoice","11-12-2024","MC06459",,"Unilever Kenya Ltd:Sunlight Scouring Pwd","Sunlight Scouring Powd Lavender 24X500G","Income","Sunlight Scouring Powd Lav 500g",,"Accounts Receivable","",22803.90,6928686.31
,"Invoice","11-12-2024","MC06462",,"Unilever Kenya Ltd:Sunlight Scouring Pwd","Sunlight Scouring Powd Lavender 12X1KG","Income","Sunlight Scouring Powd Lav 500g",,"Accounts Receivable","",48156.50,6976842.81
,"Invoice","14-12-2024","MC06469",,"Unilever Kenya Ltd:Sunlight Scouring Pwd","Sunlight Scouring Powd Lavender 24X500G","Income","Sunlight Scouring Powd Lav 500g",,"Accounts Receivable","",109458.72,7086301.53
,"Invoice","17-12-2024","MC06474",,"Unilever Kenya Ltd:Sunlight Scouring Pwd","Sunlight Scouring Powd Lavender 12X1KG","Income","Sunlight Scouring Powd Lav 500g",,"Accounts Receivable","",149973.10,7236274.63
,"Invoice","23-12-2024","MC06499",,"Unilever Kenya Ltd:Sunlight Scouring Pwd","Sunlight Scouring Powd Lavender 24X500G","Income","Sunlight Scouring Powd Lav 500g",,"Accounts Receivable","",72972.48,7309247.11
,"Invoice","24-12-2024","MC06516",,"Unilever Kenya Ltd:Sunlight Scouring Pwd","Sunlight Scouring Powd Lavender 24X500G","Income","Sunlight Scouring Powd Lav 500g",,"Accounts Receivable","",45607.80,7354854.91
"Total Sunlight Scouring Powd Lav 500g",,,,,,,,,,,0.00,7354854.91,7354854.91
"Total Sunlight Lavender",,,,,,,,,,,0.00,7355288.71,7355288.71
"Sunlight Lemon",,,,,,,,,,,,,""
"Sunlight Scourg Powd Lemon 1 Kg",,,,,,,,,,,,,""
,"Invoice","16-01-2024","MC05323",,"Unilever Kenya Ltd:Sunlight Scouring Pwd","Sunlight Scouring Powd Lemon 12X1KG","Income","Sunlight Scourg Powd Lemon 1 Kg",,"Accounts Receivable","",48920.20,48920.20
,"Invoice","26-01-2024","MC05354",,"Unilever Kenya Ltd:Sunlight Scouring Pwd","Sunlight Scouring Powd Lemon 12X1KG","Income","Sunlight Scourg Powd Lemon 1 Kg",,"Accounts Receivable","",48920.20,97840.40
,"Invoice","29-01-2024","MC05365",,"Unilever Kenya Ltd:Sunlight Scouring Pwd","Sunlight Scouring Powd Lemon 12X1KG","Income","Sunlight Scourg Powd Lemon 1 Kg",,"Accounts Receivable","",97840.40,195680.80
,"Invoice","30-01-2024","MC05370",,"Unilever Kenya Ltd:Sunlight Scouring Pwd","Sunlight Scouring Powd Lemon 12X1KG","Income","Sunlight Scourg Powd Lemon 1 Kg",,"Accounts Receivable","",22363.52,218044.32
,"Invoice","01-02-2024","MC05377",,"Unilever Kenya Ltd","Outer Sunlight Lemon 12x1Kg","Income","Sunlight Scourg Powd Lemon 1 Kg",,"Accounts Receivable","",216.90,218261.22
,"Invoice","23-02-2024","MC05439",,"Unilever Kenya Ltd:Sunlight Scouring Pwd","Sunlight Scouring Powd Lemon 12X1KG","Income","Sunlight Scourg Powd Lemon 1 Kg",,"Accounts Receivable","",215947.74,434208.96
,"Invoice","03-04-2024","MC05556",,"Unilever Kenya Ltd:Sunlight Scouring Pwd","Sunlight Scouring Powd Lemon 12X1KG","Income","Sunlight Scourg Powd Lemon 1 Kg",,"Accounts Receivable","",145855.50,580064.46
,"Invoice","05-04-2024","MC05574",,"Unilever Kenya Ltd:Sunlight Scouring Pwd","Sunlight Scouring Powd Lemon 12X1KG","Income","Sunlight Scourg Powd Lemon 1 Kg",,"Accounts Receivable","",62509.50,642573.96
,"Invoice","26-04-2024","MC05644",,"Unilever Kenya Ltd:Sunlight Scouring Pwd","Sunlight Scouring Powd Lemon 12X1KG","Income","Sunlight Scourg Powd Lemon 1 Kg",,"Accounts Receivable","",97237.00,739810.96
,"Invoice","14-05-2024","MC05698",,"Unilever Kenya Ltd:Sunlight Scouring Pwd","Sunlight Scouring Powd Lemon 12X1KG","Income","Sunlight Scourg Powd Lemon 1 Kg",,"Accounts Receivable","",97237.00,837047.96
,"Invoice","23-05-2024","MC05733",,"Unilever Kenya Ltd:Sunlight Scouring Pwd","Sunlight Scouring Powd Lemon 12X1KG","Income","Sunlight Scourg Powd Lemon 1 Kg",,"Accounts Receivable","",28476.55,865524.51
,"Invoice","30-05-2024","MC05779",,"Unilever Kenya Ltd:Sunlight Scouring Pwd","Sunlight Scouring Powd Lemon 12X1KG","Income","Sunlight Scourg Powd Lemon 1 Kg",,"Accounts Receivable","",209059.55,1074584.06
,"Invoice","09-07-2024","MC05905",,"Unilever Kenya Ltd:Sunlight Scouring Pwd","Sunlight Scouring Powd Lemon 12X1KG","Income","Sunlight Scourg Powd Lemon 1 Kg",,"Accounts Receivable","",100885.40,1175469.46
,"Invoice","12-07-2024","MC05917",,"Unilever Kenya Ltd:Sunlight Scouring Pwd","Sunlight Scouring Powd Lemon 12X1KG","Income","Sunlight Scourg Powd Lemon 1 Kg",,"Accounts Receivable","",79267.10,1254736.56
,"Invoice","26-07-2024","MC05972",,"Unilever Kenya Ltd:Sunlight Scouring Pwd","Sunlight Scouring Powd Lemon 12X1KG","Income","Sunlight Scourg Powd Lemon 1 Kg",,"Accounts Receivable","",36030.50,1290767.06
,"Invoice","02-08-2024","MC06000",,"Unilever Kenya Ltd:Sunlight Scouring Pwd","Sunlight Scouring Powd Lemon 12X1KG","Income","Sunlight Scourg Powd Lemon 1 Kg",,"Accounts Receivable","",100885.40,1391652.46
,"Invoice","15-08-2024","MC06043",,"Unilever Kenya Ltd:Sunlight Scouring Pwd","Sunlight Scouring Powd Lemon 12X1KG","Income","Sunlight Scourg Powd Lemon 1 Kg",,"Accounts Receivable","",50442.70,1442095.16
,"Invoice","21-08-2024","MC06058",,"Unilever Kenya Ltd:Sunlight Scouring Pwd","Sunlight Scouring Powd Lemon 12X1KG","Income","Sunlight Scourg Powd Lemon 1 Kg",,"Accounts Receivable","",64134.29,1506229.45
,"Invoice","11-09-2024","MC06141",,"Unilever Kenya Ltd:Sunlight Scouring Pwd","Sunlight Scouring Powd Lemon 12X1KG","Income","Sunlight Scourg Powd Lemon 1 Kg",,"Accounts Receivable","",50442.70,1556672.15
,"Invoice","17-09-2024","MC06160",,"Unilever Kenya Ltd:Sunlight Scouring Pwd","Sunlight Scouring Powd Lemon 12X1KG","Income","Sunlight Scourg Powd Lemon 1 Kg",,"Accounts Receivable","",90796.86,1647469.01
,"Invoice","27-09-2024","MC06215",,"Unilever Kenya Ltd:Sunlight Scouring Pwd","Sunlight Scouring Powd Lemon 12X1KG","Income","Sunlight Scourg Powd Lemon 1 Kg",,"Accounts Receivable","",50442.70,1697911.71
,"Invoice","03-10-2024","MC06234",,"Unilever Kenya Ltd:Sunlight Scouring Pwd","Sunlight Scouring Powd Lemon 12X1KG","Income","Sunlight Scourg Powd Lemon 1 Kg",,"Accounts Receivable","",118003.68,1815915.39
,"Invoice","25-10-2024","MC06302",,"Unilever Kenya Ltd:Sunlight Scouring Pwd","Sunlight Scouring Powd Lemon 12X1KG","Income","Sunlight Scourg Powd Lemon 1 Kg",,"Accounts Receivable","",109032.64,1924948.03
,"Invoice","20-11-2024","MC06389",,"Unilever Kenya Ltd:Sunlight Scouring Pwd","Sunlight Scouring Powd Lemon 12X1KG","Income","Sunlight Scourg Powd Lemon 1 Kg",,"Accounts Receivable","",115933.44,2040881.47
,"Invoice","21-11-2024","MC06396",,"Unilever Kenya Ltd:Sunlight Scouring Pwd","Sunlight Scouring Powd Lemon 12X1KG","Income","Sunlight Scourg Powd Lemon 1 Kg",,"Accounts Receivable","",96611.20,2137492.67
,"Invoice","18-12-2024","MC06484",,"Unilever Kenya Ltd:Sunlight Scouring Pwd","Sunlight Scouring Powd Lemon 12X1KG","Income","Sunlight Scourg Powd Lemon 1 Kg",,"Accounts Receivable","",193222.40,2330715.07
"Total Sunlight Scourg Powd Lemon 1 Kg",,,,,,,,,,,0.00,2330715.07,2330715.07
"Sunlight Scourg Powd Lemon 500g",,,,,,,,,,,,,""
,"Invoice","15-01-2024","MC05313",,"Unilever Kenya Ltd:Sunlight Scouring Pwd","Sunlight Scouring Powd Lemon 24X500G","Income","Sunlight Scourg Powd Lemon 500g",,"Accounts Receivable","",700875.36,700875.36
,"Invoice","01-02-2024","MC05377",,"Unilever Kenya Ltd","Outer Sunlight Lemon 24x500g","Income","Sunlight Scourg Powd Lemon 500g",,"Accounts Receivable","",157.56,701032.92
,"Invoice","07-02-2024","MC05388",,"Unilever Kenya Ltd:Sunlight Scouring Pwd","Sunlight Scouring Powd Lemon 24X500G","Income","Sunlight Scourg Powd Lemon 500g",,"Accounts Receivable","",111029.76,812062.68
,"Invoice","13-02-2024","MC05403",,"Unilever Kenya Ltd:Sunlight Scouring Pwd","Sunlight Scouring Powd Lemon 24X500G","Income","Sunlight Scourg Powd Lemon 500g",,"Accounts Receivable","",37009.92,849072.60
,"Invoice","19-02-2024","MC05412",,"Unilever Kenya Ltd:Sunlight Scouring Pwd","Sunlight Scouring Powd Lemon 24X500G","Income","Sunlight Scourg Powd Lemon 500g",,"Accounts Receivable","",231312.00,1080384.60
,"Invoice","22-02-2024","MC05433",,"Unilever Kenya Ltd:Sunlight Scouring Pwd","Sunlight Scouring Powd Lemon 24X500G","Income","Sunlight Scourg Powd Lemon 500g",,"Accounts Receivable","",83272.32,1163656.92
,"Invoice","08-03-2024","MC05481",,"Unilever Kenya Ltd:Sunlight Scouring Pwd","Sunlight Scouring Powd Lemon 24X500G","Income","Sunlight Scourg Powd Lemon 500g",,"Accounts Receivable","",222059.52,1385716.44
,"Invoice","11-03-2024","MC05487",,"Unilever Kenya Ltd:Sunlight Scouring Pwd","Sunlight Scouring Powd Lemon 24X500G","Income","Sunlight Scourg Powd Lemon 500g",,"Accounts Receivable","",128763.68,1514480.12
,"Invoice","23-03-2024","MC05523",,"Unilever Kenya Ltd:Sunlight Scouring Pwd","Sunlight Scouring Powd Lemon 24X500G","Income","Sunlight Scourg Powd Lemon 500g",,"Accounts Receivable","",117198.08,1631678.20
,"Invoice","26-03-2024","MC05534",,"Unilever Kenya Ltd:Sunlight Scouring Pwd","Sunlight Scouring Powd Lemon 24X500G","Income","Sunlight Scourg Powd Lemon 500g",,"Accounts Receivable","",111029.76,1742707.96
,"Invoice","03-04-2024","MC05559",,"Unilever Kenya Ltd:Sunlight Scouring Pwd","Sunlight Scouring Powd Lemon 24X500G","Income","Sunlight Scourg Powd Lemon 500g",,"Accounts Receivable","",73606.08,1816314.04
,"Invoice","11-04-2024","MC05586",,"Unilever Kenya Ltd:Sunlight Scouring Pwd","Sunlight Scouring Powd Lemon 24X500G","Income","Sunlight Scourg Powd Lemon 500g",,"Accounts Receivable","",381064.81,2197378.85
,"Invoice","19-04-2024","MC05619",,"Unilever Kenya Ltd:Sunlight Scouring Pwd","Sunlight Scouring Powd Lemon 24X500G","Income","Sunlight Scourg Powd Lemon 500g",,"Accounts Receivable","",73606.08,2270984.93
,"Invoice","26-04-2024","MC05643",,"Unilever Kenya Ltd:Sunlight Scouring Pwd","Sunlight Scouring Powd Lemon 24X500G","Income","Sunlight Scourg Powd Lemon 500g",,"Accounts Receivable","",73606.08,2344591.01
,"Invoice","09-05-2024","MC05684",,"Unilever Kenya Ltd:Sunlight Scouring Pwd","Sunlight Scouring Powd Lemon 24X500G","Income","Sunlight Scourg Powd Lemon 500g",,"Accounts Receivable","",213917.67,2558508.68
,"Invoice","09-05-2024","MC05689",,"Unilever Kenya Ltd:Sunlight Scouring Pwd","Sunlight Scouring Powd Lemon 24X500G","Income","Sunlight Scourg Powd Lemon 500g",,"Accounts Receivable","",441636.48,3000145.16
,"Invoice","09-05-2024","MC05691",,"Unilever Kenya Ltd:Sunlight Scouring Pwd","Sunlight Scouring Powd Lemon 24X500G","Income","Sunlight Scourg Powd Lemon 500g",,"Accounts Receivable","",108108.93,3108254.09
,"Invoice","17-05-2024","MC05715",,"Unilever Kenya Ltd:Sunlight Scouring Pwd","Sunlight Scouring Powd Lemon 24X500G","Income","Sunlight Scourg Powd Lemon 500g",,"Accounts Receivable","",147212.16,3255466.25
,"Invoice","20-05-2024","MC05721",,"Unilever Kenya Ltd:Sunlight Scouring Pwd","Sunlight Scouring Powd Lemon 24X500G","Income","Sunlight Scourg Powd Lemon 500g",,"Accounts Receivable","",73606.08,3329072.33
,"Invoice","07-06-2024","MC05805",,"Unilever Kenya Ltd:Sunlight Scouring Pwd","Sunlight Scouring Powd Lemon 24X500G","Income","Sunlight Scourg Powd Lemon 500g",,"Accounts Receivable","",383365.00,3712437.33
,"Invoice","24-06-2024","MC05860",,"Unilever Kenya Ltd:Sunlight Scouring Pwd","Sunlight Scouring Powd Lemon 24X500G","Income","Sunlight Scourg Powd Lemon 500g",,"Accounts Receivable","",73606.08,3786043.41
,"Invoice","08-07-2024","MC05901",,"Unilever Kenya Ltd:Sunlight Scouring Pwd","Sunlight Scouring Powd Lemon 24X500G","Income","Sunlight Scourg Powd Lemon 500g",,"Accounts Receivable","",132395.93,3918439.34
,"Invoice","15-07-2024","MC05926",,"Unilever Kenya Ltd:Sunlight Scouring Pwd","Sunlight Scouring Powd Lemon 24X500G","Income","Sunlight Scourg Powd Lemon 500g",,"Accounts Receivable","",76107.84,3994547.18
,"Invoice","26-07-2024","MC05971",,"Unilever Kenya Ltd:Sunlight Scouring Pwd","Sunlight Scouring Powd Lemon 24X500G","Income","Sunlight Scourg Powd Lemon 500g",,"Accounts Receivable","",45189.03,4039736.21
,"Invoice","02-08-2024","MC05999",,"Unilever Kenya Ltd:Sunlight Scouring Pwd","Sunlight Scouring Powd Lemon 24X500G","Income","Sunlight Scourg Powd Lemon 500g",,"Accounts Receivable","",84828.53,4124564.74
,"Invoice","06-08-2024","MC06003",,"Unilever Kenya Ltd:Sunlight Scouring Pwd","Sunlight Scouring Powd Lemon 24X500G","Income","Sunlight Scourg Powd Lemon 500g",,"Accounts Receivable","",228323.52,4352888.26
,"Invoice","09-08-2024","MC06025",,"Unilever Kenya Ltd:Sunlight Scouring Pwd","Sunlight Scouring Powd Lemon 24X500G","Income","Sunlight Scourg Powd Lemon 500g",,"Accounts Receivable","",76107.84,4428996.10
,"Invoice","15-08-2024","MC06042",,"Unilever Kenya Ltd:Sunlight Scouring Pwd","Sunlight Scouring Powd Lemon 24X500G","Income","Sunlight Scourg Powd Lemon 500g",,"Accounts Receivable","",57080.88,4486076.98
,"Invoice","30-08-2024","MC06104",,"Unilever Kenya Ltd:Sunlight Scouring Pwd","Sunlight Scouring Powd Lemon 24X500G","Income","Sunlight Scourg Powd Lemon 500g",,"Accounts Receivable","",76107.84,4562184.82
,"Invoice","04-09-2024","MC06119",,"Unilever Kenya Ltd:Sunlight Scouring Pwd","Sunlight Scouring Powd Lemon 24X500G","Income","Sunlight Scourg Powd Lemon 500g",,"Accounts Receivable","",396395.00,4958579.82
,"Invoice","11-09-2024","MC06140",,"Unilever Kenya Ltd:Sunlight Scouring Pwd","Sunlight Scouring Powd Lemon 24X500G","Income","Sunlight Scourg Powd Lemon 500g",,"Accounts Receivable","",71351.10,5029930.92
,"Invoice","21-09-2024","MC06181",,"Unilever Kenya Ltd:Sunlight Scouring Pwd","Sunlight Scouring Powd Lemon 24X500G","Income","Sunlight Scourg Powd Lemon 500g",,"Accounts Receivable","",277476.50,5307407.42
,"Invoice","24-09-2024","MC06191",,"Unilever Kenya Ltd:Sunlight Scouring Pwd","Sunlight Scouring Powd Lemon 24X500G","Income","Sunlight Scourg Powd Lemon 500g",,"Accounts Receivable","",76107.84,5383515.26
,"Invoice","23-10-2024","MC06289",,"Unilever Kenya Ltd:Sunlight Scouring Pwd","Sunlight Scouring Powd Lemon 24X500G","Income","Sunlight Scourg Powd Lemon 500g",,"Accounts Receivable","",691369.82,6074885.08
,"Invoice","24-10-2024","MC06294",,"Unilever Kenya Ltd:Sunlight Scouring Pwd","Sunlight Scouring Powd Lemon 24X500G","Income","Sunlight Scourg Powd Lemon 500g",,"Accounts Receivable","",219530.88,6294415.96
,"Invoice","30-10-2024","MC06324",,"Unilever Kenya Ltd:Sunlight Scouring Pwd","Sunlight Scouring Powd Lemon 24X500G","Income","Sunlight Scourg Powd Lemon 500g",,"Accounts Receivable","",583891.16,6878307.12
,"Invoice","08-11-2024","MC06347",,"Unilever Kenya Ltd:Sunlight Scouring Pwd","Sunlight Scouring Powd Lemon 24X500G","Income","Sunlight Scourg Powd Lemon 500g",,"Accounts Receivable","",708901.80,7587208.92
,"Invoice","23-11-2024","MC06409",,"Unilever Kenya Ltd:Sunlight Scouring Pwd","Sunlight Scouring Powd Lemon 24X500G","Income","Sunlight Scourg Powd Lemon 500g",,"Accounts Receivable","",36588.48,7623797.40
,"Invoice","28-11-2024","MC06424",,"Unilever Kenya Ltd:Sunlight Scouring Pwd","Sunlight Scouring Powd Lemon 24X500G","Income","Sunlight Scourg Powd Lemon 500g",,"Accounts Receivable","",138731.32,7762528.72
,"Invoice","19-12-2024","MC06488",,"Unilever Kenya Ltd:Sunlight Scouring Pwd","Sunlight Scouring Powd Lemon 24X500G","Income","Sunlight Scourg Powd Lemon 500g",,"Accounts Receivable","",533582.00,8296110.72
"Total Sunlight Scourg Powd Lemon 500g",,,,,,,,,,,0.00,8296110.72,8296110.72
"Total Sunlight Lemon",,,,,,,,,,,0.00,10626825.79,10626825.79
"Total Sunlight Scouring Powder",,,,,,,,,,,0.00,17982114.50,17982114.50
"Vim",,,,,,,,,,,,,""
"Vim Lavender",,,,,,,,,,,,,""
"Vim Pwd Lav Fresh SA 24X500G",,,,,,,,,,,,,""
,"Invoice","29-02-2024","MC05456",,"Unilever Kenya Ltd:Vim SA","Vim Powder Lavender Fresh SA 24X500G","Income","Vim Pwd Lav Fresh SA 24X500G",,"Accounts Receivable","",1608133.50,1608133.50
,"Invoice","25-03-2024","MC05531",,"Unilever Kenya Ltd:Vim SA","Vim Powder Lavender Fresh SA 24X500G","Income","Vim Pwd Lav Fresh SA 24X500G",,"Accounts Receivable","",1608133.50,3216267.00
,"Invoice","28-03-2024","MC05547",,"Unilever Kenya Ltd:Vim SA","Vim Powder Lavender Fresh SA 24X500G","Income","Vim Pwd Lav Fresh SA 24X500G",,"Accounts Receivable","",317656.00,3533923.00
,"Invoice","29-05-2024","MC05771",,"Unilever Kenya Ltd:Vim SA","Vim Powder Lavender Fresh SA 24X500G","Income","Vim Pwd Lav Fresh SA 24X500G",,"Accounts Receivable","",215765.10,3749688.10
,"Invoice","19-06-2024","MC05841",,"Unilever Kenya Ltd:Vim SA","Vim Powder Lavender Fresh SA 24X500G","Income","Vim Pwd Lav Fresh SA 24X500G",,"Accounts Receivable","",639304.00,4388992.10
,"Invoice","26-06-2024","MC05869",,"Unilever Kenya Ltd:Vim SA","Vim Powder Lavender Fresh SA 24X500G","Income","Vim Pwd Lav Fresh SA 24X500G",,"Accounts Receivable","",215765.10,4604757.20
,"Invoice","27-07-2024","MC05978",,"Unilever Kenya Ltd:Vim SA","Vim Powder Lavender Fresh SA 24X500G","Income","Vim Pwd Lav Fresh SA 24X500G",,"Accounts Receivable","",1052261.28,5657018.48
,"Invoice","27-07-2024","MC05980",,"Unilever Kenya Ltd:Vim SA","Vim Powder Lavender Fresh SA 24X500G","Income","Vim Pwd Lav Fresh SA 24X500G",,"Accounts Receivable","",740480.16,6397498.64
,"Invoice","27-07-2024","MC05982",,"Unilever Kenya Ltd:Vim SA","Vim Powder Lavender Fresh SA 24X500G","Income","Vim Pwd Lav Fresh SA 24X500G",,"Accounts Receivable","",608947.50,7006446.14
,"Invoice","16-08-2024","MC06047",,"Unilever Kenya Ltd:Vim SA","Vim Powder Lavender Fresh SA 24X500G","Income","Vim Pwd Lav Fresh SA 24X500G",,"Accounts Receivable","",660911.02,7667357.16
,"Invoice","29-08-2024","MC06098",,"Unilever Kenya Ltd:Vim SA","Vim Powder Lavender Fresh SA 24X500G","Income","Vim Pwd Lav Fresh SA 24X500G",,"Accounts Receivable","",365368.50,8032725.66
,"Invoice","23-09-2024","MC06189",,"Unilever Kenya Ltd:Vim SA","Vim Powder Lavender Fresh SA 24X500G","Income","Vim Pwd Lav Fresh SA 24X500G",,"Accounts Receivable","",893123.00,8925848.66
,"Invoice","19-11-2024","MC06382",,"Unilever Kenya Ltd:Vim SA","Vim Powder Lavender Fresh SA 24X500G","Income","Vim Pwd Lav Fresh SA 24X500G",,"Accounts Receivable","",1281967.92,10207816.58
"Total Vim Pwd Lav Fresh SA 24X500G",,,,,,,,,,,0.00,10207816.58,10207816.58
"Vim Lavender Fresh 12x1 Kg",,,,,,,,,,,,,""
,"Invoice","09-01-2024","MC05285",,"Unilever Kenya Ltd:Vim","Vim Lavender Fresh 12x1Kg","Income","Vim Lavender Fresh 12x1 Kg",,"Accounts Receivable","",410771.20,410771.20
,"Invoice","15-01-2024","MC05318",,"Unilever Kenya Ltd:Vim","Vim Lavender Fresh 12x1Kg","Income","Vim Lavender Fresh 12x1 Kg",,"Accounts Receivable","",102692.80,513464.00
,"Invoice","16-01-2024","MC05321",,"Unilever Kenya Ltd:Vim","Vim Lavender Fresh 12x1Kg","Income","Vim Lavender Fresh 12x1 Kg",,"Accounts Receivable","",85821.84,599285.84
,"Invoice","19-01-2024","MC05335",,"Unilever Kenya Ltd:Vim","Vim Lavender Fresh 12x1Kg","Income","Vim Lavender Fresh 12x1 Kg",,"Accounts Receivable","",162107.92,761393.76
,"Invoice","26-01-2024","MC05352",,"Unilever Kenya Ltd:Vim","Vim Lavender Fresh 12x1Kg","Income","Vim Lavender Fresh 12x1 Kg",,"Accounts Receivable","",308078.40,1069472.16
,"Invoice","26-01-2024","MC05356",,"Unilever Kenya Ltd:Vim","Vim Lavender Fresh 12x1Kg","Income","Vim Lavender Fresh 12x1 Kg",,"Accounts Receivable","",242061.60,1311533.76
,"Invoice","30-01-2024","MC05369",,"Unilever Kenya Ltd:Vim","Vim Lavender Fresh 12x1Kg","Income","Vim Lavender Fresh 12x1 Kg",,"Accounts Receivable","",373361.68,1684895.44
,"Invoice","01-02-2024","MC05377",,"Unilever Kenya Ltd","Outer Vim Lavender Fresh 12x1Kg","Income","Vim Lavender Fresh 12x1 Kg",,"Accounts Receivable","",1120.65,1686016.09
,"Invoice","07-02-2024","MC05393",,"Unilever Kenya Ltd:Vim","Vim Lavender Fresh 12x1Kg","Income","Vim Lavender Fresh 12x1 Kg",,"Accounts Receivable","",513464.00,2199480.09
,"Invoice","12-02-2024","MC05398",,"Unilever Kenya Ltd:Vim","Vim Lavender Fresh 12x1Kg","Income","Vim Lavender Fresh 12x1 Kg",,"Accounts Receivable","",154039.20,2353519.29
,"Invoice","16-02-2024","MC05410",,"Unilever Kenya Ltd:Vim","Vim Lavender Fresh 12x1Kg","Income","Vim Lavender Fresh 12x1 Kg",,"Accounts Receivable","",586816.00,2940335.29
,"Invoice","22-02-2024","MC05424",,"Unilever Kenya Ltd:Vim","Vim Lavender Fresh 12x1Kg","Income","Vim Lavender Fresh 12x1 Kg",,"Accounts Receivable","",359424.80,3299760.09
,"Invoice","23-02-2024","MC05438",,"Unilever Kenya Ltd:Vim","Vim Lavender Fresh 12x1Kg","Income","Vim Lavender Fresh 12x1 Kg",,"Accounts Receivable","",33008.40,3332768.49
,"Invoice","29-02-2024","MC05454",,"Unilever Kenya Ltd:Vim","Vim Lavender Fresh 12x1Kg","Income","Vim Lavender Fresh 12x1 Kg",,"Accounts Receivable","",545738.88,3878507.37
,"Invoice","12-03-2024","MC05490",,"Unilever Kenya Ltd:Vim","Vim Lavender Fresh 12x1Kg","Income","Vim Lavender Fresh 12x1 Kg",,"Accounts Receivable","",205385.60,4083892.97
,"Invoice","21-03-2024","MC05509",,"Unilever Kenya Ltd:Vim","Vim Lavender Fresh 12x1Kg","Income","Vim Lavender Fresh 12x1 Kg",,"Accounts Receivable","",513464.00,4597356.97
,"Invoice","22-03-2024","MC05512",,"Unilever Kenya Ltd:Vim","Vim Lavender Fresh 12x1Kg","Income","Vim Lavender Fresh 12x1 Kg",,"Accounts Receivable","",29340.80,4626697.77
,"Invoice","22-03-2024","MC05518",,"Unilever Kenya Ltd:Vim","Vim Lavender Fresh 12x1Kg","Income","Vim Lavender Fresh 12x1 Kg",,"Accounts Receivable","",14670.40,4641368.17
,"Invoice","23-03-2024","MC05522",,"Unilever Kenya Ltd:Vim","Vim Lavender Fresh 12x1Kg","Income","Vim Lavender Fresh 12x1 Kg",,"Accounts Receivable","",51346.40,4692714.57
,"Invoice","23-03-2024","MC05527",,"Unilever Kenya Ltd:Vim","Vim Lavender Fresh 12x1Kg","Income","Vim Lavender Fresh 12x1 Kg",,"Accounts Receivable","",1026928.00,5719642.57
,"Invoice","26-03-2024","MC05533",,"Unilever Kenya Ltd:Vim","Vim Lavender Fresh 12x1Kg","Income","Vim Lavender Fresh 12x1 Kg",,"Accounts Receivable","",200984.48,5920627.05
,"Invoice","04-04-2024","MC05561",,"Unilever Kenya Ltd:Vim","Vim Lavender Fresh 12x1Kg","Income","Vim Lavender Fresh 12x1 Kg",,"Accounts Receivable","",283587.84,6204214.89
,"Invoice","11-04-2024","MC05585",,"Unilever Kenya Ltd:Vim","Vim Lavender Fresh 12x1Kg","Income","Vim Lavender Fresh 12x1 Kg",,"Accounts Receivable","",11816.16,6216031.05
,"Invoice","11-04-2024","MC05589",,"Unilever Kenya Ltd:Vim","Vim Lavender Fresh 12x1Kg","Income","Vim Lavender Fresh 12x1 Kg",,"Accounts Receivable","",295404.00,6511435.05
,"Invoice","18-04-2024","MC05609",,"Unilever Kenya Ltd:Vim","Vim Lavender Fresh 12x1Kg","Income","Vim Lavender Fresh 12x1 Kg",,"Accounts Receivable","",337499.07,6848934.12
,"Invoice","19-04-2024","MC05618",,"Unilever Kenya Ltd:Vim","Vim Lavender Fresh 12x1Kg","Income","Vim Lavender Fresh 12x1 Kg",,"Accounts Receivable","",253308.93,7102243.05
,"Invoice","23-04-2024","MC05627",,"Unilever Kenya Ltd:Vim","Vim Lavender Fresh 12x1Kg","Income","Vim Lavender Fresh 12x1 Kg",,"Accounts Receivable","",413565.60,7515808.65
,"Invoice","29-04-2024","MC05649",,"Unilever Kenya Ltd:Vim","Vim Lavender Fresh 12x1Kg","Income","Vim Lavender Fresh 12x1 Kg",,"Accounts Receivable","",177980.91,7693789.56
,"Invoice","06-05-2024","MC05670",,"Unilever Kenya Ltd:Vim","Vim Lavender Fresh 12x1Kg","Income","Vim Lavender Fresh 12x1 Kg",,"Accounts Receivable","",553143.99,8246933.55
,"Invoice","07-05-2024","MC05675",,"Unilever Kenya Ltd:Vim","Vim Lavender Fresh 12x1Kg","Income","Vim Lavender Fresh 12x1 Kg",,"Accounts Receivable","",103391.40,8350324.95
,"Invoice","09-05-2024","MC05688",,"Unilever Kenya Ltd:Vim","Vim Lavender Fresh 12x1Kg","Income","Vim Lavender Fresh 12x1 Kg",,"Accounts Receivable","",81236.10,8431561.05
,"Invoice","13-05-2024","MC05693",,"Unilever Kenya Ltd:Vim","Vim Lavender Fresh 12x1Kg","Income","Vim Lavender Fresh 12x1 Kg",,"Accounts Receivable","",911321.34,9342882.39
,"Invoice","24-05-2024","MC05745",,"Unilever Kenya Ltd:Vim","Vim Lavender Fresh 12x1Kg","Income","Vim Lavender Fresh 12x1 Kg",,"Accounts Receivable","",206782.80,9549665.19
,"Invoice","24-05-2024","MC05753",,"Unilever Kenya Ltd:Vim","Vim Lavender Fresh 12x1Kg","Income","Vim Lavender Fresh 12x1 Kg",,"Accounts Receivable","",320513.34,9870178.53
,"Invoice","27-05-2024","MC05756",,"Unilever Kenya Ltd:Vim","Vim Lavender Fresh 12x1Kg","Income","Vim Lavender Fresh 12x1 Kg",,"Accounts Receivable","",51695.70,9921874.23
,"Credit Note","27-05-2024","CN01062",,"Unilever Kenya Ltd:Vim","Vim Lavender Fresh 12x1Kg","Income","Vim Lavender Fresh 12x1 Kg",,"Accounts Receivable",51695.70,"",9870178.53
,"Invoice","27-05-2024","MC05754",,"Unilever Kenya Ltd:Vim","Vim Lavender Fresh 12x1Kg","Income","Vim Lavender Fresh 12x1 Kg",,"Accounts Receivable","",51695.70,9921874.23
,"Invoice","29-05-2024","MC05769",,"Unilever Kenya Ltd:Vim","Vim Lavender Fresh 12x1Kg","Income","Vim Lavender Fresh 12x1 Kg",,"Accounts Receivable","",383286.69,10305160.92
,"Invoice","06-06-2024","MC05793",,"Unilever Kenya Ltd:Vim","Vim Lavender Fresh 12x1Kg","Income","Vim Lavender Fresh 12x1 Kg",,"Accounts Receivable","",609270.75,10914431.67
,"Invoice","07-06-2024","MC05801",,"Unilever Kenya Ltd:Vim","Vim Lavender Fresh 12x1Kg","Income","Vim Lavender Fresh 12x1 Kg",,"Accounts Receivable","",258478.50,11172910.17
,"Invoice","24-06-2024","MC05850",,"Unilever Kenya Ltd:Vim","Vim Lavender Fresh 12x1Kg","Income","Vim Lavender Fresh 12x1 Kg",,"Accounts Receivable","",206782.80,11379692.97
,"Invoice","02-07-2024","MC05875",,"Unilever Kenya Ltd:Vim","Vim Lavender Fresh 12x1Kg","Income","Vim Lavender Fresh 12x1 Kg",,"Accounts Receivable","",781372.80,12161065.77
,"Invoice","05-07-2024","MC05896",,"Unilever Kenya Ltd:Vim","Vim Lavender Fresh 12x1Kg","Income","Vim Lavender Fresh 12x1 Kg",,"Accounts Receivable","",282496.32,12443562.09
,"Invoice","12-07-2024","MC05912",,"Unilever Kenya Ltd:Vim","Vim Lavender Fresh 12x1Kg","Income","Vim Lavender Fresh 12x1 Kg",,"Accounts Receivable","",631108.80,13074670.89
,"Invoice","12-07-2024","MC05916",,"Unilever Kenya Ltd:Vim","Vim Lavender Fresh 12x1Kg","Income","Vim Lavender Fresh 12x1 Kg",,"Accounts Receivable","",157777.20,13232448.09
,"Invoice","17-07-2024","MC05937",,"Unilever Kenya Ltd:Vim","Vim Lavender Fresh 12x1Kg","Income","Vim Lavender Fresh 12x1 Kg",,"Accounts Receivable","",191586.60,13424034.69
,"Invoice","19-07-2024","MC05956",,"Unilever Kenya Ltd:Vim","Vim Lavender Fresh 12x1Kg","Income","Vim Lavender Fresh 12x1 Kg",,"Accounts Receivable","",525924.00,13949958.69
,"Invoice","26-07-2024","MC05970",,"Unilever Kenya Ltd:Vim","Vim Lavender Fresh 12x1Kg","Income","Vim Lavender Fresh 12x1 Kg",,"Accounts Receivable","",105184.80,14055143.49
,"Invoice","09-08-2024","MC06024",,"Unilever Kenya Ltd:Vim","Vim Lavender Fresh 12x1Kg","Income","Vim Lavender Fresh 12x1 Kg",,"Accounts Receivable","",52592.40,14107735.89
,"Invoice","12-08-2024","MC06033",,"Unilever Kenya Ltd:Vim","Vim Lavender Fresh 12x1Kg","Income","Vim Lavender Fresh 12x1 Kg",,"Accounts Receivable","",514654.20,14622390.09
,"Invoice","21-08-2024","MC06057",,"Unilever Kenya Ltd:Vim","Vim Lavender Fresh 12x1Kg","Income","Vim Lavender Fresh 12x1 Kg",,"Accounts Receivable","",72878.04,14695268.13
,"Invoice","26-08-2024","MC06079",,"Unilever Kenya Ltd:Vim","Vim Lavender Fresh 12x1Kg","Income","Vim Lavender Fresh 12x1 Kg",,"Accounts Receivable","",368146.80,15063414.93
,"Invoice","26-08-2024","MC06086",,"Unilever Kenya Ltd:Vim","Vim Lavender Fresh 12x1Kg","Income","Vim Lavender Fresh 12x1 Kg",,"Accounts Receivable","",191586.60,15255001.53
,"Invoice","29-08-2024","MC06096",,"Unilever Kenya Ltd:Vim","Vim Lavender Fresh 12x1Kg","Income","Vim Lavender Fresh 12x1 Kg",,"Accounts Receivable","",210369.60,15465371.13
,"Invoice","30-08-2024","MC06103",,"Unilever Kenya Ltd:Vim","Vim Lavender Fresh 12x1Kg","Income","Vim Lavender Fresh 12x1 Kg",,"Accounts Receivable","",416982.60,15882353.73
,"Invoice","06-09-2024","MC06127",,"Unilever Kenya Ltd:Vim","Vim Lavender Fresh 12x1Kg","Income","Vim Lavender Fresh 12x1 Kg",,"Accounts Receivable","",105184.80,15987538.53
,"Invoice","10-09-2024","MC06133",,"Unilever Kenya Ltd:Vim","Vim Lavender Fresh 12x1Kg","Income","Vim Lavender Fresh 12x1 Kg",,"Accounts Receivable","",578516.40,16566054.93
,"Invoice","13-09-2024","MC06151",,"Unilever Kenya Ltd:Vim","Vim Lavender Fresh 12x1Kg","Income","Vim Lavender Fresh 12x1 Kg",,"Accounts Receivable","",262962.00,16829016.93
,"Invoice","19-09-2024","MC06169",,"Unilever Kenya Ltd:Vim","Vim Lavender Fresh 12x1Kg","Income","Vim Lavender Fresh 12x1 Kg",,"Accounts Receivable","",246432.96,17075449.89
,"Invoice","23-09-2024","MC06186",,"Unilever Kenya Ltd:Vim","Vim Lavender Fresh 12x1Kg","Income","Vim Lavender Fresh 12x1 Kg",,"Accounts Receivable","",262962.00,17338411.89
,"Invoice","25-09-2024","MC06202",,"Unilever Kenya Ltd:Vim","Vim Lavender Fresh 12x1Kg","Income","Vim Lavender Fresh 12x1 Kg",,"Accounts Receivable","",149512.68,17487924.57
,"Invoice","27-09-2024","MC06209",,"Unilever Kenya Ltd:Vim","Vim Lavender Fresh 12x1Kg","Income","Vim Lavender Fresh 12x1 Kg",,"Accounts Receivable","",52592.40,17540516.97
,"Invoice","27-09-2024","MC06214",,"Unilever Kenya Ltd:Vim","Vim Lavender Fresh 12x1Kg","Income","Vim Lavender Fresh 12x1 Kg",,"Accounts Receivable","",210369.60,17750886.57
,"Invoice","30-09-2024","MC06220",,"Unilever Kenya Ltd:Vim","Vim Lavender Fresh 12x1Kg","Income","Vim Lavender Fresh 12x1 Kg",,"Accounts Receivable","",210369.60,17961256.17
,"Invoice","03-10-2024","MC06233",,"Unilever Kenya Ltd:Vim","Vim Lavender Fresh 12x1Kg","Income","Vim Lavender Fresh 12x1 Kg",,"Accounts Receivable","",154068.60,18115324.77
,"Invoice","09-10-2024","MC06248",,"Unilever Kenya Ltd:Vim","Vim Lavender Fresh 12x1Kg","Income","Vim Lavender Fresh 12x1 Kg",,"Accounts Receivable","",511361.02,18626685.79
,"Invoice","15-10-2024","MC06262",,"Unilever Kenya Ltd:Vim","Vim Lavender Fresh 12x1Kg","Income","Vim Lavender Fresh 12x1 Kg",,"Accounts Receivable","",400578.36,19027264.15
,"Invoice","17-10-2024","MC06276",,"Unilever Kenya Ltd:Vim","Vim Lavender Fresh 12x1Kg","Income","Vim Lavender Fresh 12x1 Kg",,"Accounts Receivable","",548044.02,19575308.17
,"Invoice","25-10-2024","MC06297",,"Unilever Kenya Ltd:Vim","Vim Lavender Fresh 12x1Kg","Income","Vim Lavender Fresh 12x1 Kg",,"Accounts Receivable","",462205.80,20037513.97
,"Invoice","05-11-2024","MC06330",,"Unilever Kenya Ltd:Vim","Vim Lavender Fresh 12x1Kg","Income","Vim Lavender Fresh 12x1 Kg",,"Accounts Receivable","",416718.88,20454232.85
,"Invoice","18-11-2024","MC06370",,"Unilever Kenya Ltd:Vim","Vim Lavender Fresh 12x1Kg","Income","Vim Lavender Fresh 12x1 Kg",,"Accounts Receivable","",527501.54,20981734.39
,"Invoice","22-11-2024","MC06404",,"Unilever Kenya Ltd:Vim","Vim Lavender Fresh 12x1Kg","Income","Vim Lavender Fresh 12x1 Kg",,"Accounts Receivable","",400578.36,21382312.75
,"Invoice","28-11-2024","MC06419",,"Unilever Kenya Ltd:Vim","Vim Lavender Fresh 12x1Kg","Income","Vim Lavender Fresh 12x1 Kg",,"Accounts Receivable","",250178.06,21632490.81
,"Invoice","30-11-2024","MC06430",,"Unilever Kenya Ltd:Vim","Vim Lavender Fresh 12x1Kg","Income","Vim Lavender Fresh 12x1 Kg",,"Accounts Receivable","",256781.00,21889271.81
,"Invoice","02-12-2024","MC06432",,"Unilever Kenya Ltd:Vim","Vim Lavender Fresh 12x1Kg","Income","Vim Lavender Fresh 12x1 Kg",,"Accounts Receivable","",124722.20,22013994.01
,"Invoice","04-12-2024","MC06444",,"Unilever Kenya Ltd:Vim","Vim Lavender Fresh 12x1Kg","Income","Vim Lavender Fresh 12x1 Kg",,"Accounts Receivable","",102712.40,22116706.41
,"Invoice","05-12-2024","MC06451",,"Unilever Kenya Ltd:Vim","Vim Lavender Fresh 12x1Kg","Income","Vim Lavender Fresh 12x1 Kg",,"Accounts Receivable","",513562.00,22630268.41
,"Invoice","13-12-2024","MC06465",,"Unilever Kenya Ltd:Vim","Vim Lavender Fresh 12x1Kg","Income","Vim Lavender Fresh 12x1 Kg",,"Accounts Receivable","",366096.34,22996364.75
,"Invoice","16-12-2024","MC06470",,"Unilever Kenya Ltd:Vim","Vim Lavender Fresh 12x1Kg","Income","Vim Lavender Fresh 12x1 Kg",,"Accounts Receivable","",498155.14,23494519.89
,"Invoice","19-12-2024","MC06492",,"Unilever Kenya Ltd:Vim","Vim Lavender Fresh 12x1Kg","Income","Vim Lavender Fresh 12x1 Kg",,"Accounts Receivable","",359493.40,23854013.29
,"Invoice","24-12-2024","MC06509",,"Unilever Kenya Ltd:Vim","Vim Lavender Fresh 12x1Kg","Income","Vim Lavender Fresh 12x1 Kg",,"Accounts Receivable","",346287.52,24200300.81
,"Invoice","24-12-2024","MC06512",,"Unilever Kenya Ltd:Vim","Vim Lavender Fresh 12x1Kg","Income","Vim Lavender Fresh 12x1 Kg",,"Accounts Receivable","",264117.60,24464418.41
"Total Vim Lavender Fresh 12x1 Kg",,,,,,,,,,,51695.70,24516114.11,24464418.41
"Vim Lavender Fresh 24x500g",,,,,,,,,,,,,""
,"Invoice","08-01-2024","MC05281",,"Unilever Kenya Ltd:Vim","Vim Lavender Fresh 24x500g","Income","Vim Lavender Fresh 24x500g",,"Accounts Receivable","",235388.16,235388.16
,"Invoice","09-01-2024","MC05283",,"Unilever Kenya Ltd:Vim","Vim Lavender Fresh 24x500g","Income","Vim Lavender Fresh 24x500g",,"Accounts Receivable","",262359.72,497747.88
,"Invoice","15-01-2024","MC05317",,"Unilever Kenya Ltd:Vim","Vim Lavender Fresh 24x500g","Income","Vim Lavender Fresh 24x500g",,"Accounts Receivable","",78462.72,576210.60
,"Invoice","16-01-2024","MC05322",,"Unilever Kenya Ltd:Vim","Vim Lavender Fresh 24x500g","Income","Vim Lavender Fresh 24x500g",,"Accounts Receivable","",117694.08,693904.68
,"Invoice","17-01-2024","MC05326",,"Unilever Kenya Ltd:Vim","Vim Lavender Fresh 24x500g","Income","Vim Lavender Fresh 24x500g",,"Accounts Receivable","",179810.40,873715.08
,"Invoice","19-01-2024","MC05333",,"Unilever Kenya Ltd:Vim","Vim Lavender Fresh 24x500g","Income","Vim Lavender Fresh 24x500g",,"Accounts Receivable","",117694.08,991409.16
,"Invoice","26-01-2024","MC05351",,"Unilever Kenya Ltd:Vim","Vim Lavender Fresh 24x500g","Income","Vim Lavender Fresh 24x500g",,"Accounts Receivable","",274619.52,1266028.68
,"Invoice","29-01-2024","MC05364",,"Unilever Kenya Ltd:Vim","Vim Lavender Fresh 24x500g","Income","Vim Lavender Fresh 24x500g",,"Accounts Receivable","",420102.48,1686131.16
,"Invoice","01-02-2024","MC05377",,"Unilever Kenya Ltd","Outer Vim Lavender Fresh 24x500g","Income","Vim Lavender Fresh 24x500g",,"Accounts Receivable","",433.29,1686564.45
,"Invoice","07-02-2024","MC05387",,"Unilever Kenya Ltd:Vim","Vim Lavender Fresh 24x500g","Income","Vim Lavender Fresh 24x500g",,"Accounts Receivable","",313850.88,2000415.33
,"Invoice","12-02-2024","MC05397",,"Unilever Kenya Ltd:Vim","Vim Lavender Fresh 24x500g","Income","Vim Lavender Fresh 24x500g",,"Accounts Receivable","",488757.36,2489172.69
,"Invoice","21-02-2024","MC05419",,"Unilever Kenya Ltd:Vim","Vim Lavender Fresh 24x500g","Income","Vim Lavender Fresh 24x500g",,"Accounts Receivable","",392313.60,2881486.29
,"Invoice","22-02-2024","MC05432",,"Unilever Kenya Ltd:Vim","Vim Lavender Fresh 24x500g","Income","Vim Lavender Fresh 24x500g",,"Accounts Receivable","",235388.16,3116874.45
,"Invoice","23-02-2024","MC05437",,"Unilever Kenya Ltd:Vim","Vim Lavender Fresh 24x500g","Income","Vim Lavender Fresh 24x500g",,"Accounts Receivable","",51491.16,3168365.61
,"Invoice","07-03-2024","MC05476",,"Unilever Kenya Ltd:Vim","Vim Lavender Fresh 24x500g","Income","Vim Lavender Fresh 24x500g",,"Accounts Receivable","",143031.00,3311396.61
,"Invoice","08-03-2024","MC05479",,"Unilever Kenya Ltd:Vim","Vim Lavender Fresh 24x500g","Income","Vim Lavender Fresh 24x500g",,"Accounts Receivable","",655490.64,3966887.25
,"Invoice","12-03-2024","MC05489",,"Unilever Kenya Ltd:Vim","Vim Lavender Fresh 24x500g","Income","Vim Lavender Fresh 24x500g",,"Accounts Receivable","",295052.52,4261939.77
,"Invoice","22-03-2024","MC05511",,"Unilever Kenya Ltd:Vim","Vim Lavender Fresh 24x500g","Income","Vim Lavender Fresh 24x500g",,"Accounts Receivable","",456064.56,4718004.33
,"Invoice","22-03-2024","MC05517",,"Unilever Kenya Ltd:Vim","Vim Lavender Fresh 24x500g","Income","Vim Lavender Fresh 24x500g",,"Accounts Receivable","",24519.60,4742523.93
,"Invoice","23-03-2024","MC05521",,"Unilever Kenya Ltd:Vim","Vim Lavender Fresh 24x500g","Income","Vim Lavender Fresh 24x500g",,"Accounts Receivable","",61299.00,4803822.93
,"Invoice","26-03-2024","MC05532",,"Unilever Kenya Ltd:Vim","Vim Lavender Fresh 24x500g","Income","Vim Lavender Fresh 24x500g",,"Accounts Receivable","",14711.76,4818534.69
,"Invoice","26-03-2024","MC05539",,"Unilever Kenya Ltd:Vim","Vim Lavender Fresh 24x500g","Income","Vim Lavender Fresh 24x500g",,"Accounts Receivable","",510007.68,5328542.37
,"Invoice","28-03-2024","MC05550",,"Unilever Kenya Ltd:Vim","Vim Lavender Fresh 24x500g","Income","Vim Lavender Fresh 24x500g",,"Accounts Receivable","",33510.12,5362052.49
,"Invoice","02-04-2024","MC05552",,"Unilever Kenya Ltd:Vim","Vim Lavender Fresh 24x500g","Income","Vim Lavender Fresh 24x500g",,"Accounts Receivable","",313850.88,5675903.37
,"Invoice","03-04-2024","MC05555",,"Unilever Kenya Ltd:Vim","Vim Lavender Fresh 24x500g","Income","Vim Lavender Fresh 24x500g",,"Accounts Receivable","",601930.92,6277834.29
,"Invoice","12-04-2024","MC05597",,"Unilever Kenya Ltd:Vim","Vim Lavender Fresh 24x500g","Income","Vim Lavender Fresh 24x500g",,"Accounts Receivable","",370861.81,6648696.10
,"Invoice","12-04-2024","MC05598",,"Unilever Kenya Ltd:Vim","Vim Lavender Fresh 24x500g","Income","Vim Lavender Fresh 24x500g",,"Accounts Receivable","",224490.63,6873186.73
,"Invoice","19-04-2024","MC05617",,"Unilever Kenya Ltd:Vim","Vim Lavender Fresh 24x500g","Income","Vim Lavender Fresh 24x500g",,"Accounts Receivable","",394708.80,7267895.53
,"Invoice","23-04-2024","MC05626",,"Unilever Kenya Ltd:Vim","Vim Lavender Fresh 24x500g","Income","Vim Lavender Fresh 24x500g",,"Accounts Receivable","",260672.27,7528567.80
,"Invoice","26-04-2024","MC05641",,"Unilever Kenya Ltd:Vim","Vim Lavender Fresh 24x500g","Income","Vim Lavender Fresh 24x500g",,"Accounts Receivable","",445692.02,7974259.82
,"Invoice","29-04-2024","MC05648",,"Unilever Kenya Ltd:Vim","Vim Lavender Fresh 24x500g","Income","Vim Lavender Fresh 24x500g",,"Accounts Receivable","",60850.94,8035110.76
,"Invoice","03-05-2024","MC05660",,"Unilever Kenya Ltd:Vim","Vim Lavender Fresh 24x500g","Income","Vim Lavender Fresh 24x500g",,"Accounts Receivable","",460493.60,8495604.36
,"Invoice","03-05-2024","MC05665",,"Unilever Kenya Ltd:Vim","Vim Lavender Fresh 24x500g","Income","Vim Lavender Fresh 24x500g",,"Accounts Receivable","",473650.56,8969254.92
,"Invoice","03-05-2024","MC05668",,"Unilever Kenya Ltd:Vim","Vim Lavender Fresh 24x500g","Income","Vim Lavender Fresh 24x500g",,"Accounts Receivable","",78941.76,9048196.68
,"Invoice","06-05-2024","MC05669",,"Unilever Kenya Ltd:Vim","Vim Lavender Fresh 24x500g","Income","Vim Lavender Fresh 24x500g",,"Accounts Receivable","",118412.64,9166609.32
,"Invoice","08-05-2024","MC05680",,"Unilever Kenya Ltd:Vim","Vim Lavender Fresh 24x500g","Income","Vim Lavender Fresh 24x500g",,"Accounts Receivable","",39470.88,9206080.20
,"Invoice","09-05-2024","MC05683",,"Unilever Kenya Ltd:Vim","Vim Lavender Fresh 24x500g","Income","Vim Lavender Fresh 24x500g",,"Accounts Receivable","",328101.69,9534181.89
,"Invoice","09-05-2024","MC05687",,"Unilever Kenya Ltd:Vim","Vim Lavender Fresh 24x500g","Income","Vim Lavender Fresh 24x500g",,"Accounts Receivable","",64962.49,9599144.38
,"Credit Note","09-05-2024","CN01061",,"Unilever Kenya Ltd:Vim","Vim Lavender Fresh 24x500g","Income","Vim Lavender Fresh 24x500g",,"Accounts Receivable",1644.62,"",9597499.76
,"Invoice","16-05-2024","MC05711",,"Unilever Kenya Ltd:Vim","Vim Lavender Fresh 24x500g","Income","Vim Lavender Fresh 24x500g",,"Accounts Receivable","",39470.88,9636970.64
,"Invoice","17-05-2024","MC05714",,"Unilever Kenya Ltd:Vim","Vim Lavender Fresh 24x500g","Income","Vim Lavender Fresh 24x500g",,"Accounts Receivable","",552592.32,10189562.96
,"Invoice","21-05-2024","MC05725",,"Unilever Kenya Ltd:Vim","Vim Lavender Fresh 24x500g","Income","Vim Lavender Fresh 24x500g",,"Accounts Receivable","",236825.28,10426388.24
,"Invoice","24-05-2024","MC05744",,"Unilever Kenya Ltd:Vim","Vim Lavender Fresh 24x500g","Income","Vim Lavender Fresh 24x500g",,"Accounts Receivable","",28780.85,10455169.09
,"Invoice","24-05-2024","MC05752",,"Unilever Kenya Ltd:Vim","Vim Lavender Fresh 24x500g","Income","Vim Lavender Fresh 24x500g",,"Accounts Receivable","",153771.97,10608941.06
,"Invoice","27-05-2024","MC05755",,"Unilever Kenya Ltd:Vim","Vim Lavender Fresh 24x500g","Income","Vim Lavender Fresh 24x500g",,"Accounts Receivable","",731855.90,11340796.96
,"Invoice","28-05-2024","MC05760",,"Unilever Kenya Ltd:Vim","Vim Lavender Fresh 24x500g","Income","Vim Lavender Fresh 24x500g",,"Accounts Receivable","",434179.68,11774976.64
,"Invoice","29-05-2024","MC05768",,"Unilever Kenya Ltd:Vim","Vim Lavender Fresh 24x500g","Income","Vim Lavender Fresh 24x500g",,"Accounts Receivable","",210511.36,11985488.00
,"Invoice","18-06-2024","MC05836",,"Unilever Kenya Ltd:Vim","Vim Lavender Fresh 24x500g","Income","Vim Lavender Fresh 24x500g",,"Accounts Receivable","",424311.96,12409799.96
,"Invoice","19-06-2024","MC05839",,"Unilever Kenya Ltd:Vim","Vim Lavender Fresh 24x500g","Income","Vim Lavender Fresh 24x500g",,"Accounts Receivable","",78941.76,12488741.72
,"Invoice","21-06-2024","MC05847",,"Unilever Kenya Ltd:Vim","Vim Lavender Fresh 24x500g","Income","Vim Lavender Fresh 24x500g",,"Accounts Receivable","",197354.40,12686096.12
,"Invoice","24-06-2024","MC05849",,"Unilever Kenya Ltd:Vim","Vim Lavender Fresh 24x500g","Income","Vim Lavender Fresh 24x500g",,"Accounts Receivable","",236825.28,12922921.40
,"Invoice","24-06-2024","MC05856",,"Unilever Kenya Ltd:Vim","Vim Lavender Fresh 24x500g","Income","Vim Lavender Fresh 24x500g",,"Accounts Receivable","",246693.00,13169614.40
,"Invoice","24-06-2024","MC05859",,"Unilever Kenya Ltd:Vim","Vim Lavender Fresh 24x500g","Income","Vim Lavender Fresh 24x500g",,"Accounts Receivable","",256560.72,13426175.12
,"Invoice","02-07-2024","MC05877",,"Unilever Kenya Ltd:Vim","Vim Lavender Fresh 24x500g","Income","Vim Lavender Fresh 24x500g",,"Accounts Receivable","",601279.20,14027454.32
,"Credit Note","03-07-2024","CN01063",,"Unilever Kenya Ltd:Vim","Vim Lavender Fresh 24x500g","Income","Vim Lavender Fresh 24x500g",,"Accounts Receivable",601279.20,"",13426175.12
,"Invoice","04-07-2024","MC05889",,"Unilever Kenya Ltd:Vim","Vim Lavender Fresh 24x500g","Income","Vim Lavender Fresh 24x500g",,"Accounts Receivable","",213788.16,13639963.28
,"Invoice","05-07-2024","MC05892",,"Unilever Kenya Ltd:Vim","Vim Lavender Fresh 24x500g","Income","Vim Lavender Fresh 24x500g",,"Accounts Receivable","",400852.80,14040816.08
,"Invoice","05-07-2024","MC05898",,"Unilever Kenya Ltd:Vim","Vim Lavender Fresh 24x500g","Income","Vim Lavender Fresh 24x500g",,"Accounts Receivable","",417555.00,14458371.08
,"Invoice","08-07-2024","MC05900",,"Unilever Kenya Ltd:Vim","Vim Lavender Fresh 24x500g","Income","Vim Lavender Fresh 24x500g",,"Accounts Receivable","",280596.96,14738968.04
,"Invoice","12-07-2024","MC05920",,"Unilever Kenya Ltd","Outer Vim Lavender Fresh 24x500g","Income","Vim Lavender Fresh 24x500g",,"Accounts Receivable","",3939.00,14742907.04
,"Invoice","15-07-2024","MC05925",,"Unilever Kenya Ltd:Vim","Vim Lavender Fresh 24x500g","Income","Vim Lavender Fresh 24x500g",,"Accounts Receivable","",115245.18,14858152.22
,"Invoice","16-07-2024","MC05934",,"Unilever Kenya Ltd:Vim","Vim Lavender Fresh 24x500g","Income","Vim Lavender Fresh 24x500g",,"Accounts Receivable","",793354.50,15651506.72
,"Invoice","19-07-2024","MC05955",,"Unilever Kenya Ltd:Vim","Vim Lavender Fresh 24x500g","Income","Vim Lavender Fresh 24x500g",,"Accounts Receivable","",200426.40,15851933.12
,"Invoice","23-07-2024","MC05963",,"Unilever Kenya Ltd:Vim","Vim Lavender Fresh 24x500g","Income","Vim Lavender Fresh 24x500g",,"Accounts Receivable","",80170.56,15932103.68
,"Invoice","23-07-2024","MC05966",,"Unilever Kenya Ltd:Vim","Vim Lavender Fresh 24x500g","Income","Vim Lavender Fresh 24x500g",,"Accounts Receivable","",293123.61,16225227.29
,"Invoice","08-08-2024","MC06012",,"Unilever Kenya Ltd:Vim","Vim Lavender Fresh 24x500g","Income","Vim Lavender Fresh 24x500g",,"Accounts Receivable","",129442.05,16354669.34
,"Invoice","15-08-2024","MC06041",,"Unilever Kenya Ltd:Vim","Vim Lavender Fresh 24x500g","Income","Vim Lavender Fresh 24x500g",,"Accounts Receivable","",339054.66,16693724.00
,"Invoice","20-08-2024","MC06052",,"Unilever Kenya Ltd:Vim","Vim Lavender Fresh 24x500g","Income","Vim Lavender Fresh 24x500g",,"Accounts Receivable","",578731.23,17272455.23
,"Invoice","26-08-2024","MC06085",,"Unilever Kenya Ltd:Vim","Vim Lavender Fresh 24x500g","Income","Vim Lavender Fresh 24x500g",,"Accounts Receivable","",160341.12,17432796.35
,"Invoice","27-08-2024","MC06091",,"Unilever Kenya Ltd:Vim","Vim Lavender Fresh 24x500g","Income","Vim Lavender Fresh 24x500g",,"Accounts Receivable","",200426.40,17633222.75
,"Invoice","29-08-2024","MC06095",,"Unilever Kenya Ltd:Vim","Vim Lavender Fresh 24x500g","Income","Vim Lavender Fresh 24x500g",,"Accounts Receivable","",160341.12,17793563.87
,"Invoice","04-09-2024","MC06114",,"Unilever Kenya Ltd:Vim","Vim Lavender Fresh 24x500g","Income","Vim Lavender Fresh 24x500g",,"Accounts Receivable","",160341.12,17953904.99
,"Invoice","11-09-2024","MC06139",,"Unilever Kenya Ltd:Vim","Vim Lavender Fresh 24x500g","Income","Vim Lavender Fresh 24x500g",,"Accounts Receivable","",320682.24,18274587.23
,"Invoice","16-09-2024","MC06155",,"Unilever Kenya Ltd:Vim","Vim Lavender Fresh 24x500g","Income","Vim Lavender Fresh 24x500g",,"Accounts Receivable","",360767.52,18635354.75
,"Credit Note","17-09-2024","CN01068",,"Unilever Kenya Ltd:Vim","Vim Lavender Fresh 24x500g","Income","Vim Lavender Fresh 24x500g",,"Accounts Receivable",360767.52,"",18274587.23
,"Invoice","17-09-2024","MC06156",,"Unilever Kenya Ltd:Vim","Vim Lavender Fresh 24x500g","Income","Vim Lavender Fresh 24x500g",,"Accounts Receivable","",327363.12,18601950.35
,"Invoice","17-09-2024","MC06159",,"Unilever Kenya Ltd:Vim","Vim Lavender Fresh 24x500g","Income","Vim Lavender Fresh 24x500g",,"Accounts Receivable","",200426.40,18802376.75
,"Invoice","20-09-2024","MC06174",,"Unilever Kenya Ltd:Vim","Vim Lavender Fresh 24x500g","Income","Vim Lavender Fresh 24x500g",,"Accounts Receivable","",240511.68,19042888.43
,"Invoice","23-09-2024","MC06185",,"Unilever Kenya Ltd:Vim","Vim Lavender Fresh 24x500g","Income","Vim Lavender Fresh 24x500g",,"Accounts Receivable","",364943.07,19407831.50
,"Invoice","27-09-2024","MC06213",,"Unilever Kenya Ltd:Vim","Vim Lavender Fresh 24x500g","Income","Vim Lavender Fresh 24x500g",,"Accounts Receivable","",200426.40,19608257.90
,"Invoice","03-10-2024","MC06227",,"Unilever Kenya Ltd:Vim","Vim Lavender Fresh 24x500g","Income","Vim Lavender Fresh 24x500g",,"Accounts Receivable","",134880.90,19743138.80
,"Invoice","03-10-2024","MC06232",,"Unilever Kenya Ltd:Vim","Vim Lavender Fresh 24x500g","Income","Vim Lavender Fresh 24x500g",,"Accounts Receivable","",156952.32,19900091.12
,"Invoice","09-10-2024","MC06244",,"Unilever Kenya Ltd:Vim","Vim Lavender Fresh 24x500g","Income","Vim Lavender Fresh 24x500g",,"Accounts Receivable","",416087.14,20316178.26
,"Invoice","14-10-2024","MC06254",,"Unilever Kenya Ltd:Vim","Vim Lavender Fresh 24x500g","Income","Vim Lavender Fresh 24x500g",,"Accounts Receivable","",235428.48,20551606.74
,"Invoice","14-10-2024","MC06259",,"Unilever Kenya Ltd:Vim","Vim Lavender Fresh 24x500g","Income","Vim Lavender Fresh 24x500g",,"Accounts Receivable","",549333.12,21100939.86
,"Invoice","15-10-2024","MC06261",,"Unilever Kenya Ltd:Vim","Vim Lavender Fresh 24x500g","Income","Vim Lavender Fresh 24x500g",,"Accounts Receivable","",166761.84,21267701.70
,"Invoice","17-10-2024","MC06275",,"Unilever Kenya Ltd:Vim","Vim Lavender Fresh 24x500g","Income","Vim Lavender Fresh 24x500g",,"Accounts Receivable","",353142.72,21620844.42
,"Invoice","18-10-2024","MC06278",,"Unilever Kenya Ltd:Vim","Vim Lavender Fresh 24x500g","Income","Vim Lavender Fresh 24x500g",,"Accounts Receivable","",272214.18,21893058.60
,"Invoice","25-10-2024","MC06296",,"Unilever Kenya Ltd:Vim","Vim Lavender Fresh 24x500g","Income","Vim Lavender Fresh 24x500g",,"Accounts Receivable","",73571.40,21966630.00
,"Invoice","25-10-2024","MC06304",,"Unilever Kenya Ltd:Vim","Vim Lavender Fresh 24x500g","Income","Vim Lavender Fresh 24x500g",,"Accounts Receivable","",594293.42,22560923.42
,"Invoice","29-10-2024","MC06315",,"Unilever Kenya Ltd:Vim","Vim Lavender Fresh 24x500g","Income","Vim Lavender Fresh 24x500g",,"Accounts Receivable","",102182.50,22663105.92
,"Invoice","04-11-2024","MC06328",,"Unilever Kenya Ltd:Vim","Vim Lavender Fresh 24x500g","Income","Vim Lavender Fresh 24x500g",,"Accounts Receivable","",667047.36,23330153.28
,"Invoice","07-11-2024","MC06341",,"Unilever Kenya Ltd:Vim","Vim Lavender Fresh 24x500g","Income","Vim Lavender Fresh 24x500g",,"Accounts Receivable","",29428.56,23359581.84
,"Invoice","15-11-2024","MC06365",,"Unilever Kenya Ltd:Vim","Vim Lavender Fresh 24x500g","Income","Vim Lavender Fresh 24x500g",,"Accounts Receivable","",779039.38,24138621.22
,"Invoice","21-11-2024","MC06395",,"Unilever Kenya Ltd:Vim","Vim Lavender Fresh 24x500g","Income","Vim Lavender Fresh 24x500g",,"Accounts Receivable","",431618.88,24570240.10
,"Invoice","22-11-2024","MC06403",,"Unilever Kenya Ltd:Vim","Vim Lavender Fresh 24x500g","Income","Vim Lavender Fresh 24x500g",,"Accounts Receivable","",235428.48,24805668.58
,"Invoice","23-11-2024","MC06407",,"Unilever Kenya Ltd:Vim","Vim Lavender Fresh 24x500g","Income","Vim Lavender Fresh 24x500g",,"Accounts Receivable","",58039.66,24863708.24
,"Invoice","30-11-2024","MC06429",,"Unilever Kenya Ltd:Vim","Vim Lavender Fresh 24x500g","Income","Vim Lavender Fresh 24x500g",,"Accounts Receivable","",392380.80,25256089.04
,"Invoice","02-12-2024","MC06431",,"Unilever Kenya Ltd:Vim","Vim Lavender Fresh 24x500g","Income","Vim Lavender Fresh 24x500g",,"Accounts Receivable","",353142.72,25609231.76
,"Invoice","11-12-2024","MC06461",,"Unilever Kenya Ltd:Vim","Vim Lavender Fresh 24x500g","Income","Vim Lavender Fresh 24x500g",,"Accounts Receivable","",470856.96,26080088.72
,"Invoice","16-12-2024","MC06471",,"Unilever Kenya Ltd:Vim","Vim Lavender Fresh 24x500g","Income","Vim Lavender Fresh 24x500g",,"Accounts Receivable","",376031.60,26456120.32
,"Invoice","18-12-2024","MC06487",,"Unilever Kenya Ltd:Vim","Vim Lavender Fresh 24x500g","Income","Vim Lavender Fresh 24x500g",,"Accounts Receivable","",152047.56,26608167.88
,"Invoice","20-12-2024","MC06494",,"Unilever Kenya Ltd:Vim","Vim Lavender Fresh 24x500g","Income","Vim Lavender Fresh 24x500g",,"Accounts Receivable","",245238.00,26853405.88
,"Invoice","23-12-2024","MC06503",,"Unilever Kenya Ltd:Vim","Vim Lavender Fresh 24x500g","Income","Vim Lavender Fresh 24x500g",,"Accounts Receivable","",751245.74,27604651.62
"Total Vim Lavender Fresh 24x500g",,,,,,,,,,,963691.34,28568342.96,27604651.62
"Total Vim Lavender",,,,,,,,,,,1015387.04,63292273.65,62276886.61
"Vim Lemon",,,,,,,,,,,,,""
"Vim Pwd Lemon Fresh SA 24X500G",,,,,,,,,,,,,""
,"Invoice","29-02-2024","MC05457",,"Unilever Kenya Ltd:Vim SA","Vim Powder Lemon Fresh SA 24X500G","Income","Vim Pwd Lemon Fresh SA 24X500G",,"Accounts Receivable","",1607202.00,1607202.00
,"Invoice","25-03-2024","MC05528",,"Unilever Kenya Ltd:Vim SA","Vim Powder Lemon Fresh SA 24X500G","Income","Vim Pwd Lemon Fresh SA 24X500G",,"Accounts Receivable","",1607202.00,3214404.00
,"Invoice","28-03-2024","MC05546",,"Unilever Kenya Ltd:Vim SA","Vim Powder Lemon Fresh SA 24X500G","Income","Vim Pwd Lemon Fresh SA 24X500G",,"Accounts Receivable","",634944.00,3849348.00
,"Invoice","22-05-2024","MC05729",,"Unilever Kenya Ltd:Vim SA","Vim Powder Lemon Fresh SA 24X500G","Income","Vim Pwd Lemon Fresh SA 24X500G",,"Accounts Receivable","",1615686.75,5465034.75
,"Invoice","29-05-2024","MC05770",,"Unilever Kenya Ltd:Vim SA","Vim Powder Lemon Fresh SA 24X500G","Income","Vim Pwd Lemon Fresh SA 24X500G",,"Accounts Receivable","",502658.10,5967692.85
,"Invoice","19-06-2024","MC05840",,"Unilever Kenya Ltd:Vim SA","Vim Powder Lemon Fresh SA 24X500G","Income","Vim Pwd Lemon Fresh SA 24X500G",,"Accounts Receivable","",797870.00,6765562.85
,"Invoice","26-06-2024","MC05868",,"Unilever Kenya Ltd:Vim SA","Vim Powder Lemon Fresh SA 24X500G","Income","Vim Pwd Lemon Fresh SA 24X500G",,"Accounts Receivable","",502658.10,7268220.95
,"Invoice","25-07-2024","MC05968",,"Unilever Kenya Ltd:Vim SA","Vim Powder Lemon Fresh SA 24X500G","Income","Vim Pwd Lemon Fresh SA 24X500G",,"Accounts Receivable","",1598409.60,8866630.55
,"Invoice","27-07-2024","MC05977",,"Unilever Kenya Ltd:Vim SA","Vim Powder Lemon Fresh SA 24X500G","Income","Vim Pwd Lemon Fresh SA 24X500G",,"Accounts Receivable","",545798.40,9412428.95
,"Invoice","27-07-2024","MC05979",,"Unilever Kenya Ltd:Vim SA","Vim Powder Lemon Fresh SA 24X500G","Income","Vim Pwd Lemon Fresh SA 24X500G",,"Accounts Receivable","",857683.20,10270112.15
,"Invoice","27-07-2024","MC05981",,"Unilever Kenya Ltd:Vim SA","Vim Powder Lemon Fresh SA 24X500G","Income","Vim Pwd Lemon Fresh SA 24X500G",,"Accounts Receivable","",121830.00,10391942.15
,"Invoice","16-08-2024","MC06046",,"Unilever Kenya Ltd:Vim SA","Vim Powder Lemon Fresh SA 24X500G","Income","Vim Pwd Lemon Fresh SA 24X500G",,"Accounts Receivable","",882049.20,11273991.35
,"Invoice","29-08-2024","MC06097",,"Unilever Kenya Ltd:Vim SA","Vim Powder Lemon Fresh SA 24X500G","Income","Vim Pwd Lemon Fresh SA 24X500G",,"Accounts Receivable","",365490.00,11639481.35
,"Invoice","23-09-2024","MC06188",,"Unilever Kenya Ltd:Vim SA","Vim Powder Lemon Fresh SA 24X500G","Income","Vim Pwd Lemon Fresh SA 24X500G",,"Accounts Receivable","",568540.00,12208021.35
,"Invoice","18-11-2024","MC06373",,"Unilever Kenya Ltd:Vim SA","Vim Powder Lemon Fresh SA 24X500G","Income","Vim Pwd Lemon Fresh SA 24X500G",,"Accounts Receivable","",1552317.30,13760338.65
,"Invoice","19-11-2024","MC06381",,"Unilever Kenya Ltd:Vim SA","Vim Powder Lemon Fresh SA 24X500G","Income","Vim Pwd Lemon Fresh SA 24X500G",,"Accounts Receivable","",233418.90,13993757.55
"Total Vim Pwd Lemon Fresh SA 24X500G",,,,,,,,,,,0.00,13993757.55,13993757.55
"Vim Lemon Fresh 24x500g",,,,,,,,,,,,,""
,"Invoice","04-01-2024","MC05270",,"Unilever Kenya Ltd:Vim","Vim Lemon Fresh 24x500g","Income","Vim Lemon Fresh 24x500g",,"Accounts Receivable","",717638.40,717638.40
,"Invoice","05-01-2024","MC05273",,"Unilever Kenya Ltd:Vim","Vim Lemon Fresh 24x500g","Income","Vim Lemon Fresh 24x500g",,"Accounts Receivable","",567299.80,1284938.20
,"Invoice","08-01-2024","MC05277",,"Unilever Kenya Ltd:Vim","Vim Lemon Fresh 24x500g","Income","Vim Lemon Fresh 24x500g",,"Accounts Receivable","",717638.40,2002576.60
,"Invoice","08-01-2024","MC05279",,"Unilever Kenya Ltd:Vim","Vim Lemon Fresh 24x500g","Income","Vim Lemon Fresh 24x500g",,"Accounts Receivable","",159475.20,2162051.80
,"Invoice","10-01-2024","MC05287",,"Unilever Kenya Ltd:Vim","Vim Lemon Fresh 24x500g","Income","Vim Lemon Fresh 24x500g",,"Accounts Receivable","",211803.00,2373854.80
,"Invoice","11-01-2024","MC05296",,"Unilever Kenya Ltd:Vim","Vim Lemon Fresh 24x500g","Income","Vim Lemon Fresh 24x500g",,"Accounts Receivable","",438556.80,2812411.60
,"Invoice","12-01-2024","MC05297",,"Unilever Kenya Ltd:Vim","Vim Lemon Fresh 24x500g","Income","Vim Lemon Fresh 24x500g",,"Accounts Receivable","",774949.80,3587361.40
,"Invoice","15-01-2024","MC05316",,"Unilever Kenya Ltd:Vim","Vim Lemon Fresh 24x500g","Income","Vim Lemon Fresh 24x500g",,"Accounts Receivable","",598032.00,4185393.40
,"Invoice","16-01-2024","MC05325",,"Unilever Kenya Ltd:Vim","Vim Lemon Fresh 24x500g","Income","Vim Lemon Fresh 24x500g",,"Accounts Receivable","",318950.40,4504343.80
,"Invoice","17-01-2024","MC05329",,"Unilever Kenya Ltd:Vim","Vim Lemon Fresh 24x500g","Income","Vim Lemon Fresh 24x500g",,"Accounts Receivable","",338054.20,4842398.00
,"Invoice","22-01-2024","MC05338",,"Unilever Kenya Ltd:Vim","Vim Lemon Fresh 24x500g","Income","Vim Lemon Fresh 24x500g",,"Accounts Receivable","",209311.20,5051709.20
,"Invoice","25-01-2024","MC05349",,"Unilever Kenya Ltd:Vim","Vim Lemon Fresh 24x500g","Income","Vim Lemon Fresh 24x500g",,"Accounts Receivable","",770796.80,5822506.00
,"Invoice","26-01-2024","MC05359",,"Unilever Kenya Ltd:Vim","Vim Lemon Fresh 24x500g","Income","Vim Lemon Fresh 24x500g",,"Accounts Receivable","",199344.00,6021850.00
,"Invoice","26-01-2024","MC05362",,"Unilever Kenya Ltd:Vim","Vim Lemon Fresh 24x500g","Income","Vim Lemon Fresh 24x500g",,"Accounts Receivable","",830600.00,6852450.00
,"Invoice","30-01-2024","MC05372",,"Unilever Kenya Ltd:Vim","Vim Lemon Fresh 24x500g","Income","Vim Lemon Fresh 24x500g",,"Accounts Receivable","",1245900.00,8098350.00
,"Invoice","01-02-2024","MC05374",,"Unilever Kenya Ltd:Vim","Vim Lemon Fresh 24x500g","Income","Vim Lemon Fresh 24x500g",,"Accounts Receivable","",279081.60,8377431.60
,"Invoice","01-02-2024","MC05377",,"Unilever Kenya Ltd","-MULTIPLE-","Income","Vim Lemon Fresh 24x500g",,"Accounts Receivable","",2292.63,8379724.23
,"Invoice","02-02-2024","MC05380",,"Unilever Kenya Ltd:Vim","Vim Lemon Fresh 24x500g","Income","Vim Lemon Fresh 24x500g",,"Accounts Receivable","",373770.00,8753494.23
,"Invoice","05-02-2024","MC05386",,"Unilever Kenya Ltd:Vim","Vim Lemon Fresh 24x500g","Income","Vim Lemon Fresh 24x500g",,"Accounts Receivable","",1495080.00,10248574.23
,"Invoice","07-02-2024","MC05392",,"Unilever Kenya Ltd:Vim","Vim Lemon Fresh 24x500g","Income","Vim Lemon Fresh 24x500g",,"Accounts Receivable","",398688.00,10647262.23
,"Invoice","13-02-2024","MC05401",,"Unilever Kenya Ltd:Vim","Vim Lemon Fresh 24x500g","Income","Vim Lemon Fresh 24x500g",,"Accounts Receivable","",625441.80,11272704.03
,"Invoice","15-02-2024","MC05408",,"Unilever Kenya Ltd:Vim","Vim Lemon Fresh 24x500g","Income","Vim Lemon Fresh 24x500g",,"Accounts Receivable","",1661200.00,12933904.03
,"Invoice","21-02-2024","MC05414",,"Unilever Kenya Ltd:Vim","Vim Lemon Fresh 24x500g","Income","Vim Lemon Fresh 24x500g",,"Accounts Receivable","",598032.00,13531936.03
,"Invoice","22-02-2024","MC05426",,"Unilever Kenya Ltd:Vim","Vim Lemon Fresh 24x500g","Income","Vim Lemon Fresh 24x500g",,"Accounts Receivable","",1245900.00,14777836.03
,"Invoice","22-02-2024","MC05430",,"Unilever Kenya Ltd:Vim","Vim Lemon Fresh 24x500g","Income","Vim Lemon Fresh 24x500g",,"Accounts Receivable","",154491.60,14932327.63
,"Invoice","27-02-2024","MC05447",,"Unilever Kenya Ltd:Vim","Vim Lemon Fresh 24x500g","Income","Vim Lemon Fresh 24x500g",,"Accounts Receivable","",677769.60,15610097.23
,"Invoice","29-02-2024","MC05458",,"Unilever Kenya Ltd:Vim","Vim Lemon Fresh 24x500g","Income","Vim Lemon Fresh 24x500g",,"Accounts Receivable","",830600.00,16440697.23
,"Invoice","05-03-2024","MC05464",,"Unilever Kenya Ltd:Vim","Vim Lemon Fresh 24x500g","Income","Vim Lemon Fresh 24x500g",,"Accounts Receivable","",763321.40,17204018.63
,"Invoice","06-03-2024","MC05472",,"Unilever Kenya Ltd:Vim","Vim Lemon Fresh 24x500g","Income","Vim Lemon Fresh 24x500g",,"Accounts Receivable","",733419.80,17937438.43
,"Invoice","07-03-2024","MC05474",,"Unilever Kenya Ltd:Vim","Vim Lemon Fresh 24x500g","Income","Vim Lemon Fresh 24x500g",,"Accounts Receivable","",455999.40,18393437.83
,"Invoice","08-03-2024","MC05478",,"Unilever Kenya Ltd:Vim","Vim Lemon Fresh 24x500g","Income","Vim Lemon Fresh 24x500g",,"Accounts Receivable","",119606.40,18513044.23
,"Invoice","11-03-2024","MC05485",,"Unilever Kenya Ltd:Vim","Vim Lemon Fresh 24x500g","Income","Vim Lemon Fresh 24x500g",,"Accounts Receivable","",1287430.00,19800474.23
,"Invoice","19-03-2024","MC05498",,"Unilever Kenya Ltd:Vim","Vim Lemon Fresh 24x500g","Income","Vim Lemon Fresh 24x500g",,"Accounts Receivable","",786578.20,20587052.43
,"Invoice","19-03-2024","MC05500",,"Unilever Kenya Ltd:Vim","Vim Lemon Fresh 24x500g","Income","Vim Lemon Fresh 24x500g",,"Accounts Receivable","",782425.20,21369477.63
,"Invoice","20-03-2024","MC05505",,"Unilever Kenya Ltd:Vim","Vim Lemon Fresh 24x500g","Income","Vim Lemon Fresh 24x500g",,"Accounts Receivable","",671124.80,22040602.43
,"Invoice","22-03-2024","MC05510",,"Unilever Kenya Ltd:Vim","Vim Lemon Fresh 24x500g","Income","Vim Lemon Fresh 24x500g",,"Accounts Receivable","",119606.40,22160208.83
,"Invoice","22-03-2024","MC05515",,"Unilever Kenya Ltd:Vim","Vim Lemon Fresh 24x500g","Income","Vim Lemon Fresh 24x500g",,"Accounts Receivable","",581420.00,22741628.83
,"Invoice","23-03-2024","MC05519",,"Unilever Kenya Ltd:Vim","Vim Lemon Fresh 24x500g","Income","Vim Lemon Fresh 24x500g",,"Accounts Receivable","",103825.00,22845453.83
,"Invoice","28-03-2024","MC05544",,"Unilever Kenya Ltd:Vim","Vim Lemon Fresh 24x500g","Income","Vim Lemon Fresh 24x500g",,"Accounts Receivable","",618797.00,23464250.83
,"Invoice","28-03-2024","MC05548",,"Unilever Kenya Ltd:Vim","Vim Lemon Fresh 24x500g","Income","Vim Lemon Fresh 24x500g",,"Accounts Receivable","",677769.60,24142020.43
,"Invoice","02-04-2024","MC05551",,"Unilever Kenya Ltd:Vim","Vim Lemon Fresh 24x500g","Income","Vim Lemon Fresh 24x500g",,"Accounts Receivable","",478425.60,24620446.03
,"Invoice","03-04-2024","MC05558",,"Unilever Kenya Ltd:Vim","Vim Lemon Fresh 24x500g","Income","Vim Lemon Fresh 24x500g",,"Accounts Receivable","",575163.42,25195609.45
,"Invoice","04-04-2024","MC05562",,"Unilever Kenya Ltd:Vim","Vim Lemon Fresh 24x500g","Income","Vim Lemon Fresh 24x500g",,"Accounts Receivable","",343094.58,25538704.03
,"Invoice","04-04-2024","MC05568",,"Unilever Kenya Ltd:Vim","Vim Lemon Fresh 24x500g","Income","Vim Lemon Fresh 24x500g",,"Accounts Receivable","",480833.28,26019537.31
,"Invoice","05-04-2024","MC05571",,"Unilever Kenya Ltd:Vim","Vim Lemon Fresh 24x500g","Income","Vim Lemon Fresh 24x500g",,"Accounts Receivable","",37565.10,26057102.41
,"Invoice","09-04-2024","MC05579",,"Unilever Kenya Ltd:Vim","Vim Lemon Fresh 24x500g","Income","Vim Lemon Fresh 24x500g",,"Accounts Receivable","",345598.92,26402701.33
,"Invoice","09-04-2024","MC05583",,"Unilever Kenya Ltd","Outer Vim Lemon Fresh 500g","Income","Vim Lemon Fresh 24x500g",,"Accounts Receivable","",5908.50,26408609.83
,"Invoice","15-04-2024","MC05600",,"Unilever Kenya Ltd:Vim","Vim Lemon Fresh 24x500g","Income","Vim Lemon Fresh 24x500g",,"Accounts Receivable","",761319.36,27169929.19
,"Invoice","17-04-2024","MC05604",,"Unilever Kenya Ltd:Vim","Vim Lemon Fresh 24x500g","Income","Vim Lemon Fresh 24x500g",,"Accounts Receivable","",748797.66,27918726.85
,"Invoice","18-04-2024","MC05605",,"Unilever Kenya Ltd:Vim","Vim Lemon Fresh 24x500g","Income","Vim Lemon Fresh 24x500g",,"Accounts Receivable","",280486.08,28199212.93
,"Invoice","18-04-2024","MC05608",,"Unilever Kenya Ltd:Vim","Vim Lemon Fresh 24x500g","Income","Vim Lemon Fresh 24x500g",,"Accounts Receivable","",520902.72,28720115.65
,"Invoice","23-04-2024","MC05629",,"Unilever Kenya Ltd:Vim","Vim Lemon Fresh 24x500g","Income","Vim Lemon Fresh 24x500g",,"Accounts Receivable","",774675.84,29494791.49
,"Invoice","24-04-2024","MC05632",,"Unilever Kenya Ltd:Vim","Vim Lemon Fresh 24x500g","Income","Vim Lemon Fresh 24x500g",,"Accounts Receivable","",400694.40,29895485.89
,"Invoice","26-04-2024","MC05639",,"Unilever Kenya Ltd:Vim","Vim Lemon Fresh 24x500g","Income","Vim Lemon Fresh 24x500g",,"Accounts Receivable","",216208.02,30111693.91
,"Invoice","26-04-2024","MC05642",,"Unilever Kenya Ltd:Vim","Vim Lemon Fresh 24x500g","Income","Vim Lemon Fresh 24x500g",,"Accounts Receivable","",554293.92,30665987.83
,"Invoice","29-04-2024","MC05646",,"Unilever Kenya Ltd:Vim","Vim Lemon Fresh 24x500g","Income","Vim Lemon Fresh 24x500g",,"Accounts Receivable","",160277.76,30826265.59
,"Invoice","03-05-2024","MC05658",,"Unilever Kenya Ltd:Vim","Vim Lemon Fresh 24x500g","Income","Vim Lemon Fresh 24x500g",,"Accounts Receivable","",200347.20,31026612.79
,"Invoice","03-05-2024","MC05661",,"Unilever Kenya Ltd:Vim","Vim Lemon Fresh 24x500g","Income","Vim Lemon Fresh 24x500g",,"Accounts Receivable","",120208.32,31146821.11
,"Invoice","03-05-2024","MC05664",,"Unilever Kenya Ltd:Vim","Vim Lemon Fresh 24x500g","Income","Vim Lemon Fresh 24x500g",,"Accounts Receivable","",318051.18,31464872.29
,"Invoice","03-05-2024","MC05666",,"Unilever Kenya Ltd:Vim","Vim Lemon Fresh 24x500g","Income","Vim Lemon Fresh 24x500g",,"Accounts Receivable","",440763.84,31905636.13
,"Invoice","08-05-2024","MC05677",,"Unilever Kenya Ltd:Vim","Vim Lemon Fresh 24x500g","Income","Vim Lemon Fresh 24x500g",,"Accounts Receivable","",529250.52,32434886.65
,"Invoice","09-05-2024","MC05685",,"Unilever Kenya Ltd:Vim","Vim Lemon Fresh 24x500g","Income","Vim Lemon Fresh 24x500g",,"Accounts Receivable","",80138.88,32515025.53
,"Credit Note","09-05-2024","CN01060",,"Unilever Kenya Ltd:Vim","Vim Lemon Fresh 24x500g","Income","Vim Lemon Fresh 24x500g",,"Accounts Receivable",13356.48,"",32501669.05
,"Invoice","09-05-2024","MC05690",,"Unilever Kenya Ltd:Vim","Vim Lemon Fresh 24x500g","Income","Vim Lemon Fresh 24x500g",,"Accounts Receivable","",408207.42,32909876.47
,"Invoice","14-05-2024","MC05697",,"Unilever Kenya Ltd:Vim","Vim Lemon Fresh 24x500g","Income","Vim Lemon Fresh 24x500g",,"Accounts Receivable","",664484.88,33574361.35
,"Invoice","15-05-2024","MC05707",,"Unilever Kenya Ltd:Vim","Vim Lemon Fresh 24x500g","Income","Vim Lemon Fresh 24x500g",,"Accounts Receivable","",368972.76,33943334.11
,"Invoice","20-05-2024","MC05720",,"Unilever Kenya Ltd:Vim","Vim Lemon Fresh 24x500g","Income","Vim Lemon Fresh 24x500g",,"Accounts Receivable","",601041.60,34544375.71
,"Invoice","21-05-2024","MC05724",,"Unilever Kenya Ltd:Vim","Vim Lemon Fresh 24x500g","Income","Vim Lemon Fresh 24x500g",,"Accounts Receivable","",476659.38,35021035.09
,"Invoice","21-05-2024","MC05727",,"Unilever Kenya Ltd:Vim","Vim Lemon Fresh 24x500g","Income","Vim Lemon Fresh 24x500g",,"Accounts Receivable","",761319.36,35782354.45
,"Invoice","23-05-2024","MC05737",,"Unilever Kenya Ltd:Vim","Vim Lemon Fresh 24x500g","Income","Vim Lemon Fresh 24x500g",,"Accounts Receivable","",1586082.00,37368436.45
,"Invoice","24-05-2024","MC05740",,"Unilever Kenya Ltd:Vim","Vim Lemon Fresh 24x500g","Income","Vim Lemon Fresh 24x500g",,"Accounts Receivable","",314712.06,37683148.51
,"Invoice","24-05-2024","MC05751",,"Unilever Kenya Ltd:Vim","Vim Lemon Fresh 24x500g","Income","Vim Lemon Fresh 24x500g",,"Accounts Receivable","",360624.96,38043773.47
,"Invoice","28-05-2024","MC05759",,"Unilever Kenya Ltd:Vim","Vim Lemon Fresh 24x500g","Income","Vim Lemon Fresh 24x500g",,"Accounts Receivable","",360624.96,38404398.43
,"Invoice","29-05-2024","MC05766",,"Unilever Kenya Ltd:Vim","Vim Lemon Fresh 24x500g","Income","Vim Lemon Fresh 24x500g",,"Accounts Receivable","",120208.32,38524606.75
,"Invoice","30-05-2024","MC05781",,"Unilever Kenya Ltd:Vim","Vim Lemon Fresh 24x500g","Income","Vim Lemon Fresh 24x500g",,"Accounts Receivable","",480833.28,39005440.03
,"Invoice","31-05-2024","MC05783",,"Unilever Kenya Ltd:Vim","Vim Lemon Fresh 24x500g","Income","Vim Lemon Fresh 24x500g",,"Accounts Receivable","",669493.56,39674933.59
,"Invoice","04-06-2024","MC05786",,"Unilever Kenya Ltd:Vim","Vim Lemon Fresh 24x500g","Income","Vim Lemon Fresh 24x500g",,"Accounts Receivable","",505041.90,40179975.49
,"Invoice","06-06-2024","MC05791",,"Unilever Kenya Ltd:Vim","Vim Lemon Fresh 24x500g","Income","Vim Lemon Fresh 24x500g",,"Accounts Receivable","",120208.32,40300183.81
,"Invoice","07-06-2024","MC05798",,"Unilever Kenya Ltd:Vim","Vim Lemon Fresh 24x500g","Income","Vim Lemon Fresh 24x500g",,"Accounts Receivable","",40069.44,40340253.25
,"Invoice","10-06-2024","MC05806",,"Unilever Kenya Ltd:Vim","Vim Lemon Fresh 24x500g","Income","Vim Lemon Fresh 24x500g",,"Accounts Receivable","",328903.32,40669156.57
,"Invoice","11-06-2024","MC05811",,"Unilever Kenya Ltd:Vim","Vim Lemon Fresh 24x500g","Income","Vim Lemon Fresh 24x500g",,"Accounts Receivable","",601041.60,41270198.17
,"Invoice","12-06-2024","MC05816",,"Unilever Kenya Ltd:Vim","Vim Lemon Fresh 24x500g","Income","Vim Lemon Fresh 24x500g",,"Accounts Receivable","",400694.40,41670892.57
,"Invoice","13-06-2024","MC05821",,"Unilever Kenya Ltd:Vim","Vim Lemon Fresh 24x500g","Income","Vim Lemon Fresh 24x500g",,"Accounts Receivable","",667824.00,42338716.57
,"Invoice","13-06-2024","MC05822",,"Unilever Kenya Ltd:Vim","Vim Lemon Fresh 24x500g","Income","Vim Lemon Fresh 24x500g",,"Accounts Receivable","",400694.40,42739410.97
,"Invoice","14-06-2024","MC05824",,"Unilever Kenya Ltd:Vim","Vim Lemon Fresh 24x500g","Income","Vim Lemon Fresh 24x500g",,"Accounts Receivable","",568485.18,43307896.15
,"Invoice","21-06-2024","MC05846",,"Unilever Kenya Ltd:Vim","Vim Lemon Fresh 24x500g","Income","Vim Lemon Fresh 24x500g",,"Accounts Receivable","",601041.60,43908937.75
,"Invoice","24-06-2024","MC05848",,"Unilever Kenya Ltd:Vim","Vim Lemon Fresh 24x500g","Income","Vim Lemon Fresh 24x500g",,"Accounts Receivable","",400694.40,44309632.15
,"Invoice","24-06-2024","MC05855",,"Unilever Kenya Ltd:Vim","Vim Lemon Fresh 24x500g","Income","Vim Lemon Fresh 24x500g",,"Accounts Receivable","",1377387.00,45687019.15
,"Invoice","24-06-2024","MC05857",,"Unilever Kenya Ltd:Vim","Vim Lemon Fresh 24x500g","Income","Vim Lemon Fresh 24x500g",,"Accounts Receivable","",95999.70,45783018.85
,"Invoice","26-06-2024","MC05867",,"Unilever Kenya Ltd:Vim","Vim Lemon Fresh 24x500g","Income","Vim Lemon Fresh 24x500g",,"Accounts Receivable","",417390.00,46200408.85
,"Invoice","28-06-2024","MC05870",,"Unilever Kenya Ltd:Vim","Vim Lemon Fresh 24x500g","Income","Vim Lemon Fresh 24x500g",,"Accounts Receivable","",788032.32,46988441.17
,"Invoice","28-06-2024","MC05871",,"Unilever Kenya Ltd:Vim","Vim Lemon Fresh 24x500g","Income","Vim Lemon Fresh 24x500g",,"Accounts Receivable","",80138.88,47068580.05
,"Invoice","03-07-2024","MC05879",,"Unilever Kenya Ltd:Vim","Vim Lemon Fresh 24x500g","Income","Vim Lemon Fresh 24x500g",,"Accounts Receivable","",601473.60,47670053.65
,"Invoice","05-07-2024","MC05897",,"Unilever Kenya Ltd:Vim","Vim Lemon Fresh 24x500g","Income","Vim Lemon Fresh 24x500g",,"Accounts Receivable","",626535.00,48296588.65
,"Invoice","08-07-2024","MC05899",,"Unilever Kenya Ltd:Vim","Vim Lemon Fresh 24x500g","Income","Vim Lemon Fresh 24x500g",,"Accounts Receivable","",240589.44,48537178.09
,"Invoice","09-07-2024","MC05903",,"Unilever Kenya Ltd:Vim","Vim Lemon Fresh 24x500g","Income","Vim Lemon Fresh 24x500g",,"Accounts Receivable","",521277.12,49058455.21
,"Invoice","12-07-2024","MC05914",,"Unilever Kenya Ltd:Vim","Vim Lemon Fresh 24x500g","Income","Vim Lemon Fresh 24x500g",,"Accounts Receivable","",200491.20,49258946.41
,"Invoice","12-07-2024","MC05920",,"Unilever Kenya Ltd","Outer Vim Lemon Fresh 500g","Income","Vim Lemon Fresh 24x500g",,"Accounts Receivable","",3939.00,49262885.41
,"Invoice","17-07-2024","MC05935",,"Unilever Kenya Ltd:Vim","Vim Lemon Fresh 24x500g","Income","Vim Lemon Fresh 24x500g",,"Accounts Receivable","",468648.18,49731533.59
,"Invoice","17-07-2024","MC05943",,"Unilever Kenya Ltd:Vim","Vim Lemon Fresh 24x500g","Income","Vim Lemon Fresh 24x500g",,"Accounts Receivable","",441080.64,50172614.23
,"Invoice","18-07-2024","MC05948",,"Unilever Kenya Ltd:Vim","Vim Lemon Fresh 24x500g","Income","Vim Lemon Fresh 24x500g",,"Accounts Receivable","",709237.62,50881851.85
,"Invoice","18-07-2024","MC05950",,"Unilever Kenya Ltd:Vim","Vim Lemon Fresh 24x500g","Income","Vim Lemon Fresh 24x500g",,"Accounts Receivable","",320785.92,51202637.77
,"Invoice","19-07-2024","MC05953",,"Unilever Kenya Ltd:Vim","Vim Lemon Fresh 24x500g","Income","Vim Lemon Fresh 24x500g",,"Accounts Receivable","",120294.72,51322932.49
,"Invoice","23-07-2024","MC05959",,"Unilever Kenya Ltd:Vim","Vim Lemon Fresh 24x500g","Income","Vim Lemon Fresh 24x500g",,"Accounts Receivable","",406830.06,51729762.55
,"Invoice","23-07-2024","MC05964",,"Unilever Kenya Ltd:Vim","Vim Lemon Fresh 24x500g","Income","Vim Lemon Fresh 24x500g",,"Accounts Receivable","",320785.92,52050548.47
,"Invoice","31-07-2024","MC05986",,"Unilever Kenya Ltd:Vim","Vim Lemon Fresh 24x500g","Income","Vim Lemon Fresh 24x500g",,"Accounts Receivable","",481178.88,52531727.35
,"Invoice","01-08-2024","MC05991",,"Unilever Kenya Ltd:Vim","Vim Lemon Fresh 24x500g","Income","Vim Lemon Fresh 24x500g",,"Accounts Receivable","",40098.24,52571825.59
,"Invoice","01-08-2024","MC05994",,"Unilever Kenya Ltd:Vim","Vim Lemon Fresh 24x500g","Income","Vim Lemon Fresh 24x500g",,"Accounts Receivable","",666633.24,53238458.83
,"Invoice","02-08-2024","MC05998",,"Unilever Kenya Ltd:Vim","Vim Lemon Fresh 24x500g","Income","Vim Lemon Fresh 24x500g",,"Accounts Receivable","",593119.80,53831578.63
,"Invoice","06-08-2024","MC06001",,"Unilever Kenya Ltd:Vim","Vim Lemon Fresh 24x500g","Income","Vim Lemon Fresh 24x500g",,"Accounts Receivable","",360884.16,54192462.79
,"Invoice","08-08-2024","MC06011",,"Unilever Kenya Ltd:Vim","Vim Lemon Fresh 24x500g","Income","Vim Lemon Fresh 24x500g",,"Accounts Receivable","",561375.36,54753838.15
,"Invoice","09-08-2024","MC06023",,"Unilever Kenya Ltd:Vim","Vim Lemon Fresh 24x500g","Income","Vim Lemon Fresh 24x500g",,"Accounts Receivable","",327468.96,55081307.11
,"Invoice","12-08-2024","MC06028",,"Unilever Kenya Ltd:Vim","Vim Lemon Fresh 24x500g","Income","Vim Lemon Fresh 24x500g",,"Accounts Receivable","",656608.68,55737915.79
,"Invoice","15-08-2024","MC06040",,"Unilever Kenya Ltd:Vim","Vim Lemon Fresh 24x500g","Income","Vim Lemon Fresh 24x500g",,"Accounts Receivable","",187960.50,55925876.29
,"Invoice","19-08-2024","MC06048",,"Unilever Kenya Ltd:Vim","Vim Lemon Fresh 24x500g","Income","Vim Lemon Fresh 24x500g",,"Accounts Receivable","",160392.96,56086269.25
,"Invoice","20-08-2024","MC06053",,"Unilever Kenya Ltd:Vim","Vim Lemon Fresh 24x500g","Income","Vim Lemon Fresh 24x500g",,"Accounts Receivable","",1587222.00,57673491.25
,"Invoice","21-08-2024","MC06055",,"Unilever Kenya Ltd:Vim","Vim Lemon Fresh 24x500g","Income","Vim Lemon Fresh 24x500g",,"Accounts Receivable","",160392.96,57833884.21
,"Invoice","23-08-2024","MC06072",,"Unilever Kenya Ltd:Vim","Vim Lemon Fresh 24x500g","Income","Vim Lemon Fresh 24x500g",,"Accounts Receivable","",601473.60,58435357.81
,"Invoice","23-08-2024","MC06074",,"Unilever Kenya Ltd:Vim","Vim Lemon Fresh 24x500g","Income","Vim Lemon Fresh 24x500g",,"Accounts Receivable","",835380.00,59270737.81
,"Invoice","23-08-2024","MC06075",,"Unilever Kenya Ltd:Vim","Vim Lemon Fresh 24x500g","Income","Vim Lemon Fresh 24x500g",,"Accounts Receivable","",568893.78,59839631.59
,"Invoice","26-08-2024","MC06077",,"Unilever Kenya Ltd:Vim","Vim Lemon Fresh 24x500g","Income","Vim Lemon Fresh 24x500g",,"Accounts Receivable","",160392.96,60000024.55
,"Invoice","26-08-2024","MC06083",,"Unilever Kenya Ltd:Vim","Vim Lemon Fresh 24x500g","Income","Vim Lemon Fresh 24x500g",,"Accounts Receivable","",213857.28,60213881.83
,"Invoice","27-08-2024","MC06088",,"Unilever Kenya Ltd:Vim","Vim Lemon Fresh 24x500g","Income","Vim Lemon Fresh 24x500g",,"Accounts Receivable","",160392.96,60374274.79
,"Invoice","28-08-2024","MC06093",,"Unilever Kenya Ltd:Vim","Vim Lemon Fresh 24x500g","Income","Vim Lemon Fresh 24x500g",,"Accounts Receivable","",1587222.00,61961496.79
,"Invoice","29-08-2024","MC06094",,"Unilever Kenya Ltd:Vim","Vim Lemon Fresh 24x500g","Income","Vim Lemon Fresh 24x500g",,"Accounts Receivable","",464471.28,62425968.07
,"Invoice","29-08-2024","MC06099",,"Unilever Kenya Ltd:Vim","Vim Lemon Fresh 24x500g","Income","Vim Lemon Fresh 24x500g",,"Accounts Receivable","",601473.60,63027441.67
,"Invoice","04-09-2024","MC06117",,"Unilever Kenya Ltd:Vim","Vim Lemon Fresh 24x500g","Income","Vim Lemon Fresh 24x500g",,"Accounts Receivable","",83538.00,63110979.67
,"Invoice","05-09-2024","MC06124",,"Unilever Kenya Ltd:Vim","Vim Lemon Fresh 24x500g","Income","Vim Lemon Fresh 24x500g",,"Accounts Receivable","",1002456.00,64113435.67
,"Invoice","09-09-2024","MC06130",,"Unilever Kenya Ltd:Vim","Vim Lemon Fresh 24x500g","Income","Vim Lemon Fresh 24x500g",,"Accounts Receivable","",1253070.00,65366505.67
,"Invoice","12-09-2024","MC06148",,"Unilever Kenya Ltd:Vim","Vim Lemon Fresh 24x500g","Income","Vim Lemon Fresh 24x500g",,"Accounts Receivable","",801964.80,66168470.47
,"Invoice","16-09-2024","MC06154",,"Unilever Kenya Ltd:Vim","Vim Lemon Fresh 24x500g","Income","Vim Lemon Fresh 24x500g",,"Accounts Receivable","",411842.34,66580312.81
,"Invoice","17-09-2024","MC06157",,"Unilever Kenya Ltd:Vim","Vim Lemon Fresh 24x500g","Income","Vim Lemon Fresh 24x500g",,"Accounts Receivable","",400982.40,66981295.21
,"Invoice","20-09-2024","MC06173",,"Unilever Kenya Ltd:Vim","Vim Lemon Fresh 24x500g","Income","Vim Lemon Fresh 24x500g",,"Accounts Receivable","",376756.38,67358051.59
,"Invoice","21-09-2024","MC06180",,"Unilever Kenya Ltd:Vim","Vim Lemon Fresh 24x500g","Income","Vim Lemon Fresh 24x500g",,"Accounts Receivable","",481178.88,67839230.47
,"Invoice","23-09-2024","MC06182",,"Unilever Kenya Ltd:Vim","Vim Lemon Fresh 24x500g","Income","Vim Lemon Fresh 24x500g",,"Accounts Receivable","",400982.40,68240212.87
,"Invoice","23-09-2024","MC06184",,"Unilever Kenya Ltd:Vim","Vim Lemon Fresh 24x500g","Income","Vim Lemon Fresh 24x500g",,"Accounts Receivable","",120294.72,68360507.59
,"Invoice","25-09-2024","MC06200",,"Unilever Kenya Ltd:Vim","Vim Lemon Fresh 24x500g","Income","Vim Lemon Fresh 24x500g",,"Accounts Receivable","",578082.96,68938590.55
,"Invoice","26-09-2024","MC06203",,"Unilever Kenya Ltd:Vim","Vim Lemon Fresh 24x500g","Income","Vim Lemon Fresh 24x500g",,"Accounts Receivable","",705060.72,69643651.27
,"Invoice","27-09-2024","MC06212",,"Unilever Kenya Ltd:Vim","Vim Lemon Fresh 24x500g","Income","Vim Lemon Fresh 24x500g",,"Accounts Receivable","",400982.40,70044633.67
,"Invoice","30-09-2024","MC06222",,"Unilever Kenya Ltd:Vim","Vim Lemon Fresh 24x500g","Income","Vim Lemon Fresh 24x500g",,"Accounts Receivable","",751842.00,70796475.67
,"Invoice","03-10-2024","MC06230",,"Unilever Kenya Ltd:Vim","Vim Lemon Fresh 24x500g","Income","Vim Lemon Fresh 24x500g",,"Accounts Receivable","",376863.66,71173339.33
,"Invoice","04-10-2024","MC06235",,"Unilever Kenya Ltd:Vim","Vim Lemon Fresh 24x500g","Income","Vim Lemon Fresh 24x500g",,"Accounts Receivable","",805766.40,71979105.73
,"Invoice","07-10-2024","MC06236",,"Unilever Kenya Ltd:Vim","Vim Lemon Fresh 24x500g","Income","Vim Lemon Fresh 24x500g",,"Accounts Receivable","",791497.62,72770603.35
,"Invoice","08-10-2024","MC06239",,"Unilever Kenya Ltd:Vim","Vim Lemon Fresh 24x500g","Income","Vim Lemon Fresh 24x500g",,"Accounts Receivable","",780586.20,73551189.55
,"Invoice","11-10-2024","MC06252",,"Unilever Kenya Ltd:Vim","Vim Lemon Fresh 24x500g","Income","Vim Lemon Fresh 24x500g",,"Accounts Receivable","",1259010.00,74810199.55
,"Invoice","16-10-2024","MC06263",,"Unilever Kenya Ltd:Vim","Vim Lemon Fresh 24x500g","Income","Vim Lemon Fresh 24x500g",,"Accounts Receivable","",201441.60,75011641.15
,"Invoice","17-10-2024","MC06270",,"Unilever Kenya Ltd:Vim","Vim Lemon Fresh 24x500g","Income","Vim Lemon Fresh 24x500g",,"Accounts Receivable","",201441.60,75213082.75
,"Invoice","18-10-2024","MC06277",,"Unilever Kenya Ltd:Vim","Vim Lemon Fresh 24x500g","Income","Vim Lemon Fresh 24x500g",,"Accounts Receivable","",523748.16,75736830.91
,"Invoice","18-10-2024","MC06279",,"Unilever Kenya Ltd:Vim","Vim Lemon Fresh 24x500g","Income","Vim Lemon Fresh 24x500g",,"Accounts Receivable","",1510812.00,77247642.91
,"Invoice","18-10-2024","MC06280",,"Unilever Kenya Ltd:Vim","Vim Lemon Fresh 24x500g","Income","Vim Lemon Fresh 24x500g",,"Accounts Receivable","",79737.30,77327380.21
,"Invoice","22-10-2024","MC06285",,"Unilever Kenya Ltd:Vim","Vim Lemon Fresh 24x500g","Income","Vim Lemon Fresh 24x500g",,"Accounts Receivable","",523748.16,77851128.37
,"Invoice","24-10-2024","MC06291",,"Unilever Kenya Ltd:Vim","Vim Lemon Fresh 24x500g","Income","Vim Lemon Fresh 24x500g",,"Accounts Receivable","",663078.60,78514206.97
,"Invoice","25-10-2024","MC06301",,"Unilever Kenya Ltd:Vim","Vim Lemon Fresh 24x500g","Income","Vim Lemon Fresh 24x500g",,"Accounts Receivable","",40288.32,78554495.29
,"Invoice","25-10-2024","MC06303",,"Unilever Kenya Ltd","Outer Vim Lemon Fresh 500g","Income","Vim Lemon Fresh 24x500g",,"Accounts Receivable","",2757.30,78557252.59
,"Invoice","28-10-2024","MC06305",,"Unilever Kenya Ltd:Vim","Vim Lemon Fresh 24x500g","Income","Vim Lemon Fresh 24x500g",,"Accounts Receivable","",805766.40,79363018.99
,"Invoice","30-10-2024","MC06319",,"Unilever Kenya Ltd:Vim","Vim Lemon Fresh 24x500g","Income","Vim Lemon Fresh 24x500g",,"Accounts Receivable","",440653.50,79803672.49
,"Invoice","30-10-2024","MC06323",,"Unilever Kenya Ltd:Vim","Vim Lemon Fresh 24x500g","Income","Vim Lemon Fresh 24x500g",,"Accounts Receivable","",839340.00,80643012.49
,"Invoice","31-10-2024","MC06325",,"Unilever Kenya Ltd:Vim","Vim Lemon Fresh 24x500g","Income","Vim Lemon Fresh 24x500g",,"Accounts Receivable","",606842.82,81249855.31
,"Invoice","06-11-2024","MC06331",,"Unilever Kenya Ltd:Vim","Vim Lemon Fresh 24x500g","Income","Vim Lemon Fresh 24x500g",,"Accounts Receivable","",595092.06,81844947.37
,"Invoice","07-11-2024","MC06345",,"Unilever Kenya Ltd:Vim","Vim Lemon Fresh 24x500g","Income","Vim Lemon Fresh 24x500g",,"Accounts Receivable","",1259010.00,83103957.37
,"Invoice","13-11-2024","MC06353",,"Unilever Kenya Ltd:Vim","Vim Lemon Fresh 24x500g","Income","Vim Lemon Fresh 24x500g",,"Accounts Receivable","",711760.32,83815717.69
,"Invoice","14-11-2024","MC06360",,"Unilever Kenya Ltd:Vim","Vim Lemon Fresh 24x500g","Income","Vim Lemon Fresh 24x500g",,"Accounts Receivable","",433099.44,84248817.13
,"Invoice","15-11-2024","MC06368",,"Unilever Kenya Ltd:Vim","Vim Lemon Fresh 24x500g","Income","Vim Lemon Fresh 24x500g",,"Accounts Receivable","",1259010.00,85507827.13
,"Invoice","18-11-2024","MC06369",,"Unilever Kenya Ltd:Vim","Vim Lemon Fresh 24x500g","Income","Vim Lemon Fresh 24x500g",,"Accounts Receivable","",120864.96,85628692.09
,"Invoice","19-11-2024","MC06375",,"Unilever Kenya Ltd:Vim","Vim Lemon Fresh 24x500g","Income","Vim Lemon Fresh 24x500g",,"Accounts Receivable","",791497.62,86420189.71
,"Invoice","20-11-2024","MC06383",,"Unilever Kenya Ltd:Vim","Vim Lemon Fresh 24x500g","Income","Vim Lemon Fresh 24x500g",,"Accounts Receivable","",644613.12,87064802.83
,"Invoice","20-11-2024","MC06386",,"Unilever Kenya Ltd:Vim","Vim Lemon Fresh 24x500g","Income","Vim Lemon Fresh 24x500g",,"Accounts Receivable","",120864.96,87185667.79
,"Invoice","22-11-2024","MC06401",,"Unilever Kenya Ltd:Vim","Vim Lemon Fresh 24x500g","Income","Vim Lemon Fresh 24x500g",,"Accounts Receivable","",1259010.00,88444677.79
,"Invoice","23-11-2024","MC06405",,"Unilever Kenya Ltd:Vim","Vim Lemon Fresh 24x500g","Income","Vim Lemon Fresh 24x500g",,"Accounts Receivable","",153599.22,88598277.01
,"Invoice","26-11-2024","MC06413",,"Unilever Kenya Ltd:Vim","Vim Lemon Fresh 24x500g","Income","Vim Lemon Fresh 24x500g",,"Accounts Receivable","",161153.28,88759430.29
,"Invoice","26-11-2024","MC06417",,"Unilever Kenya Ltd:Vim","Vim Lemon Fresh 24x500g","Income","Vim Lemon Fresh 24x500g",,"Accounts Receivable","",778068.18,89537498.47
,"Invoice","28-11-2024","MC06418",,"Unilever Kenya Ltd:Vim","Vim Lemon Fresh 24x500g","Income","Vim Lemon Fresh 24x500g",,"Accounts Receivable","",241729.92,89779228.39
,"Invoice","28-11-2024","MC06422",,"Unilever Kenya Ltd:Vim","Vim Lemon Fresh 24x500g","Income","Vim Lemon Fresh 24x500g",,"Accounts Receivable","",322306.56,90101534.95
,"Invoice","04-12-2024","MC06440",,"Unilever Kenya Ltd:Vim","Vim Lemon Fresh 24x500g","Income","Vim Lemon Fresh 24x500g",,"Accounts Receivable","",362594.88,90464129.83
,"Invoice","04-12-2024","MC06445",,"Unilever Kenya Ltd:Vim","Vim Lemon Fresh 24x500g","Income","Vim Lemon Fresh 24x500g",,"Accounts Receivable","",275303.52,90739433.35
,"Invoice","11-12-2024","MC06460",,"Unilever Kenya Ltd:Vim","Vim Lemon Fresh 24x500g","Income","Vim Lemon Fresh 24x500g",,"Accounts Receivable","",265231.44,91004664.79
,"Invoice","14-12-2024","MC06466",,"Unilever Kenya Ltd:Vim","Vim Lemon Fresh 24x500g","Income","Vim Lemon Fresh 24x500g",,"Accounts Receivable","",402883.20,91407547.99
,"Invoice","17-12-2024","MC06472",,"Unilever Kenya Ltd:Vim","Vim Lemon Fresh 24x500g","Income","Vim Lemon Fresh 24x500g",,"Accounts Receivable","",542213.64,91949761.63
,"Invoice","17-12-2024","MC06478",,"Unilever Kenya Ltd:Vim","Vim Lemon Fresh 24x500g","Income","Vim Lemon Fresh 24x500g",,"Accounts Receivable","",543052.98,92492814.61
,"Invoice","20-12-2024","MC06493",,"Unilever Kenya Ltd:Vim","Vim Lemon Fresh 24x500g","Income","Vim Lemon Fresh 24x500g",,"Accounts Receivable","",1611532.80,94104347.41
,"Invoice","23-12-2024","MC06498",,"Unilever Kenya Ltd:Vim","Vim Lemon Fresh 24x500g","Income","Vim Lemon Fresh 24x500g",,"Accounts Receivable","",725189.76,94829537.17
,"Invoice","23-12-2024","MC06504",,"Unilever Kenya Ltd:Vim","Vim Lemon Fresh 24x500g","Income","Vim Lemon Fresh 24x500g",,"Accounts Receivable","",1678680.00,96508217.17
,"Invoice","24-12-2024","MC06505",,"Unilever Kenya Ltd:Vim","Vim Lemon Fresh 24x500g","Income","Vim Lemon Fresh 24x500g",,"Accounts Receivable","",587538.00,97095755.17
,"Invoice","24-12-2024","MC06514",,"Unilever Kenya Ltd:Vim","Vim Lemon Fresh 24x500g","Income","Vim Lemon Fresh 24x500g",,"Accounts Receivable","",658042.56,97753797.73
"Total Vim Lemon Fresh 24x500g",,,,,,,,,,,13356.48,97767154.21,97753797.73
"Vim Lemon Fresh Pouch 500gx24",,,,,,,,,,,,,""
,"Invoice","04-01-2024","MC05271",,"Unilever Kenya Ltd:Vim","Vim Lemon Fresh Pouch 24x500g","Income","Vim Lemon Fresh Pouch 500gx24",,"Accounts Receivable","",75614.40,75614.40
,"Invoice","05-01-2024","MC05274",,"Unilever Kenya Ltd:Vim","Vim Lemon Fresh Pouch 24x500g","Income","Vim Lemon Fresh Pouch 500gx24",,"Accounts Receivable","",81915.60,157530.00
,"Invoice","11-01-2024","MC05293",,"Unilever Kenya Ltd:Vim","Vim Lemon Fresh Pouch 24x500g","Income","Vim Lemon Fresh Pouch 500gx24",,"Accounts Receivable","",47784.10,205314.10
,"Invoice","17-01-2024","MC05327",,"Unilever Kenya Ltd:Vim","Vim Lemon Fresh Pouch 24x500g","Income","Vim Lemon Fresh Pouch 500gx24",,"Accounts Receivable","",100819.20,306133.30
,"Invoice","30-01-2024","MC05368",,"Unilever Kenya Ltd:Vim","Vim Lemon Fresh Pouch 24x500g","Income","Vim Lemon Fresh Pouch 500gx24",,"Accounts Receivable","",147028.00,453161.30
,"Invoice","01-02-2024","MC05377",,"Unilever Kenya Ltd","Outer 500g Lemon Fresh Pouch","Income","Vim Lemon Fresh Pouch 500gx24",,"Accounts Receivable","",329.63,453490.93
,"Invoice","13-02-2024","MC05402",,"Unilever Kenya Ltd:Vim","Vim Lemon Fresh Pouch 24x500g","Income","Vim Lemon Fresh Pouch 500gx24",,"Accounts Receivable","",75614.40,529105.33
,"Invoice","21-02-2024","MC05415",,"Unilever Kenya Ltd:Vim","Vim Lemon Fresh Pouch 24x500g","Income","Vim Lemon Fresh Pouch 500gx24",,"Accounts Receivable","",75614.40,604719.73
,"Invoice","21-02-2024","MC05418",,"Unilever Kenya Ltd:Vim","Vim Lemon Fresh Pouch 24x500g","Income","Vim Lemon Fresh Pouch 500gx24",,"Accounts Receivable","",136000.90,740720.63
,"Invoice","23-02-2024","MC05435",,"Unilever Kenya Ltd:Vim","Vim Lemon Fresh Pouch 24x500g","Income","Vim Lemon Fresh Pouch 500gx24",,"Accounts Receivable","",15227.90,755948.53
,"Invoice","27-02-2024","MC05448",,"Unilever Kenya Ltd:Vim","Vim Lemon Fresh Pouch 24x500g","Income","Vim Lemon Fresh Pouch 500gx24",,"Accounts Receivable","",75614.40,831562.93
,"Invoice","28-02-2024","MC05450",,"Unilever Kenya Ltd:Vim","Vim Lemon Fresh Pouch 24x500g","Income","Vim Lemon Fresh Pouch 500gx24",,"Accounts Receivable","",74564.20,906127.13
,"Invoice","07-03-2024","MC05475",,"Unilever Kenya Ltd:Vim","Vim Lemon Fresh Pouch 24x500g","Income","Vim Lemon Fresh Pouch 500gx24",,"Accounts Receivable","",133375.40,1039502.53
,"Invoice","12-03-2024","MC05488",,"Unilever Kenya Ltd:Vim","Vim Lemon Fresh Pouch 24x500g","Income","Vim Lemon Fresh Pouch 500gx24",,"Accounts Receivable","",130224.80,1169727.33
,"Invoice","14-03-2024","MC05493",,"Unilever Kenya Ltd:Vim","Vim Lemon Fresh Pouch 24x500g","Income","Vim Lemon Fresh Pouch 500gx24",,"Accounts Receivable","",256248.80,1425976.13
,"Invoice","28-03-2024","MC05549",,"Unilever Kenya Ltd:Vim","Vim Lemon Fresh Pouch 24x500g","Income","Vim Lemon Fresh Pouch 500gx24",,"Accounts Receivable","",64587.30,1490563.43
,"Invoice","03-04-2024","MC05554",,"Unilever Kenya Ltd:Vim","Vim Lemon Fresh Pouch 24x500g","Income","Vim Lemon Fresh Pouch 500gx24",,"Accounts Receivable","",38108.88,1528672.31
,"Invoice","03-04-2024","MC05557",,"Unilever Kenya Ltd:Vim","Vim Lemon Fresh Pouch 24x500g","Income","Vim Lemon Fresh Pouch 500gx24",,"Accounts Receivable","",85215.69,1613888.00
,"Invoice","04-04-2024","MC05570",,"Unilever Kenya Ltd:Vim","Vim Lemon Fresh Pouch 24x500g","Income","Vim Lemon Fresh Pouch 500gx24",,"Accounts Receivable","",59809.77,1673697.77
,"Invoice","05-04-2024","MC05572",,"Unilever Kenya Ltd:Vim","Vim Lemon Fresh Pouch 24x500g","Income","Vim Lemon Fresh Pouch 500gx24",,"Accounts Receivable","",73042.02,1746739.79
,"Invoice","11-04-2024","MC05584",,"Unilever Kenya Ltd:Vim","Vim Lemon Fresh Pouch 24x500g","Income","Vim Lemon Fresh Pouch 500gx24",,"Accounts Receivable","",19583.73,1766323.52
,"Invoice","12-04-2024","MC05594",,"Unilever Kenya Ltd:Vim","Vim Lemon Fresh Pouch 24x500g","Income","Vim Lemon Fresh Pouch 500gx24",,"Accounts Receivable","",76217.76,1842541.28
,"Invoice","18-04-2024","MC05606",,"Unilever Kenya Ltd:Vim","Vim Lemon Fresh Pouch 24x500g","Income","Vim Lemon Fresh Pouch 500gx24",,"Accounts Receivable","",106387.29,1948928.57
,"Invoice","19-04-2024","MC05616",,"Unilever Kenya Ltd:Vim","Vim Lemon Fresh Pouch 24x500g","Income","Vim Lemon Fresh Pouch 500gx24",,"Accounts Receivable","",76217.76,2025146.33
,"Invoice","23-04-2024","MC05625",,"Unilever Kenya Ltd:Vim","Vim Lemon Fresh Pouch 24x500g","Income","Vim Lemon Fresh Pouch 500gx24",,"Accounts Receivable","",50282.55,2075428.88
,"Invoice","24-04-2024","MC05633",,"Unilever Kenya Ltd:Vim","Vim Lemon Fresh Pouch 24x500g","Income","Vim Lemon Fresh Pouch 500gx24",,"Accounts Receivable","",38108.88,2113537.76
,"Invoice","25-04-2024","MC05637",,"Unilever Kenya Ltd:Vim","Vim Lemon Fresh Pouch 24x500g","Income","Vim Lemon Fresh Pouch 500gx24",,"Accounts Receivable","",110092.32,2223630.08
,"Invoice","26-04-2024","MC05640",,"Unilever Kenya Ltd:Vim","Vim Lemon Fresh Pouch 24x500g","Income","Vim Lemon Fresh Pouch 500gx24",,"Accounts Receivable","",76217.76,2299847.84
,"Invoice","30-04-2024","MC05654",,"Unilever Kenya Ltd:Vim","Vim Lemon Fresh Pouch 24x500g","Income","Vim Lemon Fresh Pouch 500gx24",,"Accounts Receivable","",86274.27,2386122.11
,"Invoice","03-05-2024","MC05659",,"Unilever Kenya Ltd:Vim","Vim Lemon Fresh Pouch 24x500g","Income","Vim Lemon Fresh Pouch 500gx24",,"Accounts Receivable","",109033.74,2495155.85
,"Invoice","07-05-2024","MC05673",,"Unilever Kenya Ltd:Vim","Vim Lemon Fresh Pouch 24x500g","Income","Vim Lemon Fresh Pouch 500gx24",,"Accounts Receivable","",141849.72,2637005.57
,"Invoice","08-05-2024","MC05678",,"Unilever Kenya Ltd:Vim","Vim Lemon Fresh Pouch 24x500g","Income","Vim Lemon Fresh Pouch 500gx24",,"Accounts Receivable","",109563.03,2746568.60
,"Invoice","09-05-2024","MC05686",,"Unilever Kenya Ltd:Vim","Vim Lemon Fresh Pouch 24x500g","Income","Vim Lemon Fresh Pouch 500gx24",,"Accounts Receivable","",58751.19,2805319.79
,"Invoice","16-05-2024","MC05709",,"Unilever Kenya Ltd:Vim","Vim Lemon Fresh Pouch 24x500g","Income","Vim Lemon Fresh Pouch 500gx24",,"Accounts Receivable","",14820.12,2820139.91
,"Invoice","24-05-2024","MC05742",,"Unilever Kenya Ltd:Vim","Vim Lemon Fresh Pouch 24x500g","Income","Vim Lemon Fresh Pouch 500gx24",,"Accounts Receivable","",32815.98,2852955.89
,"Invoice","29-05-2024","MC05767",,"Unilever Kenya Ltd:Vim","Vim Lemon Fresh Pouch 24x500g","Income","Vim Lemon Fresh Pouch 500gx24",,"Accounts Receivable","",112738.77,2965694.66
,"Invoice","04-06-2024","MC05787",,"Unilever Kenya Ltd:Vim","Vim Lemon Fresh Pouch 24x500g","Income","Vim Lemon Fresh Pouch 500gx24",,"Accounts Receivable","",55046.16,3020740.82
,"Invoice","06-06-2024","MC05792",,"Unilever Kenya Ltd:Vim","Vim Lemon Fresh Pouch 24x500g","Income","Vim Lemon Fresh Pouch 500gx24",,"Accounts Receivable","",69336.99,3090077.81
,"Invoice","07-06-2024","MC05799",,"Unilever Kenya Ltd:Vim","Vim Lemon Fresh Pouch 24x500g","Income","Vim Lemon Fresh Pouch 500gx24",,"Accounts Receivable","",66161.25,3156239.06
,"Invoice","10-06-2024","MC05807",,"Unilever Kenya Ltd:Vim","Vim Lemon Fresh Pouch 24x500g","Income","Vim Lemon Fresh Pouch 500gx24",,"Accounts Receivable","",64573.38,3220812.44
,"Invoice","18-06-2024","MC05833",,"Unilever Kenya Ltd:Vim","Vim Lemon Fresh Pouch 24x500g","Income","Vim Lemon Fresh Pouch 500gx24",,"Accounts Receivable","",146084.04,3366896.48
,"Invoice","04-07-2024","MC05887",,"Unilever Kenya Ltd:Vim","Vim Lemon Fresh Pouch 24x500g","Income","Vim Lemon Fresh Pouch 500gx24",,"Accounts Receivable","",163629.62,3530526.10
,"Invoice","05-07-2024","MC05894",,"Unilever Kenya Ltd:Vim","Vim Lemon Fresh Pouch 24x500g","Income","Vim Lemon Fresh Pouch 500gx24",,"Accounts Receivable","",212011.80,3742537.90
,"Invoice","09-07-2024","MC05904",,"Unilever Kenya Ltd:Vim","Vim Lemon Fresh Pouch 24x500g","Income","Vim Lemon Fresh Pouch 500gx24",,"Accounts Receivable","",45664.08,3788201.98
,"Invoice","12-07-2024","MC05911",,"Unilever Kenya Ltd:Vim","Vim Lemon Fresh Pouch 24x500g","Income","Vim Lemon Fresh Pouch 500gx24",,"Accounts Receivable","",166891.34,3955093.32
,"Invoice","17-07-2024","MC05944",,"Unilever Kenya Ltd:Vim","Vim Lemon Fresh Pouch 24x500g","Income","Vim Lemon Fresh Pouch 500gx24",,"Accounts Receivable","",131556.04,4086649.36
,"Invoice","18-07-2024","MC05949",,"Unilever Kenya Ltd:Vim","Vim Lemon Fresh Pouch 24x500g","Income","Vim Lemon Fresh Pouch 500gx24",,"Accounts Receivable","",67952.50,4154601.86
,"Invoice","18-07-2024","MC05951",,"Unilever Kenya Ltd:Vim","Vim Lemon Fresh Pouch 24x500g","Income","Vim Lemon Fresh Pouch 500gx24",,"Accounts Receivable","",75019.56,4229621.42
,"Invoice","26-07-2024","MC05969",,"Unilever Kenya Ltd:Vim","Vim Lemon Fresh Pouch 24x500g","Income","Vim Lemon Fresh Pouch 500gx24",,"Accounts Receivable","",195703.20,4425324.62
,"Invoice","31-07-2024","MC05987",,"Unilever Kenya Ltd:Vim","Vim Lemon Fresh Pouch 24x500g","Income","Vim Lemon Fresh Pouch 500gx24",,"Accounts Receivable","",156562.56,4581887.18
,"Invoice","12-08-2024","MC06029",,"Unilever Kenya Ltd:Vim","Vim Lemon Fresh Pouch 24x500g","Income","Vim Lemon Fresh Pouch 500gx24",,"Accounts Receivable","",108724.00,4690611.18
,"Invoice","12-08-2024","MC06032",,"Unilever Kenya Ltd:Vim","Vim Lemon Fresh Pouch 24x500g","Income","Vim Lemon Fresh Pouch 500gx24",,"Accounts Receivable","",100026.08,4790637.26
,"Invoice","21-08-2024","MC06056",,"Unilever Kenya Ltd:Vim","Vim Lemon Fresh Pouch 24x500g","Income","Vim Lemon Fresh Pouch 500gx24",,"Accounts Receivable","",145690.16,4936327.42
,"Invoice","27-08-2024","MC06089",,"Unilever Kenya Ltd:Vim","Vim Lemon Fresh Pouch 24x500g","Income","Vim Lemon Fresh Pouch 500gx24",,"Accounts Receivable","",36966.16,4973293.58
,"Invoice","30-08-2024","MC06102",,"Unilever Kenya Ltd:Vim","Vim Lemon Fresh Pouch 24x500g","Income","Vim Lemon Fresh Pouch 500gx24",,"Accounts Receivable","",173414.78,5146708.36
,"Invoice","06-09-2024","MC06126",,"Unilever Kenya Ltd:Vim","Vim Lemon Fresh Pouch 24x500g","Income","Vim Lemon Fresh Pouch 500gx24",,"Accounts Receivable","",225058.68,5371767.04
,"Invoice","17-09-2024","MC06158",,"Unilever Kenya Ltd:Vim","Vim Lemon Fresh Pouch 24x500g","Income","Vim Lemon Fresh Pouch 500gx24",,"Accounts Receivable","",86435.58,5458202.62
,"Invoice","19-09-2024","MC06167",,"Unilever Kenya Ltd:Vim","Vim Lemon Fresh Pouch 24x500g","Income","Vim Lemon Fresh Pouch 500gx24",,"Accounts Receivable","",138079.48,5596282.10
,"Invoice","26-09-2024","MC06204",,"Unilever Kenya Ltd:Vim","Vim Lemon Fresh Pouch 24x500g","Income","Vim Lemon Fresh Pouch 500gx24",,"Accounts Receivable","",78281.28,5674563.38
,"Invoice","27-09-2024","MC06207",,"Unilever Kenya Ltd:Vim","Vim Lemon Fresh Pouch 24x500g","Income","Vim Lemon Fresh Pouch 500gx24",,"Accounts Receivable","",84804.72,5759368.10
,"Invoice","03-10-2024","MC06225",,"Unilever Kenya Ltd:Vim","Vim Lemon Fresh Pouch 24x500g","Income","Vim Lemon Fresh Pouch 500gx24",,"Accounts Receivable","",238265.28,5997633.38
,"Invoice","14-10-2024","MC06257",,"Unilever Kenya Ltd:Vim","Vim Lemon Fresh Pouch 24x500g","Income","Vim Lemon Fresh Pouch 500gx24",,"Accounts Receivable","",141194.24,6138827.62
,"Invoice","16-10-2024","MC06264",,"Unilever Kenya Ltd:Vim","Vim Lemon Fresh Pouch 24x500g","Income","Vim Lemon Fresh Pouch 500gx24",,"Accounts Receivable","",175941.26,6314768.88
,"Invoice","17-10-2024","MC06271",,"Unilever Kenya Ltd:Vim","Vim Lemon Fresh Pouch 24x500g","Income","Vim Lemon Fresh Pouch 500gx24",,"Accounts Receivable","",134024.22,6448793.10
,"Invoice","18-10-2024","MC06281",,"Unilever Kenya Ltd:Vim","Vim Lemon Fresh Pouch 24x500g","Income","Vim Lemon Fresh Pouch 500gx24",,"Accounts Receivable","",111962.62,6560755.72
,"Invoice","29-10-2024","MC06314",,"Unilever Kenya Ltd:Vim","Vim Lemon Fresh Pouch 24x500g","Income","Vim Lemon Fresh Pouch 500gx24",,"Accounts Receivable","",187523.60,6748279.32
,"Invoice","06-11-2024","MC06332",,"Unilever Kenya Ltd:Vim","Vim Lemon Fresh Pouch 24x500g","Income","Vim Lemon Fresh Pouch 500gx24",,"Accounts Receivable","",190281.30,6938560.62
,"Invoice","07-11-2024","MC06339",,"Unilever Kenya Ltd:Vim","Vim Lemon Fresh Pouch 24x500g","Income","Vim Lemon Fresh Pouch 500gx24",,"Accounts Receivable","",62875.56,7001436.18
,"Invoice","13-11-2024","MC06354",,"Unilever Kenya Ltd:Vim","Vim Lemon Fresh Pouch 24x500g","Income","Vim Lemon Fresh Pouch 500gx24",,"Accounts Receivable","",79421.76,7080857.94
,"Invoice","14-11-2024","MC06361",,"Unilever Kenya Ltd:Vim","Vim Lemon Fresh Pouch 24x500g","Income","Vim Lemon Fresh Pouch 500gx24",,"Accounts Receivable","",39710.88,7120568.82
,"Invoice","20-11-2024","MC06387",,"Unilever Kenya Ltd:Vim","Vim Lemon Fresh Pouch 24x500g","Income","Vim Lemon Fresh Pouch 500gx24",,"Accounts Receivable","",198554.40,7319123.22
,"Invoice","28-11-2024","MC06423",,"Unilever Kenya Ltd:Vim","Vim Lemon Fresh Pouch 24x500g","Income","Vim Lemon Fresh Pouch 500gx24",,"Accounts Receivable","",158843.52,7477966.74
,"Invoice","04-12-2024","MC06439",,"Unilever Kenya Ltd:Vim","Vim Lemon Fresh Pouch 24x500g","Income","Vim Lemon Fresh Pouch 500gx24",,"Accounts Receivable","",79421.76,7557388.50
,"Invoice","05-12-2024","MC06450",,"Unilever Kenya Ltd:Vim","Vim Lemon Fresh Pouch 24x500g","Income","Vim Lemon Fresh Pouch 500gx24",,"Accounts Receivable","",119132.64,7676521.14
,"Invoice","11-12-2024","MC06457",,"Unilever Kenya Ltd:Vim","Vim Lemon Fresh Pouch 24x500g","Income","Vim Lemon Fresh Pouch 500gx24",,"Accounts Receivable","",79421.76,7755942.90
,"Invoice","14-12-2024","MC06467",,"Unilever Kenya Ltd:Vim","Vim Lemon Fresh Pouch 24x500g","Income","Vim Lemon Fresh Pouch 500gx24",,"Accounts Receivable","",222822.16,7978765.06
,"Invoice","19-12-2024","MC06489",,"Unilever Kenya Ltd:Vim","Vim Lemon Fresh Pouch 24x500g","Income","Vim Lemon Fresh Pouch 500gx24",,"Accounts Receivable","",109756.46,8088521.52
,"Invoice","24-12-2024","MC06507",,"Unilever Kenya Ltd:Vim","Vim Lemon Fresh Pouch 24x500g","Income","Vim Lemon Fresh Pouch 500gx24",,"Accounts Receivable","",158843.52,8247365.04
"Total Vim Lemon Fresh Pouch 500gx24",,,,,,,,,,,0.00,8247365.04,8247365.04
"Vim Powder Lemon Fresh 12x1Kg",,,,,,,,,,,,,""
,"Invoice","08-01-2024","MC05280",,"Unilever Kenya Ltd:Vim","Vim Lemon Fresh 12x1Kg","Income","Vim Powder Lemon Fresh 12x1Kg",,"Accounts Receivable","",298191.79,298191.79
,"Invoice","09-01-2024","MC05286",,"Unilever Kenya Ltd:Vim","Vim Lemon Fresh 12x1Kg","Income","Vim Powder Lemon Fresh 12x1Kg",,"Accounts Receivable","",119128.73,417320.52
,"Invoice","10-01-2024","MC05288",,"Unilever Kenya Ltd:Vim","Vim Lemon Fresh 12x1Kg","Income","Vim Powder Lemon Fresh 12x1Kg",,"Accounts Receivable","",517951.00,935271.52
,"Invoice","11-01-2024","MC05294",,"Unilever Kenya Ltd:Vim","Vim Lemon Fresh 12x1Kg","Income","Vim Powder Lemon Fresh 12x1Kg",,"Accounts Receivable","",178323.13,1113594.65
,"Invoice","16-01-2024","MC05320",,"Unilever Kenya Ltd:Vim","Vim Lemon Fresh 12x1Kg","Income","Vim Powder Lemon Fresh 12x1Kg",,"Accounts Receivable","",258975.50,1372570.15
,"Invoice","17-01-2024","MC05328",,"Unilever Kenya Ltd:Vim","Vim Lemon Fresh 12x1Kg","Income","Vim Powder Lemon Fresh 12x1Kg",,"Accounts Receivable","",77692.65,1450262.80
,"Invoice","19-01-2024","MC05332",,"Unilever Kenya Ltd:Vim","Vim Lemon Fresh 12x1Kg","Income","Vim Powder Lemon Fresh 12x1Kg",,"Accounts Receivable","",414360.80,1864623.60
,"Invoice","22-01-2024","MC05341",,"Unilever Kenya Ltd:Vim","Vim Lemon Fresh 12x1Kg","Income","Vim Powder Lemon Fresh 12x1Kg",,"Accounts Receivable","",611922.11,2476545.71
,"Invoice","26-01-2024","MC05355",,"Unilever Kenya Ltd:Vim","Vim Lemon Fresh 12x1Kg","Income","Vim Powder Lemon Fresh 12x1Kg",,"Accounts Receivable","",258975.50,2735521.21
,"Invoice","26-01-2024","MC05360",,"Unilever Kenya Ltd:Vim","Vim Lemon Fresh 12x1Kg","Income","Vim Powder Lemon Fresh 12x1Kg",,"Accounts Receivable","",278213.68,3013734.89
,"Invoice","26-01-2024","MC05363",,"Unilever Kenya Ltd:Vim","Vim Lemon Fresh 12x1Kg","Income","Vim Powder Lemon Fresh 12x1Kg",,"Accounts Receivable","",369965.00,3383699.89
,"Invoice","01-02-2024","MC05375",,"Unilever Kenya Ltd:Vim","Vim Lemon Fresh 12x1Kg","Income","Vim Powder Lemon Fresh 12x1Kg",,"Accounts Receivable","",590464.14,3974164.03
,"Invoice","02-02-2024","MC05381",,"Unilever Kenya Ltd:Vim","Vim Lemon Fresh 12x1Kg","Income","Vim Powder Lemon Fresh 12x1Kg",,"Accounts Receivable","",500192.68,4474356.71
,"Invoice","16-02-2024","MC05409",,"Unilever Kenya Ltd:Vim","Vim Lemon Fresh 12x1Kg","Income","Vim Powder Lemon Fresh 12x1Kg",,"Accounts Receivable","",310770.60,4785127.31
,"Invoice","22-02-2024","MC05423",,"Unilever Kenya Ltd:Vim","Vim Lemon Fresh 12x1Kg","Income","Vim Powder Lemon Fresh 12x1Kg",,"Accounts Receivable","",509811.77,5294939.08
,"Invoice","22-02-2024","MC05427",,"Unilever Kenya Ltd:Vim","Vim Lemon Fresh 12x1Kg","Income","Vim Powder Lemon Fresh 12x1Kg",,"Accounts Receivable","",295972.00,5590911.08
,"Invoice","22-02-2024","MC05431",,"Unilever Kenya Ltd:Vim","Vim Lemon Fresh 12x1Kg","Income","Vim Powder Lemon Fresh 12x1Kg",,"Accounts Receivable","",310770.60,5901681.68
,"Invoice","23-02-2024","MC05436",,"Unilever Kenya Ltd:Vim","Vim Lemon Fresh 12x1Kg","Income","Vim Powder Lemon Fresh 12x1Kg",,"Accounts Receivable","",179063.06,6080744.74
,"Invoice","28-02-2024","MC05451",,"Unilever Kenya Ltd:Vim","Vim Lemon Fresh 12x1Kg","Income","Vim Powder Lemon Fresh 12x1Kg",,"Accounts Receivable","",621541.20,6702285.94
,"Invoice","05-03-2024","MC05465",,"Unilever Kenya Ltd:Vim","Vim Lemon Fresh 12x1Kg","Income","Vim Powder Lemon Fresh 12x1Kg",,"Accounts Receivable","",237517.53,6939803.47
,"Invoice","08-03-2024","MC05480",,"Unilever Kenya Ltd:Vim","Vim Lemon Fresh 12x1Kg","Income","Vim Powder Lemon Fresh 12x1Kg",,"Accounts Receivable","",621541.20,7561344.67
,"Invoice","14-03-2024","MC05494",,"Unilever Kenya Ltd:Vim","Vim Lemon Fresh 12x1Kg","Income","Vim Powder Lemon Fresh 12x1Kg",,"Accounts Receivable","",310770.60,7872115.27
,"Invoice","21-03-2024","MC05508",,"Unilever Kenya Ltd:Vim","Vim Lemon Fresh 12x1Kg","Income","Vim Powder Lemon Fresh 12x1Kg",,"Accounts Receivable","",503152.40,8375267.67
,"Invoice","22-03-2024","MC05516",,"Unilever Kenya Ltd:Vim","Vim Lemon Fresh 12x1Kg","Income","Vim Powder Lemon Fresh 12x1Kg",,"Accounts Receivable","",480954.50,8856222.17
,"Invoice","23-03-2024","MC05520",,"Unilever Kenya Ltd:Vim","Vim Lemon Fresh 12x1Kg","Income","Vim Powder Lemon Fresh 12x1Kg",,"Accounts Receivable","",476514.92,9332737.09
,"Invoice","27-03-2024","MC05543",,"Unilever Kenya Ltd:Vim","Vim Lemon Fresh 12x1Kg","Income","Vim Powder Lemon Fresh 12x1Kg",,"Accounts Receivable","",1035902.00,10368639.09
,"Invoice","28-03-2024","MC05545",,"Unilever Kenya Ltd:Vim","Vim Lemon Fresh 12x1Kg","Income","Vim Powder Lemon Fresh 12x1Kg",,"Accounts Receivable","",146506.14,10515145.23
,"Invoice","04-04-2024","MC05569",,"Unilever Kenya Ltd:Vim","Vim Lemon Fresh 12x1Kg","Income","Vim Powder Lemon Fresh 12x1Kg",,"Accounts Receivable","",312530.40,10827675.63
,"Invoice","05-04-2024","MC05573",,"Unilever Kenya Ltd:Vim","Vim Lemon Fresh 12x1Kg","Income","Vim Powder Lemon Fresh 12x1Kg",,"Accounts Receivable","",517163.40,11344839.03
,"Invoice","09-04-2024","MC05580",,"Unilever Kenya Ltd:Vim","Vim Lemon Fresh 12x1Kg","Income","Vim Powder Lemon Fresh 12x1Kg",,"Accounts Receivable","",312530.40,11657369.43
,"Invoice","12-04-2024","MC05599",,"Unilever Kenya Ltd:Vim","Vim Lemon Fresh 12x1Kg","Income","Vim Powder Lemon Fresh 12x1Kg",,"Accounts Receivable","",569995.92,12227365.35
,"Invoice","15-04-2024","MC05601",,"Unilever Kenya Ltd:Vim","Vim Lemon Fresh 12x1Kg","Income","Vim Powder Lemon Fresh 12x1Kg",,"Accounts Receivable","",52088.40,12279453.75
,"Invoice","16-04-2024","MC05602",,"Unilever Kenya Ltd:Vim","Vim Lemon Fresh 12x1Kg","Income","Vim Powder Lemon Fresh 12x1Kg",,"Accounts Receivable","",973308.96,13252762.71
,"Invoice","18-04-2024","MC05607",,"Unilever Kenya Ltd:Vim","Vim Lemon Fresh 12x1Kg","Income","Vim Powder Lemon Fresh 12x1Kg",,"Accounts Receivable","",425636.64,13678399.35
,"Invoice","24-04-2024","MC05634",,"Unilever Kenya Ltd:Vim","Vim Lemon Fresh 12x1Kg","Income","Vim Powder Lemon Fresh 12x1Kg",,"Accounts Receivable","",260442.00,13938841.35
,"Invoice","25-04-2024","MC05638",,"Unilever Kenya Ltd:Vim","Vim Lemon Fresh 12x1Kg","Income","Vim Powder Lemon Fresh 12x1Kg",,"Accounts Receivable","",852017.40,14790858.75
,"Invoice","29-04-2024","MC05647",,"Unilever Kenya Ltd:Vim","Vim Lemon Fresh 12x1Kg","Income","Vim Powder Lemon Fresh 12x1Kg",,"Accounts Receivable","",494839.80,15285698.55
,"Invoice","30-04-2024","MC05655",,"Unilever Kenya Ltd:Vim","Vim Lemon Fresh 12x1Kg","Income","Vim Powder Lemon Fresh 12x1Kg",,"Accounts Receivable","",468795.60,15754494.15
,"Invoice","03-05-2024","MC05662",,"Unilever Kenya Ltd:Vim","Vim Lemon Fresh 12x1Kg","Income","Vim Powder Lemon Fresh 12x1Kg",,"Accounts Receivable","",601248.96,16355743.11
,"Invoice","03-05-2024","MC05667",,"Unilever Kenya Ltd:Vim","Vim Lemon Fresh 12x1Kg","Income","Vim Powder Lemon Fresh 12x1Kg",,"Accounts Receivable","",342295.20,16698038.31
,"Invoice","07-05-2024","MC05674",,"Unilever Kenya Ltd:Vim","Vim Lemon Fresh 12x1Kg","Income","Vim Powder Lemon Fresh 12x1Kg",,"Accounts Receivable","",692775.72,17390814.03
,"Invoice","08-05-2024","MC05679",,"Unilever Kenya Ltd:Vim","Vim Lemon Fresh 12x1Kg","Income","Vim Powder Lemon Fresh 12x1Kg",,"Accounts Receivable","",104176.80,17494990.83
,"Invoice","15-05-2024","MC05708",,"Unilever Kenya Ltd:Vim","Vim Lemon Fresh 12x1Kg","Income","Vim Powder Lemon Fresh 12x1Kg",,"Accounts Receivable","",499304.52,17994295.35
,"Invoice","16-05-2024","MC05710",,"Unilever Kenya Ltd:Vim","Vim Lemon Fresh 12x1Kg","Income","Vim Powder Lemon Fresh 12x1Kg",,"Accounts Receivable","",937591.20,18931886.55
,"Invoice","23-05-2024","MC05732",,"Unilever Kenya Ltd:Vim","Vim Lemon Fresh 12x1Kg","Income","Vim Powder Lemon Fresh 12x1Kg",,"Accounts Receivable","",364618.80,19296505.35
,"Invoice","24-05-2024","MC05743",,"Unilever Kenya Ltd:Vim","Vim Lemon Fresh 12x1Kg","Income","Vim Powder Lemon Fresh 12x1Kg",,"Accounts Receivable","",192727.08,19489232.43
,"Invoice","30-05-2024","MC05777",,"Unilever Kenya Ltd:Vim","Vim Lemon Fresh 12x1Kg","Income","Vim Powder Lemon Fresh 12x1Kg",,"Accounts Receivable","",503025.12,19992257.55
,"Invoice","04-06-2024","MC05788",,"Unilever Kenya Ltd:Vim","Vim Lemon Fresh 12x1Kg","Income","Vim Powder Lemon Fresh 12x1Kg",,"Accounts Receivable","",260442.00,20252699.55
,"Invoice","07-06-2024","MC05800",,"Unilever Kenya Ltd:Vim","Vim Lemon Fresh 12x1Kg","Income","Vim Powder Lemon Fresh 12x1Kg",,"Accounts Receivable","",462098.52,20714798.07
,"Invoice","11-06-2024","MC05812",,"Unilever Kenya Ltd:Vim","Vim Lemon Fresh 12x1Kg","Income","Vim Powder Lemon Fresh 12x1Kg",,"Accounts Receivable","",171891.72,20886689.79
,"Invoice","12-06-2024","MC05817",,"Unilever Kenya Ltd:Vim","Vim Lemon Fresh 12x1Kg","Income","Vim Powder Lemon Fresh 12x1Kg",,"Accounts Receivable","",520884.00,21407573.79
,"Invoice","13-06-2024","MC05823",,"Unilever Kenya Ltd:Vim","Vim Lemon Fresh 12x1Kg","Income","Vim Powder Lemon Fresh 12x1Kg",,"Accounts Receivable","",514186.92,21921760.71
,"Invoice","19-06-2024","MC05838",,"Unilever Kenya Ltd:Vim","Vim Lemon Fresh 12x1Kg","Income","Vim Powder Lemon Fresh 12x1Kg",,"Accounts Receivable","",896664.60,22818425.31
,"Invoice","24-06-2024","MC05858",,"Unilever Kenya Ltd:Vim","Vim Lemon Fresh 12x1Kg","Income","Vim Powder Lemon Fresh 12x1Kg",,"Accounts Receivable","",416707.20,23235132.51
,"Invoice","28-06-2024","MC05872",,"Unilever Kenya Ltd:Vim","Vim Lemon Fresh 12x1Kg","Income","Vim Powder Lemon Fresh 12x1Kg",,"Accounts Receivable","",747840.60,23982973.11
,"Invoice","04-07-2024","MC05888",,"Unilever Kenya Ltd:Vim","Vim Lemon Fresh 12x1Kg","Income","Vim Powder Lemon Fresh 12x1Kg",,"Accounts Receivable","",315663.60,24298636.71
,"Invoice","05-07-2024","MC05891",,"Unilever Kenya Ltd:Vim","Vim Lemon Fresh 12x1Kg","Income","Vim Powder Lemon Fresh 12x1Kg",,"Accounts Receivable","",314912.02,24613548.73
,"Invoice","05-07-2024","MC05895",,"Unilever Kenya Ltd:Vim","Vim Lemon Fresh 12x1Kg","Income","Vim Powder Lemon Fresh 12x1Kg",,"Accounts Receivable","",420133.22,25033681.95
,"Invoice","09-07-2024","MC05908",,"Unilever Kenya Ltd:Vim","Vim Lemon Fresh 12x1Kg","Income","Vim Powder Lemon Fresh 12x1Kg",,"Accounts Receivable","",849285.40,25882967.35
,"Invoice","12-07-2024","MC05915",,"Unilever Kenya Ltd:Vim","Vim Lemon Fresh 12x1Kg","Income","Vim Powder Lemon Fresh 12x1Kg",,"Accounts Receivable","",263053.00,26146020.35
,"Invoice","17-07-2024","MC05936",,"Unilever Kenya Ltd:Vim","Vim Lemon Fresh 12x1Kg","Income","Vim Powder Lemon Fresh 12x1Kg",,"Accounts Receivable","",210442.40,26356462.75
,"Invoice","17-07-2024","MC05945",,"Unilever Kenya Ltd:Vim","Vim Lemon Fresh 12x1Kg","Income","Vim Powder Lemon Fresh 12x1Kg",,"Accounts Receivable","",240505.60,26596968.35
,"Invoice","18-07-2024","MC05952",,"Unilever Kenya Ltd:Vim","Vim Lemon Fresh 12x1Kg","Income","Vim Powder Lemon Fresh 12x1Kg",,"Accounts Receivable","",447190.10,27044158.45
,"Invoice","19-07-2024","MC05954",,"Unilever Kenya Ltd:Vim","Vim Lemon Fresh 12x1Kg","Income","Vim Powder Lemon Fresh 12x1Kg",,"Accounts Receivable","",105221.20,27149379.65
,"Invoice","23-07-2024","MC05960",,"Unilever Kenya Ltd:Vim","Vim Lemon Fresh 12x1Kg","Income","Vim Powder Lemon Fresh 12x1Kg",,"Accounts Receivable","",205932.92,27355312.57
,"Invoice","23-07-2024","MC05965",,"Unilever Kenya Ltd:Vim","Vim Lemon Fresh 12x1Kg","Income","Vim Powder Lemon Fresh 12x1Kg",,"Accounts Receivable","",157831.80,27513144.37
,"Invoice","01-08-2024","MC05992",,"Unilever Kenya Ltd:Vim","Vim Lemon Fresh 12x1Kg","Income","Vim Powder Lemon Fresh 12x1Kg",,"Accounts Receivable","",771121.08,28284265.45
,"Invoice","06-08-2024","MC06002",,"Unilever Kenya Ltd:Vim","Vim Lemon Fresh 12x1Kg","Income","Vim Powder Lemon Fresh 12x1Kg",,"Accounts Receivable","",263053.00,28547318.45
,"Invoice","08-08-2024","MC06007",,"Unilever Kenya Ltd:Vim","Vim Lemon Fresh 12x1Kg","Income","Vim Powder Lemon Fresh 12x1Kg",,"Accounts Receivable","",635085.10,29182403.55
,"Invoice","12-08-2024","MC06035",,"Unilever Kenya Ltd:Vim","Vim Lemon Fresh 12x1Kg","Income","Vim Powder Lemon Fresh 12x1Kg",,"Accounts Receivable","",105221.20,29287624.75
,"Invoice","19-08-2024","MC06049",,"Unilever Kenya Ltd:Vim","Vim Lemon Fresh 12x1Kg","Income","Vim Powder Lemon Fresh 12x1Kg",,"Accounts Receivable","",789910.58,30077535.33
,"Invoice","20-08-2024","MC06051",,"Unilever Kenya Ltd:Vim","Vim Lemon Fresh 12x1Kg","Income","Vim Powder Lemon Fresh 12x1Kg",,"Accounts Receivable","",263053.00,30340588.33
,"Invoice","23-08-2024","MC06073",,"Unilever Kenya Ltd:Vim","Vim Lemon Fresh 12x1Kg","Income","Vim Powder Lemon Fresh 12x1Kg",,"Accounts Receivable","",222467.68,30563056.01
,"Invoice","23-08-2024","MC06076",,"Unilever Kenya Ltd:Vim","Vim Lemon Fresh 12x1Kg","Income","Vim Powder Lemon Fresh 12x1Kg",,"Accounts Receivable","",263053.00,30826109.01
,"Invoice","26-08-2024","MC06078",,"Unilever Kenya Ltd:Vim","Vim Lemon Fresh 12x1Kg","Income","Vim Powder Lemon Fresh 12x1Kg",,"Accounts Receivable","",420884.80,31246993.81
,"Invoice","26-08-2024","MC06084",,"Unilever Kenya Ltd:Vim","Vim Lemon Fresh 12x1Kg","Income","Vim Powder Lemon Fresh 12x1Kg",,"Accounts Receivable","",263053.00,31510046.81
,"Invoice","27-08-2024","MC06090",,"Unilever Kenya Ltd:Vim","Vim Lemon Fresh 12x1Kg","Income","Vim Powder Lemon Fresh 12x1Kg",,"Accounts Receivable","",287103.56,31797150.37
,"Invoice","29-08-2024","MC06100",,"Unilever Kenya Ltd:Vim","Vim Lemon Fresh 12x1Kg","Income","Vim Powder Lemon Fresh 12x1Kg",,"Accounts Receivable","",210442.40,32007592.77
,"Invoice","04-09-2024","MC06113",,"Unilever Kenya Ltd:Vim","Vim Lemon Fresh 12x1Kg","Income","Vim Powder Lemon Fresh 12x1Kg",,"Accounts Receivable","",659887.24,32667480.01
,"Invoice","04-09-2024","MC06118",,"Unilever Kenya Ltd:Vim","Vim Lemon Fresh 12x1Kg","Income","Vim Powder Lemon Fresh 12x1Kg",,"Accounts Receivable","",150316.00,32817796.01
,"Invoice","05-09-2024","MC06125",,"Unilever Kenya Ltd:Vim","Vim Lemon Fresh 12x1Kg","Income","Vim Powder Lemon Fresh 12x1Kg",,"Accounts Receivable","",601264.00,33419060.01
,"Invoice","09-09-2024","MC06131",,"Unilever Kenya Ltd:Vim","Vim Lemon Fresh 12x1Kg","Income","Vim Powder Lemon Fresh 12x1Kg",,"Accounts Receivable","",300632.00,33719692.01
,"Invoice","10-09-2024","MC06132",,"Unilever Kenya Ltd:Vim","Vim Lemon Fresh 12x1Kg","Income","Vim Powder Lemon Fresh 12x1Kg",,"Accounts Receivable","",368274.20,34087966.21
,"Invoice","11-09-2024","MC06138",,"Unilever Kenya Ltd:Vim","Vim Lemon Fresh 12x1Kg","Income","Vim Powder Lemon Fresh 12x1Kg",,"Accounts Receivable","",257040.36,34345006.57
,"Invoice","13-09-2024","MC06150",,"Unilever Kenya Ltd:Vim","Vim Lemon Fresh 12x1Kg","Income","Vim Powder Lemon Fresh 12x1Kg",,"Accounts Receivable","",441177.46,34786184.03
,"Invoice","19-09-2024","MC06168",,"Unilever Kenya Ltd:Vim","Vim Lemon Fresh 12x1Kg","Income","Vim Powder Lemon Fresh 12x1Kg",,"Accounts Receivable","",368274.20,35154458.23
,"Invoice","23-09-2024","MC06183",,"Unilever Kenya Ltd:Vim","Vim Lemon Fresh 12x1Kg","Income","Vim Powder Lemon Fresh 12x1Kg",,"Accounts Receivable","",520844.94,35675303.17
,"Invoice","24-09-2024","MC06190",,"Unilever Kenya Ltd:Vim","Vim Lemon Fresh 12x1Kg","Income","Vim Powder Lemon Fresh 12x1Kg",,"Accounts Receivable","",592245.04,36267548.21
,"Invoice","25-09-2024","MC06201",,"Unilever Kenya Ltd:Vim","Vim Lemon Fresh 12x1Kg","Income","Vim Powder Lemon Fresh 12x1Kg",,"Accounts Receivable","",105221.20,36372769.41
,"Invoice","27-09-2024","MC06208",,"Unilever Kenya Ltd:Vim","Vim Lemon Fresh 12x1Kg","Income","Vim Powder Lemon Fresh 12x1Kg",,"Accounts Receivable","",616295.60,36989065.01
,"Invoice","30-09-2024","MC06219",,"Unilever Kenya Ltd:Vim","Vim Lemon Fresh 12x1Kg","Income","Vim Powder Lemon Fresh 12x1Kg",,"Accounts Receivable","",789159.00,37778224.01
,"Invoice","09-10-2024","MC06245",,"Unilever Kenya Ltd:Vim","Vim Lemon Fresh 12x1Kg","Income","Vim Powder Lemon Fresh 12x1Kg",,"Accounts Receivable","",365681.36,38143905.37
,"Invoice","09-10-2024","MC06247",,"Unilever Kenya Ltd:Vim","Vim Lemon Fresh 12x1Kg","Income","Vim Powder Lemon Fresh 12x1Kg",,"Accounts Receivable","",264439.00,38408344.37
,"Invoice","14-10-2024","MC06253",,"Unilever Kenya Ltd:Vim","Vim Lemon Fresh 12x1Kg","Income","Vim Powder Lemon Fresh 12x1Kg",,"Accounts Receivable","",450301.84,38858646.21
,"Invoice","14-10-2024","MC06258",,"Unilever Kenya Ltd:Vim","Vim Lemon Fresh 12x1Kg","Income","Vim Powder Lemon Fresh 12x1Kg",,"Accounts Receivable","",52887.80,38911534.01
,"Invoice","15-10-2024","MC06260",,"Unilever Kenya Ltd:Vim","Vim Lemon Fresh 12x1Kg","Income","Vim Powder Lemon Fresh 12x1Kg",,"Accounts Receivable","",358125.96,39269659.97
,"Invoice","16-10-2024","MC06265",,"Unilever Kenya Ltd:Vim","Vim Lemon Fresh 12x1Kg","Income","Vim Powder Lemon Fresh 12x1Kg",,"Accounts Receivable","",361148.12,39630808.09
,"Invoice","18-10-2024","MC06282",,"Unilever Kenya Ltd:Vim","Vim Lemon Fresh 12x1Kg","Income","Vim Powder Lemon Fresh 12x1Kg",,"Accounts Receivable","",435946.58,40066754.67
,"Invoice","24-10-2024","MC06292",,"Unilever Kenya Ltd:Vim","Vim Lemon Fresh 12x1Kg","Income","Vim Powder Lemon Fresh 12x1Kg",,"Accounts Receivable","",158663.40,40225418.07
,"Invoice","24-10-2024","MC06293",,"Unilever Kenya Ltd:Vim","Vim Lemon Fresh 12x1Kg","Income","Vim Powder Lemon Fresh 12x1Kg",,"Accounts Receivable","",737407.04,40962825.11
,"Invoice","25-10-2024","MC06295",,"Unilever Kenya Ltd:Vim","Vim Lemon Fresh 12x1Kg","Income","Vim Powder Lemon Fresh 12x1Kg",,"Accounts Receivable","",317326.80,41280151.91
,"Invoice","30-10-2024","MC06320",,"Unilever Kenya Ltd:Vim","Vim Lemon Fresh 12x1Kg","Income","Vim Powder Lemon Fresh 12x1Kg",,"Accounts Receivable","",223639.84,41503791.75
,"Invoice","04-11-2024","MC06327",,"Unilever Kenya Ltd:Vim","Vim Lemon Fresh 12x1Kg","Income","Vim Powder Lemon Fresh 12x1Kg",,"Accounts Receivable","",158663.40,41662455.15
,"Invoice","05-11-2024","MC06329",,"Unilever Kenya Ltd:Vim","Vim Lemon Fresh 12x1Kg","Income","Vim Powder Lemon Fresh 12x1Kg",,"Accounts Receivable","",581765.80,42244220.95
,"Invoice","07-11-2024","MC06340",,"Unilever Kenya Ltd:Vim","Vim Lemon Fresh 12x1Kg","Income","Vim Powder Lemon Fresh 12x1Kg",,"Accounts Receivable","",333193.14,42577414.09
,"Invoice","15-11-2024","MC06364",,"Unilever Kenya Ltd:Vim","Vim Lemon Fresh 12x1Kg","Income","Vim Powder Lemon Fresh 12x1Kg",,"Accounts Receivable","",1028289.94,43605704.03
,"Invoice","20-11-2024","MC06388",,"Unilever Kenya Ltd:Vim","Vim Lemon Fresh 12x1Kg","Income","Vim Powder Lemon Fresh 12x1Kg",,"Accounts Receivable","",29466.06,43635170.09
,"Invoice","22-11-2024","MC06402",,"Unilever Kenya Ltd:Vim","Vim Lemon Fresh 12x1Kg","Income","Vim Powder Lemon Fresh 12x1Kg",,"Accounts Receivable","",225150.92,43860321.01
,"Invoice","23-11-2024","MC06406",,"Unilever Kenya Ltd:Vim","Vim Lemon Fresh 12x1Kg","Income","Vim Powder Lemon Fresh 12x1Kg",,"Accounts Receivable","",399680.66,44260001.67
,"Credit Note","25-11-2024","CN01075",,"Unilever Kenya Ltd:Vim","Vim Lemon Fresh 12x1Kg","Income","Vim Powder Lemon Fresh 12x1Kg",,"Accounts Receivable",399680.66,"",43860321.01
,"Invoice","25-11-2024","MC06410",,"Unilever Kenya Ltd:Vim","Vim Lemon Fresh 12x1Kg","Income","Vim Powder Lemon Fresh 12x1Kg",,"Accounts Receivable","",398925.12,44259246.13
,"Invoice","26-11-2024","MC06414",,"Unilever Kenya Ltd:Vim","Vim Lemon Fresh 12x1Kg","Income","Vim Powder Lemon Fresh 12x1Kg",,"Accounts Receivable","",807672.26,45066918.39
,"Invoice","30-11-2024","MC06428",,"Unilever Kenya Ltd:Vim","Vim Lemon Fresh 12x1Kg","Income","Vim Powder Lemon Fresh 12x1Kg",,"Accounts Receivable","",222128.76,45289047.15
,"Invoice","02-12-2024","MC06433",,"Unilever Kenya Ltd:Vim","Vim Lemon Fresh 12x1Kg","Income","Vim Powder Lemon Fresh 12x1Kg",,"Accounts Receivable","",324882.20,45613929.35
,"Invoice","04-12-2024","MC06446",,"Unilever Kenya Ltd:Vim","Vim Lemon Fresh 12x1Kg","Income","Vim Powder Lemon Fresh 12x1Kg",,"Accounts Receivable","",528878.00,46142807.35
,"Invoice","05-12-2024","MC06449",,"Unilever Kenya Ltd:Vim","Vim Lemon Fresh 12x1Kg","Income","Vim Powder Lemon Fresh 12x1Kg",,"Accounts Receivable","",211551.20,46354358.55
,"Invoice","11-12-2024","MC06458",,"Unilever Kenya Ltd:Vim","Vim Lemon Fresh 12x1Kg","Income","Vim Powder Lemon Fresh 12x1Kg",,"Accounts Receivable","",883981.80,47238340.35
,"Invoice","13-12-2024","MC06464",,"Unilever Kenya Ltd:Vim","Vim Lemon Fresh 12x1Kg","Income","Vim Powder Lemon Fresh 12x1Kg",,"Accounts Receivable","",525100.30,47763440.65
,"Invoice","14-12-2024","MC06468",,"Unilever Kenya Ltd:Vim","Vim Lemon Fresh 12x1Kg","Income","Vim Powder Lemon Fresh 12x1Kg",,"Accounts Receivable","",52887.80,47816328.45
,"Invoice","18-12-2024","MC06486",,"Unilever Kenya Ltd:Vim","Vim Lemon Fresh 12x1Kg","Income","Vim Powder Lemon Fresh 12x1Kg",,"Accounts Receivable","",475990.20,48292318.65
,"Invoice","19-12-2024","MC06490",,"Unilever Kenya Ltd:Vim","Vim Lemon Fresh 12x1Kg","Income","Vim Powder Lemon Fresh 12x1Kg",,"Accounts Receivable","",400436.20,48692754.85
,"Invoice","20-12-2024","MC06495",,"Unilever Kenya Ltd:Vim","Vim Lemon Fresh 12x1Kg","Income","Vim Powder Lemon Fresh 12x1Kg",,"Accounts Receivable","",671675.06,49364429.91
,"Invoice","24-12-2024","MC06506",,"Unilever Kenya Ltd:Vim","Vim Lemon Fresh 12x1Kg","Income","Vim Powder Lemon Fresh 12x1Kg",,"Accounts Receivable","",264439.00,49628868.91
,"Invoice","24-12-2024","MC06508",,"Unilever Kenya Ltd:Vim","Vim Lemon Fresh 12x1Kg","Income","Vim Powder Lemon Fresh 12x1Kg",,"Accounts Receivable","",158663.40,49787532.31
,"Invoice","24-12-2024","MC06511",,"Unilever Kenya Ltd:Vim","Vim Lemon Fresh 12x1Kg","Income","Vim Powder Lemon Fresh 12x1Kg",,"Accounts Receivable","",528878.00,50316410.31
,"Invoice","24-12-2024","MC06515",,"Unilever Kenya Ltd:Vim","Vim Lemon Fresh 12x1Kg","Income","Vim Powder Lemon Fresh 12x1Kg",,"Accounts Receivable","",51376.72,50367787.03
"Total Vim Powder Lemon Fresh 12x1Kg",,,,,,,,,,,399680.66,50767467.69,50367787.03
"Total Vim Lemon",,,,,,,,,,,413037.14,170775744.49,170362707.35
"Vim - Other",,,,,,,,,,,,,""
,"Invoice","10-01-2024","MC05291",,"Unilever Kenya Ltd:Vim","Vim Scourer Lmn 12X(1Kg+ Vim Lvr 1Kg)","Income","Vim",,"Accounts Receivable","",15668.40,15668.40
,"Invoice","11-01-2024","MC05295",,"Unilever Kenya Ltd:Vim","Vim Scourer Lmn 12X(1Kg+ Vim Lvr 1Kg)","Income","Vim",,"Accounts Receivable","",109678.80,125347.20
,"Invoice","19-01-2024","MC05336",,"Unilever Kenya Ltd:Vim","Vim Scourer Lmn 12X(1Kg+ Vim Lvr 1Kg)","Income","Vim",,"Accounts Receivable","",70507.80,195855.00
,"Invoice","26-01-2024","MC05357",,"Unilever Kenya Ltd:Vim","Vim Scourer Lmn 12X(1Kg+ Vim Lvr 1Kg)","Income","Vim",,"Accounts Receivable","",109678.80,305533.80
,"Invoice","01-02-2024","MC05376",,"Unilever Kenya Ltd:Vim","Vim Scourer Lmn 12X(1Kg+ Vim Lvr 1Kg)","Income","Vim",,"Accounts Receivable","",54839.40,360373.20
,"Invoice","01-02-2024","MC05377",,"Unilever Kenya Ltd","Outer Vim Lemon fresh + Lavender 6x2x1kg","Income","Vim",,"Accounts Receivable","",1337.55,361710.75
,"Invoice","07-02-2024","MC05391",,"Unilever Kenya Ltd:Vim","Vim Scourer Lmn 12X(1Kg+ Vim Lvr 1Kg)","Income","Vim",,"Accounts Receivable","",53272.56,414983.31
,"Invoice","12-02-2024","MC05399",,"Unilever Kenya Ltd:Vim","Vim Scourer Lmn 12X(1Kg+ Vim Lvr 1Kg)","Income","Vim",,"Accounts Receivable","",181753.44,596736.75
,"Invoice","16-02-2024","MC05411",,"Unilever Kenya Ltd:Vim","Vim Scourer Lmn 12X(1Kg+ Vim Lvr 1Kg)","Income","Vim",,"Accounts Receivable","",109678.80,706415.55
,"Invoice","22-02-2024","MC05425",,"Unilever Kenya Ltd:Vim","Vim Scourer Lmn 12X(1Kg+ Vim Lvr 1Kg)","Income","Vim",,"Accounts Receivable","",125347.20,831762.75
,"Invoice","23-02-2024","MC05442",,"Unilever Kenya Ltd:Vim","Vim Scourer Lmn 12X(1Kg+ Vim Lvr 1Kg)","Income","Vim",,"Accounts Receivable","",53272.56,885035.31
,"Invoice","05-03-2024","MC05468",,"Unilever Kenya Ltd:Vim","Vim Scourer Lmn 12X(1Kg+ Vim Lvr 1Kg)","Income","Vim",,"Accounts Receivable","",231892.32,1116927.63
,"Invoice","12-03-2024","MC05491",,"Unilever Kenya Ltd:Vim","Vim Scourer Lmn 12X(1Kg+ Vim Lvr 1Kg)","Income","Vim",,"Accounts Receivable","",211523.40,1328451.03
,"Invoice","20-03-2024","MC05506",,"Unilever Kenya Ltd:Vim","Vim Scourer Lmn 12X(1Kg+ Vim Lvr 1Kg)","Income","Vim",,"Accounts Receivable","",125347.20,1453798.23
,"Invoice","26-03-2024","MC05538",,"Unilever Kenya Ltd:Vim","Vim Scourer Lmn 12X(1Kg+ Vim Lvr 1Kg)","Income","Vim",,"Accounts Receivable","",125347.20,1579145.43
,"Invoice","04-04-2024","MC05560",,"Unilever Kenya Ltd:Vim","Vim Scourer Lmn 12X(1Kg+ Vim Lvr 1Kg)","Income","Vim",,"Accounts Receivable","",254527.23,1833672.66
,"Invoice","05-04-2024","MC05575",,"Unilever Kenya Ltd:Vim","Vim Scourer Lmn 12X(1Kg+ Vim Lvr 1Kg)","Income","Vim",,"Accounts Receivable","",217490.76,2051163.42
,"Invoice","12-04-2024","MC05596",,"Unilever Kenya Ltd:Vim","Vim Scourer Lmn 12X(1Kg+ Vim Lvr 1Kg)","Income","Vim",,"Accounts Receivable","",16548.21,2067711.63
,"Invoice","24-04-2024","MC05635",,"Unilever Kenya Ltd:Vim","Vim Scourer Lmn 12X(1Kg+ Vim Lvr 1Kg)","Income","Vim",,"Accounts Receivable","",204094.59,2271806.22
,"Invoice","03-05-2024","MC05663",,"Unilever Kenya Ltd:Vim","Vim Scourer Lmn 12X(1Kg+ Vim Lvr 1Kg)","Income","Vim",,"Accounts Receivable","",266347.38,2538153.60
,"Invoice","09-05-2024","MC05692",,"Unilever Kenya Ltd:Vim","Vim Scourer Lmn 12X(1Kg+ Vim Lvr 1Kg)","Income","Vim",,"Accounts Receivable","",252163.20,2790316.80
,"Invoice","21-05-2024","MC05726",,"Unilever Kenya Ltd:Vim","Vim Scourer Lmn 12X(1Kg+ Vim Lvr 1Kg)","Income","Vim",,"Accounts Receivable","",110321.40,2900638.20
,"Invoice","23-05-2024","MC05736",,"Unilever Kenya Ltd:Vim","Vim Scourer Lmn 12X(1Kg+ Vim Lvr 1Kg)","Income","Vim",,"Accounts Receivable","",173362.20,3074000.40
,"Invoice","30-05-2024","MC05780",,"Unilever Kenya Ltd:Vim","Vim Scourer Lmn 12X(1Kg+ Vim Lvr 1Kg)","Income","Vim",,"Accounts Receivable","",165482.10,3239482.50
,"Invoice","10-06-2024","MC05809",,"Unilever Kenya Ltd:Vim","Vim Scourer Lmn 12X(1Kg+ Vim Lvr 1Kg)","Income","Vim",,"Accounts Receivable","",86681.10,3326163.60
,"Invoice","11-06-2024","MC05813",,"Unilever Kenya Ltd:Vim","Vim Scourer Lmn 12X(1Kg+ Vim Lvr 1Kg)","Income","Vim",,"Accounts Receivable","",55160.70,3381324.30
,"Invoice","11-06-2024","MC05814",,"Unilever Kenya Ltd:Plastics","-MULTIPLE-","Income","Vim",,"Accounts Receivable","",206200.00,3587524.30
,"Invoice","14-06-2024","MC05826",,"Unilever Kenya Ltd:Vim","Vim Scourer Lmn 12X(1Kg+ Vim Lvr 1Kg)","Income","Vim",,"Accounts Receivable","",110321.40,3697845.70
,"Invoice","02-07-2024","MC05878",,"Unilever Kenya Ltd:Vim","Vim Scourer Lmn 12X(1Kg+ Vim Lvr 1Kg)","Income","Vim",,"Accounts Receivable","",239442.00,3937287.70
,"Invoice","09-07-2024","MC05907",,"Unilever Kenya Ltd:Vim","Vim Scourer Lmn 12X(1Kg+ Vim Lvr 1Kg)","Income","Vim",,"Accounts Receivable","",111739.60,4049027.30
,"Invoice","09-07-2024","MC05909",,"Unilever Kenya Ltd:Vim","Vim Scourer Lmn 12X(1Kg+ Vim Lvr 1Kg)","Income","Vim",,"Accounts Receivable","",124509.84,4173537.14
,"Invoice","12-07-2024","MC05919",,"Unilever Kenya Ltd:Vim","Vim Scourer Lmn 12X(1Kg+ Vim Lvr 1Kg)","Income","Vim",,"Accounts Receivable","",167609.40,4341146.54
,"Invoice","15-07-2024","MC05930",,"Unilever Kenya Ltd:Vim","Vim Scourer Lmn 12X(1Kg+ Vim Lvr 1Kg)","Income","Vim",,"Accounts Receivable","",150050.32,4491196.86
,"Invoice","26-07-2024","MC05975",,"Unilever Kenya Ltd:Vim","Vim Scourer Lmn 12X(1Kg+ Vim Lvr 1Kg)","Income","Vim",,"Accounts Receivable","",217094.08,4708290.94
,"Invoice","08-08-2024","MC06010",,"Unilever Kenya Ltd:Vim","Vim Scourer Lmn 12X(1Kg+ Vim Lvr 1Kg)","Income","Vim",,"Accounts Receivable","",55869.80,4764160.74
,"Invoice","09-08-2024","MC06027",,"Unilever Kenya Ltd:Vim","Vim Scourer Lmn 12X(1Kg+ Vim Lvr 1Kg)","Income","Vim",,"Accounts Receivable","",239442.00,5003602.74
,"Invoice","21-08-2024","MC06060",,"Unilever Kenya Ltd:Vim","Vim Scourer Lmn 12X(1Kg+ Vim Lvr 1Kg)","Income","Vim",,"Accounts Receivable","",255404.80,5259007.54
,"Invoice","04-09-2024","MC06115",,"Unilever Kenya Ltd:Vim","Vim Scourer Lmn 12X(1Kg+ Vim Lvr 1Kg)","Income","Vim",,"Accounts Receivable","",127702.40,5386709.94
,"Invoice","06-09-2024","MC06129",,"Unilever Kenya Ltd:Vim","Vim Scourer Lmn 12X(1Kg+ Vim Lvr 1Kg)","Income","Vim",,"Accounts Receivable","",349585.32,5736295.26
,"Invoice","19-09-2024","MC06172",,"Unilever Kenya Ltd:Plastics","Vim Powder Canister 500g","Income","Vim",,"Accounts Receivable","",339075.20,6075370.46
,"Invoice","20-09-2024","MC06176",,"Unilever Kenya Ltd:Vim","Vim Scourer Lmn 12X(1Kg+ Vim Lvr 1Kg)","Income","Vim",,"Accounts Receivable","",111739.60,6187110.06
,"Invoice","20-09-2024","MC06177",,"Unilever Kenya Ltd:Plastics","Vim Powder Canister 500g","Income","Vim",,"Accounts Receivable","",344061.60,6531171.66
,"Invoice","23-09-2024","MC06187",,"Unilever Kenya Ltd:Vim","Vim Scourer Lmn 12X(1Kg+ Vim Lvr 1Kg)","Income","Vim",,"Accounts Receivable","",111739.60,6642911.26
,"Invoice","30-09-2024","MC06221",,"Unilever Kenya Ltd:Vim","Vim Scourer Lmn 12X(1Kg+ Vim Lvr 1Kg)","Income","Vim",,"Accounts Receivable","",15962.80,6658874.06
,"Invoice","30-09-2024","MC06223",,"Unilever Kenya Ltd:Vim","Vim Scourer Lmn 12X(1Kg+ Vim Lvr 1Kg)","Income","Vim",,"Accounts Receivable","",55869.80,6714743.86
,"Invoice","03-10-2024","MC06229",,"Unilever Kenya Ltd:Vim","Vim Scourer Lmn 12X(1Kg+ Vim Lvr 1Kg)","Income","Vim",,"Accounts Receivable","",126606.40,6841350.26
,"Invoice","09-10-2024","MC06250",,"Unilever Kenya Ltd:Vim","Vim Scourer Lmn 12X(1Kg+ Vim Lvr 1Kg)","Income","Vim",,"Accounts Receivable","",221561.20,7062911.46
,"Invoice","17-10-2024","MC06274",,"Unilever Kenya Ltd:Vim","Vim Scourer Lmn 12X(1Kg+ Vim Lvr 1Kg)","Income","Vim",,"Accounts Receivable","",181996.70,7244908.16
,"Invoice","22-10-2024","MC06288",,"Unilever Kenya Ltd:Vim","Vim Scourer Lmn 12X(1Kg+ Vim Lvr 1Kg)","Income","Vim",,"Accounts Receivable","",183579.28,7428487.44
,"Invoice","30-10-2024","MC06321",,"Unilever Kenya Ltd:Vim","Vim Scourer Lmn 12X(1Kg+ Vim Lvr 1Kg)","Income","Vim",,"Accounts Receivable","",181996.70,7610484.14
,"Invoice","07-11-2024","MC06344",,"Unilever Kenya Ltd:Vim","Vim Scourer Lmn 12X(1Kg+ Vim Lvr 1Kg)","Income","Vim",,"Accounts Receivable","",237387.00,7847871.14
,"Invoice","20-11-2024","MC06385",,"Unilever Kenya Ltd:Vim","Vim Scourer Lmn 12X(1Kg+ Vim Lvr 1Kg)","Income","Vim",,"Accounts Receivable","",55390.30,7903261.44
,"Invoice","20-11-2024","MC06391",,"Unilever Kenya Ltd:Vim","Vim Scourer Lmn 12X(1Kg+ Vim Lvr 1Kg)","Income","Vim",,"Accounts Receivable","",181996.70,8085258.14
,"Invoice","21-11-2024","MC06398",,"Unilever Kenya Ltd:Vim","Vim Scourer Lmn 12X(1Kg+ Vim Lvr 1Kg)","Income","Vim",,"Accounts Receivable","",221561.20,8306819.34
,"Invoice","28-11-2024","MC06421",,"Unilever Kenya Ltd:Vim","Vim Scourer Lmn 12X(1Kg+ Vim Lvr 1Kg)","Income","Vim",,"Accounts Receivable","",120276.08,8427095.42
,"Invoice","05-12-2024","MC06448",,"Unilever Kenya Ltd:Vim","Vim Scourer Lmn 12X(1Kg+ Vim Lvr 1Kg)","Income","Vim",,"Accounts Receivable","",166170.90,8593266.32
,"Invoice","17-12-2024","MC06473",,"Unilever Kenya Ltd:Vim","Vim Scourer Lmn 12X(1Kg+ Vim Lvr 1Kg)","Income","Vim",,"Accounts Receivable","",71216.10,8664482.42
,"Invoice","19-12-2024","MC06491",,"Unilever Kenya Ltd:Vim","Vim Scourer Lmn 12X(1Kg+ Vim Lvr 1Kg)","Income","Vim",,"Accounts Receivable","",110780.60,8775263.02
,"Invoice","24-12-2024","MC06510",,"Unilever Kenya Ltd:Vim","Vim Scourer Lmn 12X(1Kg+ Vim Lvr 1Kg)","Income","Vim",,"Accounts Receivable","",332341.80,9107604.82
"Total Vim - Other",,,,,,,,,,,0.00,9107604.82,9107604.82
"Total Vim",,,,,,,,,,,1428424.18,243175622.96,241747198.78
"Sales - Other",,,,,,,,,,,,,""
,"Bill","30-01-2024","0020107030000380428",,"Towfiq Kenya Limited","Dettol Soap 175g","Income","Sales",,"Accounts Payable",41940.00,"",-41940.00
,"Invoice","01-02-2024","MC05373",,"THE M-PESA ACADEMY","Dettol Soap 175g","Income","Sales",,"Accounts Receivable","",52600.00,10660.00
,"Invoice","12-02-2024","MC05395",,"THE M-PESA ACADEMY","Dettol Soap 175g","Income","Sales",,"Accounts Receivable","",45344.83,56004.83
,"Credit Note","12-02-2024","CN01056",,"THE M-PESA ACADEMY","Dettol Soap 175g","Income","Sales",,"Accounts Receivable",52600.00,"",3404.83
,"Bill","21-02-2024","0020107030000389364",,"Towfiq Kenya Limited","Dettol Soap 175g","Income","Sales",,"Accounts Payable",62910.00,"",-59505.17
,"Invoice","21-02-2024","MC05422",,"THE M-PESA ACADEMY","Dettol Soap 175g","Income","Sales",,"Accounts Receivable","",68017.24,8512.07
,"Invoice","23-05-2024","MC05738",,"THE M-PESA ACADEMY","Dettol Soap 175g","Income","Sales",,"Accounts Receivable","",71896.55,80408.62
,"Bill","23-05-2024","0020107030000428668",,"Towfiq Kenya Limited","Dettol Soap 175g","Income","Sales",,"Accounts Payable",64308.00,"",16100.62
,"Invoice","31-07-2024","MC05989",,"Clarjos Enterprise","Stretchfilm","Income","Sales",,"Accounts Receivable","",7830.00,23930.62
,"Invoice","18-09-2024","MC06166",,"THE M-PESA ACADEMY","Dettol Soap 175g","Income","Sales",,"Accounts Receivable","",49000.00,72930.62
,"Bill","18-09-2024","0020107030000474115",,"Towfiq Kenya Limited","Dettol Soap 175g","Income","Sales",,"Accounts Payable",42447.94,"",30482.68
"Total Sales - Other",,,,,,,,,,,264205.94,294688.62,30482.68
"Total Sales",,,,,,,,,,,1965497.08,291575149.34,289609652.26
"Total Income",,,,,,,,,,,1965497.08,291575149.34,289609652.26
"Cost of Goods Sold",,,,,,,,,,,,,""
"Cost of Goods Sold",,,,,,,,,,,,,""
"Zelia",,,,,,,,,,,,,""
"Zelia Machine Wash",,,,,,,,,,,,,""
,"Sales Receipt","06-11-2024","3402",,"Cash Sales","Zelia Machine Wash 16x750ML","Cost of Goods Sold","Zelia Machine Wash",,"Undeposited Funds",67.96,"",67.96
,"Build Assembly","08-11-2024","11902",,,,"Cost of Goods Sold","Zelia Machine Wash","X","-SPLIT-",5.93,"",73.89
,"Sales Receipt","12-11-2024","3431",,"Cash Sales","-MULTIPLE-","Cost of Goods Sold","Zelia Machine Wash",,"Undeposited Funds",1153.78,"",1227.67
,"Sales Receipt","18-11-2024","3473",,"Cash Sales","Zelia Machine Wash 16x750ML","Cost of Goods Sold","Zelia Machine Wash",,"Undeposited Funds",73.90,"",1301.57
,"Sales Receipt","22-11-2024","3499",,"Cash Sales","Zelia Machine Wash 16x750ML","Cost of Goods Sold","Zelia Machine Wash",,"Undeposited Funds",147.79,"",1449.36
,"Sales Receipt","28-11-2024","3750",,"Cash Sales","Zelia Machine Wash 4x5L","Cost of Goods Sold","Zelia Machine Wash",,"Undeposited Funds",253.45,"",1702.81
,"Sales Receipt","28-11-2024","3751",,"Cash Sales","Zelia Machine Wash 4x5L","Cost of Goods Sold","Zelia Machine Wash",,"Undeposited Funds",253.45,"",1956.26
,"Sales Receipt","30-11-2024","AT203",,"Cash Sales","-MULTIPLE-","Cost of Goods Sold","Zelia Machine Wash",,"Undeposited Funds",1983.22,"",3939.48
,"Sales Receipt","02-12-2024","3767",,"Cash Sales","Zelia Machine Wash 9x1.5L","Cost of Goods Sold","Zelia Machine Wash",,"Undeposited Funds",119.99,"",4059.47
,"Build Assembly","04-12-2024","12142",,,,"Cost of Goods Sold","Zelia Machine Wash","X","-SPLIT-",232.83,"",4292.30
,"Sales Receipt","09-12-2024","3318",,"Cash Sales","Zelia Machine Wash 16x750ML","Cost of Goods Sold","Zelia Machine Wash",,"Undeposited Funds",73.90,"",4366.20
,"Sales Receipt","16-12-2024","3348",,"Cash Sales","Zelia Machine Wash 4x5L","Cost of Goods Sold","Zelia Machine Wash",,"Undeposited Funds",292.25,"",4658.45
,"Sales Receipt","17-12-2024","3355",,"Cash Sales","Zelia Machine Wash 4x5L","Cost of Goods Sold","Zelia Machine Wash",,"Undeposited Funds",584.51,"",5242.96
,"Sales Receipt","19-12-2024","3373",,"Cash Sales","Zelia Machine Wash 4x5L","Cost of Goods Sold","Zelia Machine Wash",,"Undeposited Funds",292.25,"",5535.21
"Total Zelia Machine Wash",,,,,,,,,,,5535.21,0.00,5535.21
"Fuel Gel",,,,,,,,,,,,,""
,"Sales Receipt","23-07-2024","2581",,"Cash Sales","Flem Fuel Gel 200ML","Cost of Goods Sold","Fuel Gel",,"Undeposited Funds",82.88,"",82.88
,"Build Assembly","26-07-2024","11033",,,,"Cost of Goods Sold","Fuel Gel","X","-SPLIT-",6.33,"",89.21
,"Sales Receipt","29-07-2024","2602",,"Cash Sales","Flem Fuel Gel 200ML","Cost of Goods Sold","Fuel Gel",,"Undeposited Funds",44.60,"",133.81
,"Sales Receipt","29-07-2024","2603",,"Cash Sales","Flem Fuel Gel 200ML","Cost of Goods Sold","Fuel Gel",,"Undeposited Funds",44.60,"",178.41
,"Sales Receipt","01-08-2024","2636",,"Cash Sales","Flem Fuel Gel 200ML","Cost of Goods Sold","Fuel Gel",,"Undeposited Funds",89.21,"",267.62
,"Sales Receipt","02-08-2024","2651",,"Cash Sales","-MULTIPLE-","Cost of Goods Sold","Fuel Gel",,"Undeposited Funds",93.69,"",361.31
,"Sales Receipt","06-08-2024","2662",,"Cash Sales","Flem Fuel Gel 200ML","Cost of Goods Sold","Fuel Gel",,"Undeposited Funds",133.81,"",495.12
,"Sales Receipt","08-08-2024","2685",,"Cash Sales","Flem Fuel Gel 500ML","Cost of Goods Sold","Fuel Gel",,"Undeposited Funds",49.09,"",544.21
,"Sales Receipt","09-08-2024","2696",,"Cash Sales","Flem Fuel Gel 200ML","Cost of Goods Sold","Fuel Gel",,"Undeposited Funds",89.21,"",633.42
,"Invoice","14-08-2024","MC06036",,"Entumoto Safari Camp Ltd","-MULTIPLE-","Cost of Goods Sold","Fuel Gel",,"Accounts Receivable",4311.06,"",4944.48
,"Build Assembly","14-08-2024","11315",,,,"Cost of Goods Sold","Fuel Gel","X","-SPLIT-",151.85,"",5096.33
,"Sales Receipt","16-08-2024","2903",,"Cash Sales","Flem Fuel Gel 200ML","Cost of Goods Sold","Fuel Gel",,"Undeposited Funds",89.21,"",5185.54
,"Sales Receipt","19-08-2024","2838",,"Cash Sales","Flem Fuel Gel 200ML","Cost of Goods Sold","Fuel Gel",,"Undeposited Funds",178.41,"",5363.95
,"Sales Receipt","19-08-2024","2839",,"Cash Sales","Flem Fuel Gel 200ML","Cost of Goods Sold","Fuel Gel",,"Undeposited Funds",89.21,"",5453.16
,"Invoice","21-08-2024","MC06061",,"Muhaya & Rukundo Holdings Ltd","-MULTIPLE-","Cost of Goods Sold","Fuel Gel",,"Accounts Receivable",30421.80,"",35874.96
,"Build Assembly","21-08-2024","11199",,,,"Cost of Goods Sold","Fuel Gel","X","-SPLIT-",2.56,"",35877.52
,"Build Assembly","21-08-2024","11297",,,,"Cost of Goods Sold","Fuel Gel","X","-SPLIT-",783.48,"",36661.00
,"Build Assembly","21-08-2024","11314",,,,"Cost of Goods Sold","Fuel Gel","X","-SPLIT-","",3745.98,32915.02
,"Sales Receipt","03-09-2024","2922",,"Cash Sales","Flem Fuel Gel 48X200ML","Cost of Goods Sold","Fuel Gel",,"Undeposited Funds",84.51,"",32999.53
,"Sales Receipt","05-09-2024","2952",,"Cash Sales","Flem Fuel Gel 48X200ML","Cost of Goods Sold","Fuel Gel",,"Undeposited Funds",126.76,"",33126.29
,"Invoice","11-09-2024","MC06137",,"MUTHU SILVER SPRINGS MANAGEMENT LIMITED","Flem Fuel Gel 48X200ML","Cost of Goods Sold","Fuel Gel",,"Accounts Receivable",2028.12,"",35154.41
,"Invoice","11-10-2024","MC06251",,"HOPEMART SELF SERVICES LTD","Flem Fuel Gel 48X200ML  6 Pieces @96.28","Cost of Goods Sold","Fuel Gel",,"Accounts Receivable",253.52,"",35407.93
,"Invoice","07-11-2024","MC06337",,"HOTEL MONARCH LIMITED","Flem Fuel Gel 5L","Cost of Goods Sold","Fuel Gel",,"Accounts Receivable",1826.35,"",37234.28
,"Build Assembly","07-11-2024","11897",,,,"Cost of Goods Sold","Fuel Gel","X","-SPLIT-","",51.84,37182.44
,"Invoice","11-11-2024","MC06351",,"HOTEL MONARCH LIMITED","Flem Fuel Gel 5L","Cost of Goods Sold","Fuel Gel",,"Accounts Receivable",2196.55,"",39378.99
,"Sales Receipt","14-11-2024","3727",,"Cash Sales","Flem Fuel Gel 48X200ML","Cost of Goods Sold","Fuel Gel",,"Undeposited Funds",86.30,"",39465.29
,"Sales Receipt","18-11-2024","3455",,"Cash Sales","Flem Fuel Gel 500ML","Cost of Goods Sold","Fuel Gel",,"Undeposited Funds",51.65,"",39516.94
,"Invoice","19-11-2024","MC06380",,"HOTEL MONARCH LIMITED","Flem Fuel Gel 5L","Cost of Goods Sold","Fuel Gel",,"Accounts Receivable",2196.55,"",41713.49
,"Credit Note","19-11-2024","CN01074",,"HOTEL MONARCH LIMITED","Flem Fuel Gel 5L","Cost of Goods Sold","Fuel Gel",,"Accounts Receivable","",2196.55,39516.94
,"Sales Receipt","19-11-2024","3471",,"Kedulle Enterprises","Flem Fuel Gel 48X200ML","Cost of Goods Sold","Fuel Gel",,"Undeposited Funds",1035.51,"",40552.45
,"Sales Receipt","19-11-2024","3749",,"Kedulle Enterprises","Flem Fuel Gel 500ML","Cost of Goods Sold","Fuel Gel",,"Undeposited Funds",1032.99,"",41585.44
,"Sales Receipt","20-11-2024","3477",,"Cash Sales","Flem Fuel Gel 48X200ML","Cost of Goods Sold","Fuel Gel",,"Undeposited Funds",43.14,"",41628.58
,"Sales Receipt","22-11-2024","3485",,"Cash Sales","Flem Fuel Gel 500ML","Cost of Goods Sold","Fuel Gel",,"Undeposited Funds",258.25,"",41886.83
,"Sales Receipt","22-11-2024","3487",,"Cash Sales","Flem Fuel Gel 500ML","Cost of Goods Sold","Fuel Gel",,"Undeposited Funds",51.65,"",41938.48
,"Sales Receipt","10-12-2024","3322",,"Cash Sales","Flem Fuel Gel 5L Label","Cost of Goods Sold","Fuel Gel",,"Undeposited Funds",15.83,"",41954.31
"Total Fuel Gel",,,,,,,,,,,47948.68,5994.37,41954.31
"Carneli Shower Gel",,,,,,,,,,,,,""
,"Sales Receipt","03-01-2024","1598",,"Cash Sales","-MULTIPLE-","Cost of Goods Sold","Carneli Shower Gel",,"Undeposited Funds",192.97,"",192.97
,"Sales Receipt","11-01-2024","1723",,"Cash Sales","Carneli Sweet Vanilla Shower Gel 400ML","Cost of Goods Sold","Carneli Shower Gel",,"Undeposited Funds",2269.68,"",2462.65
,"Sales Receipt","12-01-2024","1727",,"Cash Sales","Carneli Sweet Vanilla Shower Gel 400ML","Cost of Goods Sold","Carneli Shower Gel",,"Undeposited Funds",98.68,"",2561.33
,"Sales Receipt","19-01-2024","1744",,"Cash Sales","Carneli Normal Shower Gel 400ML","Cost of Goods Sold","Carneli Shower Gel",,"Undeposited Funds",188.59,"",2749.92
,"Sales Receipt","30-01-2024","1767",,"Cash Sales","Carneli Normal Shower Gel 400ML","Cost of Goods Sold","Carneli Shower Gel",,"Undeposited Funds",94.29,"",2844.21
,"Sales Receipt","31-01-2024","1773",,"Cash Sales","Carneli Normal Shower Gel 400ML","Cost of Goods Sold","Carneli Shower Gel",,"Undeposited Funds",94.29,"",2938.50
,"Sales Receipt","02-02-2024","1782",,"Cash Sales","Carneli Normal Shower Gel 400ML","Cost of Goods Sold","Carneli Shower Gel",,"Undeposited Funds",94.29,"",3032.79
,"Sales Receipt","19-02-2024",,,"Joyce Body wash","-MULTIPLE-","Cost of Goods Sold","Carneli Shower Gel",,"Undeposited Funds",8754.07,"",11786.86
,"Sales Receipt","22-02-2024","1866",,"Cash Sales","Carneli Sweet Vanilla Shower Gel 400ML","Cost of Goods Sold","Carneli Shower Gel",,"Undeposited Funds",98.68,"",11885.54
,"Sales Receipt","22-02-2024","1868",,"Cash Sales","Carneli Sweet Vanilla Shower Gel 400ML","Cost of Goods Sold","Carneli Shower Gel",,"Undeposited Funds",98.68,"",11984.22
,"Sales Receipt","29-02-2024","1890",,"Cash Sales","Carneli Normal Shower Gel 400ML","Cost of Goods Sold","Carneli Shower Gel",,"Undeposited Funds",188.59,"",12172.81
,"Build Assembly","29-02-2024","9767",,,,"Cost of Goods Sold","Carneli Shower Gel","X","-SPLIT-","",975.00,11197.81
,"Build Assembly","29-02-2024","9768",,,,"Cost of Goods Sold","Carneli Shower Gel","X","-SPLIT-","",1175.01,10022.80
,"Sales Receipt","04-03-2024","1895",,"Cash Sales","Carneli Normal Shower Gel 400ML","Cost of Goods Sold","Carneli Shower Gel",,"Undeposited Funds",69.29,"",10092.09
,"Sales Receipt","07-03-2024","2029",,"Cash Sales","Carneli Normal Shower Gel 400ML","Cost of Goods Sold","Carneli Shower Gel",,"Undeposited Funds",69.29,"",10161.38
,"Sales Receipt","12-03-2024","2057",,"Cash Sales","-MULTIPLE-","Cost of Goods Sold","Carneli Shower Gel",,"Undeposited Funds",335.95,"",10497.33
,"Sales Receipt","23-03-2024","2100",,,"Carneli Intense Clean Body Wash 400ML","Cost of Goods Sold","Carneli Shower Gel",,"Undeposited Funds",69.29,"",10566.62
,"Sales Receipt","28-03-2024","2130",,"Cash Sales","Carneli Sweet Vanilla Body Wash 400ML","Cost of Goods Sold","Carneli Shower Gel",,"Undeposited Funds",98.68,"",10665.30
,"Sales Receipt","03-04-2024","2144",,"Cash Sales","Carneli Intense Clean Body Wash 400ML","Cost of Goods Sold","Carneli Shower Gel",,"Undeposited Funds",69.29,"",10734.59
,"Sales Receipt","03-04-2024","2145",,"Cash Sales","Carneli Intense Clean Body Wash 400ML","Cost of Goods Sold","Carneli Shower Gel",,"Undeposited Funds",69.29,"",10803.88
,"Sales Receipt","08-04-2024","2164",,"Kangundo Briolly Bookshop","Carneli Intense Clean Body Wash 400ML","Cost of Goods Sold","Carneli Shower Gel",,"Undeposited Funds",69.29,"",10873.17
,"Sales Receipt","19-04-2024","2231",,"Cash Sales","Carneli Intense Clean Body Wash 400ML","Cost of Goods Sold","Carneli Shower Gel",,"Undeposited Funds",69.29,"",10942.46
,"Sales Receipt","02-05-2024","2287",,"5pm Hotel","Carneli Intense Clean Body Wash 400ML","Cost of Goods Sold","Carneli Shower Gel",,"Undeposited Funds",138.59,"",11081.05
,"Sales Receipt","03-05-2024","2300",,"Cash Sales","Carneli Intense Clean Body Wash 400ML","Cost of Goods Sold","Carneli Shower Gel",,"Undeposited Funds",138.59,"",11219.64
,"Sales Receipt","03-05-2024","2304",,"Cash Sales","Carneli Sweet Vanilla Body Wash 400ML","Cost of Goods Sold","Carneli Shower Gel",,"Undeposited Funds",98.68,"",11318.32
,"Build Assembly","08-05-2024","10398",,,"24192","Cost of Goods Sold","Carneli Shower Gel","X","-SPLIT-","",810.57,10507.75
,"Sales Receipt","13-05-2024","2351",,"Aymat Wholesalers","-MULTIPLE-","Cost of Goods Sold","Carneli Shower Gel",,"Undeposited Funds",860.47,"",11368.22
,"Sales Receipt","13-05-2024","02916",,"Joyce Body wash","-MULTIPLE-","Cost of Goods Sold","Carneli Shower Gel",,"Undeposited Funds",5288.28,"",16656.50
,"Build Assembly","14-05-2024","10399",,,"24201","Cost of Goods Sold","Carneli Shower Gel","X","-SPLIT-",240.26,"",16896.76
,"Sales Receipt","14-05-2024","1925",,"Cash Sales","Carneli Sweet Vanilla Body Wash 400ML","Cost of Goods Sold","Carneli Shower Gel",,"Undeposited Funds",74.12,"",16970.88
,"Sales Receipt","15-05-2024","2361",,"Lango Supermarket","-MULTIPLE-","Cost of Goods Sold","Carneli Shower Gel",,"Undeposited Funds",904.15,"",17875.03
,"Sales Receipt","15-05-2024","2362",,"Cash Sales","Carneli Sweet Vanilla Body Wash 400ML","Cost of Goods Sold","Carneli Shower Gel",,"Undeposited Funds",74.12,"",17949.15
,"Sales Receipt","27-05-2024","2386",,"Joyce Body wash","-MULTIPLE-","Cost of Goods Sold","Carneli Shower Gel",,"Undeposited Funds",4822.17,"",22771.32
,"Sales Receipt","07-06-2024","1994",,"Cash Sales","Carneli Intense Clean Body Wash 400ML","Cost of Goods Sold","Carneli Shower Gel",,"Undeposited Funds",76.57,"",22847.89
,"Sales Receipt","07-06-2024","1995",,"Cash Sales","Carneli Intense Clean Body Wash 400ML","Cost of Goods Sold","Carneli Shower Gel",,"Undeposited Funds",76.57,"",22924.46
,"Sales Receipt","12-06-2024","10274",,"Joyce Body wash","-MULTIPLE-","Cost of Goods Sold","Carneli Shower Gel",,"Undeposited Funds",122430.30,"",145354.76
,"Sales Receipt","01-07-2024","2756",,"Cash Sales","-MULTIPLE-","Cost of Goods Sold","Carneli Shower Gel",,"Undeposited Funds",150.69,"",145505.45
,"Sales Receipt","03-07-2024","2761",,"Cash Sales","-MULTIPLE-","Cost of Goods Sold","Carneli Shower Gel",,"Undeposited Funds",904.15,"",146409.60
,"Sales Receipt","05-07-2024","2792",,"Cash Sales","Carneli Sweet Vanilla Body Wash 400ML","Cost of Goods Sold","Carneli Shower Gel",,"Undeposited Funds",74.12,"",146483.72
,"Sales Receipt","12-07-2024","2537",,"Cash Sales","Carneli Sweet Vanilla Body Wash 400ML","Cost of Goods Sold","Carneli Shower Gel",,"Undeposited Funds",74.12,"",146557.84
,"Sales Receipt","15-07-2024","2542",,"Cash Sales","-MULTIPLE-","Cost of Goods Sold","Carneli Shower Gel",,"Undeposited Funds",150.69,"",146708.53
,"Sales Receipt","23-07-2024","2585",,"Cash Sales","Carneli Intense Clean Body Wash 400ML","Cost of Goods Sold","Carneli Shower Gel",,"Undeposited Funds",76.57,"",146785.10
,"Sales Receipt","14-08-2024","2822",,"Cash Sales","Carneli Intense Clean Body Wash 400ML","Cost of Goods Sold","Carneli Shower Gel",,"Undeposited Funds",76.57,"",146861.67
,"Sales Receipt","19-08-2024","2837",,"Cash Sales","Carneli Intense Clean Body Wash 400ML","Cost of Goods Sold","Carneli Shower Gel",,"Undeposited Funds",76.57,"",146938.24
,"Invoice","22-08-2024","MC06066",,"Cash Sales","Carneli Intense Clean Body Wash 400ML","Cost of Goods Sold","Carneli Shower Gel",,"Accounts Receivable",76.57,"",147014.81
,"Credit Note","22-08-2024","CN01065",,"Cash Sales","Carneli Intense Clean Body Wash 400ML","Cost of Goods Sold","Carneli Shower Gel",,"Accounts Receivable","",76.57,146938.24
,"Sales Receipt","23-08-2024","2880",,"Cash Sales","Carneli Intense Clean Body Wash 400ML","Cost of Goods Sold","Carneli Shower Gel",,"Undeposited Funds",76.57,"",147014.81
,"Sales Receipt","26-08-2024","2885",,"Cash Sales","Carneli Intense Clean Body Wash 400ML","Cost of Goods Sold","Carneli Shower Gel",,"Undeposited Funds",229.72,"",147244.53
,"Sales Receipt","10-09-2024","2978",,"Cash Sales","Carneli Intense Clean Body Wash 400ML","Cost of Goods Sold","Carneli Shower Gel",,"Undeposited Funds",76.57,"",147321.10
,"Sales Receipt","12-09-2024","2987",,"Cash Sales","Carneli Intense Clean Body Wash 400ML","Cost of Goods Sold","Carneli Shower Gel",,"Undeposited Funds",76.57,"",147397.67
,"Sales Receipt","17-09-2024","3051",,"Cash Sales","Carneli Intense Clean Body Wash 400ML","Cost of Goods Sold","Carneli Shower Gel",,"Undeposited Funds",536.02,"",147933.69
,"Sales Receipt","26-09-2024","3209",,"Cash Sales","Carneli Intense Clean Body Wash 400ML","Cost of Goods Sold","Carneli Shower Gel",,"Undeposited Funds",153.15,"",148086.84
,"Sales Receipt","04-10-2024","3251",,"Cash Sales","Carneli Intense Clean Body Wash 400ML","Cost of Goods Sold","Carneli Shower Gel",,"Undeposited Funds",229.72,"",148316.56
,"Sales Receipt","04-10-2024","AT200",,"Cash Sales","Carneli Intense Clean Body Wash 400ML","Cost of Goods Sold","Carneli Shower Gel",,"Undeposited Funds",382.87,"",148699.43
,"Sales Receipt","07-10-2024","3256",,"Cash Sales","Carneli Intense Clean Body Wash 400ML","Cost of Goods Sold","Carneli Shower Gel",,"Undeposited Funds",76.57,"",148776.00
,"Sales Receipt","24-10-2024","3148",,"Cash Sales","Carneli Sweet Vanilla Body Wash 400ML","Cost of Goods Sold","Carneli Shower Gel",,"Undeposited Funds",148.24,"",148924.24
,"Sales Receipt","12-11-2024","3431",,"Cash Sales","Carneli Intense Clean Body Wash 400ML","Cost of Goods Sold","Carneli Shower Gel",,"Undeposited Funds",3216.11,"",152140.35
,"Sales Receipt","13-11-2024","3434",,"Cash Sales","Carneli Intense Clean Body Wash 5L","Cost of Goods Sold","Carneli Shower Gel",,"Undeposited Funds",699.09,"",152839.44
,"Sales Receipt","13-11-2024","3435",,"Cash Sales","Carneli Sweet Vanilla Body Wash 400ML","Cost of Goods Sold","Carneli Shower Gel",,"Undeposited Funds",222.36,"",153061.80
,"Sales Receipt","22-11-2024","3484",,"Cash Sales","Carneli Sweet Vanilla Body Wash 400ML","Cost of Goods Sold","Carneli Shower Gel",,"Undeposited Funds",74.12,"",153135.92
,"Invoice","25-11-2024","MC06411",,"Solucom Enterprises Limited","Perfume Spiritz 2130420","Cost of Goods Sold","Carneli Shower Gel",,"Accounts Receivable",9450.00,"",162585.92
,"Sales Receipt","02-12-2024","3767",,"Cash Sales","Carneli Intense Clean Body Wash 400ML","Cost of Goods Sold","Carneli Shower Gel",,"Undeposited Funds",76.57,"",162662.49
,"Sales Receipt","02-12-2024","3779",,"Cash Sales","Carneli Intense Clean Body Wash 400ML","Cost of Goods Sold","Carneli Shower Gel",,"Undeposited Funds",153.15,"",162815.64
,"Sales Receipt","11-12-2024","3336",,"Cash Sales","Carneli Intense Clean Body Wash 400ML","Cost of Goods Sold","Carneli Shower Gel",,"Undeposited Funds",76.57,"",162892.21
,"Sales Receipt","16-12-2024","3344",,"Cash Sales","Carneli Intense Clean Body Wash 400ML","Cost of Goods Sold","Carneli Shower Gel",,"Undeposited Funds",153.15,"",163045.36
"Total Carneli Shower Gel",,,,,,,,,,,166082.51,3037.15,163045.36
"Zelia Surface Cleaner",,,,,,,,,,,,,""
,"Invoice","04-01-2024","MC05269",,"OFFSHORE GLOBAL LOGISTICS LIMITED","Zelia Surface Cleaner 750ML","Cost of Goods Sold","Zelia Surface Cleaner",,"Accounts Receivable",655.13,"",655.13
,"Sales Receipt","12-01-2024","1727",,"Cash Sales","Zelia Surface Cleaner 750ML","Cost of Goods Sold","Zelia Surface Cleaner",,"Undeposited Funds",163.78,"",818.91
,"Sales Receipt","25-01-2024","1758",,"Cash Sales","Zelia Surface Cleaner 750ML","Cost of Goods Sold","Zelia Surface Cleaner",,"Undeposited Funds",327.56,"",1146.47
,"Sales Receipt","30-01-2024","1766",,"Cash Sales","Zelia Surface Cleaner 750ML","Cost of Goods Sold","Zelia Surface Cleaner",,"Undeposited Funds",491.34,"",1637.81
,"Sales Receipt","31-01-2024","1773",,"Cash Sales","Zelia Surface Cleaner 750ML","Cost of Goods Sold","Zelia Surface Cleaner",,"Undeposited Funds",163.78,"",1801.59
,"Sales Receipt","10-02-2024","1821",,"Alma Mart","Zelia Surface Cleaner 750ML","Cost of Goods Sold","Zelia Surface Cleaner",,"Undeposited Funds",327.56,"",2129.15
,"Sales Receipt","28-03-2024","2129",,"Cash Sales","Zelia Surface Cleaner 750ML","Cost of Goods Sold","Zelia Surface Cleaner",,"Undeposited Funds",163.78,"",2292.93
,"Sales Receipt","12-04-2024","2175",,"Tekonstruct LTD","Zelia Surface Cleaner 750ML","Cost of Goods Sold","Zelia Surface Cleaner",,"Undeposited Funds",655.13,"",2948.06
,"Sales Receipt","08-05-2024","2321",,"Cash Sales","Zelia Surface Cleaner 750ML","Cost of Goods Sold","Zelia Surface Cleaner",,"Undeposited Funds",163.78,"",3111.84
,"Sales Receipt","10-05-2024","1918",,"Cash Sales","Zelia Surface Cleaner 750ML","Cost of Goods Sold","Zelia Surface Cleaner",,"Undeposited Funds",655.13,"",3766.97
,"Sales Receipt","13-05-2024","2356",,"The Hub Minimart","Zelia Surface Cleaner 750ML","Cost of Goods Sold","Zelia Surface Cleaner",,"Undeposited Funds",163.78,"",3930.75
,"Sales Receipt","31-05-2024","1937",,"Island Gift Shop","Zelia Surface Cleaner 750ML","Cost of Goods Sold","Zelia Surface Cleaner",,"Undeposited Funds",327.56,"",4258.31
,"Sales Receipt","22-07-2024","2571",,"Fahma Qali","Zelia Surface Cleaner 750ML","Cost of Goods Sold","Zelia Surface Cleaner",,"Undeposited Funds",655.13,"",4913.44
,"Sales Receipt","03-09-2024","3226",,"Soft Landing","Zelia Surface Cleaner 750ML","Cost of Goods Sold","Zelia Surface Cleaner",,"Undeposited Funds",327.56,"",5241.00
,"Sales Receipt","03-09-2024","2922",,"Cash Sales","Zelia Surface Cleaner 750ML","Cost of Goods Sold","Zelia Surface Cleaner",,"Undeposited Funds",327.56,"",5568.56
,"Sales Receipt","10-09-2024","2973",,"Cash Sales","Zelia Surface Cleaner 750ML","Cost of Goods Sold","Zelia Surface Cleaner",,"Undeposited Funds",163.78,"",5732.34
,"Sales Receipt","16-09-2024","3044",,"Afro Drip LTD","Zelia Surface Cleaner 750ML","Cost of Goods Sold","Zelia Surface Cleaner",,"Undeposited Funds",163.78,"",5896.12
,"Sales Receipt","16-09-2024","3045",,"Afro Drip LTD Reception","Zelia Surface Cleaner 750ML","Cost of Goods Sold","Zelia Surface Cleaner",,"Undeposited Funds",163.78,"",6059.90
,"Sales Receipt","25-09-2024","3095",,"Cash Sales","Zelia Surface Cleaner 750ML","Cost of Goods Sold","Zelia Surface Cleaner",,"Undeposited Funds",163.78,"",6223.68
,"Sales Receipt","27-09-2024","3216",,"Cash Sales","Zelia Surface Cleaner 750ML","Cost of Goods Sold","Zelia Surface Cleaner",,"Undeposited Funds",327.56,"",6551.24
,"Sales Receipt","16-10-2024","3109",,"Cash Sales","Zelia Surface Cleaner 750ML","Cost of Goods Sold","Zelia Surface Cleaner",,"Undeposited Funds",163.78,"",6715.02
,"Sales Receipt","08-11-2024","3458",,"Mama Sam Shop","Zelia Surface Cleaner 750ML","Cost of Goods Sold","Zelia Surface Cleaner",,"Undeposited Funds",982.69,"",7697.71
,"Sales Receipt","11-11-2024","3420",,"Cash Sales","Zelia Surface Cleaner 750ML","Cost of Goods Sold","Zelia Surface Cleaner",,"Undeposited Funds",163.78,"",7861.49
,"Sales Receipt","26-11-2024","3740",,"Afrodrip JKIA","Zelia Surface Cleaner 750ML","Cost of Goods Sold","Zelia Surface Cleaner",,"Undeposited Funds",163.78,"",8025.27
,"Sales Receipt","28-11-2024","3750",,"Cash Sales","Zelia Surface Cleaner 750ML","Cost of Goods Sold","Zelia Surface Cleaner",,"Undeposited Funds",163.78,"",8189.05
,"Sales Receipt","16-12-2024","3346",,"Cash Sales","Zelia Surface Cleaner 750ML","Cost of Goods Sold","Zelia Surface Cleaner",,"Undeposited Funds",655.13,"",8844.18
,"Sales Receipt","17-12-2024","3355",,"Cash Sales","Zelia Surface Cleaner 750ML","Cost of Goods Sold","Zelia Surface Cleaner",,"Undeposited Funds",327.56,"",9171.74
"Total Zelia Surface Cleaner",,,,,,,,,,,9171.74,0.00,9171.74
"Zelia Bleach",,,,,,,,,,,,,""
,"Sales Receipt","03-01-2024","1592",,"Cash Sales","Zelia Bleach 500ML","Cost of Goods Sold","Zelia Bleach",,"Undeposited Funds",35.79,"",35.79
,"Invoice","04-01-2024","MC05269",,"OFFSHORE GLOBAL LOGISTICS LIMITED","Zelia Bleach 5L","Cost of Goods Sold","Zelia Bleach",,"Accounts Receivable",500.86,"",536.65
,"Sales Receipt","04-01-2024","1707",,"Mama Amina","Zelia Bleach 500ML","Cost of Goods Sold","Zelia Bleach",,"Undeposited Funds",214.76,"",751.41
,"Sales Receipt","04-01-2024","1708",,"Cash Sales","Zelia Bleach 5L","Cost of Goods Sold","Zelia Bleach",,"Undeposited Funds",250.43,"",1001.84
,"Invoice","05-01-2024","MC05272",,"Mumsha Supamat","-MULTIPLE-","Cost of Goods Sold","Zelia Bleach",,"Accounts Receivable",538.62,"",1540.46
,"Sales Receipt","05-01-2024","1600",,"Cash Sales","Zelia Bleach 5L","Cost of Goods Sold","Zelia Bleach",,"Undeposited Funds",250.43,"",1790.89
,"Sales Receipt","05-01-2024","1711",,"Summer Outlets","Zelia Bleach 500ML","Cost of Goods Sold","Zelia Bleach",,"Undeposited Funds",214.76,"",2005.65
,"Invoice","12-01-2024","MC05300",,"MUHINDI MWEUSI SUPERMARKET LIMITED","-MULTIPLE-","Cost of Goods Sold","Zelia Bleach",,"Accounts Receivable",862.48,"",2868.13
,"Invoice","12-01-2024","MC05302",,"MUHINDI MWEUSI SUPERMARKET LIMITED","Zelia Bleach 500ML","Cost of Goods Sold","Zelia Bleach",,"Accounts Receivable",214.76,"",3082.89
,"Sales Receipt","12-01-2024","1727",,"Cash Sales","Zelia Bleach 750ML","Cost of Goods Sold","Zelia Bleach",,"Undeposited Funds",53.98,"",3136.87
,"Invoice","15-01-2024","MC05309",,"MUHINDI MWEUSI SUPERMARKET LIMITED","Zelia Bleach 750ML","Cost of Goods Sold","Zelia Bleach",,"Accounts Receivable",647.72,"",3784.59
,"Invoice","15-01-2024","MC05311",,"Seasons lane Mart","-MULTIPLE-","Cost of Goods Sold","Zelia Bleach",,"Accounts Receivable",538.62,"",4323.21
,"Invoice","15-01-2024","MC05315",,"MUHINDI MWEUSI SUPERMARKET LIMITED","Zelia Bleach 500ML","Cost of Goods Sold","Zelia Bleach",,"Accounts Receivable",859.06,"",5182.27
,"Sales Receipt","18-01-2024","1738",,"Cash Sales","Zelia Bleach 750ML","Cost of Goods Sold","Zelia Bleach",,"Undeposited Funds",53.98,"",5236.25
,"Sales Receipt","19-01-2024","1739",,"Cash Sales","Zelia Bleach 500ML","Cost of Goods Sold","Zelia Bleach",,"Undeposited Funds",35.79,"",5272.04
,"Sales Receipt","19-01-2024","1744",,"Cash Sales","-MULTIPLE-","Cost of Goods Sold","Zelia Bleach",,"Undeposited Funds",1182.92,"",6454.96
,"Invoice","23-01-2024","MC05343",,"MUHINDI MWEUSI SUPERMARKET LIMITED","Zelia Bleach 500ML","Cost of Goods Sold","Zelia Bleach",,"Accounts Receivable",429.53,"",6884.49
,"Invoice","24-01-2024","MC05346",,"Qways Supermarket","-MULTIPLE-","Cost of Goods Sold","Zelia Bleach",,"Accounts Receivable",753.39,"",7637.88
,"Sales Receipt","24-01-2024","1754",,"Cash Sales","Zelia Bleach 5L","Cost of Goods Sold","Zelia Bleach",,"Undeposited Funds",250.43,"",7888.31
,"Sales Receipt","24-01-2024","1755",,"Alma Mart","-MULTIPLE-","Cost of Goods Sold","Zelia Bleach",,"Undeposited Funds",1077.25,"",8965.56
,"Sales Receipt","24-01-2024","1757",,"Cash Sales","Zelia Bleach 750ML","Cost of Goods Sold","Zelia Bleach",,"Undeposited Funds",53.98,"",9019.54
,"Sales Receipt","29-01-2024","1761",,"Cash Sales","Zelia Bleach 500ML","Cost of Goods Sold","Zelia Bleach",,"Undeposited Funds",107.38,"",9126.92
,"Sales Receipt","29-01-2024","1769",,"Cash Sales","-MULTIPLE-","Cost of Goods Sold","Zelia Bleach",,"Undeposited Funds",89.77,"",9216.69
,"Sales Receipt","30-01-2024","1765",,"Cash Sales","Zelia Bleach 5L","Cost of Goods Sold","Zelia Bleach",,"Undeposited Funds",250.43,"",9467.12
,"Sales Receipt","30-01-2024","1766",,"Cash Sales","Zelia Bleach 5L","Cost of Goods Sold","Zelia Bleach",,"Undeposited Funds",250.43,"",9717.55
,"Sales Receipt","30-01-2024","1767",,"Cash Sales","Zelia Bleach 750ML","Cost of Goods Sold","Zelia Bleach",,"Undeposited Funds",53.98,"",9771.53
,"Sales Receipt","31-01-2024","1773",,"Cash Sales","Zelia Bleach 500ML","Cost of Goods Sold","Zelia Bleach",,"Undeposited Funds",35.79,"",9807.32
,"Sales Receipt","01-02-2024","1776",,"FARMERS BEST GROCERY","-MULTIPLE-","Cost of Goods Sold","Zelia Bleach",,"Undeposited Funds",718.16,"",10525.48
,"Invoice","02-02-2024","MC05379",,"HOPEMART SELF SERVICES LTD","Zelia Bleach 500ML","Cost of Goods Sold","Zelia Bleach",,"Accounts Receivable",214.76,"",10740.24
,"Sales Receipt","02-02-2024","1783",,"Cheche Minimart","-MULTIPLE-","Cost of Goods Sold","Zelia Bleach",,"Undeposited Funds",376.69,"",11116.93
,"Sales Receipt","03-02-2024","1792",,"Soimo Minimart","Zelia Bleach 500ML","Cost of Goods Sold","Zelia Bleach",,"Undeposited Funds",107.38,"",11224.31
,"Invoice","05-02-2024","MC05385",,"TAWALA SUPERMARKET LIMITED","-MULTIPLE-","Cost of Goods Sold","Zelia Bleach",,"Accounts Receivable",1077.25,"",12301.56
,"Sales Receipt","05-02-2024","1787",,"Cash Sales","Zelia Bleach 500ML","Cost of Goods Sold","Zelia Bleach",,"Undeposited Funds",35.79,"",12337.35
,"Sales Receipt","05-02-2024","1788",,"Cash Sales","Zelia Bleach 750ML","Cost of Goods Sold","Zelia Bleach",,"Undeposited Funds",53.98,"",12391.33
,"Sales Receipt","05-02-2024","1791",,"The Hub Minimart","Zelia Bleach 500ML","Cost of Goods Sold","Zelia Bleach",,"Undeposited Funds",214.76,"",12606.09
,"Sales Receipt","06-02-2024","1798",,"Cash Sales","Zelia Bleach 750ML","Cost of Goods Sold","Zelia Bleach",,"Undeposited Funds",53.98,"",12660.07
,"Sales Receipt","06-02-2024","1799",,"Cash Sales","Zelia Bleach 5L","Cost of Goods Sold","Zelia Bleach",,"Undeposited Funds",250.43,"",12910.50
,"Sales Receipt","06-02-2024","1800",,"Mama Amina","Zelia Bleach 500ML","Cost of Goods Sold","Zelia Bleach",,"Undeposited Funds",214.76,"",13125.26
,"Sales Receipt","06-02-2024","1808",,"Cash Sales","Zelia Bleach 750ML","Cost of Goods Sold","Zelia Bleach",,"Undeposited Funds",53.98,"",13179.24
,"Sales Receipt","07-02-2024","1809",,"Cash Sales","Zelia Bleach 5L","Cost of Goods Sold","Zelia Bleach",,"Undeposited Funds",250.43,"",13429.67
,"Sales Receipt","08-02-2024","1814",,"Cash Sales","Zelia Bleach 500ML","Cost of Goods Sold","Zelia Bleach",,"Undeposited Funds",35.79,"",13465.46
,"Sales Receipt","08-02-2024","1815",,"Cash Sales","Zelia Bleach 500ML","Cost of Goods Sold","Zelia Bleach",,"Undeposited Funds",35.79,"",13501.25
,"Invoice","12-02-2024","MC05396",,"OFFSHORE GLOBAL LOGISTICS LIMITED","Zelia Bleach 5L","Cost of Goods Sold","Zelia Bleach",,"Accounts Receivable",500.86,"",14002.11
,"Invoice","12-02-2024","MC05400",,"KASAMAT INVESTMENTS LTD","Zelia Bleach 500ML","Cost of Goods Sold","Zelia Bleach",,"Accounts Receivable",214.76,"",14216.87
,"Sales Receipt","12-02-2024","1824",,"Cash Sales","Zelia Bleach 750ML","Cost of Goods Sold","Zelia Bleach",,"Undeposited Funds",53.98,"",14270.85
,"Sales Receipt","13-02-2024","1834",,"Cash Sales","Zelia Bleach 750ML","Cost of Goods Sold","Zelia Bleach",,"Undeposited Funds",107.95,"",14378.80
,"Invoice","14-02-2024","MC05405",,"MUHINDI MWEUSI SUPERMARKET LIMITED","Zelia Bleach 500ML","Cost of Goods Sold","Zelia Bleach",,"Accounts Receivable",211.30,"",14590.10
,"Invoice","14-02-2024","MC05406",,"MUHINDI MWEUSI SUPERMARKET LIMITED","Zelia Bleach 500ML","Cost of Goods Sold","Zelia Bleach",,"Accounts Receivable",422.60,"",15012.70
,"Sales Receipt","14-02-2024","1838",,"Cash Sales","Zelia Bleach 750ML","Cost of Goods Sold","Zelia Bleach",,"Undeposited Funds",53.98,"",15066.68
,"Sales Receipt","15-02-2024","1839",,"Cash Sales","Zelia Bleach 750ML","Cost of Goods Sold","Zelia Bleach",,"Undeposited Funds",53.98,"",15120.66
,"Sales Receipt","16-02-2024","1847",,"Gidesh Supermarket","-MULTIPLE-","Cost of Goods Sold","Zelia Bleach",,"Undeposited Funds",535.16,"",15655.82
,"Sales Receipt","16-02-2024","1848",,"Cash Sales","Zelia Bleach 500ML","Cost of Goods Sold","Zelia Bleach",,"Undeposited Funds",70.43,"",15726.25
,"Sales Receipt","16-02-2024","1849",,"Cash Sales","Zelia Bleach 500ML","Cost of Goods Sold","Zelia Bleach",,"Undeposited Funds",140.87,"",15867.12
,"Sales Receipt","16-02-2024","1852",,"Nuclear Supermarket","-MULTIPLE-","Cost of Goods Sold","Zelia Bleach",,"Undeposited Funds",535.16,"",16402.28
,"Sales Receipt","17-02-2024","1851",,"MumsCereal and General Stores","-MULTIPLE-","Cost of Goods Sold","Zelia Bleach",,"Undeposited Funds",267.58,"",16669.86
,"Sales Receipt","19-02-2024","1853",,"Restoration Traders","-MULTIPLE-","Cost of Goods Sold","Zelia Bleach",,"Undeposited Funds",1492.92,"",18162.78
,"Sales Receipt","21-02-2024","1855",,"Cash Sales","Zelia Bleach 750ML","Cost of Goods Sold","Zelia Bleach",,"Undeposited Funds",53.98,"",18216.76
,"Sales Receipt","21-02-2024","1856",,"Cash Sales","Zelia Bleach 750ML","Cost of Goods Sold","Zelia Bleach",,"Undeposited Funds",53.98,"",18270.74
,"Sales Receipt","21-02-2024","1861",,"Cash Sales","Zelia Bleach 750ML","Cost of Goods Sold","Zelia Bleach",,"Undeposited Funds",161.93,"",18432.67
,"Invoice","23-02-2024","MC05443",,"DAILY CHAMPIONS MINI SUPERMARKET LIMITED","Zelia Bleach 500ML","Cost of Goods Sold","Zelia Bleach",,"Accounts Receivable",211.30,"",18643.97
,"Sales Receipt","26-02-2024","1873",,"mamkon minimart","Zelia Bleach 500ML","Cost of Goods Sold","Zelia Bleach",,"Undeposited Funds",70.43,"",18714.40
,"Sales Receipt","26-02-2024","1877",,"Cash Sales","Zelia Bleach 750ML","Cost of Goods Sold","Zelia Bleach",,"Undeposited Funds",53.98,"",18768.38
,"Sales Receipt","27-02-2024","1879",,"Cash Sales","Zelia Bleach 5L","Cost of Goods Sold","Zelia Bleach",,"Undeposited Funds",250.43,"",19018.81
,"Sales Receipt","27-02-2024","1880",,"Cash Sales","Zelia Bleach 5L","Cost of Goods Sold","Zelia Bleach",,"Undeposited Funds",250.43,"",19269.24
,"Sales Receipt","27-02-2024","1881",,"Gure Yare Shop Nasra","Zelia Bleach 750ML","Cost of Goods Sold","Zelia Bleach",,"Undeposited Funds",647.72,"",19916.96
,"Sales Receipt","29-02-2024","1890",,"Cash Sales","-MULTIPLE-","Cost of Goods Sold","Zelia Bleach",,"Undeposited Funds",538.24,"",20455.20
,"Sales Receipt","29-02-2024","AT185",,"Cash Sales","Zelia Bleach 500ML","Cost of Goods Sold","Zelia Bleach",,"Undeposited Funds",842.13,"",21297.33
,"Sales Receipt","04-03-2024","2003",,"Cash Sales","Zelia Bleach 500ML","Cost of Goods Sold","Zelia Bleach",,"Undeposited Funds",35.09,"",21332.42
,"Invoice","05-03-2024","MC05471",,"PRICE CHOPPER STORES LIMITED","-MULTIPLE-","Cost of Goods Sold","Zelia Bleach",,"Accounts Receivable",492.46,"",21824.88
,"Sales Receipt","06-03-2024","2026",,"Mama Amina","-MULTIPLE-","Cost of Goods Sold","Zelia Bleach",,"Undeposited Funds",492.46,"",22317.34
,"Sales Receipt","06-03-2024","2027",,"Khalifa Shop","Zelia Bleach 500ML","Cost of Goods Sold","Zelia Bleach",,"Undeposited Funds",421.07,"",22738.41
,"Invoice","07-03-2024","MC05477",,"OFFSHORE GLOBAL LOGISTICS LIMITED","Zelia Bleach 5L","Cost of Goods Sold","Zelia Bleach",,"Accounts Receivable",751.29,"",23489.70
,"Sales Receipt","07-03-2024","2029",,"Cash Sales","Zelia Bleach 750ML","Cost of Goods Sold","Zelia Bleach",,"Undeposited Funds",46.99,"",23536.69
,"Sales Receipt","07-03-2024","2033",,"Cash Sales","Zelia Bleach 750ML","Cost of Goods Sold","Zelia Bleach",,"Undeposited Funds",46.99,"",23583.68
,"Sales Receipt","07-03-2024","2037",,"Cash Sales","Zelia Bleach 750ML","Cost of Goods Sold","Zelia Bleach",,"Undeposited Funds",46.99,"",23630.67
,"Sales Receipt","08-03-2024","2041",,"Cash Sales","Zelia Bleach 750ML","Cost of Goods Sold","Zelia Bleach",,"Undeposited Funds",93.98,"",23724.65
,"Sales Receipt","08-03-2024","2046",,"Cash Sales","Zelia Bleach 750ML","Cost of Goods Sold","Zelia Bleach",,"Undeposited Funds",46.99,"",23771.64
,"Sales Receipt","08-03-2024","2047",,"Cash Sales","Zelia Bleach 750ML","Cost of Goods Sold","Zelia Bleach",,"Undeposited Funds",46.99,"",23818.63
,"Sales Receipt","11-03-2024","2049",,"MWASPART AIRWAYS","-MULTIPLE-","Cost of Goods Sold","Zelia Bleach",,"Undeposited Funds",492.46,"",24311.09
,"Sales Receipt","11-03-2024","2052",,"Cash Sales","Zelia Bleach 500ML","Cost of Goods Sold","Zelia Bleach",,"Undeposited Funds",35.09,"",24346.18
,"Sales Receipt","11-03-2024","2053",,"Cash Sales","Zelia Bleach 5L","Cost of Goods Sold","Zelia Bleach",,"Undeposited Funds",250.43,"",24596.61
,"Sales Receipt","11-03-2024","2055",,"Beta Traders","-MULTIPLE-","Cost of Goods Sold","Zelia Bleach",,"Undeposited Funds",492.46,"",25089.07
,"Sales Receipt","11-03-2024","2056",,"Nasib Wholesallers","Zelia Bleach 500ML","Cost of Goods Sold","Zelia Bleach",,"Undeposited Funds",842.13,"",25931.20
,"Sales Receipt","13-03-2024","2058",,"Cash Sales","Zelia Bleach 750ML","Cost of Goods Sold","Zelia Bleach",,"Undeposited Funds",46.99,"",25978.19
,"Sales Receipt","13-03-2024","2059",,"Cash Sales","Zelia Bleach 750ML","Cost of Goods Sold","Zelia Bleach",,"Undeposited Funds",46.99,"",26025.18
,"Sales Receipt","14-03-2024","2063",,"Cash Sales","Zelia Bleach 750ML","Cost of Goods Sold","Zelia Bleach",,"Undeposited Funds",46.99,"",26072.17
,"Sales Receipt","14-03-2024","2065",,"Cash Sales","Zelia Bleach 750ML","Cost of Goods Sold","Zelia Bleach",,"Undeposited Funds",46.99,"",26119.16
,"Sales Receipt","14-03-2024","2067",,"Nzurimart wholesale","Zelia Bleach 750ML","Cost of Goods Sold","Zelia Bleach",,"Undeposited Funds",46.99,"",26166.15
,"Sales Receipt","18-03-2024","2074",,"Cash Sales","Zelia Bleach 5L","Cost of Goods Sold","Zelia Bleach",,"Undeposited Funds",250.43,"",26416.58
,"Invoice","19-03-2024","MC05502",,"Tupo Mart Limited","Zelia Bleach 500ML","Cost of Goods Sold","Zelia Bleach",,"Accounts Receivable",210.53,"",26627.11
,"Invoice","20-03-2024","MC05507",,"DAILY CHAMPIONS MINI SUPERMARKET LIMITED","Zelia Bleach 500ML","Cost of Goods Sold","Zelia Bleach",,"Accounts Receivable",210.53,"",26837.64
,"Sales Receipt","20-03-2024","2083",,"Cash Sales","Zelia Bleach 5L","Cost of Goods Sold","Zelia Bleach",,"Undeposited Funds",250.43,"",27088.07
,"Sales Receipt","20-03-2024","2087",,"Pambazuka Mart (K) Limited","-MULTIPLE-","Cost of Goods Sold","Zelia Bleach",,"Undeposited Funds",1405.99,"",28494.06
,"Sales Receipt","20-03-2024","2093",,"Cash Sales","Zelia Bleach 750ML","Cost of Goods Sold","Zelia Bleach",,"Undeposited Funds",46.99,"",28541.05
,"Sales Receipt","21-03-2024","2092",,"Norham Groceries","Zelia Bleach 500ML","Cost of Goods Sold","Zelia Bleach",,"Undeposited Funds",210.53,"",28751.58
,"Sales Receipt","21-03-2024","2101",,"Raymart Minimart","Zelia Bleach 500ML","Cost of Goods Sold","Zelia Bleach",,"Undeposited Funds",105.27,"",28856.85
,"Sales Receipt","25-03-2024","2099",,"Cash Sales","Zelia Bleach 750ML","Cost of Goods Sold","Zelia Bleach",,"Undeposited Funds",93.98,"",28950.83
,"Sales Receipt","26-03-2024","2108",,"Cash Sales","Zelia Bleach 5L","Cost of Goods Sold","Zelia Bleach",,"Undeposited Funds",250.43,"",29201.26
,"Sales Receipt","28-03-2024","2118",,"Cash Sales","Zelia Bleach 750ML","Cost of Goods Sold","Zelia Bleach",,"Undeposited Funds",46.99,"",29248.25
,"Sales Receipt","28-03-2024","2127",,"Cash Sales","Zelia Bleach 500ML","Cost of Goods Sold","Zelia Bleach",,"Undeposited Funds",35.09,"",29283.34
,"Sales Receipt","28-03-2024","2129",,"Cash Sales","Zelia Bleach 5L","Cost of Goods Sold","Zelia Bleach",,"Undeposited Funds",250.43,"",29533.77
,"Sales Receipt","02-04-2024","2132",,"Cash Sales","Zelia Bleach 5L","Cost of Goods Sold","Zelia Bleach",,"Undeposited Funds",250.43,"",29784.20
,"Invoice","04-04-2024","MC05564",,"Azaavi Collections Limited","Zelia Bleach 750ML","Cost of Goods Sold","Zelia Bleach",,"Accounts Receivable",46.99,"",29831.19
,"Sales Receipt","04-04-2024","2149",,"Cash Sales","Zelia Bleach 5L","Cost of Goods Sold","Zelia Bleach",,"Undeposited Funds",250.43,"",30081.62
,"Sales Receipt","05-04-2024","2157",,"Cash Sales","Zelia Bleach 500ML","Cost of Goods Sold","Zelia Bleach",,"Undeposited Funds",70.18,"",30151.80
,"Sales Receipt","05-04-2024","2161",,"Cash Sales","Zelia Bleach 500ML","Cost of Goods Sold","Zelia Bleach",,"Undeposited Funds",35.09,"",30186.89
,"Sales Receipt","05-04-2024","AT 193",,"JUDY USENGE","Zelia Bleach 500ML","Cost of Goods Sold","Zelia Bleach",,"Undeposited Funds",3368.54,"",33555.43
,"Sales Receipt","08-04-2024","2164",,"Kangundo Briolly Bookshop","Zelia Bleach 500ML","Cost of Goods Sold","Zelia Bleach",,"Undeposited Funds",35.09,"",33590.52
,"Sales Receipt","08-04-2024","2165",,"Cash Sales","Zelia Bleach 5L","Cost of Goods Sold","Zelia Bleach",,"Undeposited Funds",250.43,"",33840.95
,"Sales Receipt","08-04-2024","2166",,"Cash Sales","Zelia Bleach 750ML","Cost of Goods Sold","Zelia Bleach",,"Undeposited Funds",46.99,"",33887.94
,"Sales Receipt","11-04-2024","2173",,"Cash Sales","Zelia Bleach 5L","Cost of Goods Sold","Zelia Bleach",,"Undeposited Funds",250.43,"",34138.37
,"Sales Receipt","11-04-2024","2205",,"Gure Yare Shop Nasra","-MULTIPLE-","Cost of Goods Sold","Zelia Bleach",,"Undeposited Funds",1405.99,"",35544.36
,"Sales Receipt","12-04-2024","2175",,"Tekonstruct LTD","Zelia Bleach 5L","Cost of Goods Sold","Zelia Bleach",,"Undeposited Funds",250.43,"",35794.79
,"Sales Receipt","12-04-2024","2176",,"Cash Sales","Zelia Bleach 5L","Cost of Goods Sold","Zelia Bleach",,"Undeposited Funds",500.86,"",36295.65
,"Sales Receipt","12-04-2024","2185",,"Mamken Minimart","-MULTIPLE-","Cost of Goods Sold","Zelia Bleach",,"Undeposited Funds",492.46,"",36788.11
,"Sales Receipt","12-04-2024","2186",,"Kandara minimart","-MULTIPLE-","Cost of Goods Sold","Zelia Bleach",,"Undeposited Funds",492.46,"",37280.57
,"Sales Receipt","15-04-2024","2189",,"Deep Store","Zelia Bleach 500ML","Cost of Goods Sold","Zelia Bleach",,"Undeposited Funds",421.07,"",37701.64
,"Sales Receipt","15-04-2024","2190",,"Cash Sales","Zelia Bleach 500ML","Cost of Goods Sold","Zelia Bleach",,"Undeposited Funds",35.09,"",37736.73
,"Sales Receipt","15-04-2024","2191",,"Cash Sales","Zelia Bleach 5L","Cost of Goods Sold","Zelia Bleach",,"Undeposited Funds",250.43,"",37987.16
,"Sales Receipt","15-04-2024","2193",,"Diaspora Diaries","Zelia Bleach 750ML","Cost of Goods Sold","Zelia Bleach",,"Undeposited Funds",93.98,"",38081.14
,"Sales Receipt","15-04-2024","2200",,"Cash Sales","Zelia Bleach 500ML","Cost of Goods Sold","Zelia Bleach",,"Undeposited Funds",35.09,"",38116.23
,"Sales Receipt","17-04-2024","2215",,"Best Ratino Stores","Zelia Bleach 5L","Cost of Goods Sold","Zelia Bleach",,"Undeposited Funds",1001.72,"",39117.95
,"Sales Receipt","17-04-2024","2218",,"Maida Minimart","Zelia Bleach 500ML","Cost of Goods Sold","Zelia Bleach",,"Undeposited Funds",105.27,"",39223.22
,"Invoice","19-04-2024","MC05610",,"DISII TRADERS LTD","Zelia Bleach 500ML","Cost of Goods Sold","Zelia Bleach",,"Accounts Receivable",421.07,"",39644.29
,"Sales Receipt","19-04-2024","2231",,"Cash Sales","Zelia Bleach 500ML","Cost of Goods Sold","Zelia Bleach",,"Undeposited Funds",70.18,"",39714.47
,"Sales Receipt","19-04-2024","2236",,"Restoration Traders","-MULTIPLE-","Cost of Goods Sold","Zelia Bleach",,"Undeposited Funds",984.93,"",40699.40
,"Invoice","22-04-2024","MC05622",,"KASAMAT INVESTMENTS LTD","Zelia Bleach 500ML","Cost of Goods Sold","Zelia Bleach",,"Accounts Receivable",140.36,"",40839.76
,"Sales Receipt","23-04-2024","2251",,"Cash Sales","Zelia Bleach 500ML","Cost of Goods Sold","Zelia Bleach",,"Undeposited Funds",35.09,"",40874.85
,"Invoice","24-04-2024","MC05630",,"Mumsha Supamat","Zelia Bleach 500ML","Cost of Goods Sold","Zelia Bleach",,"Accounts Receivable",210.53,"",41085.38
,"Invoice","24-04-2024","MC05636",,"Maji Asili Limited","-MULTIPLE-","Cost of Goods Sold","Zelia Bleach",,"Accounts Receivable",1400.41,"",42485.79
,"Sales Receipt","24-04-2024","2259",,"Muleshe Wholesallers","Zelia Bleach 500ML","Cost of Goods Sold","Zelia Bleach",,"Undeposited Funds",421.07,"",42906.86
,"Sales Receipt","25-04-2024","2268",,"Mama Amina","Zelia Bleach 750ML","Cost of Goods Sold","Zelia Bleach",,"Undeposited Funds",279.14,"",43186.00
,"Sales Receipt","26-04-2024","2270",,"Cash Sales","Zelia Bleach 5L","Cost of Goods Sold","Zelia Bleach",,"Undeposited Funds",250.43,"",43436.43
,"Sales Receipt","29-04-2024","2273",,"Blessed Shop","Zelia Bleach 750ML","Cost of Goods Sold","Zelia Bleach",,"Undeposited Funds",46.52,"",43482.95
,"Sales Receipt","29-04-2024","2275",,"Cash Sales","Zelia Bleach 750ML","Cost of Goods Sold","Zelia Bleach",,"Undeposited Funds",46.52,"",43529.47
,"Credit Note","29-04-2024","CN01059",,"TAWALA SUPERMARKET LIMITED","Zelia Bleach 750ML","Cost of Goods Sold","Zelia Bleach",,"Accounts Receivable","",558.28,42971.19
,"Sales Receipt","29-04-2024","2280",,"Cash Sales","Zelia Bleach 750ML","Cost of Goods Sold","Zelia Bleach",,"Undeposited Funds",46.52,"",43017.71
,"Invoice","30-04-2024","MC05652",,"OFFSHORE GLOBAL LOGISTICS LIMITED","Zelia Bleach 5L","Cost of Goods Sold","Zelia Bleach",,"Accounts Receivable",751.29,"",43769.00
,"Sales Receipt","30-04-2024","2283",,"Cash Sales","Zelia Bleach 750ML","Cost of Goods Sold","Zelia Bleach",,"Undeposited Funds",46.52,"",43815.52
,"Sales Receipt","02-05-2024","2287",,"5pm Hotel","Zelia Bleach 500ML","Cost of Goods Sold","Zelia Bleach",,"Undeposited Funds",35.09,"",43850.61
,"Sales Receipt","02-05-2024","2290",,"Mama Amina","Zelia Bleach 500ML","Cost of Goods Sold","Zelia Bleach",,"Undeposited Funds",210.53,"",44061.14
,"Sales Receipt","02-05-2024","2296",,"Tawakal Wholesale Eastleigh","Zelia Bleach 500ML","Cost of Goods Sold","Zelia Bleach",,"Undeposited Funds",842.13,"",44903.27
,"Sales Receipt","03-05-2024","2303",,"Cash Sales","Zelia Bleach 750ML","Cost of Goods Sold","Zelia Bleach",,"Undeposited Funds",46.52,"",44949.79
,"Sales Receipt","05-05-2024","2308",,"Cash Sales","Zelia Bleach 750ML","Cost of Goods Sold","Zelia Bleach",,"Undeposited Funds",46.52,"",44996.31
,"Sales Receipt","07-05-2024","2316",,"Cash Sales","Zelia Bleach 750ML","Cost of Goods Sold","Zelia Bleach",,"Undeposited Funds",558.28,"",45554.59
,"Sales Receipt","08-05-2024","2321",,"Cash Sales","Zelia Bleach 500ML","Cost of Goods Sold","Zelia Bleach",,"Undeposited Funds",35.09,"",45589.68
,"Sales Receipt","08-05-2024","2323",,"Cash Sales","Zelia Bleach 5L","Cost of Goods Sold","Zelia Bleach",,"Undeposited Funds",250.10,"",45839.78
,"Sales Receipt","10-05-2024","1918",,"Cash Sales","Zelia Bleach 750ML","Cost of Goods Sold","Zelia Bleach",,"Undeposited Funds",93.05,"",45932.83
,"Sales Receipt","13-05-2024","2344",,"Cash Sales","Zelia Bleach 500ML","Cost of Goods Sold","Zelia Bleach",,"Undeposited Funds",421.07,"",46353.90
,"Sales Receipt","13-05-2024","2346",,"Garumo Wholesallers","Zelia Bleach 500ML","Cost of Goods Sold","Zelia Bleach",,"Undeposited Funds",842.13,"",47196.03
,"Sales Receipt","13-05-2024","2356",,"The Hub Minimart","-MULTIPLE-","Cost of Goods Sold","Zelia Bleach",,"Undeposited Funds",700.21,"",47896.24
,"Sales Receipt","13-05-2024","1920",,"Cash Sales","Zelia Bleach 750ML","Cost of Goods Sold","Zelia Bleach",,"Undeposited Funds",46.52,"",47942.76
,"Sales Receipt","13-05-2024","1924",,"Cash Sales","Zelia Bleach 750ML","Cost of Goods Sold","Zelia Bleach",,"Undeposited Funds",46.52,"",47989.28
,"Sales Receipt","14-05-2024","2355",,"Beraccah Wholesallers","Zelia Bleach 500ML","Cost of Goods Sold","Zelia Bleach",,"Undeposited Funds",421.07,"",48410.35
,"Sales Receipt","16-05-2024","2370",,"Imani General Store","Zelia Bleach 500ML","Cost of Goods Sold","Zelia Bleach",,"Undeposited Funds",210.53,"",48620.88
,"Sales Receipt","16-05-2024","1930",,"Cash Sales","Zelia Bleach 5L","Cost of Goods Sold","Zelia Bleach",,"Undeposited Funds",250.10,"",48870.98
,"Sales Receipt","17-05-2024","1934",,"Cash Sales","Zelia Bleach 750ML","Cost of Goods Sold","Zelia Bleach",,"Undeposited Funds",46.52,"",48917.50
,"Sales Receipt","20-05-2024","1939",,"Nuclear Supermarket","Zelia Bleach 500ML","Cost of Goods Sold","Zelia Bleach",,"Undeposited Funds",210.53,"",49128.03
,"Sales Receipt","22-05-2024","1952",,"Cash Sales","Zelia Bleach 5L","Cost of Goods Sold","Zelia Bleach",,"Undeposited Funds",250.10,"",49378.13
,"Sales Receipt","23-05-2024","1955",,"Cash Sales","Zelia Bleach 750ML","Cost of Goods Sold","Zelia Bleach",,"Undeposited Funds",46.52,"",49424.65
,"Sales Receipt","23-05-2024","1963",,"Safa Shop","Zelia Bleach 500ML","Cost of Goods Sold","Zelia Bleach",,"Undeposited Funds",421.07,"",49845.72
,"Sales Receipt","24-05-2024","2381",,"Cash Sales","Zelia Bleach 5L","Cost of Goods Sold","Zelia Bleach",,"Undeposited Funds",250.10,"",50095.82
,"Invoice","28-05-2024","MC05765",,"TAWALA SUPERMARKET LIMITED","Zelia Bleach 500ML","Cost of Goods Sold","Zelia Bleach",,"Accounts Receivable",421.07,"",50516.89
,"Sales Receipt","28-05-2024","2389",,"Restoration Traders","-MULTIPLE-","Cost of Goods Sold","Zelia Bleach",,"Undeposited Funds",1400.41,"",51917.30
,"Sales Receipt","29-05-2024","2390",,"Cash Sales","Zelia Bleach 750ML","Cost of Goods Sold","Zelia Bleach",,"Undeposited Funds",93.05,"",52010.35
,"Sales Receipt","29-05-2024","1971",,"Freshfinds Wholesale","-MULTIPLE-","Cost of Goods Sold","Zelia Bleach",,"Undeposited Funds",489.67,"",52500.02
,"Invoice","30-05-2024","MC05776",,"OFFSHORE GLOBAL LOGISTICS LIMITED","Zelia Bleach 5L","Cost of Goods Sold","Zelia Bleach",,"Accounts Receivable",500.19,"",53000.21
,"Sales Receipt","31-05-2024","1975",,"Cash Sales","Zelia Bleach 750ML","Cost of Goods Sold","Zelia Bleach",,"Undeposited Funds",46.52,"",53046.73
,"Sales Receipt","31-05-2024","1976",,"Cash Sales","Zelia Bleach 750ML","Cost of Goods Sold","Zelia Bleach",,"Undeposited Funds",93.05,"",53139.78
,"Sales Receipt","03-06-2024","2399",,"Cash Sales","Zelia Bleach 750ML","Cost of Goods Sold","Zelia Bleach",,"Undeposited Funds",46.52,"",53186.30
,"Sales Receipt","03-06-2024","1975",,"Cash Sales","Zelia Bleach 750ML","Cost of Goods Sold","Zelia Bleach",,"Undeposited Funds",46.52,"",53232.82
,"Sales Receipt","03-06-2024","1983",,"Marris Mini mart","Zelia Bleach 500ML","Cost of Goods Sold","Zelia Bleach",,"Undeposited Funds",210.53,"",53443.35
,"Sales Receipt","04-06-2024","1985",,"Cash Sales","Zelia Bleach 5L","Cost of Goods Sold","Zelia Bleach",,"Undeposited Funds",250.10,"",53693.45
,"Sales Receipt","04-06-2024","2742",,"Arwa Wholesale","-MULTIPLE-","Cost of Goods Sold","Zelia Bleach",,"Undeposited Funds",700.21,"",54393.66
,"Sales Receipt","05-06-2024","1989",,"Cash Sales","Zelia Bleach 750ML","Cost of Goods Sold","Zelia Bleach",,"Undeposited Funds",46.39,"",54440.05
,"Sales Receipt","07-06-2024","1996",,"Cash Sales","Zelia Bleach 500ML","Cost of Goods Sold","Zelia Bleach",,"Undeposited Funds",139.80,"",54579.85
,"Sales Receipt","07-06-2024","2426",,"Cash Sales","Zelia Bleach 5L","Cost of Goods Sold","Zelia Bleach",,"Undeposited Funds",250.10,"",54829.95
,"Sales Receipt","10-06-2024","1997",,"Cash Sales","Zelia Bleach 750ML","Cost of Goods Sold","Zelia Bleach",,"Undeposited Funds",46.39,"",54876.34
,"Sales Receipt","10-06-2024","2434",,"Cash Sales","Zelia Bleach 5L","Cost of Goods Sold","Zelia Bleach",,"Undeposited Funds",250.10,"",55126.44
,"Invoice","11-06-2024","MC05815",,"MADINA SUPERMARKET LIMITED","Zelia Bleach 500ML","Cost of Goods Sold","Zelia Bleach",,"Accounts Receivable",209.70,"",55336.14
,"Sales Receipt","11-06-2024","2440",,"Cash Sales","Zelia Bleach 750ML","Cost of Goods Sold","Zelia Bleach",,"Undeposited Funds",46.39,"",55382.53
,"Sales Receipt","11-06-2024","2442",,"Cash Sales","Zelia Bleach 5L","Cost of Goods Sold","Zelia Bleach",,"Undeposited Funds",250.10,"",55632.63
,"Sales Receipt","12-06-2024","2451",,"Cash Sales","Zelia Bleach 5L","Cost of Goods Sold","Zelia Bleach",,"Undeposited Funds",250.10,"",55882.73
,"Sales Receipt","12-06-2024","2453",,"Cash Sales","-MULTIPLE-","Cost of Goods Sold","Zelia Bleach",,"Undeposited Funds",1278.57,"",57161.30
,"Sales Receipt","12-06-2024","2461",,"Cash Sales","Zelia Bleach 750ML","Cost of Goods Sold","Zelia Bleach",,"Undeposited Funds",46.39,"",57207.69
,"Sales Receipt","12-06-2024","2462",,"Mama Amina","Zelia Bleach 500ML","Cost of Goods Sold","Zelia Bleach",,"Undeposited Funds",419.40,"",57627.09
,"Sales Receipt","13-06-2024","2471",,"Cash Sales","Zelia Bleach 5L","Cost of Goods Sold","Zelia Bleach",,"Undeposited Funds",500.19,"",58127.28
,"Sales Receipt","13-06-2024","2472",,"Cash Sales","Zelia Bleach 750ML","Cost of Goods Sold","Zelia Bleach",,"Undeposited Funds",46.39,"",58173.67
,"Sales Receipt","13-06-2024","2473",,"Horn of Africa","Zelia Bleach 500ML","Cost of Goods Sold","Zelia Bleach",,"Undeposited Funds",419.40,"",58593.07
,"Sales Receipt","14-06-2024","2476",,"Cash Sales","Zelia Bleach 500ML","Cost of Goods Sold","Zelia Bleach",,"Undeposited Funds",34.95,"",58628.02
,"Sales Receipt","14-06-2024","2477",,"Cash Sales","Zelia Bleach 750ML","Cost of Goods Sold","Zelia Bleach",,"Undeposited Funds",185.56,"",58813.58
,"Sales Receipt","14-06-2024","2481",,"Cash Sales","Zelia Bleach 500ML","Cost of Goods Sold","Zelia Bleach",,"Undeposited Funds",34.95,"",58848.53
,"Sales Receipt","19-06-2024","2484",,"Cash Sales","Zelia Bleach 750ML","Cost of Goods Sold","Zelia Bleach",,"Undeposited Funds",92.78,"",58941.31
,"Invoice","20-06-2024","MC05842",,"HOPEMART SELF SERVICES LTD","Zelia Bleach 500ML","Cost of Goods Sold","Zelia Bleach",,"Accounts Receivable",419.40,"",59360.71
,"Sales Receipt","20-06-2024","2493",,"Cash Sales","Zelia Bleach 500ML","Cost of Goods Sold","Zelia Bleach",,"Undeposited Funds",34.95,"",59395.66
,"Sales Receipt","20-06-2024","AT197",,"Cash Sales","Zelia Bleach 500ML","Cost of Goods Sold","Zelia Bleach",,"Undeposited Funds",419.40,"",59815.06
,"Sales Receipt","20-06-2024","AT198",,"Cash Sales","Zelia Bleach 750ML","Cost of Goods Sold","Zelia Bleach",,"Undeposited Funds",556.69,"",60371.75
,"Sales Receipt","20-06-2024","2498",,"Mamken Minimart","-MULTIPLE-","Cost of Goods Sold","Zelia Bleach",,"Undeposited Funds",1395.49,"",61767.24
,"Sales Receipt","21-06-2024","2716",,"Cash Sales","Zelia Bleach 5L","Cost of Goods Sold","Zelia Bleach",,"Undeposited Funds",250.10,"",62017.34
,"Sales Receipt","21-06-2024","2722",,"Kika Mart","Zelia Bleach 500ML","Cost of Goods Sold","Zelia Bleach",,"Undeposited Funds",419.40,"",62436.74
,"Sales Receipt","22-06-2024","2131",,"Ekai moke wholesale","-MULTIPLE-","Cost of Goods Sold","Zelia Bleach",,"Undeposited Funds",488.04,"",62924.78
,"Sales Receipt","24-06-2024","8960",,"Pambazuka Mart (K) Limited","Zelia Bleach 750ML","Cost of Goods Sold","Zelia Bleach",,"Undeposited Funds",556.69,"",63481.47
,"Invoice","26-06-2024","MC05863",,"Tupo Mart Limited","Zelia Bleach 500ML","Cost of Goods Sold","Zelia Bleach",,"Accounts Receivable",209.70,"",63691.17
,"Invoice","26-06-2024","MC05865",,"KASAMAT INVESTMENTS LTD","Zelia Bleach 500ML","Cost of Goods Sold","Zelia Bleach",,"Accounts Receivable",209.70,"",63900.87
,"Sales Receipt","26-06-2024","2732",,"Instanbul Shop","Zelia Bleach 500ML","Cost of Goods Sold","Zelia Bleach",,"Undeposited Funds",209.70,"",64110.57
,"Sales Receipt","01-07-2024","2750",,"Adurus Wholesallers","Zelia Bleach 750ML","Cost of Goods Sold","Zelia Bleach",,"Undeposited Funds",278.34,"",64388.91
,"Sales Receipt","02-07-2024","2758",,"Cash Sales","Zelia Bleach 5L","Cost of Goods Sold","Zelia Bleach",,"Undeposited Funds",250.10,"",64639.01
,"Sales Receipt","02-07-2024","2760",,"Cash Sales","Zelia Bleach 750ML","Cost of Goods Sold","Zelia Bleach",,"Undeposited Funds",46.39,"",64685.40
,"Sales Receipt","02-07-2024","2762",,"Maida Minimart","Zelia Bleach 500ML","Cost of Goods Sold","Zelia Bleach",,"Undeposited Funds",209.70,"",64895.10
,"Sales Receipt","03-07-2024","2763",,"Cash Sales","Zelia Bleach 5L","Cost of Goods Sold","Zelia Bleach",,"Undeposited Funds",1000.38,"",65895.48
,"Sales Receipt","03-07-2024","2767",,"Cash Sales","Zelia Bleach 750ML","Cost of Goods Sold","Zelia Bleach",,"Undeposited Funds",46.39,"",65941.87
,"Sales Receipt","03-07-2024","2773",,"Muleshe Wholesallers","Zelia Bleach 5L","Cost of Goods Sold","Zelia Bleach",,"Undeposited Funds",1500.57,"",67442.44
,"Sales Receipt","04-07-2024","2784",,"Cash Sales","Zelia Bleach 750ML","Cost of Goods Sold","Zelia Bleach",,"Undeposited Funds",46.39,"",67488.83
,"Sales Receipt","04-07-2024","2785",,"Cash Sales","Zelia Bleach 5L","Cost of Goods Sold","Zelia Bleach",,"Undeposited Funds",250.10,"",67738.93
,"Sales Receipt","04-07-2024","2786",,"Cash Sales","Zelia Bleach 5L","Cost of Goods Sold","Zelia Bleach",,"Undeposited Funds",250.10,"",67989.03
,"Sales Receipt","04-07-2024","2787",,"Cash Sales","Zelia Bleach 750ML","Cost of Goods Sold","Zelia Bleach",,"Undeposited Funds",92.78,"",68081.81
,"Sales Receipt","04-07-2024","2788",,"Cash Sales","Zelia Bleach 750ML","Cost of Goods Sold","Zelia Bleach",,"Undeposited Funds",46.39,"",68128.20
,"Build Assembly","05-07-2024","10770",,,"24275","Cost of Goods Sold","Zelia Bleach","X","-SPLIT-",0.70,"",68128.90
,"Sales Receipt","05-07-2024","2791",,"Cash Sales","Zelia Bleach 5L","Cost of Goods Sold","Zelia Bleach",,"Undeposited Funds",250.23,"",68379.13
,"Sales Receipt","05-07-2024","2797",,"Afro Drip LTD","Zelia Bleach 5L","Cost of Goods Sold","Zelia Bleach",,"Undeposited Funds",250.23,"",68629.36
,"Sales Receipt","06-07-2024","2502",,"Cash Sales","Zelia Bleach 5L","Cost of Goods Sold","Zelia Bleach",,"Undeposited Funds",250.23,"",68879.59
,"Sales Receipt","08-07-2024","2504",,"Cash Sales","Zelia Bleach 5L","Cost of Goods Sold","Zelia Bleach",,"Undeposited Funds",250.23,"",69129.82
,"Sales Receipt","08-07-2024","2520",,"Brightfood Nasra","Zelia Bleach 500ML","Cost of Goods Sold","Zelia Bleach",,"Undeposited Funds",104.85,"",69234.67
,"Sales Receipt","09-07-2024","2508",,"Cash Sales","Zelia Bleach 5L","Cost of Goods Sold","Zelia Bleach",,"Undeposited Funds",250.23,"",69484.90
,"Sales Receipt","09-07-2024","2509",,"Cash Sales","Zelia Bleach 5L","Cost of Goods Sold","Zelia Bleach",,"Undeposited Funds",250.23,"",69735.13
,"Sales Receipt","09-07-2024","2510",,"Cash Sales","Zelia Bleach 750ML","Cost of Goods Sold","Zelia Bleach",,"Undeposited Funds",46.39,"",69781.52
,"Sales Receipt","09-07-2024","2523",,"Mama Amina","Zelia Bleach 500ML","Cost of Goods Sold","Zelia Bleach",,"Undeposited Funds",419.40,"",70200.92
,"Sales Receipt","12-07-2024","2537",,"Cash Sales","Zelia Bleach 500ML","Cost of Goods Sold","Zelia Bleach",,"Undeposited Funds",139.80,"",70340.72
,"Sales Receipt","12-07-2024","2547",,"Farmwell Enterprises","Zelia Bleach 500ML","Cost of Goods Sold","Zelia Bleach",,"Undeposited Funds",209.70,"",70550.42
,"Sales Receipt","13-07-2024","2654",,"Damim Mart","Zelia Bleach 500ML","Cost of Goods Sold","Zelia Bleach",,"Undeposited Funds",209.70,"",70760.12
,"Invoice","15-07-2024","MC05924",,"Azaavi Collections Limited","Zelia Bleach 750ML","Cost of Goods Sold","Zelia Bleach",,"Accounts Receivable",46.39,"",70806.51
,"Sales Receipt","15-07-2024","2543",,"Cash Sales","Zelia Bleach 750ML","Cost of Goods Sold","Zelia Bleach",,"Undeposited Funds",92.78,"",70899.29
,"Sales Receipt","16-07-2024","2550",,"Summer Outlets","Zelia Bleach 500ML","Cost of Goods Sold","Zelia Bleach",,"Undeposited Funds",209.70,"",71108.99
,"Sales Receipt","17-07-2024","2562",,"Fresh Finds Mart","Zelia Bleach 750ML","Cost of Goods Sold","Zelia Bleach",,"Undeposited Funds",278.34,"",71387.33
,"Sales Receipt","20-07-2024","2578",,"Horn of Africa","-MULTIPLE-","Cost of Goods Sold","Zelia Bleach",,"Undeposited Funds",976.09,"",72363.42
,"Sales Receipt","23-07-2024","2582",,"Cash Sales","Zelia Bleach 500ML","Cost of Goods Sold","Zelia Bleach",,"Undeposited Funds",34.95,"",72398.37
,"Sales Receipt","23-07-2024","2591",,"Cash Sales","Zelia Bleach 5L","Cost of Goods Sold","Zelia Bleach",,"Undeposited Funds",250.23,"",72648.60
,"Sales Receipt","23-07-2024","2581",,"Cash Sales","Zelia Bleach 500ML","Cost of Goods Sold","Zelia Bleach",,"Undeposited Funds",69.90,"",72718.50
,"Sales Receipt","24-07-2024","2587",,"Cash Sales","Zelia Bleach 750ML","Cost of Goods Sold","Zelia Bleach",,"Undeposited Funds",46.39,"",72764.89
,"Sales Receipt","24-07-2024","2608",,"Capital Halal","Zelia Bleach 500ML","Cost of Goods Sold","Zelia Bleach",,"Undeposited Funds",209.70,"",72974.59
,"Sales Receipt","25-07-2024","2592",,"Cash Sales","Zelia Bleach 5L","Cost of Goods Sold","Zelia Bleach",,"Undeposited Funds",250.23,"",73224.82
,"Sales Receipt","25-07-2024","2594",,"Cash Sales","Zelia Bleach 750ML","Cost of Goods Sold","Zelia Bleach",,"Undeposited Funds",46.39,"",73271.21
,"Sales Receipt","26-07-2024","2690",,"Amani Store","Zelia Bleach 500ML","Cost of Goods Sold","Zelia Bleach",,"Undeposited Funds",419.40,"",73690.61
,"Invoice","29-07-2024","MC05984",,"Mumsha Supamat","Zelia Bleach 750ML","Cost of Goods Sold","Zelia Bleach",,"Accounts Receivable",278.34,"",73968.95
,"Sales Receipt","29-07-2024","2602",,"Cash Sales","Zelia Bleach 500ML","Cost of Goods Sold","Zelia Bleach",,"Undeposited Funds",34.95,"",74003.90
,"Sales Receipt","30-07-2024","2619",,"Cash Sales","Zelia Bleach 750ML","Cost of Goods Sold","Zelia Bleach",,"Undeposited Funds",46.39,"",74050.29
,"Sales Receipt","30-07-2024","2620",,"Cash Sales","Zelia Bleach 750ML","Cost of Goods Sold","Zelia Bleach",,"Undeposited Funds",92.78,"",74143.07
,"Sales Receipt","30-07-2024","2623",,"Smart Choice","-MULTIPLE-","Cost of Goods Sold","Zelia Bleach",,"Undeposited Funds",766.39,"",74909.46
,"Sales Receipt","30-07-2024","2627",,"Elliane Wholesalers","Zelia Bleach 500ML","Cost of Goods Sold","Zelia Bleach",,"Undeposited Funds",209.70,"",75119.16
,"Sales Receipt","30-07-2024","2626",,"Nzuri Supermarket","Zelia Bleach 500ML","Cost of Goods Sold","Zelia Bleach",,"Undeposited Funds",104.85,"",75224.01
,"Sales Receipt","30-07-2024","2689",,"Mt Kenya  mart","Zelia Bleach 500ML","Cost of Goods Sold","Zelia Bleach",,"Undeposited Funds",209.70,"",75433.71
,"Sales Receipt","02-08-2024","2644",,"Cash Sales","Zelia Bleach 750ML","Cost of Goods Sold","Zelia Bleach",,"Undeposited Funds",46.39,"",75480.10
,"Sales Receipt","02-08-2024","2647",,"Cash Sales","Zelia Bleach 500ML","Cost of Goods Sold","Zelia Bleach",,"Undeposited Funds",34.95,"",75515.05
,"Sales Receipt","02-08-2024","2648",,"Cash Sales","Zelia Bleach 500ML","Cost of Goods Sold","Zelia Bleach",,"Undeposited Funds",34.95,"",75550.00
,"Sales Receipt","02-08-2024","2650",,"Cash Sales","Zelia Bleach 500ML","Cost of Goods Sold","Zelia Bleach",,"Undeposited Funds",104.85,"",75654.85
,"Sales Receipt","02-08-2024","2666",,"Mama Amina","-MULTIPLE-","Cost of Goods Sold","Zelia Bleach",,"Undeposited Funds",976.09,"",76630.94
,"Sales Receipt","03-08-2024","2669",,"Kilimanjaro Store","Zelia Bleach 500ML","Cost of Goods Sold","Zelia Bleach",,"Undeposited Funds",838.80,"",77469.74
,"Sales Receipt","06-08-2024","2659",,"Cash Sales","Zelia Bleach 5L","Cost of Goods Sold","Zelia Bleach",,"Undeposited Funds",250.23,"",77719.97
,"Sales Receipt","06-08-2024","2680",,"Juja Minimart","-MULTIPLE-","Cost of Goods Sold","Zelia Bleach",,"Undeposited Funds",1395.49,"",79115.46
,"Sales Receipt","07-08-2024","828",,"B-Shop","-MULTIPLE-","Cost of Goods Sold","Zelia Bleach",,"Undeposited Funds",2790.97,"",81906.43
,"Invoice","08-08-2024","MC06018",,"OFFSHORE GLOBAL LOGISTICS LIMITED","Zelia Bleach 5L","Cost of Goods Sold","Zelia Bleach",,"Accounts Receivable",250.23,"",82156.66
,"Sales Receipt","09-08-2024","2699",,"Cash Sales","Zelia Bleach 500ML","Cost of Goods Sold","Zelia Bleach",,"Undeposited Funds",34.95,"",82191.61
,"Invoice","12-08-2024","MC06031",,"KAVYA SUPERMARKET LIMITED","Zelia Bleach 750ML","Cost of Goods Sold","Zelia Bleach",,"Accounts Receivable",556.26,"",82747.87
,"Sales Receipt","12-08-2024","2807",,"Cash Sales","Zelia Bleach 5L","Cost of Goods Sold","Zelia Bleach",,"Undeposited Funds",250.00,"",82997.87
,"Sales Receipt","12-08-2024","2813",,"Mamken Minimart","Zelia Bleach 500ML","Cost of Goods Sold","Zelia Bleach",,"Undeposited Funds",209.70,"",83207.57
,"Sales Receipt","12-08-2024","2815",,"Kibibi Wasai Store","Zelia Bleach 500ML","Cost of Goods Sold","Zelia Bleach",,"Undeposited Funds",838.80,"",84046.37
,"Sales Receipt","13-08-2024","2820",,"Cash Sales","Zelia Bleach 5L","Cost of Goods Sold","Zelia Bleach",,"Undeposited Funds",250.00,"",84296.37
,"Sales Receipt","14-08-2024","2821",,"Cash Sales","Zelia Bleach 5L","Cost of Goods Sold","Zelia Bleach",,"Undeposited Funds",500.01,"",84796.38
,"Sales Receipt","14-08-2024","2823",,"Cash Sales","Zelia Bleach 500ML","Cost of Goods Sold","Zelia Bleach",,"Undeposited Funds",104.85,"",84901.23
,"Sales Receipt","14-08-2024","2847",,"Memos Supermarket","-MULTIPLE-","Cost of Goods Sold","Zelia Bleach",,"Undeposited Funds",1394.22,"",86295.45
,"Sales Receipt","15-08-2024","2824",,"Cash Sales","Zelia Bleach 5L","Cost of Goods Sold","Zelia Bleach",,"Undeposited Funds",500.01,"",86795.46
,"Sales Receipt","16-08-2024","2901",,"Cash Sales","Zelia Bleach 750ML","Cost of Goods Sold","Zelia Bleach",,"Undeposited Funds",46.29,"",86841.75
,"Sales Receipt","16-08-2024","2850",,"Hawkers Paradise","Zelia Bleach 5L","Cost of Goods Sold","Zelia Bleach",,"Undeposited Funds",250.00,"",87091.75
,"Sales Receipt","16-08-2024","2851",,"Tahila Enterprises","-MULTIPLE-","Cost of Goods Sold","Zelia Bleach",,"Undeposited Funds",162.47,"",87254.22
,"Sales Receipt","17-08-2024","2843",,"Horn of Africa","-MULTIPLE-","Cost of Goods Sold","Zelia Bleach",,"Undeposited Funds",974.82,"",88229.04
,"Invoice","19-08-2024","MC06050",,"Azaavi Collections Limited","Zelia Bleach 750ML","Cost of Goods Sold","Zelia Bleach",,"Accounts Receivable",46.29,"",88275.33
,"Sales Receipt","19-08-2024","2836",,"Cash Sales","Zelia Bleach 750ML","Cost of Goods Sold","Zelia Bleach",,"Undeposited Funds",46.29,"",88321.62
,"Sales Receipt","20-08-2024","2857",,"Nuclear Supermarket","-MULTIPLE-","Cost of Goods Sold","Zelia Bleach",,"Undeposited Funds",487.41,"",88809.03
,"Sales Receipt","20-08-2024","2869",,"Soft Landing","Zelia Bleach 750ML","Cost of Goods Sold","Zelia Bleach",,"Undeposited Funds",92.57,"",88901.60
,"Invoice","22-08-2024","MC06069",,"Mumsha Supamat","Zelia Bleach 500ML","Cost of Goods Sold","Zelia Bleach",,"Accounts Receivable",209.70,"",89111.30
,"Sales Receipt","23-08-2024","2876",,"Cash Sales","Zelia Bleach 750ML","Cost of Goods Sold","Zelia Bleach",,"Undeposited Funds",46.29,"",89157.59
,"Sales Receipt","23-08-2024","2877",,"Cash Sales","Zelia Bleach 750ML","Cost of Goods Sold","Zelia Bleach",,"Undeposited Funds",46.29,"",89203.88
,"Sales Receipt","23-08-2024","2878",,"Cash Sales","Zelia Bleach 750ML","Cost of Goods Sold","Zelia Bleach",,"Undeposited Funds",46.29,"",89250.17
,"Sales Receipt","26-08-2024","2883",,"Cash Sales","Zelia Bleach 750ML","Cost of Goods Sold","Zelia Bleach",,"Undeposited Funds",92.57,"",89342.74
,"Sales Receipt","26-08-2024","2886",,"Cash Sales","Zelia Bleach 5L","Cost of Goods Sold","Zelia Bleach",,"Undeposited Funds",500.01,"",89842.75
,"Sales Receipt","26-08-2024","1207",,"Kemera Discount","Zelia Bleach 5L","Cost of Goods Sold","Zelia Bleach",,"Undeposited Funds",250.00,"",90092.75
,"Sales Receipt","27-08-2024","2909",,"Horn of Africa","Zelia Bleach 500ML","Cost of Goods Sold","Zelia Bleach",,"Undeposited Funds",838.80,"",90931.55
,"Sales Receipt","02-09-2024","2916",,"Anne","Zelia Bleach 24X500ML","Cost of Goods Sold","Zelia Bleach",,"Undeposited Funds",110.30,"",91041.85
,"Sales Receipt","02-09-2024","2923",,"Blossom Beauty","Zelia Bleach 24X500ML","Cost of Goods Sold","Zelia Bleach",,"Undeposited Funds",220.61,"",91262.46
,"Sales Receipt","02-09-2024","2972",,"Muleshe Wholesallers","Zelia Bleach 4X5L","Cost of Goods Sold","Zelia Bleach",,"Undeposited Funds",2133.68,"",93396.14
,"Sales Receipt","02-09-2024","3002",,"Cash Sales","Zelia Bleach 12X750ML","Cost of Goods Sold","Zelia Bleach",,"Undeposited Funds",58.58,"",93454.72
,"Sales Receipt","02-09-2024","3005",,"Cash Sales","Zelia Bleach 4X5L","Cost of Goods Sold","Zelia Bleach",,"Undeposited Funds",266.71,"",93721.43
,"Sales Receipt","02-09-2024","3008",,"Cash Sales","Zelia Bleach 12X750ML","Cost of Goods Sold","Zelia Bleach",,"Undeposited Funds",58.58,"",93780.01
,"Sales Receipt","02-09-2024","3010",,"Cash Sales","Zelia Bleach 24X500ML","Cost of Goods Sold","Zelia Bleach",,"Undeposited Funds",36.77,"",93816.78
,"Sales Receipt","02-09-2024","3012",,"Cash Sales","Zelia Bleach 12X750ML","Cost of Goods Sold","Zelia Bleach",,"Undeposited Funds",117.16,"",93933.94
,"Sales Receipt","02-09-2024","2921",,"Cash Sales","Zelia Bleach 12X750ML","Cost of Goods Sold","Zelia Bleach",,"Undeposited Funds",58.58,"",93992.52
,"Invoice","04-09-2024","MC06108",,"PRICE CHOPPER STORES LIMITED","-MULTIPLE-","Cost of Goods Sold","Zelia Bleach",,"Accounts Receivable",487.41,"",94479.93
,"Sales Receipt","04-09-2024","2937",,"Restoration Traders","-MULTIPLE-","Cost of Goods Sold","Zelia Bleach",,"Undeposited Funds",1585.41,"",96065.34
,"Sales Receipt","04-09-2024","2932",,"Cash Sales","Zelia Bleach 4X5L","Cost of Goods Sold","Zelia Bleach",,"Undeposited Funds",266.71,"",96332.05
,"Sales Receipt","04-09-2024","2935",,"Cash Sales","Zelia Bleach 12X750ML","Cost of Goods Sold","Zelia Bleach",,"Undeposited Funds",58.58,"",96390.63
,"Sales Receipt","05-09-2024","2950",,"Cash Sales","Zelia Bleach 24X500ML","Cost of Goods Sold","Zelia Bleach",,"Undeposited Funds",110.30,"",96500.93
,"Sales Receipt","05-09-2024","2951",,"Cash Sales","Zelia Bleach 24X500ML","Cost of Goods Sold","Zelia Bleach",,"Undeposited Funds",36.77,"",96537.70
,"Build Assembly","06-09-2024","11471",,,,"Cost of Goods Sold","Zelia Bleach","X","-SPLIT-","",0.56,96537.14
,"Sales Receipt","06-09-2024","2957",,"Cash Sales","Zelia Bleach 12X750ML","Cost of Goods Sold","Zelia Bleach",,"Undeposited Funds",58.58,"",96595.72
,"Sales Receipt","06-09-2024","2958",,"Cash Sales","Zelia Bleach 12X750ML","Cost of Goods Sold","Zelia Bleach",,"Undeposited Funds",58.58,"",96654.30
,"Sales Receipt","09-09-2024","2964",,"Cash Sales","Zelia Bleach 12X750ML","Cost of Goods Sold","Zelia Bleach",,"Undeposited Funds",58.58,"",96712.88
,"Sales Receipt","09-09-2024","2965",,"Cash Sales","Zelia Bleach 4X5L","Cost of Goods Sold","Zelia Bleach",,"Undeposited Funds",265.30,"",96978.18
,"Sales Receipt","09-09-2024","2970",,"Cash Sales","Zelia Bleach 12X750ML","Cost of Goods Sold","Zelia Bleach",,"Undeposited Funds",58.58,"",97036.76
,"Sales Receipt","10-09-2024","2983",,"Summer Outlets","Zelia Bleach 12X750ML","Cost of Goods Sold","Zelia Bleach",,"Undeposited Funds",351.50,"",97388.26
,"Sales Receipt","10-09-2024","2990",,"Maida Minimart","-MULTIPLE-","Cost of Goods Sold","Zelia Bleach",,"Undeposited Funds",572.07,"",97960.33
,"Sales Receipt","10-09-2024","2973",,"Cash Sales","Zelia Bleach 12X750ML","Cost of Goods Sold","Zelia Bleach",,"Undeposited Funds",58.58,"",98018.91
,"Sales Receipt","10-09-2024","2975",,"Cash Sales","Zelia Bleach 24X500ML","Cost of Goods Sold","Zelia Bleach",,"Undeposited Funds",147.05,"",98165.96
,"Sales Receipt","10-09-2024","3015",,"Cash Sales","Zelia Bleach 12X750ML","Cost of Goods Sold","Zelia Bleach",,"Undeposited Funds",58.58,"",98224.54
,"Sales Receipt","10-09-2024","3016",,"Cash Sales","Zelia Bleach 4X5L","Cost of Goods Sold","Zelia Bleach",,"Undeposited Funds",265.30,"",98489.84
,"Sales Receipt","10-09-2024","3237",,"Cash Sales","Zelia Bleach 24X500ML","Cost of Goods Sold","Zelia Bleach",,"Undeposited Funds",36.77,"",98526.61
,"Sales Receipt","12-09-2024","2987",,"Cash Sales","Zelia Bleach 12X750ML","Cost of Goods Sold","Zelia Bleach",,"Undeposited Funds",117.17,"",98643.78
,"Sales Receipt","13-09-2024","3101",,"Cash Sales","Zelia Bleach 12X750ML","Cost of Goods Sold","Zelia Bleach",,"Undeposited Funds",58.58,"",98702.36
,"Sales Receipt","16-09-2024","3044",,"Afro Drip LTD","Zelia Bleach 4X5L","Cost of Goods Sold","Zelia Bleach",,"Undeposited Funds",530.60,"",99232.96
,"Sales Receipt","16-09-2024","3045",,"Afro Drip LTD Reception","Zelia Bleach 12X750ML","Cost of Goods Sold","Zelia Bleach",,"Undeposited Funds",58.58,"",99291.54
,"Sales Receipt","18-09-2024","3060",,"Faisel Wholesalers","Zelia Bleach 4X5L","Cost of Goods Sold","Zelia Bleach",,"Undeposited Funds",2122.40,"",101413.94
,"Sales Receipt","18-09-2024","3053",,"Cash Sales","Zelia Bleach 12X750ML","Cost of Goods Sold","Zelia Bleach",,"Undeposited Funds",58.58,"",101472.52
,"Sales Receipt","18-09-2024","3056",,"Cash Sales","Zelia Bleach 12X750ML","Cost of Goods Sold","Zelia Bleach",,"Undeposited Funds",58.58,"",101531.10
,"Invoice","20-09-2024","MC06179",,"OFFSHORE GLOBAL LOGISTICS LIMITED","Zelia Bleach 4X5L","Cost of Goods Sold","Zelia Bleach",,"Accounts Receivable",530.60,"",102061.70
,"Sales Receipt","20-09-2024","3068",,"Cash Sales","Zelia Bleach 12X750ML","Cost of Goods Sold","Zelia Bleach",,"Undeposited Funds",58.58,"",102120.28
,"Sales Receipt","23-09-2024","3073",,"Cash Sales","Zelia Bleach 12X750ML","Cost of Goods Sold","Zelia Bleach",,"Undeposited Funds",58.58,"",102178.86
,"Invoice","24-09-2024","MC06196",,"KASAMAT INVESTMENTS LTD","Zelia Bleach 24X500ML","Cost of Goods Sold","Zelia Bleach",,"Accounts Receivable",220.57,"",102399.43
,"Sales Receipt","24-09-2024","3090",,"Elliane Wholesalers","Zelia Bleach 24X500ML","Cost of Goods Sold","Zelia Bleach",,"Undeposited Funds",220.57,"",102620.00
,"Sales Receipt","24-09-2024","3078",,"Cash Sales","Zelia Bleach 4X5L","Cost of Goods Sold","Zelia Bleach",,"Undeposited Funds",265.30,"",102885.30
,"Sales Receipt","24-09-2024","3079",,"Cash Sales","Zelia Bleach 4X5L","Cost of Goods Sold","Zelia Bleach",,"Undeposited Funds",1061.20,"",103946.50
,"Sales Receipt","24-09-2024","3088",,"Cash Sales","Zelia Bleach 12X750ML","Cost of Goods Sold","Zelia Bleach",,"Undeposited Funds",58.58,"",104005.08
,"Sales Receipt","24-09-2024","3089",,"Cash Sales","Zelia Bleach 24X500ML","Cost of Goods Sold","Zelia Bleach",,"Undeposited Funds",36.76,"",104041.84
,"Sales Receipt","24-09-2024","3091",,"Cash Sales","Zelia Bleach 12X750ML","Cost of Goods Sold","Zelia Bleach",,"Undeposited Funds",58.58,"",104100.42
,"Sales Receipt","25-09-2024","3202",,"Cash Sales","Zelia Bleach 12X750ML","Cost of Goods Sold","Zelia Bleach",,"Undeposited Funds",58.58,"",104159.00
,"Invoice","26-09-2024","MC06205",,"OFFSHORE GLOBAL LOGISTICS LIMITED","Zelia Bleach 4X5L","Cost of Goods Sold","Zelia Bleach",,"Accounts Receivable",530.60,"",104689.60
,"Invoice","27-09-2024","MC06216",,"QUALITYMART SUPERMARKET LIMITED","-MULTIPLE-","Cost of Goods Sold","Zelia Bleach",,"Accounts Receivable",572.07,"",105261.67
,"Invoice","27-09-2024","MC06217",,"Mumsha Supamat","-MULTIPLE-","Cost of Goods Sold","Zelia Bleach",,"Accounts Receivable",572.07,"",105833.74
,"Sales Receipt","27-09-2024","3216",,"Cash Sales","Zelia Bleach 4X5L","Cost of Goods Sold","Zelia Bleach",,"Undeposited Funds",530.60,"",106364.34
,"Sales Receipt","01-10-2024","3217",,"Cash Sales","Zelia Bleach 4X5L","Cost of Goods Sold","Zelia Bleach",,"Undeposited Funds",265.30,"",106629.64
,"Sales Receipt","02-10-2024","3232",,"Manzil Wholesalers","-MULTIPLE-","Cost of Goods Sold","Zelia Bleach",,"Undeposited Funds",1585.26,"",108214.90
,"Sales Receipt","02-10-2024","3244",,"B-Shop","Zelia Bleach 24X500ML","Cost of Goods Sold","Zelia Bleach",,"Undeposited Funds",3529.08,"",111743.98
,"Sales Receipt","03-10-2024","3240",,"Cash Sales","Zelia Bleach 4X5L","Cost of Goods Sold","Zelia Bleach",,"Undeposited Funds",265.30,"",112009.28
,"Sales Receipt","03-10-2024","3243",,"Cash Sales","Zelia Bleach 12X750ML","Cost of Goods Sold","Zelia Bleach",,"Undeposited Funds",58.58,"",112067.86
,"Sales Receipt","04-10-2024","3253",,"Cash Sales","Zelia Bleach 24X500ML","Cost of Goods Sold","Zelia Bleach",,"Undeposited Funds",110.28,"",112178.14
,"Sales Receipt","07-10-2024","3288",,"Adurus Wholesallers","-MULTIPLE-","Cost of Goods Sold","Zelia Bleach",,"Undeposited Funds",1144.13,"",113322.27
,"Sales Receipt","08-10-2024","3262",,"Cash Sales","Zelia Bleach 4X5L","Cost of Goods Sold","Zelia Bleach",,"Undeposited Funds",530.60,"",113852.87
,"Sales Receipt","08-10-2024","3264",,"Cash Sales","Zelia Bleach 4X5L","Cost of Goods Sold","Zelia Bleach",,"Undeposited Funds",265.30,"",114118.17
,"Sales Receipt","08-10-2024","3268",,"Cash Sales","Zelia Bleach 4X5L","Cost of Goods Sold","Zelia Bleach",,"Undeposited Funds",265.30,"",114383.47
,"Sales Receipt","09-10-2024","3275",,"Cash Sales","Zelia Bleach 4X5L","Cost of Goods Sold","Zelia Bleach",,"Undeposited Funds",265.30,"",114648.77
,"Sales Receipt","09-10-2024","3276",,"Cash Sales","Zelia Bleach 24X500ML","Cost of Goods Sold","Zelia Bleach",,"Undeposited Funds",36.76,"",114685.53
,"Sales Receipt","09-10-2024","3279",,"Cash Sales","Zelia Bleach 12X750ML","Cost of Goods Sold","Zelia Bleach",,"Undeposited Funds",53.02,"",114738.55
,"Sales Receipt","09-10-2024","3281",,"Cash Sales","Zelia Bleach 4X5L","Cost of Goods Sold","Zelia Bleach",,"Undeposited Funds",265.30,"",115003.85
,"Sales Receipt","09-10-2024","3287",,"Baba Ali Shop","Zelia Bleach 24X500ML","Cost of Goods Sold","Zelia Bleach",,"Undeposited Funds",441.14,"",115444.99
,"Invoice","11-10-2024","MC06251",,"HOPEMART SELF SERVICES LTD","-MULTIPLE-","Cost of Goods Sold","Zelia Bleach",,"Accounts Receivable",759.27,"",116204.26
,"Sales Receipt","11-10-2024","3289",,"Cash Sales","Zelia Bleach 4X5L","Cost of Goods Sold","Zelia Bleach",,"Undeposited Funds",263.58,"",116467.84
,"Sales Receipt","11-10-2024","3291",,"Cash Sales","Zelia Bleach 24X500ML","Cost of Goods Sold","Zelia Bleach",,"Undeposited Funds",110.28,"",116578.12
,"Sales Receipt","11-10-2024","3296",,"Restoration Traders","Zelia Bleach 12X750ML","Cost of Goods Sold","Zelia Bleach",,"Undeposited Funds",1272.50,"",117850.62
,"Sales Receipt","16-10-2024","3108",,"Cash Sales","Zelia Bleach 12X750ML","Cost of Goods Sold","Zelia Bleach",,"Undeposited Funds",50.07,"",117900.69
,"Sales Receipt","16-10-2024","3109",,"Cash Sales","Zelia Bleach 12X750ML","Cost of Goods Sold","Zelia Bleach",,"Undeposited Funds",100.14,"",118000.83
,"Invoice","17-10-2024","MC06269",,"MUHINDI MWEUSI SUPERMARKET LIMITED","-MULTIPLE-","Cost of Goods Sold","Zelia Bleach",,"Accounts Receivable",1041.97,"",119042.80
,"Sales Receipt","18-10-2024","3123",,"Cash Sales","Zelia Bleach 24X500ML","Cost of Goods Sold","Zelia Bleach",,"Undeposited Funds",36.76,"",119079.56
,"Sales Receipt","22-10-2024","3132",,"Hidika Shop","Zelia Bleach 24X500ML","Cost of Goods Sold","Zelia Bleach",,"Undeposited Funds",441.14,"",119520.70
,"Sales Receipt","23-10-2024","3137",,"Cash Sales","Zelia Bleach 4X5L","Cost of Goods Sold","Zelia Bleach",,"Undeposited Funds",527.15,"",120047.85
,"Sales Receipt","23-10-2024","3138",,"Cash Sales","Zelia Bleach 4X5L","Cost of Goods Sold","Zelia Bleach",,"Undeposited Funds",263.58,"",120311.43
,"Sales Receipt","23-10-2024","3142",,"Cash Sales","Zelia Bleach 12X750ML","Cost of Goods Sold","Zelia Bleach",,"Undeposited Funds",50.07,"",120361.50
,"Sales Receipt","23-10-2024","3144",,"Cash Sales","Zelia Bleach 4X5L","Cost of Goods Sold","Zelia Bleach",,"Undeposited Funds",263.58,"",120625.08
,"Sales Receipt","23-10-2024","3141",,"Kibibi Wasai Store","-MULTIPLE-","Cost of Goods Sold","Zelia Bleach",,"Undeposited Funds",3848.47,"",124473.55
,"Sales Receipt","24-10-2024","3147",,"Cash Sales","Zelia Bleach 12X750ML","Cost of Goods Sold","Zelia Bleach",,"Undeposited Funds",100.14,"",124573.69
,"Invoice","25-10-2024","MC06300",,"HAPPY VIEW SUPERMARKET LIMITED","Zelia Bleach 24X500ML  6Pcs@105","Cost of Goods Sold","Zelia Bleach",,"Accounts Receivable",220.57,"",124794.26
,"Sales Receipt","25-10-2024","3159",,"Marris Mini mart","Zelia Bleach 24X500ML","Cost of Goods Sold","Zelia Bleach",,"Undeposited Funds",220.57,"",125014.83
,"Sales Receipt","25-10-2024","3157",,"Mamken Minimart","-MULTIPLE-","Cost of Goods Sold","Zelia Bleach",,"Undeposited Funds",1483.10,"",126497.93
,"Sales Receipt","26-10-2024","3161",,"Cash Sales","Zelia Bleach 12X750ML","Cost of Goods Sold","Zelia Bleach",,"Undeposited Funds",100.14,"",126598.07
,"Sales Receipt","26-10-2024","3162",,"Muleshe Wholesallers","-MULTIPLE-","Cost of Goods Sold","Zelia Bleach",,"Undeposited Funds",4192.55,"",130790.62
,"Sales Receipt","29-10-2024","3169",,"Cash Sales","Zelia Bleach 12X750ML","Cost of Goods Sold","Zelia Bleach",,"Undeposited Funds",50.07,"",130840.69
,"Invoice","30-10-2024","MC06322",,"OFFSHORE GLOBAL LOGISTICS LIMITED","Zelia Bleach 4X5L","Cost of Goods Sold","Zelia Bleach",,"Accounts Receivable",263.58,"",131104.27
,"Sales Receipt","30-10-2024","3171",,"Cash Sales","Zelia Bleach 4X5L","Cost of Goods Sold","Zelia Bleach",,"Undeposited Funds",263.58,"",131367.85
,"Sales Receipt","04-11-2024","3430",,"Mabini Minimart","Zelia Bleach 12X750ML","Cost of Goods Sold","Zelia Bleach",,"Undeposited Funds",300.41,"",131668.26
,"Sales Receipt","04-11-2024","3708",,"Gure Yare Shop","-MULTIPLE-","Cost of Goods Sold","Zelia Bleach",,"Undeposited Funds",2083.89,"",133752.15
,"Invoice","06-11-2024","MC06335",,"Guard Mart Supermarket Limited","-MULTIPLE-","Cost of Goods Sold","Zelia Bleach",,"Accounts Receivable",86.83,"",133838.98
,"Sales Receipt","06-11-2024","3401",,"Cash Sales","Zelia Bleach 4X5L","Cost of Goods Sold","Zelia Bleach",,"Undeposited Funds",527.15,"",134366.13
,"Sales Receipt","06-11-2024","3402",,"Cash Sales","Zelia Bleach 24X500ML","Cost of Goods Sold","Zelia Bleach",,"Undeposited Funds",36.76,"",134402.89
,"Sales Receipt","07-11-2024","3405",,"Cash Sales","Zelia Bleach 4X5L","Cost of Goods Sold","Zelia Bleach",,"Undeposited Funds",263.58,"",134666.47
,"Sales Receipt","07-11-2024","3239",,"Cash Sales","Zelia Bleach 12X750ML","Cost of Goods Sold","Zelia Bleach",,"Undeposited Funds",600.83,"",135267.30
,"Sales Receipt","08-11-2024","3408",,"Cash Sales","Zelia Bleach 12X750ML","Cost of Goods Sold","Zelia Bleach",,"Undeposited Funds",50.07,"",135317.37
,"Sales Receipt","08-11-2024","3411",,"Cash Sales","Zelia Bleach 12X750ML","Cost of Goods Sold","Zelia Bleach",,"Undeposited Funds",50.07,"",135367.44
,"Sales Receipt","11-11-2024","3415",,"Cash Sales","Zelia Bleach 4X5L","Cost of Goods Sold","Zelia Bleach",,"Undeposited Funds",527.15,"",135894.59
,"Sales Receipt","11-11-2024","3456",,"RichMind Property","Zelia Bleach 4X5L","Cost of Goods Sold","Zelia Bleach",,"Undeposited Funds",263.58,"",136158.17
,"Sales Receipt","12-11-2024","3431",,"Cash Sales","-MULTIPLE-","Cost of Goods Sold","Zelia Bleach",,"Undeposited Funds",5547.14,"",141705.31
,"Sales Receipt","12-11-2024","3437",,"Jombs wholesalers","Zelia Bleach 12X750ML","Cost of Goods Sold","Zelia Bleach",,"Undeposited Funds",150.21,"",141855.52
,"Invoice","13-11-2024","MC06356",,"Mumsha Supamat","Zelia Bleach 12X750ML  6Pieces@143","Cost of Goods Sold","Zelia Bleach",,"Accounts Receivable",300.41,"",142155.93
,"Sales Receipt","13-11-2024","3434",,"Cash Sales","Zelia Bleach 4X5L","Cost of Goods Sold","Zelia Bleach",,"Undeposited Funds",263.58,"",142419.51
,"Sales Receipt","15-11-2024","3448",,"Cash Sales","Zelia Bleach 4X5L","Cost of Goods Sold","Zelia Bleach",,"Undeposited Funds",263.58,"",142683.09
,"Invoice","18-11-2024","MC06372",,"Guard Mart Supermarket Limited","-MULTIPLE-","Cost of Goods Sold","Zelia Bleach",,"Accounts Receivable",1483.06,"",144166.15
,"Credit Note","18-11-2024","CN01073",,"Guard Mart Supermarket Limited","-MULTIPLE-","Cost of Goods Sold","Zelia Bleach",,"Accounts Receivable","",86.83,144079.32
,"Sales Receipt","18-11-2024","3469",,"Cash Sales","Zelia Bleach 12X750ML","Cost of Goods Sold","Zelia Bleach",,"Undeposited Funds",50.07,"",144129.39
,"Sales Receipt","18-11-2024","3473",,"Cash Sales","Zelia Bleach 24X500ML","Cost of Goods Sold","Zelia Bleach",,"Undeposited Funds",36.76,"",144166.15
,"Sales Receipt","20-11-2024","3476",,"Cash Sales","Zelia Bleach 24X500ML","Cost of Goods Sold","Zelia Bleach",,"Undeposited Funds",36.76,"",144202.91
,"Sales Receipt","22-11-2024","3484",,"Cash Sales","Zelia Bleach 4X5L","Cost of Goods Sold","Zelia Bleach",,"Undeposited Funds",263.58,"",144466.49
,"Sales Receipt","22-11-2024","3489",,"Cash Sales","Zelia Bleach 4X5L","Cost of Goods Sold","Zelia Bleach",,"Undeposited Funds",527.15,"",144993.64
,"Sales Receipt","22-11-2024","3303",,"Cash Sales","Zelia Bleach 12X750ML","Cost of Goods Sold","Zelia Bleach",,"Undeposited Funds",50.07,"",145043.71
,"Sales Receipt","26-11-2024","3740",,"Afrodrip JKIA","Zelia Bleach 4X5L","Cost of Goods Sold","Zelia Bleach",,"Undeposited Funds",527.15,"",145570.86
,"Sales Receipt","28-11-2024","3750",,"Cash Sales","Zelia Bleach 4X5L","Cost of Goods Sold","Zelia Bleach",,"Undeposited Funds",527.15,"",146098.01
,"Sales Receipt","28-11-2024","3751",,"Cash Sales","Zelia Bleach 4X5L","Cost of Goods Sold","Zelia Bleach",,"Undeposited Funds",263.58,"",146361.59
,"Sales Receipt","29-11-2024","3754",,"Cash Sales","Zelia Bleach 12X750ML","Cost of Goods Sold","Zelia Bleach",,"Undeposited Funds",50.07,"",146411.66
,"Sales Receipt","29-11-2024","3757",,"Cash Sales","Zelia Bleach 4X5L","Cost of Goods Sold","Zelia Bleach",,"Undeposited Funds",263.58,"",146675.24
,"Sales Receipt","29-11-2024","3789",,"Ubwete Shop","-MULTIPLE-","Cost of Goods Sold","Zelia Bleach",,"Undeposited Funds",1041.95,"",147717.19
,"Sales Receipt","02-12-2024","3772",,"Cash Sales","Zelia Bleach 24X500ML","Cost of Goods Sold","Zelia Bleach",,"Undeposited Funds",36.76,"",147753.95
,"Sales Receipt","02-12-2024","3778",,"Cash Sales","Zelia Bleach 12X750ML","Cost of Goods Sold","Zelia Bleach",,"Undeposited Funds",50.07,"",147804.02
,"Invoice","09-12-2024","MC06452",,"DISII TRADERS LTD","Zelia Bleach 24X500ML  6Pcs@104","Cost of Goods Sold","Zelia Bleach",,"Accounts Receivable",220.56,"",148024.58
,"Sales Receipt","09-12-2024","3318",,"Cash Sales","Zelia Bleach 4X5L","Cost of Goods Sold","Zelia Bleach",,"Undeposited Funds",263.58,"",148288.16
,"Sales Receipt","09-12-2024","3320",,"Cash Sales","Zelia Bleach 24X500ML","Cost of Goods Sold","Zelia Bleach",,"Undeposited Funds",36.76,"",148324.92
,"Sales Receipt","11-12-2024","3333",,"Cash Sales","Zelia Bleach 12X750ML","Cost of Goods Sold","Zelia Bleach",,"Undeposited Funds",100.14,"",148425.06
,"Sales Receipt","11-12-2024","3334",,"Cash Sales","Zelia Bleach 4X5L","Cost of Goods Sold","Zelia Bleach",,"Undeposited Funds",263.58,"",148688.64
,"Sales Receipt","11-12-2024","3335",,"Cash Sales","Zelia Bleach 4X5L","Cost of Goods Sold","Zelia Bleach",,"Undeposited Funds",263.58,"",148952.22
,"Sales Receipt","13-12-2024","3340",,"Cash Sales","Zelia Bleach 4X5L","Cost of Goods Sold","Zelia Bleach",,"Undeposited Funds",263.58,"",149215.80
,"Sales Receipt","16-12-2024","3346",,"Cash Sales","Zelia Bleach 4X5L","Cost of Goods Sold","Zelia Bleach",,"Undeposited Funds",1054.31,"",150270.11
,"Sales Receipt","16-12-2024","3348",,"Cash Sales","Zelia Bleach 4X5L","Cost of Goods Sold","Zelia Bleach",,"Undeposited Funds",263.58,"",150533.69
,"Sales Receipt","16-12-2024","3353",,"Cash Sales","Zelia Bleach 4X5L","Cost of Goods Sold","Zelia Bleach",,"Undeposited Funds",263.58,"",150797.27
,"Invoice","17-12-2024","MC06477",,"OFFSHORE GLOBAL LOGISTICS LIMITED","Zelia Bleach 4X5L","Cost of Goods Sold","Zelia Bleach",,"Accounts Receivable",527.15,"",151324.42
,"Sales Receipt","19-12-2024","3375",,"Cash Sales","Zelia Bleach 4X5L","Cost of Goods Sold","Zelia Bleach",,"Undeposited Funds",527.15,"",151851.57
,"Sales Receipt","20-12-2024","3376",,"Cash Sales","Zelia Bleach 4X5L","Cost of Goods Sold","Zelia Bleach",,"Undeposited Funds",527.15,"",152378.72
"Total Zelia Bleach",,,,,,,,,,,153024.39,645.67,152378.72
"Zelia Carpet Cleaner",,,,,,,,,,,,,""
,"Sales Receipt","03-01-2024","1596",,"Cash Sales","Zelia Carpet Cleaner 5L","Cost of Goods Sold","Zelia Carpet Cleaner",,"Undeposited Funds",251.81,"",251.81
,"Sales Receipt","11-01-2024","1723",,"Cash Sales","Zelia Machine Wash 5L","Cost of Goods Sold","Zelia Carpet Cleaner",,"Undeposited Funds",220.29,"",472.10
,"Sales Receipt","12-01-2024","1727",,"Cash Sales","Zelia Machine Wash 5L","Cost of Goods Sold","Zelia Carpet Cleaner",,"Undeposited Funds",220.29,"",692.39
,"Sales Receipt","19-01-2024","1744",,"Cash Sales","Zelia Carpet Cleaner 1L","Cost of Goods Sold","Zelia Carpet Cleaner",,"Undeposited Funds",714.63,"",1407.02
,"Sales Receipt","31-01-2024","1773",,"Cash Sales","Zelia Carpet Cleaner 1L","Cost of Goods Sold","Zelia Carpet Cleaner",,"Undeposited Funds",64.97,"",1471.99
,"Sales Receipt","01-02-2024","1776",,"FARMERS BEST GROCERY","Zelia Machine Wash 1L","Cost of Goods Sold","Zelia Carpet Cleaner",,"Undeposited Funds",208.88,"",1680.87
,"Sales Receipt","07-02-2024","1811",,"Cash Sales","Zelia Carpet Cleaner 1L","Cost of Goods Sold","Zelia Carpet Cleaner",,"Undeposited Funds",64.97,"",1745.84
,"Sales Receipt","12-02-2024","1831",,"Cash Sales","Zelia Carpet Cleaner 5L","Cost of Goods Sold","Zelia Carpet Cleaner",,"Undeposited Funds",251.81,"",1997.65
,"Sales Receipt","21-02-2024","1856",,"Cash Sales","Zelia Carpet Cleaner 1L","Cost of Goods Sold","Zelia Carpet Cleaner",,"Undeposited Funds",64.97,"",2062.62
,"Sales Receipt","21-02-2024","1862",,"Ebenezer  Minimart","Zelia Machine Wash 5L","Cost of Goods Sold","Zelia Carpet Cleaner",,"Undeposited Funds",220.29,"",2282.91
,"Sales Receipt","21-02-2024","1864",,"Cash Sales","Zelia Carpet Cleaner 20L","Cost of Goods Sold","Zelia Carpet Cleaner",,"Undeposited Funds",933.42,"",3216.33
,"Sales Receipt","04-03-2024","2006",,"Cash Sales","Zelia Machine Wash 5L","Cost of Goods Sold","Zelia Carpet Cleaner",,"Undeposited Funds",220.29,"",3436.62
,"Sales Receipt","05-03-2024","2009",,"Cash Sales","Zelia Machine Wash 5L","Cost of Goods Sold","Zelia Carpet Cleaner",,"Undeposited Funds",660.87,"",4097.49
,"Sales Receipt","18-03-2024","2072",,"Cash Sales","Zelia Machine Wash 5L","Cost of Goods Sold","Zelia Carpet Cleaner",,"Undeposited Funds",220.29,"",4317.78
,"Sales Receipt","02-04-2024","2132",,"Cash Sales","Zelia Machine Wash 5L","Cost of Goods Sold","Zelia Carpet Cleaner",,"Undeposited Funds",440.58,"",4758.36
,"Sales Receipt","05-04-2024","AT 193",,"JUDY USENGE","Zelia Machine Wash 5L","Cost of Goods Sold","Zelia Carpet Cleaner",,"Undeposited Funds",2643.48,"",7401.84
,"Sales Receipt","15-04-2024","2196",,"Ebenezer  Minimart","Zelia Machine Wash 5L","Cost of Goods Sold","Zelia Carpet Cleaner",,"Undeposited Funds",220.29,"",7622.13
,"Sales Receipt","03-05-2024","2302",,"Cash Sales","Zelia Machine Wash 5L","Cost of Goods Sold","Zelia Carpet Cleaner",,"Undeposited Funds",220.29,"",7842.42
,"Sales Receipt","08-05-2024","2322",,"Cash Sales","Zelia Carpet Cleaner 5L","Cost of Goods Sold","Zelia Carpet Cleaner",,"Undeposited Funds",251.81,"",8094.23
,"Sales Receipt","13-05-2024","2356",,"The Hub Minimart","Zelia Carpet Cleaner 1L","Cost of Goods Sold","Zelia Carpet Cleaner",,"Undeposited Funds",64.97,"",8159.20
,"Sales Receipt","13-05-2024","1922",,"Cash Sales","Zelia Machine Wash 5L","Cost of Goods Sold","Zelia Carpet Cleaner",,"Undeposited Funds",237.68,"",8396.88
,"Sales Receipt","15-05-2024","2362",,"Cash Sales","Zelia Carpet Cleaner 5L","Cost of Goods Sold","Zelia Carpet Cleaner",,"Undeposited Funds",251.79,"",8648.67
,"Sales Receipt","23-05-2024","2379",,"Cash Sales","Zelia Machine Wash 5L","Cost of Goods Sold","Zelia Carpet Cleaner",,"Undeposited Funds",237.68,"",8886.35
,"Sales Receipt","24-05-2024","2380",,"Cash Sales","Zelia Carpet Cleaner 5L","Cost of Goods Sold","Zelia Carpet Cleaner",,"Undeposited Funds",251.81,"",9138.16
,"Sales Receipt","28-05-2024","2388",,"Cash Sales","Zelia Machine Wash 5L","Cost of Goods Sold","Zelia Carpet Cleaner",,"Undeposited Funds",237.68,"",9375.84
,"Sales Receipt","31-05-2024","1937",,"Island Gift Shop","Zelia Carpet Cleaner 1L","Cost of Goods Sold","Zelia Carpet Cleaner",,"Undeposited Funds",129.93,"",9505.77
,"Sales Receipt","07-06-2024","2426",,"Cash Sales","Zelia Carpet Cleaner 5L","Cost of Goods Sold","Zelia Carpet Cleaner",,"Undeposited Funds",251.81,"",9757.58
,"Sales Receipt","10-06-2024","2433",,"Cash Sales","Zelia Machine Wash 1L","Cost of Goods Sold","Zelia Carpet Cleaner",,"Undeposited Funds",52.22,"",9809.80
,"Sales Receipt","12-06-2024","2449",,"Cash Sales","Zelia Carpet Cleaner 1L","Cost of Goods Sold","Zelia Carpet Cleaner",,"Undeposited Funds",64.97,"",9874.77
,"Sales Receipt","13-06-2024","2470",,"Cash Sales","Zelia Machine Wash 5L","Cost of Goods Sold","Zelia Carpet Cleaner",,"Undeposited Funds",237.68,"",10112.45
,"Sales Receipt","28-06-2024","2745",,"Cash Sales","Zelia Carpet Cleaner 5L","Cost of Goods Sold","Zelia Carpet Cleaner",,"Undeposited Funds",251.81,"",10364.26
,"Sales Receipt","03-07-2024","2773",,"Muleshe Wholesallers","Zelia Machine Wash 5L","Cost of Goods Sold","Zelia Carpet Cleaner",,"Undeposited Funds",950.71,"",11314.97
,"Invoice","04-07-2024","MC05886",,"THE HOMEWAY SUPERMARKET LIMITED","Zelia Machine Wash 1L","Cost of Goods Sold","Zelia Carpet Cleaner",,"Accounts Receivable",313.32,"",11628.29
,"Sales Receipt","08-07-2024","2520",,"Brightfood Nasra","Zelia Machine Wash 1L","Cost of Goods Sold","Zelia Carpet Cleaner",,"Undeposited Funds",52.22,"",11680.51
,"Sales Receipt","09-07-2024","2510",,"Cash Sales","Zelia Machine Wash 5L","Cost of Goods Sold","Zelia Carpet Cleaner",,"Undeposited Funds",237.68,"",11918.19
,"Sales Receipt","19-07-2024","2567",,"Cash Sales","Zelia Machine Wash 5L","Cost of Goods Sold","Zelia Carpet Cleaner",,"Undeposited Funds",237.68,"",12155.87
,"Sales Receipt","22-07-2024","2574",,"Cash Sales","Zelia Machine Wash 5L","Cost of Goods Sold","Zelia Carpet Cleaner",,"Undeposited Funds",237.68,"",12393.55
,"Sales Receipt","24-07-2024","2588",,"Cash Sales","Zelia Machine Wash 20L","Cost of Goods Sold","Zelia Carpet Cleaner",,"Undeposited Funds",237.60,"",12631.15
,"Build Assembly","24-07-2024","11041",,,,"Cost of Goods Sold","Zelia Carpet Cleaner","X","-SPLIT-",580.71,"",13211.86
,"Invoice","08-08-2024","MC06017",,"INTEGRAL MEDIA LIMITED","Zelia Machine Wash 5L","Cost of Goods Sold","Zelia Carpet Cleaner",,"Accounts Receivable",237.68,"",13449.54
,"Sales Receipt","14-08-2024","MC06017",,"Cash Sales","Zelia Machine Wash 5L","Cost of Goods Sold","Zelia Carpet Cleaner",,"Undeposited Funds",237.68,"",13687.22
,"Sales Receipt","21-08-2024","2854",,"Cash Sales","Zelia Carpet Cleaner 5L","Cost of Goods Sold","Zelia Carpet Cleaner",,"Undeposited Funds",251.81,"",13939.03
,"Sales Receipt","23-08-2024","2879",,"Cash Sales","Zelia Carpet Cleaner 5L","Cost of Goods Sold","Zelia Carpet Cleaner",,"Undeposited Funds",251.81,"",14190.84
,"Sales Receipt","02-09-2024","3007",,"Cash Sales","Zelia Machine Wash 5L","Cost of Goods Sold","Zelia Carpet Cleaner",,"Undeposited Funds",237.68,"",14428.52
,"Sales Receipt","13-09-2024","3031",,"Cash Sales","Zelia Machine Wash 5L","Cost of Goods Sold","Zelia Carpet Cleaner",,"Undeposited Funds",237.67,"",14666.19
,"Sales Receipt","13-09-2024","3032",,"Cash Sales","Zelia Machine Wash 5L","Cost of Goods Sold","Zelia Carpet Cleaner",,"Undeposited Funds",237.68,"",14903.87
,"Sales Receipt","26-09-2024","3209",,"Cash Sales","Zelia Machine Wash 1L","Cost of Goods Sold","Zelia Carpet Cleaner",,"Undeposited Funds",52.22,"",14956.09
,"Sales Receipt","01-10-2024","3217",,"Cash Sales","Zelia Machine Wash 5L","Cost of Goods Sold","Zelia Carpet Cleaner",,"Undeposited Funds",237.68,"",15193.77
,"Sales Receipt","07-10-2024","3255",,"Cash Sales","Zelia Machine Wash 5L","Cost of Goods Sold","Zelia Carpet Cleaner",,"Undeposited Funds",59.42,"",15253.19
,"Sales Receipt","18-10-2024","3124",,"Cash Sales","Zelia Machine Wash 5L","Cost of Goods Sold","Zelia Carpet Cleaner",,"Undeposited Funds",237.68,"",15490.87
,"Sales Receipt","23-10-2024","3142",,"Cash Sales","Zelia Machine Wash 1L","Cost of Goods Sold","Zelia Carpet Cleaner",,"Undeposited Funds",52.22,"",15543.09
,"Sales Receipt","26-10-2024","3161",,"Cash Sales","Zelia Machine Wash 5L","Cost of Goods Sold","Zelia Carpet Cleaner",,"Undeposited Funds",237.68,"",15780.77
,"Sales Receipt","26-10-2024","3162",,"Muleshe Wholesallers","Zelia Machine Wash 5L","Cost of Goods Sold","Zelia Carpet Cleaner",,"Undeposited Funds",1901.43,"",17682.20
,"Sales Receipt","29-10-2024","3169",,"Cash Sales","Zelia Machine Wash 1L","Cost of Goods Sold","Zelia Carpet Cleaner",,"Undeposited Funds",52.22,"",17734.42
,"Sales Receipt","31-10-2024","3195",,"Cash Sales","Zelia Machine Wash 5L","Cost of Goods Sold","Zelia Carpet Cleaner",,"Undeposited Funds",237.68,"",17972.10
,"Sales Receipt","07-11-2024","3239",,"Cash Sales","Zelia Machine Wash 5L","Cost of Goods Sold","Zelia Carpet Cleaner",,"Undeposited Funds",237.68,"",18209.78
,"Build Assembly","08-11-2024","11901",,,,"Cost of Goods Sold","Zelia Carpet Cleaner","X","-SPLIT-",210.90,"",18420.68
,"Sales Receipt","12-11-2024","3431",,"Cash Sales","Zelia Machine Wash 5L","Cost of Goods Sold","Zelia Carpet Cleaner",,"Undeposited Funds",356.52,"",18777.20
,"Sales Receipt","12-11-2024","3433",,"Cash Sales","Zelia Machine Wash 5L","Cost of Goods Sold","Zelia Carpet Cleaner",,"Undeposited Funds",237.68,"",19014.88
,"Sales Receipt","18-11-2024","3468",,"Cash Sales","Zelia Machine Wash 20L","Cost of Goods Sold","Zelia Carpet Cleaner",,"Undeposited Funds",237.60,"",19252.48
,"Sales Receipt","29-11-2024","3758",,"Cash Sales","Zelia Machine Wash 20L","Cost of Goods Sold","Zelia Carpet Cleaner",,"Undeposited Funds",237.60,"",19490.08
"Total Zelia Carpet Cleaner",,,,,,,,,,,19490.08,0.00,19490.08
"Zelia Toilet Cleaner Liq",,,,,,,,,,,,,""
,"Sales Receipt","03-01-2024","1592",,"Cash Sales","-MULTIPLE-","Cost of Goods Sold","Zelia Toilet Cleaner Liq",,"Undeposited Funds",783.96,"",783.96
,"Sales Receipt","03-01-2024","1597",,"Cash Sales","Zelia Toilet Cleaner Liquid 750ML","Cost of Goods Sold","Zelia Toilet Cleaner Liq",,"Undeposited Funds",242.00,"",1025.96
,"Invoice","04-01-2024","MC05269",,"OFFSHORE GLOBAL LOGISTICS LIMITED","Zelia Toilet Cleaner Liquid 5L","Cost of Goods Sold","Zelia Toilet Cleaner Liq",,"Accounts Receivable",2651.85,"",3677.81
,"Sales Receipt","04-01-2024","1705",,"Tawakal Wholesale Eastleigh","Zelia Toilet Cleaner Liquid 750ML","Cost of Goods Sold","Zelia Toilet Cleaner Liq",,"Undeposited Funds",3388.06,"",7065.87
,"Sales Receipt","04-01-2024","1706",,"Tawakal Wholesale Eastleigh","Zelia Toilet Cleaner Liquid 750ML","Cost of Goods Sold","Zelia Toilet Cleaner Liq",,"Undeposited Funds",3388.06,"",10453.93
,"Invoice","05-01-2024","MC05272",,"Mumsha Supamat","Zelia Toilet Cleaner Liquid 750ML","Cost of Goods Sold","Zelia Toilet Cleaner Liq",,"Accounts Receivable",726.01,"",11179.94
,"Sales Receipt","05-01-2024","1600",,"Cash Sales","Zelia Toilet Cleaner Liquid 750ML","Cost of Goods Sold","Zelia Toilet Cleaner Liq",,"Undeposited Funds",242.00,"",11421.94
,"Sales Receipt","10-01-2024","1722",,"Cash Sales","Zelia Toilet Cleaner Liquid 5L","Cost of Goods Sold","Zelia Toilet Cleaner Liq",,"Undeposited Funds",662.96,"",12084.90
,"Sales Receipt","11-01-2024","1724",,"Mashallah Foodstuffs","Zelia Toilet Cleaner Liquid 750ML","Cost of Goods Sold","Zelia Toilet Cleaner Liq",,"Undeposited Funds",1694.03,"",13778.93
,"Invoice","15-01-2024","MC05308",,"MUHINDI MWEUSI SUPERMARKET LIMITED","Zelia Toilet Cleaner Liquid 750ML","Cost of Goods Sold","Zelia Toilet Cleaner Liq",,"Accounts Receivable",726.01,"",14504.94
,"Invoice","15-01-2024","MC05310",,"MUHINDI MWEUSI SUPERMARKET LIMITED","Zelia Toilet Cleaner Liquid 750ML","Cost of Goods Sold","Zelia Toilet Cleaner Liq",,"Accounts Receivable",363.01,"",14867.95
,"Invoice","15-01-2024","MC05311",,"Seasons lane Mart","Zelia Toilet Cleaner Liquid 750ML","Cost of Goods Sold","Zelia Toilet Cleaner Liq",,"Accounts Receivable",726.01,"",15593.96
,"Sales Receipt","15-01-2024","1729",,"Cash Sales","Zelia Toilet Cleaner Liquid 750ML","Cost of Goods Sold","Zelia Toilet Cleaner Liq",,"Undeposited Funds",121.00,"",15714.96
,"Sales Receipt","15-01-2024","1731",,"RAZAQ AIRWAYS","Zelia Toilet Cleaner Liquid 750ML","Cost of Goods Sold","Zelia Toilet Cleaner Liq",,"Undeposited Funds",1694.03,"",17408.99
,"Sales Receipt","16-01-2024","1740",,"Cash Sales","Zelia Toilet Cleaner Liquid 750ML","Cost of Goods Sold","Zelia Toilet Cleaner Liq",,"Undeposited Funds",121.00,"",17529.99
,"Sales Receipt","17-01-2024","1748",,"Yasin Shop","Zelia Toilet Cleaner Liquid 750ML","Cost of Goods Sold","Zelia Toilet Cleaner Liq",,"Undeposited Funds",242.00,"",17771.99
,"Sales Receipt","19-01-2024","1739",,"Cash Sales","Zelia Toilet Cleaner Liquid 750ML","Cost of Goods Sold","Zelia Toilet Cleaner Liq",,"Undeposited Funds",121.00,"",17892.99
,"Sales Receipt","19-01-2024","1742",,"Cash Sales","Zelia Toilet Cleaner Liquid 750ML","Cost of Goods Sold","Zelia Toilet Cleaner Liq",,"Undeposited Funds",363.01,"",18256.00
,"Sales Receipt","19-01-2024","1744",,"Cash Sales","Zelia Toilet Cleaner Liquid 750ML","Cost of Goods Sold","Zelia Toilet Cleaner Liq",,"Undeposited Funds",363.01,"",18619.01
,"Sales Receipt","19-01-2024","1746",,"Cash Sales","Zelia Toilet Cleaner Liquid 750ML","Cost of Goods Sold","Zelia Toilet Cleaner Liq",,"Undeposited Funds",121.00,"",18740.01
,"Sales Receipt","21-01-2024","AT186",,"Cash Sales","Zelia Toilet Cleaner Liquid 750ML","Cost of Goods Sold","Zelia Toilet Cleaner Liq",,"Undeposited Funds",1694.03,"",20434.04
,"Invoice","24-01-2024","MC05346",,"Qways Supermarket","Zelia Toilet Cleaner Liquid 750ML","Cost of Goods Sold","Zelia Toilet Cleaner Liq",,"Accounts Receivable",726.01,"",21160.05
,"Invoice","24-01-2024","MC05348",,"MUHINDI MWEUSI SUPERMARKET LIMITED","Zelia Toilet Cleaner Liquid 750ML","Cost of Goods Sold","Zelia Toilet Cleaner Liq",,"Accounts Receivable",726.01,"",21886.06
,"Sales Receipt","24-01-2024","1755",,"Alma Mart","Zelia Toilet Cleaner Liquid 750ML","Cost of Goods Sold","Zelia Toilet Cleaner Liq",,"Undeposited Funds",726.01,"",22612.07
,"Sales Receipt","24-01-2024","1756",,"Cash Sales","Zelia Toilet Cleaner Liquid 750ML","Cost of Goods Sold","Zelia Toilet Cleaner Liq",,"Undeposited Funds",121.00,"",22733.07
,"Sales Receipt","25-01-2024","1758",,"Cash Sales","Zelia Toilet Cleaner Liquid 750ML","Cost of Goods Sold","Zelia Toilet Cleaner Liq",,"Undeposited Funds",363.01,"",23096.08
,"Sales Receipt","29-01-2024","1763",,"Cash Sales","Zelia Toilet Cleaner Liquid 750ML","Cost of Goods Sold","Zelia Toilet Cleaner Liq",,"Undeposited Funds",121.00,"",23217.08
,"Sales Receipt","29-01-2024","1769",,"Cash Sales","Zelia Toilet Cleaner Liquid 750ML","Cost of Goods Sold","Zelia Toilet Cleaner Liq",,"Undeposited Funds",121.00,"",23338.08
,"Sales Receipt","30-01-2024","1766",,"Cash Sales","Zelia Toilet Cleaner Liquid 5L","Cost of Goods Sold","Zelia Toilet Cleaner Liq",,"Undeposited Funds",662.96,"",24001.04
,"Sales Receipt","30-01-2024","1767",,"Cash Sales","Zelia Toilet Cleaner Liquid 750ML","Cost of Goods Sold","Zelia Toilet Cleaner Liq",,"Undeposited Funds",121.00,"",24122.04
,"Sales Receipt","30-01-2024","1768",,"Cash Sales","Zelia Toilet Cleaner Liquid 5L","Cost of Goods Sold","Zelia Toilet Cleaner Liq",,"Undeposited Funds",662.96,"",24785.00
,"Sales Receipt","31-01-2024","1773",,"Cash Sales","Zelia Toilet Cleaner Liquid 750ML","Cost of Goods Sold","Zelia Toilet Cleaner Liq",,"Undeposited Funds",242.00,"",25027.00
,"Sales Receipt","01-02-2024","1776",,"FARMERS BEST GROCERY","Zelia Toilet Cleaner Liquid 750ML","Cost of Goods Sold","Zelia Toilet Cleaner Liq",,"Undeposited Funds",1452.03,"",26479.03
,"Invoice","02-02-2024","MC05378",,"MZOORI STORE LIMITED","Zelia Toilet Cleaner Liquid 750ML","Cost of Goods Sold","Zelia Toilet Cleaner Liq",,"Accounts Receivable",726.01,"",27205.04
,"Invoice","02-02-2024","MC05379",,"HOPEMART SELF SERVICES LTD","Zelia Toilet Cleaner Liquid 750ML","Cost of Goods Sold","Zelia Toilet Cleaner Liq",,"Accounts Receivable",726.01,"",27931.05
,"Sales Receipt","02-02-2024","1781",,"Restoration Traders","Zelia Toilet Cleaner Liquid 750ML","Cost of Goods Sold","Zelia Toilet Cleaner Liq",,"Undeposited Funds",1694.03,"",29625.08
,"Sales Receipt","02-02-2024","1782",,"Cash Sales","Zelia Toilet Cleaner Liquid 750ML","Cost of Goods Sold","Zelia Toilet Cleaner Liq",,"Undeposited Funds",121.00,"",29746.08
,"Sales Receipt","02-02-2024","1783",,"Cheche Minimart","Zelia Toilet Cleaner Liquid 750ML","Cost of Goods Sold","Zelia Toilet Cleaner Liq",,"Undeposited Funds",726.01,"",30472.09
,"Sales Receipt","02-02-2024","1784",,"Kandara minimart","Zelia Toilet Cleaner Liquid 750ML","Cost of Goods Sold","Zelia Toilet Cleaner Liq",,"Undeposited Funds",484.01,"",30956.10
,"Sales Receipt","05-02-2024","1787",,"Cash Sales","Zelia Toilet Cleaner Liquid 750ML","Cost of Goods Sold","Zelia Toilet Cleaner Liq",,"Undeposited Funds",121.00,"",31077.10
,"Sales Receipt","05-02-2024","1793",,"Saacid Shop","Zelia Toilet Cleaner Liquid 750ML","Cost of Goods Sold","Zelia Toilet Cleaner Liq",,"Undeposited Funds",1694.03,"",32771.13
,"Sales Receipt","06-02-2024","1796",,"Towba General Store","Zelia Toilet Cleaner Liquid 750ML","Cost of Goods Sold","Zelia Toilet Cleaner Liq",,"Undeposited Funds",3388.06,"",36159.19
,"Sales Receipt","06-02-2024","1800",,"Mama Amina","Zelia Toilet Cleaner Liquid 750ML","Cost of Goods Sold","Zelia Toilet Cleaner Liq",,"Undeposited Funds",605.01,"",36764.20
,"Sales Receipt","06-02-2024","1805",,"Tawakal Wholesale Eastleigh","Zelia Toilet Cleaner Liquid 750ML","Cost of Goods Sold","Zelia Toilet Cleaner Liq",,"Undeposited Funds",3388.06,"",40152.26
,"Sales Receipt","06-02-2024","1808",,"Cash Sales","Zelia Toilet Cleaner Liquid 750ML","Cost of Goods Sold","Zelia Toilet Cleaner Liq",,"Undeposited Funds",121.00,"",40273.26
,"Sales Receipt","08-02-2024","1815",,"Cash Sales","Zelia Toilet Cleaner Liquid 750ML","Cost of Goods Sold","Zelia Toilet Cleaner Liq",,"Undeposited Funds",121.00,"",40394.26
,"Sales Receipt","08-02-2024","1816",,"Cash Sales","Zelia Toilet Cleaner Liquid 750ML","Cost of Goods Sold","Zelia Toilet Cleaner Liq",,"Undeposited Funds",363.01,"",40757.27
,"Sales Receipt","08-02-2024","1817",,"Cash Sales","Zelia Toilet Cleaner Liquid 750ML","Cost of Goods Sold","Zelia Toilet Cleaner Liq",,"Undeposited Funds",121.00,"",40878.27
,"Sales Receipt","09-02-2024","1820",,"Gure Yare Shop Nasra","Zelia Toilet Cleaner Liquid 750ML","Cost of Goods Sold","Zelia Toilet Cleaner Liq",,"Undeposited Funds",8470.16,"",49348.43
,"Sales Receipt","12-02-2024","1825",,"Downtown Wholesalers","Zelia Toilet Cleaner Liquid 750ML","Cost of Goods Sold","Zelia Toilet Cleaner Liq",,"Undeposited Funds",1694.03,"",51042.46
,"Sales Receipt","12-02-2024","1827",,"MWASPART AIRWAYS","Zelia Toilet Cleaner Liquid 750ML","Cost of Goods Sold","Zelia Toilet Cleaner Liq",,"Undeposited Funds",1452.03,"",52494.49
,"Sales Receipt","12-02-2024","1830",,"Cash Sales","Zelia Toilet Cleaner Liquid 750ML","Cost of Goods Sold","Zelia Toilet Cleaner Liq",,"Undeposited Funds",121.00,"",52615.49
,"Sales Receipt","14-02-2024","1838",,"Cash Sales","Zelia Toilet Cleaner Liquid 750ML","Cost of Goods Sold","Zelia Toilet Cleaner Liq",,"Undeposited Funds",605.18,"",53220.67
,"Sales Receipt","16-02-2024","1846",,"Muumini Skood","Zelia Toilet Cleaner Liquid 750ML","Cost of Goods Sold","Zelia Toilet Cleaner Liq",,"Undeposited Funds",1694.51,"",54915.18
,"Sales Receipt","16-02-2024","1847",,"Gidesh Supermarket","Zelia Toilet Cleaner Liquid 750ML","Cost of Goods Sold","Zelia Toilet Cleaner Liq",,"Undeposited Funds",726.22,"",55641.40
,"Sales Receipt","16-02-2024","1852",,"Nuclear Supermarket","Zelia Toilet Cleaner Liquid 750ML","Cost of Goods Sold","Zelia Toilet Cleaner Liq",,"Undeposited Funds",726.22,"",56367.62
,"Sales Receipt","17-02-2024","1851",,"MumsCereal and General Stores","Zelia Toilet Cleaner Liquid 750ML","Cost of Goods Sold","Zelia Toilet Cleaner Liq",,"Undeposited Funds",363.11,"",56730.73
,"Sales Receipt","21-02-2024","1856",,"Cash Sales","Zelia Toilet Cleaner Liquid 750ML","Cost of Goods Sold","Zelia Toilet Cleaner Liq",,"Undeposited Funds",121.04,"",56851.77
,"Sales Receipt","21-02-2024","1859",,"Cash Sales","Zelia Toilet Cleaner Liquid 750ML","Cost of Goods Sold","Zelia Toilet Cleaner Liq",,"Undeposited Funds",121.04,"",56972.81
,"Sales Receipt","21-02-2024","1861",,"Cash Sales","Zelia Toilet Cleaner Liquid 750ML","Cost of Goods Sold","Zelia Toilet Cleaner Liq",,"Undeposited Funds",121.04,"",57093.85
,"Sales Receipt","21-02-2024","1862",,"Ebenezer  Minimart","Zelia Toilet Cleaner Liquid 750ML","Cost of Goods Sold","Zelia Toilet Cleaner Liq",,"Undeposited Funds",726.22,"",57820.07
,"Invoice","22-02-2024","MC05434",,"NASRI MART LIMITED","Zelia Toilet Cleaner Liquid 750ML","Cost of Goods Sold","Zelia Toilet Cleaner Liq",,"Accounts Receivable",605.18,"",58425.25
,"Sales Receipt","22-02-2024","1865",,"Cash Sales","Zelia Toilet Cleaner Liquid 750ML","Cost of Goods Sold","Zelia Toilet Cleaner Liq",,"Undeposited Funds",121.04,"",58546.29
,"Sales Receipt","22-02-2024","1866",,"Cash Sales","Zelia Toilet Cleaner Liquid 750ML","Cost of Goods Sold","Zelia Toilet Cleaner Liq",,"Undeposited Funds",242.07,"",58788.36
,"Sales Receipt","22-02-2024","1868",,"Cash Sales","Zelia Toilet Cleaner Liquid 750ML","Cost of Goods Sold","Zelia Toilet Cleaner Liq",,"Undeposited Funds",121.04,"",58909.40
,"Invoice","23-02-2024","MC05443",,"DAILY CHAMPIONS MINI SUPERMARKET LIMITED","Zelia Toilet Cleaner Liquid 750ML","Cost of Goods Sold","Zelia Toilet Cleaner Liq",,"Accounts Receivable",726.22,"",59635.62
,"Invoice","26-02-2024","MC05444",,"The Joymai Blessed Stores Limited","Zelia Toilet Cleaner Liquid 750ML","Cost of Goods Sold","Zelia Toilet Cleaner Liq",,"Accounts Receivable",726.22,"",60361.84
,"Invoice","26-02-2024","MC05445",,"Mumsha Supamat","Zelia Toilet Cleaner Liquid 750ML","Cost of Goods Sold","Zelia Toilet Cleaner Liq",,"Accounts Receivable",726.22,"",61088.06
,"Sales Receipt","26-02-2024","1872",,"Jombs wholesalers","Zelia Toilet Cleaner Liquid 750ML","Cost of Goods Sold","Zelia Toilet Cleaner Liq",,"Undeposited Funds",484.15,"",61572.21
,"Sales Receipt","26-02-2024","1876",,"Leadmark school","Zelia Toilet Cleaner Liquid 5L","Cost of Goods Sold","Zelia Toilet Cleaner Liq",,"Undeposited Funds",662.96,"",62235.17
,"Sales Receipt","27-02-2024","1878",,"Cash Sales","Zelia Toilet Cleaner Liquid 750ML","Cost of Goods Sold","Zelia Toilet Cleaner Liq",,"Undeposited Funds",484.15,"",62719.32
,"Sales Receipt","27-02-2024","1882",,"AIDURUS GENERAL SHOP","Zelia Toilet Cleaner Liquid 750ML","Cost of Goods Sold","Zelia Toilet Cleaner Liq",,"Undeposited Funds",1694.51,"",64413.83
,"Sales Receipt","28-02-2024","1806",,"Beraccah Wholesallers","Zelia Toilet Cleaner Liquid 750ML","Cost of Goods Sold","Zelia Toilet Cleaner Liq",,"Undeposited Funds",363.11,"",64776.94
,"Sales Receipt","28-02-2024","1885",,"Amulqura Shop","Zelia Toilet Cleaner Liquid 750ML","Cost of Goods Sold","Zelia Toilet Cleaner Liq",,"Undeposited Funds",1694.51,"",66471.45
,"Sales Receipt","28-02-2024","1887",,"Adno shop","Zelia Toilet Cleaner Liquid 750ML","Cost of Goods Sold","Zelia Toilet Cleaner Liq",,"Undeposited Funds",726.22,"",67197.67
,"Sales Receipt","29-02-2024","1890",,"Cash Sales","-MULTIPLE-","Cost of Goods Sold","Zelia Toilet Cleaner Liq",,"Undeposited Funds",2657.32,"",69854.99
,"Sales Receipt","29-02-2024","AT185",,"Cash Sales","Zelia Toilet Cleaner Liquid 750ML","Cost of Goods Sold","Zelia Toilet Cleaner Liq",,"Undeposited Funds",3389.02,"",73244.01
,"Sales Receipt","01-03-2024","1891",,"Mama Amina","Zelia Toilet Cleaner Liquid 750ML","Cost of Goods Sold","Zelia Toilet Cleaner Liq",,"Undeposited Funds",1694.51,"",74938.52
,"Invoice","01-03-2024","MC05459",,"THE BRIGHT STAR SUPERMARKET LIMITED","Zelia Toilet Cleaner Liquid 750ML","Cost of Goods Sold","Zelia Toilet Cleaner Liq",,"Accounts Receivable",726.22,"",75664.74
,"Sales Receipt","01-03-2024","1892",,"Ilyas Retail Shop","Zelia Toilet Cleaner Liquid 750ML","Cost of Goods Sold","Zelia Toilet Cleaner Liq",,"Undeposited Funds",1694.51,"",77359.25
,"Sales Receipt","04-03-2024","1894",,"Cash Sales","Zelia Toilet Cleaner Liquid 5L","Cost of Goods Sold","Zelia Toilet Cleaner Liq",,"Undeposited Funds",662.96,"",78022.21
,"Sales Receipt","04-03-2024","1895",,"Cash Sales","Zelia Toilet Cleaner Liquid 750ML","Cost of Goods Sold","Zelia Toilet Cleaner Liq",,"Undeposited Funds",242.08,"",78264.29
,"Sales Receipt","04-03-2024","1896",,"Cash Sales","Zelia Toilet Cleaner Liquid 750ML","Cost of Goods Sold","Zelia Toilet Cleaner Liq",,"Undeposited Funds",121.04,"",78385.33
,"Sales Receipt","04-03-2024","2001",,"AIDURUS GENERAL SHOP","Zelia Toilet Cleaner Liquid 750ML","Cost of Goods Sold","Zelia Toilet Cleaner Liq",,"Undeposited Funds",1694.51,"",80079.84
,"Sales Receipt","04-03-2024","2002",,"Himilo Wholesalers","Zelia Toilet Cleaner Liquid 750ML","Cost of Goods Sold","Zelia Toilet Cleaner Liq",,"Undeposited Funds",1694.51,"",81774.35
,"Invoice","05-03-2024","MC05471",,"PRICE CHOPPER STORES LIMITED","Zelia Toilet Cleaner Liquid 750ML","Cost of Goods Sold","Zelia Toilet Cleaner Liq",,"Accounts Receivable",726.22,"",82500.57
,"Sales Receipt","05-03-2024","2008",,"Cash Sales","Zelia Toilet Cleaner Liquid 750ML","Cost of Goods Sold","Zelia Toilet Cleaner Liq",,"Undeposited Funds",121.04,"",82621.61
,"Sales Receipt","05-03-2024","2011",,"Cash Sales","Zelia Toilet Cleaner Liquid 750ML","Cost of Goods Sold","Zelia Toilet Cleaner Liq",,"Undeposited Funds",242.07,"",82863.68
,"Sales Receipt","05-03-2024","2012",,"Cash Sales","Zelia Toilet Cleaner Liquid 750ML","Cost of Goods Sold","Zelia Toilet Cleaner Liq",,"Undeposited Funds",121.04,"",82984.72
,"Sales Receipt","05-03-2024","2013",,"Summer Outlets","Zelia Toilet Cleaner Liquid 750ML","Cost of Goods Sold","Zelia Toilet Cleaner Liq",,"Undeposited Funds",726.22,"",83710.94
,"Sales Receipt","05-03-2024","2014",,"Maida Minimart","Zelia Toilet Cleaner Liquid 750ML","Cost of Goods Sold","Zelia Toilet Cleaner Liq",,"Undeposited Funds",726.22,"",84437.16
,"Sales Receipt","07-03-2024","2024",,"Ben Bellah Store","Zelia Toilet Cleaner Liquid 750ML","Cost of Goods Sold","Zelia Toilet Cleaner Liq",,"Undeposited Funds",605.18,"",85042.34
,"Sales Receipt","08-03-2024","2045",,"Cash Sales","Zelia Toilet Cleaner Liquid 750ML","Cost of Goods Sold","Zelia Toilet Cleaner Liq",,"Undeposited Funds",370.92,"",85413.26
,"Invoice","11-03-2024","MC05484",,"MUHINDI MWEUSI SUPERMARKET LIMITED","Zelia Toilet Cleaner Liquid 750ML","Cost of Goods Sold","Zelia Toilet Cleaner Liq",,"Accounts Receivable",1298.21,"",86711.47
,"Sales Receipt","11-03-2024","2055",,"Beta Traders","Zelia Toilet Cleaner Liquid 750ML","Cost of Goods Sold","Zelia Toilet Cleaner Liq",,"Undeposited Funds",556.38,"",87267.85
,"Sales Receipt","11-03-2024","2056",,"Nasib Wholesallers","Zelia Toilet Cleaner Liquid 750ML","Cost of Goods Sold","Zelia Toilet Cleaner Liq",,"Undeposited Funds",1298.21,"",88566.06
,"Sales Receipt","13-03-2024","2059",,"Cash Sales","Zelia Toilet Cleaner Liquid 750ML","Cost of Goods Sold","Zelia Toilet Cleaner Liq",,"Undeposited Funds",92.73,"",88658.79
,"Sales Receipt","13-03-2024","2062",,"Mama Shukri","Zelia Toilet Cleaner Liquid 750ML","Cost of Goods Sold","Zelia Toilet Cleaner Liq",,"Undeposited Funds",556.38,"",89215.17
,"Sales Receipt","14-03-2024","2063",,"Cash Sales","Zelia Toilet Cleaner Liquid 750ML","Cost of Goods Sold","Zelia Toilet Cleaner Liq",,"Undeposited Funds",92.73,"",89307.90
,"Sales Receipt","14-03-2024","2064",,"Towba General Store","Zelia Toilet Cleaner Liquid 750ML","Cost of Goods Sold","Zelia Toilet Cleaner Liq",,"Undeposited Funds",5192.84,"",94500.74
,"Sales Receipt","14-03-2024","2067",,"Nzurimart wholesale","Zelia Toilet Cleaner Liquid 5L","Cost of Goods Sold","Zelia Toilet Cleaner Liq",,"Undeposited Funds",548.10,"",95048.84
,"Sales Receipt","15-03-2024","2068",,"Cash Sales","Zelia Toilet Cleaner Liquid 750ML","Cost of Goods Sold","Zelia Toilet Cleaner Liq",,"Undeposited Funds",92.73,"",95141.57
,"Sales Receipt","15-03-2024","2069",,"Cash Sales","-MULTIPLE-","Cost of Goods Sold","Zelia Toilet Cleaner Liq",,"Undeposited Funds",1289.93,"",96431.50
,"Invoice","18-03-2024","MC05497",,"MUHINDI MWEUSI SUPERMARKET LIMITED","Zelia Toilet Cleaner Liquid 750ML","Cost of Goods Sold","Zelia Toilet Cleaner Liq",,"Accounts Receivable",1298.21,"",97729.71
,"Sales Receipt","18-03-2024","2072",,"Cash Sales","Zelia Toilet Cleaner Liquid 750ML","Cost of Goods Sold","Zelia Toilet Cleaner Liq",,"Undeposited Funds",185.46,"",97915.17
,"Sales Receipt","18-03-2024","2075",,"Cash Sales","Zelia Toilet Cleaner Liquid 750ML","Cost of Goods Sold","Zelia Toilet Cleaner Liq",,"Undeposited Funds",92.73,"",98007.90
,"Invoice","19-03-2024","MC05499",,"EASEBYYTTE SUPERMARKET LIMITED","Zelia Toilet Cleaner Liquid 750ML","Cost of Goods Sold","Zelia Toilet Cleaner Liq",,"Accounts Receivable",556.38,"",98564.28
,"Invoice","19-03-2024","MC05502",,"Tupo Mart Limited","Zelia Toilet Cleaner Liquid 750ML","Cost of Goods Sold","Zelia Toilet Cleaner Liq",,"Accounts Receivable",556.38,"",99120.66
,"Invoice","19-03-2024","MC05503",,"LUCKY MART SUPERMARKET LIMITED","Zelia Toilet Cleaner Liquid 750ML","Cost of Goods Sold","Zelia Toilet Cleaner Liq",,"Accounts Receivable",556.38,"",99677.04
,"Sales Receipt","19-03-2024","2080",,"Arqam Savanna","Zelia Toilet Cleaner Liquid 750ML","Cost of Goods Sold","Zelia Toilet Cleaner Liq",,"Undeposited Funds",1221.70,"",100898.74
,"Invoice","20-03-2024","MC05507",,"DAILY CHAMPIONS MINI SUPERMARKET LIMITED","Zelia Toilet Cleaner Liquid 750ML","Cost of Goods Sold","Zelia Toilet Cleaner Liq",,"Accounts Receivable",523.59,"",101422.33
,"Sales Receipt","20-03-2024","2087",,"Pambazuka Mart (K) Limited","Zelia Toilet Cleaner Liquid 750ML","Cost of Goods Sold","Zelia Toilet Cleaner Liq",,"Undeposited Funds",1221.70,"",102644.03
,"Sales Receipt","21-03-2024","2092",,"Norham Groceries","Zelia Toilet Cleaner Liquid 750ML","Cost of Goods Sold","Zelia Toilet Cleaner Liq",,"Undeposited Funds",1221.70,"",103865.73
,"Sales Receipt","21-03-2024","2101",,"Raymart Minimart","Zelia Toilet Cleaner Liquid 750ML","Cost of Goods Sold","Zelia Toilet Cleaner Liq",,"Undeposited Funds",523.59,"",104389.32
,"Sales Receipt","21-03-2024","2103",,"Ilyes Gas and Water ltd","Zelia Toilet Cleaner Liquid 750ML","Cost of Goods Sold","Zelia Toilet Cleaner Liq",,"Undeposited Funds",1221.70,"",105611.02
,"Sales Receipt","22-03-2024","2098",,"Ushirika Shop","Zelia Toilet Cleaner Liquid 750ML","Cost of Goods Sold","Zelia Toilet Cleaner Liq",,"Undeposited Funds",2443.40,"",108054.42
,"Sales Receipt","25-03-2024","2094",,"Instanbul Shop","Zelia Toilet Cleaner Liquid 750ML","Cost of Goods Sold","Zelia Toilet Cleaner Liq",,"Undeposited Funds",1221.70,"",109276.12
,"Sales Receipt","25-03-2024","2106",,"Mamken Minimart","Zelia Toilet Cleaner Liquid 750ML","Cost of Goods Sold","Zelia Toilet Cleaner Liq",,"Undeposited Funds",349.06,"",109625.18
,"Invoice","25-03-2024","MC05530",,"KASAMAT INVESTMENTS LTD","Zelia Toilet Cleaner Liquid 750ML","Cost of Goods Sold","Zelia Toilet Cleaner Liq",,"Accounts Receivable",523.59,"",110148.77
,"Sales Receipt","26-03-2024","2108",,"Cash Sales","Zelia Toilet Cleaner Liquid 750ML","Cost of Goods Sold","Zelia Toilet Cleaner Liq",,"Undeposited Funds",86.09,"",110234.86
,"Invoice","27-03-2024","MC05542",,"BLUEMART SUPERMARKET LIMITED","Zelia Toilet Cleaner Liquid 750ML","Cost of Goods Sold","Zelia Toilet Cleaner Liq",,"Accounts Receivable",516.53,"",110751.39
,"Sales Receipt","27-03-2024","2110",,"Toyokom Wholesallers","Zelia Toilet Cleaner Liquid 750ML","Cost of Goods Sold","Zelia Toilet Cleaner Liq",,"Undeposited Funds",4820.94,"",115572.33
,"Sales Receipt","28-03-2024","2119",,"Moonlight Wholesallers","Zelia Toilet Cleaner Liquid 750ML","Cost of Goods Sold","Zelia Toilet Cleaner Liq",,"Undeposited Funds",2410.47,"",117982.80
,"Sales Receipt","28-03-2024","2121",,"Saacid Shop","Zelia Toilet Cleaner Liquid 750ML","Cost of Goods Sold","Zelia Toilet Cleaner Liq",,"Undeposited Funds",1205.24,"",119188.04
,"Sales Receipt","28-03-2024","2122",,"Marwan Shop","Zelia Toilet Cleaner Liquid 750ML","Cost of Goods Sold","Zelia Toilet Cleaner Liq",,"Undeposited Funds",1205.24,"",120393.28
,"Sales Receipt","28-03-2024","2124",,"First Choice Shop","Zelia Toilet Cleaner Liquid 750ML","Cost of Goods Sold","Zelia Toilet Cleaner Liq",,"Undeposited Funds",1205.24,"",121598.52
,"Sales Receipt","28-03-2024","2125",,"Downtown Wholesalers","Zelia Toilet Cleaner Liquid 750ML","Cost of Goods Sold","Zelia Toilet Cleaner Liq",,"Undeposited Funds",1291.32,"",122889.84
,"Sales Receipt","28-03-2024","2127",,"Cash Sales","Zelia Toilet Cleaner Liquid 750ML","Cost of Goods Sold","Zelia Toilet Cleaner Liq",,"Undeposited Funds",86.09,"",122975.93
,"Sales Receipt","28-03-2024","2129",,"Cash Sales","Zelia Toilet Cleaner Liquid 5L","Cost of Goods Sold","Zelia Toilet Cleaner Liq",,"Undeposited Funds",1096.21,"",124072.14
,"Sales Receipt","02-04-2024","2131",,"Q-mart Minimart","Zelia Toilet Cleaner Liquid 750ML","Cost of Goods Sold","Zelia Toilet Cleaner Liq",,"Undeposited Funds",172.18,"",124244.32
,"Sales Receipt","03-04-2024","2139",,"Tawakal Wholesale Eastleigh","Zelia Toilet Cleaner Liquid 750ML","Cost of Goods Sold","Zelia Toilet Cleaner Liq",,"Undeposited Funds",6026.18,"",130270.50
,"Sales Receipt","03-04-2024","2140",,"Dacaad Wholesalers","Zelia Toilet Cleaner Liquid 750ML","Cost of Goods Sold","Zelia Toilet Cleaner Liq",,"Undeposited Funds",2410.47,"",132680.97
,"Sales Receipt","03-04-2024","2142",,"AIDURUS GENERAL SHOP","Zelia Toilet Cleaner Liquid 750ML","Cost of Goods Sold","Zelia Toilet Cleaner Liq",,"Undeposited Funds",1205.24,"",133886.21
,"Sales Receipt","05-04-2024","2155",,"Nasib Wholesallers","Zelia Toilet Cleaner Liquid 750ML","Cost of Goods Sold","Zelia Toilet Cleaner Liq",,"Undeposited Funds",2410.47,"",136296.68
,"Sales Receipt","05-04-2024","2157",,"Cash Sales","Zelia Toilet Cleaner Liquid 750ML","Cost of Goods Sold","Zelia Toilet Cleaner Liq",,"Undeposited Funds",86.09,"",136382.77
,"Sales Receipt","05-04-2024","2158",,"Cash Sales","Zelia Toilet Cleaner Liquid 750ML","Cost of Goods Sold","Zelia Toilet Cleaner Liq",,"Undeposited Funds",86.09,"",136468.86
,"Sales Receipt","08-04-2024","2170",,"Antic Wholesallers","Zelia Toilet Cleaner Liquid 750ML","Cost of Goods Sold","Zelia Toilet Cleaner Liq",,"Undeposited Funds",1205.24,"",137674.10
,"Sales Receipt","08-04-2024","2171",,"Raage mart","Zelia Toilet Cleaner Liquid 750ML","Cost of Goods Sold","Zelia Toilet Cleaner Liq",,"Undeposited Funds",1205.24,"",138879.34
,"Sales Receipt","08-04-2024","2202",,"Antic Wholesallers","Zelia Toilet Cleaner Liquid 750ML","Cost of Goods Sold","Zelia Toilet Cleaner Liq",,"Undeposited Funds",1205.24,"",140084.58
,"Sales Receipt","08-04-2024","2203",,"Raage mart","Zelia Toilet Cleaner Liquid 750ML","Cost of Goods Sold","Zelia Toilet Cleaner Liq",,"Undeposited Funds",2410.47,"",142495.05
,"Sales Receipt","11-04-2024","2205",,"Gure Yare Shop Nasra","Zelia Toilet Cleaner Liquid 750ML","Cost of Goods Sold","Zelia Toilet Cleaner Liq",,"Undeposited Funds",1196.31,"",143691.36
,"Sales Receipt","12-04-2024","2175",,"Tekonstruct LTD","Zelia Toilet Cleaner Liquid 5L","Cost of Goods Sold","Zelia Toilet Cleaner Liq",,"Undeposited Funds",509.34,"",144200.70
,"Sales Receipt","12-04-2024","2176",,"Cash Sales","Zelia Toilet Cleaner Liquid 750ML","Cost of Goods Sold","Zelia Toilet Cleaner Liq",,"Undeposited Funds",170.90,"",144371.60
,"Sales Receipt","12-04-2024","2180",,"Elwak Stores Ltd","Zelia Toilet Cleaner Liquid 750ML","Cost of Goods Sold","Zelia Toilet Cleaner Liq",,"Undeposited Funds",1196.31,"",145567.91
,"Sales Receipt","12-04-2024","2181",,"Amin Wholesalers","Zelia Toilet Cleaner Liquid 750ML","Cost of Goods Sold","Zelia Toilet Cleaner Liq",,"Undeposited Funds",2392.62,"",147960.53
,"Sales Receipt","12-04-2024","2185",,"Mamken Minimart","Zelia Toilet Cleaner Liquid 750ML","Cost of Goods Sold","Zelia Toilet Cleaner Liq",,"Undeposited Funds",512.71,"",148473.24
,"Sales Receipt","12-04-2024","2186",,"Kandara minimart","Zelia Toilet Cleaner Liquid 750ML","Cost of Goods Sold","Zelia Toilet Cleaner Liq",,"Undeposited Funds",341.80,"",148815.04
,"Sales Receipt","12-04-2024","2187",,"Kikamart Minimart","Zelia Toilet Cleaner Liquid 750ML","Cost of Goods Sold","Zelia Toilet Cleaner Liq",,"Undeposited Funds",512.71,"",149327.75
,"Sales Receipt","15-04-2024","2188",,"Delta Mart","Zelia Toilet Cleaner Liquid 750ML","Cost of Goods Sold","Zelia Toilet Cleaner Liq",,"Undeposited Funds",85.45,"",149413.20
,"Sales Receipt","15-04-2024","2193",,"Diaspora Diaries","Zelia Toilet Cleaner Liquid 750ML","Cost of Goods Sold","Zelia Toilet Cleaner Liq",,"Undeposited Funds",85.45,"",149498.65
,"Sales Receipt","15-04-2024","2195",,"Zulu Enterprises","Zelia Toilet Cleaner Liquid 750ML","Cost of Goods Sold","Zelia Toilet Cleaner Liq",,"Undeposited Funds",1196.31,"",150694.96
,"Sales Receipt","15-04-2024","2197",,"Lekima Royal Merchants","Zelia Toilet Cleaner Liquid 750ML","Cost of Goods Sold","Zelia Toilet Cleaner Liq",,"Undeposited Funds",512.71,"",151207.67
,"Sales Receipt","15-04-2024","2199",,"Sharma Shop","Zelia Toilet Cleaner Liquid 750ML","Cost of Goods Sold","Zelia Toilet Cleaner Liq",,"Undeposited Funds",1196.31,"",152403.98
,"Sales Receipt","17-04-2024","2214",,"Cash Sales","Zelia Toilet Cleaner Liquid 750ML","Cost of Goods Sold","Zelia Toilet Cleaner Liq",,"Undeposited Funds",256.35,"",152660.33
,"Sales Receipt","17-04-2024","2216",,"Cash Sales","Zelia Toilet Cleaner Liquid 750ML","Cost of Goods Sold","Zelia Toilet Cleaner Liq",,"Undeposited Funds",85.45,"",152745.78
,"Sales Receipt","18-04-2024","2223",,"Cash Sales","Zelia Toilet Cleaner Liquid 750ML","Cost of Goods Sold","Zelia Toilet Cleaner Liq",,"Undeposited Funds",85.45,"",152831.23
,"Sales Receipt","18-04-2024","2228",,"Gods Favour","Zelia Toilet Cleaner Liquid 750ML","Cost of Goods Sold","Zelia Toilet Cleaner Liq",,"Undeposited Funds",1196.31,"",154027.54
,"Invoice","19-04-2024","MC05610",,"DISII TRADERS LTD","Zelia Toilet Cleaner Liquid 750ML","Cost of Goods Sold","Zelia Toilet Cleaner Liq",,"Accounts Receivable",1196.31,"",155223.85
,"Sales Receipt","19-04-2024","2232",,"Zonal Minimart","Zelia Toilet Cleaner Liquid 750ML","Cost of Goods Sold","Zelia Toilet Cleaner Liq",,"Undeposited Funds",512.71,"",155736.56
,"Sales Receipt","19-04-2024","2235",,"Publix Supermarket","Zelia Toilet Cleaner Liquid 750ML","Cost of Goods Sold","Zelia Toilet Cleaner Liq",,"Undeposited Funds",512.71,"",156249.27
,"Sales Receipt","20-04-2024","2243",,"Horn of Africa","Zelia Toilet Cleaner Liquid 750ML","Cost of Goods Sold","Zelia Toilet Cleaner Liq",,"Undeposited Funds",1196.31,"",157445.58
,"Invoice","22-04-2024","MC05623",,"MUHINDI MWEUSI SUPERMARKET LIMITED","Zelia Toilet Cleaner Liquid 750ML","Cost of Goods Sold","Zelia Toilet Cleaner Liq",,"Accounts Receivable",1196.31,"",158641.89
,"Sales Receipt","22-04-2024","2241",,"Cash Sales","Zelia Toilet Cleaner Liquid 750ML","Cost of Goods Sold","Zelia Toilet Cleaner Liq",,"Undeposited Funds",85.45,"",158727.34
,"Sales Receipt","22-04-2024","2247",,"AL Zake minimart","Zelia Toilet Cleaner Liquid 750ML","Cost of Goods Sold","Zelia Toilet Cleaner Liq",,"Undeposited Funds",427.25,"",159154.59
,"Sales Receipt","22-04-2024","2248",,"Himilo Wholesalers","Zelia Toilet Cleaner Liquid 750ML","Cost of Goods Sold","Zelia Toilet Cleaner Liq",,"Undeposited Funds",3588.94,"",162743.53
,"Sales Receipt","22-04-2024","2250",,"Brightfood Nasra","Zelia Toilet Cleaner Liquid 750ML","Cost of Goods Sold","Zelia Toilet Cleaner Liq",,"Undeposited Funds",341.80,"",163085.33
,"Sales Receipt","23-04-2024","2252",,"Cash Sales","Zelia Toilet Cleaner Liquid 750ML","Cost of Goods Sold","Zelia Toilet Cleaner Liq",,"Undeposited Funds",170.90,"",163256.23
,"Invoice","24-04-2024","MC05636",,"Maji Asili Limited","Zelia Toilet Cleaner Liquid 750ML","Cost of Goods Sold","Zelia Toilet Cleaner Liq",,"Accounts Receivable",2392.62,"",165648.85
,"Sales Receipt","24-04-2024","2255",,"Cash Sales","Zelia Toilet Cleaner Liquid 750ML","Cost of Goods Sold","Zelia Toilet Cleaner Liq",,"Undeposited Funds",85.45,"",165734.30
,"Sales Receipt","24-04-2024","2256",,"Kimathi Store","Zelia Toilet Cleaner Liquid 750ML","Cost of Goods Sold","Zelia Toilet Cleaner Liq",,"Undeposited Funds",85.45,"",165819.75
,"Sales Receipt","24-04-2024","2259",,"Muleshe Wholesallers","Zelia Toilet Cleaner Liquid 750ML","Cost of Goods Sold","Zelia Toilet Cleaner Liq",,"Undeposited Funds",1196.31,"",167016.06
,"Sales Receipt","25-04-2024","2261",,"Teyamo Enterprises","Zelia Toilet Cleaner Liquid 750ML","Cost of Goods Sold","Zelia Toilet Cleaner Liq",,"Undeposited Funds",170.90,"",167186.96
,"Sales Receipt","25-04-2024","2263",,"Cash Sales","Zelia Toilet Cleaner Liquid 5L","Cost of Goods Sold","Zelia Toilet Cleaner Liq",,"Undeposited Funds",509.34,"",167696.30
,"Sales Receipt","25-04-2024","2266",,"Goldmart Supermarket","Zelia Toilet Cleaner Liquid 750ML","Cost of Goods Sold","Zelia Toilet Cleaner Liq",,"Undeposited Funds",512.71,"",168209.01
,"Sales Receipt","25-04-2024","2268",,"Mama Amina","Zelia Toilet Cleaner Liquid 750ML","Cost of Goods Sold","Zelia Toilet Cleaner Liq",,"Undeposited Funds",512.71,"",168721.72
,"Sales Receipt","29-04-2024","2271",,"Cash Sales","Zelia Toilet Cleaner Liquid 750ML","Cost of Goods Sold","Zelia Toilet Cleaner Liq",,"Undeposited Funds",170.90,"",168892.62
,"Sales Receipt","29-04-2024","2273",,"Blessed Shop","Zelia Toilet Cleaner Liquid 750ML","Cost of Goods Sold","Zelia Toilet Cleaner Liq",,"Undeposited Funds",85.45,"",168978.07
,"Sales Receipt","29-04-2024","2275",,"Cash Sales","Zelia Toilet Cleaner Liquid 750ML","Cost of Goods Sold","Zelia Toilet Cleaner Liq",,"Undeposited Funds",85.45,"",169063.52
,"Invoice","29-04-2024","MC05650",,"MUHINDI MWEUSI SUPERMARKET LIMITED","Zelia Toilet Cleaner Liquid 750ML","Cost of Goods Sold","Zelia Toilet Cleaner Liq",,"Accounts Receivable",1025.41,"",170088.93
,"Sales Receipt","29-04-2024","2280",,"Cash Sales","Zelia Toilet Cleaner Liquid 750ML","Cost of Goods Sold","Zelia Toilet Cleaner Liq",,"Undeposited Funds",85.45,"",170174.38
,"Sales Receipt","30-04-2024","2286",,"Homecare Enterprise","Zelia Toilet Cleaner Liquid 750ML","Cost of Goods Sold","Zelia Toilet Cleaner Liq",,"Undeposited Funds",598.16,"",170772.54
,"Sales Receipt","02-05-2024","2287",,"5pm Hotel","Zelia Toilet Cleaner Liquid 750ML","Cost of Goods Sold","Zelia Toilet Cleaner Liq",,"Undeposited Funds",85.45,"",170857.99
,"Sales Receipt","02-05-2024","2290",,"Mama Amina","Zelia Toilet Cleaner Liquid 750ML","Cost of Goods Sold","Zelia Toilet Cleaner Liq",,"Undeposited Funds",1196.31,"",172054.30
,"Sales Receipt","02-05-2024","2292",,"Jamilas Store","Zelia Toilet Cleaner Liquid 750ML","Cost of Goods Sold","Zelia Toilet Cleaner Liq",,"Undeposited Funds",1196.31,"",173250.61
,"Sales Receipt","03-05-2024","2300",,"Cash Sales","Zelia Toilet Cleaner Liquid 750ML","Cost of Goods Sold","Zelia Toilet Cleaner Liq",,"Undeposited Funds",170.90,"",173421.51
,"Sales Receipt","03-05-2024","2301",,"Cash Sales","Zelia Toilet Cleaner Liquid 750ML","Cost of Goods Sold","Zelia Toilet Cleaner Liq",,"Undeposited Funds",85.45,"",173506.96
,"Sales Receipt","03-05-2024","2303",,"Cash Sales","Zelia Toilet Cleaner Liquid 750ML","Cost of Goods Sold","Zelia Toilet Cleaner Liq",,"Undeposited Funds",170.90,"",173677.86
,"Sales Receipt","03-05-2024","2305",,"Zuri Mart","Zelia Toilet Cleaner Liquid 750ML","Cost of Goods Sold","Zelia Toilet Cleaner Liq",,"Undeposited Funds",512.71,"",174190.57
,"Sales Receipt","05-05-2024","2308",,"Cash Sales","Zelia Toilet Cleaner Liquid 750ML","Cost of Goods Sold","Zelia Toilet Cleaner Liq",,"Undeposited Funds",170.90,"",174361.47
,"Sales Receipt","06-05-2024","2309",,"Jackys Shop","Zelia Toilet Cleaner Liquid 750ML","Cost of Goods Sold","Zelia Toilet Cleaner Liq",,"Undeposited Funds",86.05,"",174447.52
,"Invoice","08-05-2024","MC05676",,"LUCKY MART SUPERMARKET LIMITED","Zelia Toilet Cleaner Liquid 750ML","Cost of Goods Sold","Zelia Toilet Cleaner Liq",,"Accounts Receivable",516.30,"",174963.82
,"Sales Receipt","08-05-2024","2318",,"Adurus Wholesallers","Zelia Toilet Cleaner Liquid 750ML","Cost of Goods Sold","Zelia Toilet Cleaner Liq",,"Undeposited Funds",1204.69,"",176168.51
,"Sales Receipt","08-05-2024","2319",,"Lekima Royal Merchants","Zelia Toilet Cleaner Liquid 750ML","Cost of Goods Sold","Zelia Toilet Cleaner Liq",,"Undeposited Funds",1204.69,"",177373.20
,"Sales Receipt","08-05-2024","2323",,"Cash Sales","Zelia Toilet Cleaner Liquid 750ML","Cost of Goods Sold","Zelia Toilet Cleaner Liq",,"Undeposited Funds",172.10,"",177545.30
,"Sales Receipt","08-05-2024","2327",,"Shahrazaad Wholesalers","Zelia Toilet Cleaner Liquid 750ML","Cost of Goods Sold","Zelia Toilet Cleaner Liq",,"Undeposited Funds",602.34,"",178147.64
,"Sales Receipt","09-05-2024","2332",,"Gitonga Store","Zelia Toilet Cleaner Liquid 750ML","Cost of Goods Sold","Zelia Toilet Cleaner Liq",,"Undeposited Funds",1204.69,"",179352.33
,"Sales Receipt","09-05-2024","2333",,"RichMind Property","Zelia Toilet Cleaner Liquid 750ML","Cost of Goods Sold","Zelia Toilet Cleaner Liq",,"Undeposited Funds",172.10,"",179524.43
,"Sales Receipt","09-05-2024","2339",,"Cash Sales","Zelia Toilet Cleaner Liquid 750ML","Cost of Goods Sold","Zelia Toilet Cleaner Liq",,"Undeposited Funds",172.10,"",179696.53
,"Sales Receipt","09-05-2024","2341",,"Cash Sales","Zelia Toilet Cleaner Liquid 750ML","Cost of Goods Sold","Zelia Toilet Cleaner Liq",,"Undeposited Funds",172.10,"",179868.63
,"Sales Receipt","10-05-2024","1918",,"Cash Sales","Zelia Toilet Cleaner Liquid 750ML","Cost of Goods Sold","Zelia Toilet Cleaner Liq",,"Undeposited Funds",344.20,"",180212.83
,"Sales Receipt","13-05-2024","2345",,"Katani Foodstore","Zelia Toilet Cleaner Liquid 750ML","Cost of Goods Sold","Zelia Toilet Cleaner Liq",,"Undeposited Funds",516.30,"",180729.13
,"Sales Receipt","13-05-2024","2349",,"Arqam Savanna","Zelia Toilet Cleaner Liquid 750ML","Cost of Goods Sold","Zelia Toilet Cleaner Liq",,"Undeposited Funds",1204.69,"",181933.82
,"Sales Receipt","13-05-2024","2350",,"Aymat Wholesalers","Zelia Toilet Cleaner Liquid 750ML","Cost of Goods Sold","Zelia Toilet Cleaner Liq",,"Undeposited Funds",1204.69,"",183138.51
,"Sales Receipt","13-05-2024","2352",,"Himilo Wholesalers","Zelia Toilet Cleaner Liquid 750ML","Cost of Goods Sold","Zelia Toilet Cleaner Liq",,"Undeposited Funds",2409.38,"",185547.89
,"Sales Receipt","13-05-2024","2354",,"Juliet Store","Zelia Toilet Cleaner Liquid 750ML","Cost of Goods Sold","Zelia Toilet Cleaner Liq",,"Undeposited Funds",1204.69,"",186752.58
,"Sales Receipt","13-05-2024","2356",,"The Hub Minimart","Zelia Toilet Cleaner Liquid 750ML","Cost of Goods Sold","Zelia Toilet Cleaner Liq",,"Undeposited Funds",172.10,"",186924.68
,"Sales Receipt","14-05-2024","2355",,"Beraccah Wholesallers","Zelia Toilet Cleaner Liquid 750ML","Cost of Goods Sold","Zelia Toilet Cleaner Liq",,"Undeposited Funds",1204.69,"",188129.37
,"Sales Receipt","14-05-2024","2357",,"Horn of Africa","Zelia Toilet Cleaner Liquid 750ML","Cost of Goods Sold","Zelia Toilet Cleaner Liq",,"Undeposited Funds",1204.69,"",189334.06
,"Sales Receipt","14-05-2024","2358",,"Faisel Wholesale","Zelia Toilet Cleaner Liquid 750ML","Cost of Goods Sold","Zelia Toilet Cleaner Liq",,"Undeposited Funds",1204.69,"",190538.75
,"Sales Receipt","14-05-2024","2359",,"Beraccah Wholesallers","Zelia Toilet Cleaner Liquid 750ML","Cost of Goods Sold","Zelia Toilet Cleaner Liq",,"Undeposited Funds",1204.69,"",191743.44
,"Sales Receipt","14-05-2024","1926",,"Cash Sales","Zelia Toilet Cleaner Liquid 750ML","Cost of Goods Sold","Zelia Toilet Cleaner Liq",,"Undeposited Funds",172.10,"",191915.54
,"Invoice","15-05-2024","MC05700",,"BETTER DEAL WHOLESALERS LIMITED","Zelia Toilet Cleaner Liquid 750ML","Cost of Goods Sold","Zelia Toilet Cleaner Liq",,"Accounts Receivable",6023.44,"",197938.98
,"Invoice","15-05-2024","MC05702",,"Seasons lane Mart","Zelia Toilet Cleaner Liquid 750ML","Cost of Goods Sold","Zelia Toilet Cleaner Liq",,"Accounts Receivable",516.30,"",198455.28
,"Sales Receipt","16-05-2024","2363",,"Corner Shop","Zelia Toilet Cleaner Liquid 750ML","Cost of Goods Sold","Zelia Toilet Cleaner Liq",,"Undeposited Funds",1204.69,"",199659.97
,"Sales Receipt","16-05-2024","2370",,"Imani General Store","Zelia Toilet Cleaner Liquid 750ML","Cost of Goods Sold","Zelia Toilet Cleaner Liq",,"Undeposited Funds",516.30,"",200176.27
,"Sales Receipt","16-05-2024","2371",,"Juliet Store","Zelia Toilet Cleaner Liquid 750ML","Cost of Goods Sold","Zelia Toilet Cleaner Liq",,"Undeposited Funds",1204.69,"",201380.96
,"Sales Receipt","17-05-2024","2372",,"Danaba Wholesalers","Zelia Toilet Cleaner Liquid 750ML","Cost of Goods Sold","Zelia Toilet Cleaner Liq",,"Undeposited Funds",1204.69,"",202585.65
,"Sales Receipt","20-05-2024","1938",,"Gitonga Store","Zelia Toilet Cleaner Liquid 750ML","Cost of Goods Sold","Zelia Toilet Cleaner Liq",,"Undeposited Funds",1204.69,"",203790.34
,"Sales Receipt","20-05-2024","1940",,"AL Zake minimart","Zelia Toilet Cleaner Liquid 750ML","Cost of Goods Sold","Zelia Toilet Cleaner Liq",,"Undeposited Funds",1204.69,"",204995.03
,"Sales Receipt","21-05-2024","1942",,"Cash Sales","Zelia Toilet Cleaner Liquid 750ML","Cost of Goods Sold","Zelia Toilet Cleaner Liq",,"Undeposited Funds",86.05,"",205081.08
,"Sales Receipt","21-05-2024","1943",,"Smart Choice","Zelia Toilet Cleaner Liquid 750ML","Cost of Goods Sold","Zelia Toilet Cleaner Liq",,"Undeposited Funds",602.34,"",205683.42
,"Sales Receipt","21-05-2024","1945",,"Kinoko Store","Zelia Toilet Cleaner Liquid 750ML","Cost of Goods Sold","Zelia Toilet Cleaner Liq",,"Undeposited Funds",602.34,"",206285.76
,"Sales Receipt","21-05-2024","1947",,"Minara Shop","Zelia Toilet Cleaner Liquid 750ML","Cost of Goods Sold","Zelia Toilet Cleaner Liq",,"Undeposited Funds",2409.38,"",208695.14
,"Sales Receipt","21-05-2024","1948",,"Gure Yare Shop Nasra","Zelia Toilet Cleaner Liquid 750ML","Cost of Goods Sold","Zelia Toilet Cleaner Liq",,"Undeposited Funds",2409.38,"",211104.52
,"Sales Receipt","21-05-2024","1951",,"Gidesh Supermarket","Zelia Toilet Cleaner Liquid 750ML","Cost of Goods Sold","Zelia Toilet Cleaner Liq",,"Undeposited Funds",1204.69,"",212309.21
,"Build Assembly","22-05-2024","10423",,,,"Cost of Goods Sold","Zelia Toilet Cleaner Liq","X","-SPLIT-","",9.56,212299.65
,"Sales Receipt","22-05-2024","2376",,"Towfiqq Shop","Zelia Toilet Cleaner Liquid 750ML","Cost of Goods Sold","Zelia Toilet Cleaner Liq",,"Undeposited Funds",501.95,"",212801.60
,"Sales Receipt","23-05-2024","2378",,"Cash Sales","Zelia Toilet Cleaner Liquid 750ML","Cost of Goods Sold","Zelia Toilet Cleaner Liq",,"Undeposited Funds",250.98,"",213052.58
,"Sales Receipt","23-05-2024","1959",,"Shahrazaad Wholesalers","Zelia Toilet Cleaner Liquid 750ML","Cost of Goods Sold","Zelia Toilet Cleaner Liq",,"Undeposited Funds",2342.45,"",215395.03
,"Sales Receipt","23-05-2024","1962",,"Anab Shop","Zelia Toilet Cleaner Liquid 750ML","Cost of Goods Sold","Zelia Toilet Cleaner Liq",,"Undeposited Funds",501.95,"",215896.98
,"Sales Receipt","23-05-2024","1963",,"Safa Shop","Zelia Toilet Cleaner Liquid 750ML","Cost of Goods Sold","Zelia Toilet Cleaner Liq",,"Undeposited Funds",585.61,"",216482.59
,"Sales Receipt","23-05-2024","1965",,"Marris Minimart","Zelia Toilet Cleaner Liquid 750ML","Cost of Goods Sold","Zelia Toilet Cleaner Liq",,"Undeposited Funds",501.95,"",216984.54
,"Sales Receipt","23-05-2024","1968",,"Moonlight Wholesallers","Zelia Toilet Cleaner Liquid 750ML","Cost of Goods Sold","Zelia Toilet Cleaner Liq",,"Undeposited Funds",1171.23,"",218155.77
,"Invoice","24-05-2024","MC05741",,"MUHINDI MWEUSI SUPERMARKET LIMITED","Zelia Toilet Cleaner Liquid 750ML","Cost of Goods Sold","Zelia Toilet Cleaner Liq",,"Accounts Receivable",1171.23,"",219327.00
,"Invoice","24-05-2024","MC05746",,"MUHINDI MWEUSI SUPERMARKET LIMITED","Zelia Toilet Cleaner Liquid 750ML","Cost of Goods Sold","Zelia Toilet Cleaner Liq",,"Accounts Receivable",1003.91,"",220330.91
,"Invoice","24-05-2024","MC05747",,"NASRI MART LIMITED","Zelia Toilet Cleaner Liquid 750ML","Cost of Goods Sold","Zelia Toilet Cleaner Liq",,"Accounts Receivable",1003.91,"",221334.82
,"Invoice","24-05-2024","MC05749",,"Ck Upscales Limited","Zelia Toilet Cleaner Liquid 750ML","Cost of Goods Sold","Zelia Toilet Cleaner Liq",,"Accounts Receivable",1171.23,"",222506.05
,"Sales Receipt","24-05-2024","2380",,"Cash Sales","Zelia Toilet Cleaner Liquid 5L","Cost of Goods Sold","Zelia Toilet Cleaner Liq",,"Undeposited Funds",509.34,"",223015.39
,"Sales Receipt","24-05-2024","2382",,"Afrodrip LTD","Zelia Toilet Cleaner Liquid 5L","Cost of Goods Sold","Zelia Toilet Cleaner Liq",,"Undeposited Funds",509.34,"",223524.73
,"Sales Receipt","27-05-2024","2385",,"Alma Mart","Zelia Toilet Cleaner Liquid 750ML","Cost of Goods Sold","Zelia Toilet Cleaner Liq",,"Undeposited Funds",1171.23,"",224695.96
,"Sales Receipt","27-05-2024","2387",,"Nasib Wholesallers","Zelia Toilet Cleaner Liquid 750ML","Cost of Goods Sold","Zelia Toilet Cleaner Liq",,"Undeposited Funds",2342.45,"",227038.41
,"Invoice","28-05-2024","MC05763",,"Mumsha Supamat","Zelia Toilet Cleaner Liquid 750ML","Cost of Goods Sold","Zelia Toilet Cleaner Liq",,"Accounts Receivable",501.95,"",227540.36
,"Invoice","28-05-2024","MC05764",,"DALLAS SHOPRITE LTD","Zelia Toilet Cleaner Liquid 750ML","Cost of Goods Sold","Zelia Toilet Cleaner Liq",,"Accounts Receivable",501.95,"",228042.31
,"Invoice","28-05-2024","MC05765",,"TAWALA SUPERMARKET LIMITED","Zelia Toilet Cleaner Liquid 750ML","Cost of Goods Sold","Zelia Toilet Cleaner Liq",,"Accounts Receivable",1171.23,"",229213.54
,"Sales Receipt","28-05-2024","2389",,"Restoration Traders","Zelia Toilet Cleaner Liquid 750ML","Cost of Goods Sold","Zelia Toilet Cleaner Liq",,"Undeposited Funds",2342.45,"",231555.99
,"Sales Receipt","29-05-2024","2391",,"Cash Sales","Zelia Toilet Cleaner Liquid 750ML","Cost of Goods Sold","Zelia Toilet Cleaner Liq",,"Undeposited Funds",83.66,"",231639.65
,"Sales Receipt","29-05-2024","1970",,"Towba General Store","Zelia Toilet Cleaner Liquid 750ML","Cost of Goods Sold","Zelia Toilet Cleaner Liq",,"Undeposited Funds",3513.68,"",235153.33
,"Sales Receipt","29-05-2024","1971",,"Freshfinds Wholesale","Zelia Toilet Cleaner Liquid 750ML","Cost of Goods Sold","Zelia Toilet Cleaner Liq",,"Undeposited Funds",501.95,"",235655.28
,"Sales Receipt","30-05-2024","2395",,"Beta Traders","Zelia Toilet Cleaner Liquid 750ML","Cost of Goods Sold","Zelia Toilet Cleaner Liq",,"Undeposited Funds",669.27,"",236324.55
,"Sales Receipt","31-05-2024","1937",,"Island Gift Shop","Zelia Toilet Cleaner Liquid 750ML","Cost of Goods Sold","Zelia Toilet Cleaner Liq",,"Undeposited Funds",334.64,"",236659.19
,"Sales Receipt","31-05-2024","1975",,"Cash Sales","Zelia Toilet Cleaner Liquid 750ML","Cost of Goods Sold","Zelia Toilet Cleaner Liq",,"Undeposited Funds",83.66,"",236742.85
,"Sales Receipt","03-06-2024","1975",,"Cash Sales","Zelia Toilet Cleaner Liquid 750ML","Cost of Goods Sold","Zelia Toilet Cleaner Liq",,"Undeposited Funds",83.66,"",236826.51
,"Sales Receipt","03-06-2024","1983",,"Marris Mini mart","Zelia Toilet Cleaner Liquid 750ML","Cost of Goods Sold","Zelia Toilet Cleaner Liq",,"Undeposited Funds",501.95,"",237328.46
,"Sales Receipt","03-06-2024","2406",,"Downtown Wholesalers","Zelia Toilet Cleaner Liquid 750ML","Cost of Goods Sold","Zelia Toilet Cleaner Liq",,"Undeposited Funds",1171.23,"",238499.69
,"Sales Receipt","03-06-2024","2407",,"Sharma Shop","Zelia Toilet Cleaner Liquid 750ML","Cost of Goods Sold","Zelia Toilet Cleaner Liq",,"Undeposited Funds",1171.23,"",239670.92
,"Sales Receipt","05-06-2024","2418",,"Saacid Shop","Zelia Toilet Cleaner Liquid 750ML","Cost of Goods Sold","Zelia Toilet Cleaner Liq",,"Undeposited Funds",2342.52,"",242013.44
,"Invoice","06-06-2024","MC05789",,"ONESTOP MINI SUPERMARKET LIMITED","Zelia Toilet Cleaner Liquid 5L","Cost of Goods Sold","Zelia Toilet Cleaner Liq",,"Accounts Receivable",2037.36,"",244050.80
,"Sales Receipt","06-06-2024","2424",,"Bethel Store","Zelia Toilet Cleaner Liquid 750ML","Cost of Goods Sold","Zelia Toilet Cleaner Liq",,"Undeposited Funds",585.64,"",244636.44
,"Sales Receipt","06-06-2024","2423",,"Ekai moke wholesale","Zelia Toilet Cleaner Liquid 750ML","Cost of Goods Sold","Zelia Toilet Cleaner Liq",,"Undeposited Funds",585.64,"",245222.08
,"Sales Receipt","07-06-2024","1994",,"Cash Sales","Zelia Toilet Cleaner Liquid 750ML","Cost of Goods Sold","Zelia Toilet Cleaner Liq",,"Undeposited Funds",83.66,"",245305.74
,"Sales Receipt","10-06-2024","2433",,"Cash Sales","Zelia Toilet Cleaner Liquid 750ML","Cost of Goods Sold","Zelia Toilet Cleaner Liq",,"Undeposited Funds",83.66,"",245389.40
,"Sales Receipt","10-06-2024","2436",,"Arqam minimart","Zelia Toilet Cleaner Liquid 750ML","Cost of Goods Sold","Zelia Toilet Cleaner Liq",,"Undeposited Funds",1171.27,"",246560.67
,"Sales Receipt","10-06-2024","2437",,"Al Mubarak Wholesalers","Zelia Toilet Cleaner Liquid 750ML","Cost of Goods Sold","Zelia Toilet Cleaner Liq",,"Undeposited Funds",1171.27,"",247731.94
,"Invoice","11-06-2024","MC05815",,"MADINA SUPERMARKET LIMITED","Zelia Toilet Cleaner Liquid 750ML","Cost of Goods Sold","Zelia Toilet Cleaner Liq",,"Accounts Receivable",501.97,"",248233.91
,"Sales Receipt","11-06-2024","2439",,"Cash Sales","Zelia Toilet Cleaner Liquid 750ML","Cost of Goods Sold","Zelia Toilet Cleaner Liq",,"Undeposited Funds",83.66,"",248317.57
,"Invoice","12-06-2024","MC05819",,"INTEGRAL MEDIA LIMITED","Zelia Toilet Cleaner Liquid 5L","Cost of Goods Sold","Zelia Toilet Cleaner Liq",,"Accounts Receivable",509.34,"",248826.91
,"Sales Receipt","12-06-2024","2449",,"Cash Sales","Zelia Toilet Cleaner Liquid 750ML","Cost of Goods Sold","Zelia Toilet Cleaner Liq",,"Undeposited Funds",83.66,"",248910.57
,"Sales Receipt","12-06-2024","2453",,"Cash Sales","Zelia Toilet Cleaner Liquid 750ML","Cost of Goods Sold","Zelia Toilet Cleaner Liq",,"Undeposited Funds",1756.91,"",250667.48
,"Sales Receipt","12-06-2024","2460",,"Mt Kenya  mart","Zelia Toilet Cleaner Liquid 750ML","Cost of Goods Sold","Zelia Toilet Cleaner Liq",,"Undeposited Funds",585.64,"",251253.12
,"Sales Receipt","12-06-2024","2455",,"Antic Wholesallers","Zelia Toilet Cleaner Liquid 750ML","Cost of Goods Sold","Zelia Toilet Cleaner Liq",,"Undeposited Funds",2342.54,"",253595.66
,"Sales Receipt","12-06-2024","2463",,"Raja Foodstuffs","Zelia Toilet Cleaner Liquid 750ML","Cost of Goods Sold","Zelia Toilet Cleaner Liq",,"Undeposited Funds",1171.27,"",254766.93
,"Sales Receipt","13-06-2024","2464",,"Cash Sales","Zelia Toilet Cleaner Liquid 750ML","Cost of Goods Sold","Zelia Toilet Cleaner Liq",,"Undeposited Funds",83.66,"",254850.59
,"Sales Receipt","13-06-2024","2473",,"Horn of Africa","Zelia Toilet Cleaner Liquid 750ML","Cost of Goods Sold","Zelia Toilet Cleaner Liq",,"Undeposited Funds",1171.27,"",256021.86
,"Sales Receipt","14-06-2024","2475",,"Cash Sales","Zelia Toilet Cleaner Liquid 750ML","Cost of Goods Sold","Zelia Toilet Cleaner Liq",,"Undeposited Funds",167.32,"",256189.18
,"Sales Receipt","14-06-2024","2480",,"Cash Sales","Zelia Toilet Cleaner Liquid 750ML","Cost of Goods Sold","Zelia Toilet Cleaner Liq",,"Undeposited Funds",83.66,"",256272.84
,"Sales Receipt","14-06-2024","2481",,"Cash Sales","Zelia Toilet Cleaner Liquid 750ML","Cost of Goods Sold","Zelia Toilet Cleaner Liq",,"Undeposited Funds",83.66,"",256356.50
,"Invoice","18-06-2024","MC05831",,"MUHINDI MWEUSI SUPERMARKET LIMITED","Zelia Toilet Cleaner Liquid 750ML","Cost of Goods Sold","Zelia Toilet Cleaner Liq",,"Accounts Receivable",0.00,"",256356.50
,"Sales Receipt","18-06-2024","2711",,"Cash Sales","Zelia Toilet Cleaner Liquid 750ML","Cost of Goods Sold","Zelia Toilet Cleaner Liq",,"Undeposited Funds",83.23,"",256439.73
,"Sales Receipt","18-06-2024","2500",,"Al Hamdu shop","Zelia Toilet Cleaner Liquid 750ML","Cost of Goods Sold","Zelia Toilet Cleaner Liq",,"Undeposited Funds",582.60,"",257022.33
,"Invoice","19-06-2024","MC05837",,"MUHINDI MWEUSI SUPERMARKET LIMITED","Zelia Toilet Cleaner Liquid 750ML","Cost of Goods Sold","Zelia Toilet Cleaner Liq",,"Accounts Receivable",499.37,"",257521.70
,"Sales Receipt","19-06-2024","2483",,"Cash Sales","Zelia Toilet Cleaner Liquid 750ML","Cost of Goods Sold","Zelia Toilet Cleaner Liq",,"Undeposited Funds",83.23,"",257604.93
,"Invoice","20-06-2024","MC05843",,"MUHINDI MWEUSI SUPERMARKET LIMITED","Zelia Toilet Cleaner Liquid 750ML","Cost of Goods Sold","Zelia Toilet Cleaner Liq",,"Accounts Receivable",1165.19,"",258770.12
,"Sales Receipt","20-06-2024","2493",,"Cash Sales","Zelia Toilet Cleaner Liquid 750ML","Cost of Goods Sold","Zelia Toilet Cleaner Liq",,"Undeposited Funds",83.23,"",258853.35
,"Sales Receipt","21-06-2024","2723",,"Bethel Store","Zelia Toilet Cleaner Liquid 750ML","Cost of Goods Sold","Zelia Toilet Cleaner Liq",,"Undeposited Funds",582.60,"",259435.95
,"Sales Receipt","24-06-2024","2719",,"Cash Sales","Zelia Toilet Cleaner Liquid 750ML","Cost of Goods Sold","Zelia Toilet Cleaner Liq",,"Undeposited Funds",83.23,"",259519.18
,"Sales Receipt","24-06-2024","2729",,"Natala Shop","Zelia Toilet Cleaner Liquid 750ML","Cost of Goods Sold","Zelia Toilet Cleaner Liq",,"Undeposited Funds",582.60,"",260101.78
,"Sales Receipt","25-06-2024","2730",,"Bei Nafuu Shop","Zelia Toilet Cleaner Liquid 750ML","Cost of Goods Sold","Zelia Toilet Cleaner Liq",,"Undeposited Funds",499.37,"",260601.15
,"Invoice","26-06-2024","MC05862",,"LUCKY MART SUPERMARKET LIMITED","Zelia Toilet Cleaner Liquid 750ML","Cost of Goods Sold","Zelia Toilet Cleaner Liq",,"Accounts Receivable",499.37,"",261100.52
,"Invoice","26-06-2024","MC05864",,"Seasons lane Mart","Zelia Toilet Cleaner Liquid 750ML","Cost of Goods Sold","Zelia Toilet Cleaner Liq",,"Accounts Receivable",499.37,"",261599.89
,"Invoice","26-06-2024","MC05865",,"KASAMAT INVESTMENTS LTD","Zelia Toilet Cleaner Liquid 750ML","Cost of Goods Sold","Zelia Toilet Cleaner Liq",,"Accounts Receivable",499.37,"",262099.26
,"Sales Receipt","28-06-2024","2737",,"Cash Sales","Zelia Toilet Cleaner Liquid 750ML","Cost of Goods Sold","Zelia Toilet Cleaner Liq",,"Undeposited Funds",83.23,"",262182.49
,"Sales Receipt","28-06-2024","2743",,"Cash Sales","Zelia Toilet Cleaner Liquid 750ML","Cost of Goods Sold","Zelia Toilet Cleaner Liq",,"Undeposited Funds",166.46,"",262348.95
,"Sales Receipt","01-07-2024","2756",,"Cash Sales","Zelia Toilet Cleaner Liquid 750ML","Cost of Goods Sold","Zelia Toilet Cleaner Liq",,"Undeposited Funds",83.23,"",262432.18
,"Sales Receipt","01-07-2024","2750",,"Adurus Wholesallers","Zelia Toilet Cleaner Liquid 750ML","Cost of Goods Sold","Zelia Toilet Cleaner Liq",,"Undeposited Funds",1165.19,"",263597.37
,"Sales Receipt","01-07-2024","2751",,"Himilo Wholesallers","Zelia Toilet Cleaner Liquid 750ML","Cost of Goods Sold","Zelia Toilet Cleaner Liq",,"Undeposited Funds",2330.38,"",265927.75
,"Sales Receipt","01-07-2024","2754",,"Hidika Shop","Zelia Toilet Cleaner Liquid 750ML","Cost of Goods Sold","Zelia Toilet Cleaner Liq",,"Undeposited Funds",1165.19,"",267092.94
,"Sales Receipt","02-07-2024","2762",,"Maida Minimart","Zelia Toilet Cleaner Liquid 750ML","Cost of Goods Sold","Zelia Toilet Cleaner Liq",,"Undeposited Funds",499.37,"",267592.31
,"Sales Receipt","02-07-2024","2554",,"RichMind Property","Zelia Toilet Cleaner Liquid 750ML","Cost of Goods Sold","Zelia Toilet Cleaner Liq",,"Undeposited Funds",83.23,"",267675.54
,"Invoice","03-07-2024","MC05880",,"SECUTOR LIMITED","Zelia Toilet Cleaner Liquid 750ML","Cost of Goods Sold","Zelia Toilet Cleaner Liq",,"Accounts Receivable",83.23,"",267758.77
,"Sales Receipt","03-07-2024","2761",,"Cash Sales","Zelia Toilet Cleaner Liquid 750ML","Cost of Goods Sold","Zelia Toilet Cleaner Liq",,"Undeposited Funds",499.37,"",268258.14
,"Sales Receipt","03-07-2024","2767",,"Cash Sales","Zelia Toilet Cleaner Liquid 750ML","Cost of Goods Sold","Zelia Toilet Cleaner Liq",,"Undeposited Funds",83.23,"",268341.37
,"Sales Receipt","03-07-2024","2773",,"Muleshe Wholesallers","Zelia Toilet Cleaner Liquid 750ML","Cost of Goods Sold","Zelia Toilet Cleaner Liq",,"Undeposited Funds",2330.38,"",270671.75
,"Sales Receipt","03-07-2024","2774",,"Warfa Wholesale","Zelia Toilet Cleaner Liquid 750ML","Cost of Goods Sold","Zelia Toilet Cleaner Liq",,"Undeposited Funds",2330.38,"",273002.13
,"Sales Receipt","03-07-2024","2778",,"Fresh Finds Mart","Zelia Toilet Cleaner Liquid 750ML","Cost of Goods Sold","Zelia Toilet Cleaner Liq",,"Undeposited Funds",1165.19,"",274167.32
,"Sales Receipt","03-07-2024","2782",,"Towba general stores Eastleigh","Zelia Toilet Cleaner Liquid 750ML","Cost of Goods Sold","Zelia Toilet Cleaner Liq",,"Undeposited Funds",2330.38,"",276497.70
,"Sales Receipt","03-07-2024","2770",,"Tayamo Wholesalers","Zelia Toilet Cleaner Liquid 750ML","Cost of Goods Sold","Zelia Toilet Cleaner Liq",,"Undeposited Funds",166.46,"",276664.16
,"Sales Receipt","05-07-2024","2792",,"Cash Sales","Zelia Toilet Cleaner Liquid 750ML","Cost of Goods Sold","Zelia Toilet Cleaner Liq",,"Undeposited Funds",83.23,"",276747.39
,"Sales Receipt","05-07-2024","2793",,"Cash Sales","Zelia Toilet Cleaner Liquid 750ML","Cost of Goods Sold","Zelia Toilet Cleaner Liq",,"Undeposited Funds",499.38,"",277246.77
,"Sales Receipt","05-07-2024","2797",,"Afro Drip LTD","Zelia Toilet Cleaner Liquid 5L","Cost of Goods Sold","Zelia Toilet Cleaner Liq",,"Undeposited Funds",1528.02,"",278774.79
,"Sales Receipt","06-07-2024","2516",,"Baraka Cerials","Zelia Toilet Cleaner Liquid 750ML","Cost of Goods Sold","Zelia Toilet Cleaner Liq",,"Undeposited Funds",249.68,"",279024.47
,"Sales Receipt","08-07-2024","2527",,"Afro Drip LTD","Zelia Toilet Cleaner Liquid 750ML","Cost of Goods Sold","Zelia Toilet Cleaner Liq",,"Undeposited Funds",83.23,"",279107.70
,"Sales Receipt","08-07-2024","2520",,"Brightfood Nasra","Zelia Toilet Cleaner Liquid 750ML","Cost of Goods Sold","Zelia Toilet Cleaner Liq",,"Undeposited Funds",499.37,"",279607.07
,"Sales Receipt","09-07-2024","2509",,"Cash Sales","Zelia Toilet Cleaner Liquid 750ML","Cost of Goods Sold","Zelia Toilet Cleaner Liq",,"Undeposited Funds",83.23,"",279690.30
,"Sales Receipt","09-07-2024","2526",,"Cash Sales","Zelia Toilet Cleaner Liquid 750ML","Cost of Goods Sold","Zelia Toilet Cleaner Liq",,"Undeposited Funds",83.23,"",279773.53
,"Sales Receipt","09-07-2024","2521",,"Sooyal Wholesalers","Zelia Toilet Cleaner Liquid 750ML","Cost of Goods Sold","Zelia Toilet Cleaner Liq",,"Undeposited Funds",1165.19,"",280938.72
,"Sales Receipt","09-07-2024","2569",,"Al Hamdu shop","Zelia Toilet Cleaner Liquid 750ML","Cost of Goods Sold","Zelia Toilet Cleaner Liq",,"Undeposited Funds",582.60,"",281521.32
,"Sales Receipt","09-07-2024","2523",,"Mama Amina","Zelia Toilet Cleaner Liquid 750ML","Cost of Goods Sold","Zelia Toilet Cleaner Liq",,"Undeposited Funds",1165.19,"",282686.51
,"Sales Receipt","10-07-2024","2533",,"Mega Shop","Zelia Toilet Cleaner Liquid 750ML","Cost of Goods Sold","Zelia Toilet Cleaner Liq",,"Undeposited Funds",1165.19,"",283851.70
,"Invoice","15-07-2024","MC05933",,"MUHINDI MWEUSI SUPERMARKET LIMITED","Zelia Toilet Cleaner Liquid 750ML","Cost of Goods Sold","Zelia Toilet Cleaner Liq",,"Accounts Receivable",1165.19,"",285016.89
,"Sales Receipt","15-07-2024","2542",,"Cash Sales","Zelia Toilet Cleaner Liquid 5L","Cost of Goods Sold","Zelia Toilet Cleaner Liq",,"Undeposited Funds",438.36,"",285455.25
,"Sales Receipt","16-07-2024","2550",,"Summer Outlets","Zelia Toilet Cleaner Liquid 750ML","Cost of Goods Sold","Zelia Toilet Cleaner Liq",,"Undeposited Funds",499.37,"",285954.62
,"Sales Receipt","16-07-2024","2563",,"Zulu Enterprise","Zelia Toilet Cleaner Liquid 750ML","Cost of Goods Sold","Zelia Toilet Cleaner Liq",,"Undeposited Funds",1165.19,"",287119.81
,"Invoice","17-07-2024","MC05941",,"Ck Upscales Limited","Zelia Toilet Cleaner Liquid 750ML","Cost of Goods Sold","Zelia Toilet Cleaner Liq",,"Accounts Receivable",582.60,"",287702.41
,"Invoice","17-07-2024","MC05942",,"SUMM SUPERMARKET LIMITED","Zelia Toilet Cleaner Liquid 750ML","Cost of Goods Sold","Zelia Toilet Cleaner Liq",,"Accounts Receivable",582.60,"",288285.01
,"Sales Receipt","17-07-2024","2551",,"Cash Sales","Zelia Toilet Cleaner Liquid 750ML","Cost of Goods Sold","Zelia Toilet Cleaner Liq",,"Undeposited Funds",416.14,"",288701.15
,"Sales Receipt","18-07-2024","2565",,"Cash Sales","Zelia Toilet Cleaner Liquid 750ML","Cost of Goods Sold","Zelia Toilet Cleaner Liq",,"Undeposited Funds",83.23,"",288784.38
,"Sales Receipt","19-07-2024","2605",,"Restoration Traders","Zelia Toilet Cleaner Liquid 750ML","Cost of Goods Sold","Zelia Toilet Cleaner Liq",,"Undeposited Funds",2330.38,"",291114.76
,"Sales Receipt","22-07-2024","2573",,"Cash Sales","Zelia Toilet Cleaner Liquid 750ML","Cost of Goods Sold","Zelia Toilet Cleaner Liq",,"Undeposited Funds",83.23,"",291197.99
,"Sales Receipt","22-07-2024","2574",,"Cash Sales","Zelia Toilet Cleaner Liquid 5L","Cost of Goods Sold","Zelia Toilet Cleaner Liq",,"Undeposited Funds",438.36,"",291636.35
,"Sales Receipt","22-07-2024","2570",,"Cash Sales","Zelia Toilet Cleaner Liquid 750ML","Cost of Goods Sold","Zelia Toilet Cleaner Liq",,"Undeposited Funds",83.23,"",291719.58
,"Sales Receipt","23-07-2024","2582",,"Cash Sales","Zelia Toilet Cleaner Liquid 750ML","Cost of Goods Sold","Zelia Toilet Cleaner Liq",,"Undeposited Funds",83.23,"",291802.81
,"Sales Receipt","23-07-2024","2591",,"Cash Sales","Zelia Toilet Cleaner Liquid 750ML","Cost of Goods Sold","Zelia Toilet Cleaner Liq",,"Undeposited Funds",83.23,"",291886.04
,"Sales Receipt","23-07-2024","2581",,"Cash Sales","Zelia Toilet Cleaner Liquid 750ML","Cost of Goods Sold","Zelia Toilet Cleaner Liq",,"Undeposited Funds",249.68,"",292135.72
,"Sales Receipt","23-07-2024","2607",,"Juli Mart","Zelia Toilet Cleaner Liquid 750ML","Cost of Goods Sold","Zelia Toilet Cleaner Liq",,"Undeposited Funds",249.68,"",292385.40
,"Sales Receipt","24-07-2024","2588",,"Cash Sales","Zelia Toilet Cleaner Liquid 750ML","Cost of Goods Sold","Zelia Toilet Cleaner Liq",,"Undeposited Funds",249.68,"",292635.08
,"Sales Receipt","24-07-2024","2589",,"Cash Sales","Zelia Toilet Cleaner Liquid 5L","Cost of Goods Sold","Zelia Toilet Cleaner Liq",,"Undeposited Funds",876.72,"",293511.80
,"Sales Receipt","24-07-2024","2608",,"Capital Halal","Zelia Toilet Cleaner Liquid 750ML","Cost of Goods Sold","Zelia Toilet Cleaner Liq",,"Undeposited Funds",499.37,"",294011.17
,"Sales Receipt","25-07-2024","2592",,"Cash Sales","Zelia Toilet Cleaner Liquid 5L","Cost of Goods Sold","Zelia Toilet Cleaner Liq",,"Undeposited Funds",438.36,"",294449.53
,"Sales Receipt","27-07-2024","2653",,"Danaba Wholesallers","Zelia Toilet Cleaner Liquid 750ML","Cost of Goods Sold","Zelia Toilet Cleaner Liq",,"Undeposited Funds",665.82,"",295115.35
,"Invoice","29-07-2024","MC05983",,"Muhaya & Rukundo Holdings Ltd","0001.12.00 Zelia Toilet Cleaner Liquid 12X750ML","Cost of Goods Sold","Zelia Toilet Cleaner Liq",,"Accounts Receivable",3046.94,"",298162.29
,"Invoice","29-07-2024","MC05984",,"Mumsha Supamat","Zelia Toilet Cleaner Liquid 750ML","Cost of Goods Sold","Zelia Toilet Cleaner Liq",,"Accounts Receivable",499.37,"",298661.66
,"Sales Receipt","29-07-2024","2602",,"Cash Sales","Zelia Toilet Cleaner Liquid 750ML","Cost of Goods Sold","Zelia Toilet Cleaner Liq",,"Undeposited Funds",83.23,"",298744.89
,"Sales Receipt","29-07-2024","2612",,"Cash Sales","Zelia Toilet Cleaner Liquid 750ML","Cost of Goods Sold","Zelia Toilet Cleaner Liq",,"Undeposited Funds",83.23,"",298828.12
,"Sales Receipt","29-07-2024","2616",,"Hidika Shop","Zelia Toilet Cleaner Liquid 750ML","Cost of Goods Sold","Zelia Toilet Cleaner Liq",,"Undeposited Funds",499.37,"",299327.49
,"Build Assembly","29-07-2024","11038",,,,"Cost of Goods Sold","Zelia Toilet Cleaner Liq","X","-SPLIT-","",980.21,298347.28
,"Sales Receipt","29-07-2024","2922",,"Muhaya & Rukundo Holdings Ltd","Zelia Toilet Cleaner Liquid 12X750ML","Cost of Goods Sold","Zelia Toilet Cleaner Liq",,"Undeposited Funds",3046.94,"",301394.22
,"Sales Receipt","30-07-2024","2620",,"Cash Sales","Zelia Toilet Cleaner Liquid 750ML","Cost of Goods Sold","Zelia Toilet Cleaner Liq",,"Undeposited Funds",89.87,"",301484.09
,"Sales Receipt","30-07-2024","2629",,"Cash Sales","Zelia Toilet Cleaner Liquid 5L","Cost of Goods Sold","Zelia Toilet Cleaner Liq",,"Undeposited Funds",438.36,"",301922.45
,"Sales Receipt","30-07-2024","2622",,"Infinity Lines","Zelia Toilet Cleaner Liquid 5L","Cost of Goods Sold","Zelia Toilet Cleaner Liq",,"Undeposited Funds",438.36,"",302360.81
,"Sales Receipt","30-07-2024","2623",,"Smart Choice","Zelia Toilet Cleaner Liquid 750ML","Cost of Goods Sold","Zelia Toilet Cleaner Liq",,"Undeposited Funds",629.08,"",302989.89
,"Sales Receipt","30-07-2024","2627",,"Elliane Wholesalers","Zelia Toilet Cleaner Liquid 750ML","Cost of Goods Sold","Zelia Toilet Cleaner Liq",,"Undeposited Funds",539.21,"",303529.10
,"Sales Receipt","30-07-2024","2626",,"Nzuri Supermarket","Zelia Toilet Cleaner Liquid 750ML","Cost of Goods Sold","Zelia Toilet Cleaner Liq",,"Undeposited Funds",269.60,"",303798.70
,"Sales Receipt","31-07-2024","AT200",,"Cash Sales","Zelia Toilet Cleaner Liquid 750ML","Cost of Goods Sold","Zelia Toilet Cleaner Liq",,"Undeposited Funds",1109.72,"",304908.42
,"Sales Receipt","01-08-2024","2642",,"Mango Shop","Zelia Toilet Cleaner Liquid 750ML","Cost of Goods Sold","Zelia Toilet Cleaner Liq",,"Undeposited Funds",1290.04,"",306198.46
,"Sales Receipt","01-08-2024","2641",,"Taqwa Shop","Zelia Toilet Cleaner Liquid 750ML","Cost of Goods Sold","Zelia Toilet Cleaner Liq",,"Undeposited Funds",645.02,"",306843.48
,"Sales Receipt","01-08-2024","2640",,"Our Shop","Zelia Toilet Cleaner Liquid 750ML","Cost of Goods Sold","Zelia Toilet Cleaner Liq",,"Undeposited Funds",645.02,"",307488.50
,"Sales Receipt","01-08-2024","4353",,"Goldmart Supermarket","Zelia Toilet Cleaner Liquid 750ML","Cost of Goods Sold","Zelia Toilet Cleaner Liq",,"Undeposited Funds",1290.04,"",308778.54
,"Sales Receipt","01-08-2024","2637",,"Burhani Shop","Zelia Toilet Cleaner Liquid 750ML","Cost of Goods Sold","Zelia Toilet Cleaner Liq",,"Undeposited Funds",1290.04,"",310068.58
,"Sales Receipt","01-08-2024","2691",,"Ubwere Store","Zelia Toilet Cleaner Liquid 750ML","Cost of Goods Sold","Zelia Toilet Cleaner Liq",,"Undeposited Funds",2580.08,"",312648.66
,"Sales Receipt","01-08-2024","2664",,"Mkulima Supermarket","Zelia Toilet Cleaner Liquid 750ML","Cost of Goods Sold","Zelia Toilet Cleaner Liq",,"Undeposited Funds",1105.75,"",313754.41
,"Sales Receipt","02-08-2024","2644",,"Cash Sales","Zelia Toilet Cleaner Liquid 750ML","Cost of Goods Sold","Zelia Toilet Cleaner Liq",,"Undeposited Funds",92.15,"",313846.56
,"Sales Receipt","02-08-2024","2649",,"Cash Sales","Zelia Toilet Cleaner Liquid 750ML","Cost of Goods Sold","Zelia Toilet Cleaner Liq",,"Undeposited Funds",92.15,"",313938.71
,"Sales Receipt","02-08-2024","2650",,"Cash Sales","Zelia Toilet Cleaner Liquid 750ML","Cost of Goods Sold","Zelia Toilet Cleaner Liq",,"Undeposited Funds",92.15,"",314030.86
,"Sales Receipt","05-08-2024","2658",,"Cash Sales","Zelia Toilet Cleaner Liquid 750ML","Cost of Goods Sold","Zelia Toilet Cleaner Liq",,"Undeposited Funds",184.29,"",314215.15
,"Sales Receipt","05-08-2024","2661",,"Kibibi Wasai Store","Zelia Toilet Cleaner Liquid 750ML","Cost of Goods Sold","Zelia Toilet Cleaner Liq",,"Undeposited Funds",1290.04,"",315505.19
,"Sales Receipt","05-08-2024","2671",,"Hidika Shop","Zelia Toilet Cleaner Liquid 750ML","Cost of Goods Sold","Zelia Toilet Cleaner Liq",,"Undeposited Funds",552.87,"",316058.06
,"Sales Receipt","05-08-2024","2675",,"Adurus Wholesallers","Zelia Toilet Cleaner Liquid 750ML","Cost of Goods Sold","Zelia Toilet Cleaner Liq",,"Undeposited Funds",2580.08,"",318638.14
,"Sales Receipt","06-08-2024","2659",,"Cash Sales","Zelia Toilet Cleaner Liquid 5L","Cost of Goods Sold","Zelia Toilet Cleaner Liq",,"Undeposited Funds",446.08,"",319084.22
,"Sales Receipt","06-08-2024","2676",,"Warfa Wholesale","Zelia Toilet Cleaner Liquid 750ML","Cost of Goods Sold","Zelia Toilet Cleaner Liq",,"Undeposited Funds",3870.12,"",322954.34
,"Sales Receipt","06-08-2024","2677",,"Saacid Shop","Zelia Toilet Cleaner Liquid 750ML","Cost of Goods Sold","Zelia Toilet Cleaner Liq",,"Undeposited Funds",2580.08,"",325534.42
,"Sales Receipt","06-08-2024","2680",,"Juja Minimart","Zelia Toilet Cleaner Liquid 750ML","Cost of Goods Sold","Zelia Toilet Cleaner Liq",,"Undeposited Funds",1290.04,"",326824.46
,"Sales Receipt","06-08-2024","2681",,"Adam Boss","Zelia Toilet Cleaner Liquid 750ML","Cost of Goods Sold","Zelia Toilet Cleaner Liq",,"Undeposited Funds",645.02,"",327469.48
,"Invoice","07-08-2024","MC06006",,"NASRI MART LIMITED","Zelia Toilet Cleaner Liquid 750ML","Cost of Goods Sold","Zelia Toilet Cleaner Liq",,"Accounts Receivable",552.87,"",328022.35
,"Sales Receipt","07-08-2024","2682",,"Watopz Wholesallers","Zelia Toilet Cleaner Liquid 750ML","Cost of Goods Sold","Zelia Toilet Cleaner Liq",,"Undeposited Funds",2211.50,"",330233.85
,"Sales Receipt","07-08-2024","2683",,"Marris Mini mart","Zelia Toilet Cleaner Liquid 750ML","Cost of Goods Sold","Zelia Toilet Cleaner Liq",,"Undeposited Funds",645.02,"",330878.87
,"Sales Receipt","07-08-2024","2809",,"Safa Mart Wholesalers","Zelia Toilet Cleaner Liquid 750ML","Cost of Goods Sold","Zelia Toilet Cleaner Liq",,"Undeposited Funds",552.87,"",331431.74
,"Invoice","08-08-2024","MC06015",,"Burhani Private Mart Limited","Zelia Toilet Cleaner Liquid 750ML","Cost of Goods Sold","Zelia Toilet Cleaner Liq",,"Accounts Receivable",1290.04,"",332721.78
,"Invoice","12-08-2024","MC06031",,"KAVYA SUPERMARKET LIMITED","Zelia Toilet Cleaner Liquid 750ML","Cost of Goods Sold","Zelia Toilet Cleaner Liq",,"Accounts Receivable",1105.75,"",333827.53
,"Sales Receipt","12-08-2024","2813",,"Mamken Minimart","Zelia Toilet Cleaner Liquid 750ML","Cost of Goods Sold","Zelia Toilet Cleaner Liq",,"Undeposited Funds",552.87,"",334380.40
,"Sales Receipt","12-08-2024","2815",,"Kibibi Wasai Store","Zelia Toilet Cleaner Liquid 750ML","Cost of Goods Sold","Zelia Toilet Cleaner Liq",,"Undeposited Funds",1290.04,"",335670.44
,"Sales Receipt","12-08-2024","2816",,"Freshtake wholesalers","Zelia Toilet Cleaner Liquid 750ML","Cost of Goods Sold","Zelia Toilet Cleaner Liq",,"Undeposited Funds",2211.50,"",337881.94
,"Sales Receipt","14-08-2024","2834",,"Milimani Store","Zelia Toilet Cleaner Liquid 750ML","Cost of Goods Sold","Zelia Toilet Cleaner Liq",,"Undeposited Funds",638.44,"",338520.38
,"Sales Receipt","14-08-2024","2842",,"Kibibi Wasai Store","Zelia Toilet Cleaner Liquid 750ML","Cost of Goods Sold","Zelia Toilet Cleaner Liq",,"Undeposited Funds",1276.88,"",339797.26
,"Sales Receipt","15-08-2024","2892",,"Makueni Store","Zelia Toilet Cleaner Liquid 750ML","Cost of Goods Sold","Zelia Toilet Cleaner Liq",,"Undeposited Funds",91.01,"",339888.27
,"Sales Receipt","15-08-2024","2827",,"Capital Furniture","Zelia Toilet Cleaner Liquid 5L","Cost of Goods Sold","Zelia Toilet Cleaner Liq",,"Undeposited Funds",446.74,"",340335.01
,"Sales Receipt","15-08-2024","2845",,"Rajah Foodstuffs","Zelia Toilet Cleaner Liquid 750ML","Cost of Goods Sold","Zelia Toilet Cleaner Liq",,"Undeposited Funds",2548.39,"",342883.40
,"Sales Receipt","16-08-2024","2850",,"Hawkers Paradise","Zelia Toilet Cleaner Liquid 750ML","Cost of Goods Sold","Zelia Toilet Cleaner Liq",,"Undeposited Funds",364.06,"",343247.46
,"Sales Receipt","16-08-2024","2851",,"Tahila Enterprises","Zelia Toilet Cleaner Liquid 750ML","Cost of Goods Sold","Zelia Toilet Cleaner Liq",,"Undeposited Funds",364.06,"",343611.52
,"Sales Receipt","16-08-2024","2920",,"Kibibi Wasai Store","Zelia Toilet Cleaner Liquid 750ML","Cost of Goods Sold","Zelia Toilet Cleaner Liq",,"Undeposited Funds",1274.20,"",344885.72
,"Sales Receipt","17-08-2024","2843",,"Horn of Africa","Zelia Toilet Cleaner Liquid 750ML","Cost of Goods Sold","Zelia Toilet Cleaner Liq",,"Undeposited Funds",2548.40,"",347434.12
,"Sales Receipt","19-08-2024","2839",,"Cash Sales","Zelia Toilet Cleaner Liquid 750ML","Cost of Goods Sold","Zelia Toilet Cleaner Liq",,"Undeposited Funds",182.03,"",347616.15
,"Sales Receipt","19-08-2024","2835",,"Jombs Wholesale","Zelia Toilet Cleaner Liquid 750ML","Cost of Goods Sold","Zelia Toilet Cleaner Liq",,"Undeposited Funds",364.06,"",347980.21
,"Sales Receipt","20-08-2024","2904",,"Cash Sales","Zelia Toilet Cleaner Liquid 750ML","Cost of Goods Sold","Zelia Toilet Cleaner Liq",,"Undeposited Funds",91.01,"",348071.22
,"Sales Receipt","20-08-2024","2869",,"Soft Landing","Zelia Toilet Cleaner Liquid 750ML","Cost of Goods Sold","Zelia Toilet Cleaner Liq",,"Undeposited Funds",182.03,"",348253.25
,"Sales Receipt","20-08-2024","2859",,"Nzuri Supermarket","Zelia Toilet Cleaner Liquid 750ML","Cost of Goods Sold","Zelia Toilet Cleaner Liq",,"Undeposited Funds",546.08,"",348799.33
,"Credit Note","21-08-2024","CN01064",,"Muhaya & Rukundo Holdings Ltd","0001.12.00 Zelia Toilet Cleaner Liquid 12X750ML","Cost of Goods Sold","Zelia Toilet Cleaner Liq",,"Accounts Receivable","",3046.94,345752.39
,"Invoice","21-08-2024","MC06061",,"Muhaya & Rukundo Holdings Ltd","0001.12.00 Zelia Toilet Cleaner Liquid 12X750ML","Cost of Goods Sold","Zelia Toilet Cleaner Liq",,"Accounts Receivable",91408.20,"",437160.59
,"Invoice","21-08-2024","MC06062",,"Muhaya & Rukundo Holdings Ltd","0001.12.00 Outer Toilet cleaner 12x750ML","Cost of Goods Sold","Zelia Toilet Cleaner Liq",,"Accounts Receivable",173.15,"",437333.74
,"Invoice","21-08-2024","MC06063",,"BETTER DEAL WHOLESALERS LIMITED","Zelia Toilet Cleaner Liquid 750ML","Cost of Goods Sold","Zelia Toilet Cleaner Liq",,"Accounts Receivable",6826.04,"",444159.78
,"Invoice","21-08-2024","MC06064",,"Ck Upscales Limited","Zelia Toilet Cleaner Liquid 750ML","Cost of Goods Sold","Zelia Toilet Cleaner Liq",,"Accounts Receivable",1274.20,"",445433.98
,"Sales Receipt","21-08-2024","2853",,"Cash Sales","Zelia Toilet Cleaner Liquid 750ML","Cost of Goods Sold","Zelia Toilet Cleaner Liq",,"Undeposited Funds",91.01,"",445524.99
,"Sales Receipt","21-08-2024","2864",,"Safwan Wholesalers","Zelia Toilet Cleaner Liquid 750ML","Cost of Goods Sold","Zelia Toilet Cleaner Liq",,"Undeposited Funds",1274.20,"",446799.19
,"Sales Receipt","21-08-2024","2866",,"Budget Busket","Zelia Toilet Cleaner Liquid 750ML","Cost of Goods Sold","Zelia Toilet Cleaner Liq",,"Undeposited Funds",546.08,"",447345.27
,"Sales Receipt","21-08-2024","2855",,"Homecare Enterprise","Zelia Toilet Cleaner Liquid 5L","Cost of Goods Sold","Zelia Toilet Cleaner Liq",,"Undeposited Funds",446.74,"",447792.01
,"Build Assembly","21-08-2024","11295",,,,"Cost of Goods Sold","Zelia Toilet Cleaner Liq","X","-SPLIT-","",23800.41,423991.60
,"Invoice","22-08-2024","MC06068",,"BLUEMART SUPERMARKET LIMITED","Zelia Toilet Cleaner Liquid 750ML","Cost of Goods Sold","Zelia Toilet Cleaner Liq",,"Accounts Receivable",546.08,"",424537.68
,"Invoice","22-08-2024","MC06069",,"Mumsha Supamat","Zelia Toilet Cleaner Liquid 750ML","Cost of Goods Sold","Zelia Toilet Cleaner Liq",,"Accounts Receivable",546.08,"",425083.76
,"Invoice","22-08-2024","MC06070",,"LUCKY MART SUPERMARKET LIMITED","Zelia Toilet Cleaner Liquid 750ML","Cost of Goods Sold","Zelia Toilet Cleaner Liq",,"Accounts Receivable",546.08,"",425629.84
,"Sales Receipt","22-08-2024","2868",,"Cash Sales","Zelia Toilet Cleaner Liquid 750ML","Cost of Goods Sold","Zelia Toilet Cleaner Liq",,"Undeposited Funds",91.01,"",425720.85
,"Sales Receipt","22-08-2024","1206",,"Tangents Minimart","Zelia Toilet Cleaner Liquid 750ML","Cost of Goods Sold","Zelia Toilet Cleaner Liq",,"Undeposited Funds",455.07,"",426175.92
,"Sales Receipt","23-08-2024","2877",,"Cash Sales","Zelia Toilet Cleaner Liquid 750ML","Cost of Goods Sold","Zelia Toilet Cleaner Liq",,"Undeposited Funds",91.01,"",426266.93
,"Sales Receipt","23-08-2024","2878",,"Cash Sales","Zelia Toilet Cleaner Liquid 750ML","Cost of Goods Sold","Zelia Toilet Cleaner Liq",,"Undeposited Funds",91.01,"",426357.94
,"Sales Receipt","23-08-2024","2880",,"Cash Sales","Zelia Toilet Cleaner Liquid 750ML","Cost of Goods Sold","Zelia Toilet Cleaner Liq",,"Undeposited Funds",91.01,"",426448.95
,"Sales Receipt","23-08-2024","2899",,"Beraccah Syokimau","Zelia Toilet Cleaner Liquid 750ML","Cost of Goods Sold","Zelia Toilet Cleaner Liq",,"Undeposited Funds",1092.17,"",427541.12
,"Sales Receipt","24-08-2024","2887",,"Brightfood Nasra","Zelia Toilet Cleaner Liquid 750ML","Cost of Goods Sold","Zelia Toilet Cleaner Liq",,"Undeposited Funds",546.08,"",428087.20
,"Sales Receipt","26-08-2024","2883",,"Cash Sales","Zelia Toilet Cleaner Liquid 750ML","Cost of Goods Sold","Zelia Toilet Cleaner Liq",,"Undeposited Funds",273.04,"",428360.24
,"Sales Receipt","26-08-2024","2889",,"Mama G shop","Zelia Toilet Cleaner Liquid 750ML","Cost of Goods Sold","Zelia Toilet Cleaner Liq",,"Undeposited Funds",1274.20,"",429634.44
,"Sales Receipt","26-08-2024","2908",,"Himilo General Store","Zelia Toilet Cleaner Liquid 750ML","Cost of Goods Sold","Zelia Toilet Cleaner Liq",,"Undeposited Funds",2548.39,"",432182.83
,"Sales Receipt","26-08-2024","1207",,"Kemera Discount","Zelia Toilet Cleaner Liquid 5L","Cost of Goods Sold","Zelia Toilet Cleaner Liq",,"Undeposited Funds",446.74,"",432629.57
,"Sales Receipt","27-08-2024","2909",,"Horn of Africa","Zelia Toilet Cleaner Liquid 750ML","Cost of Goods Sold","Zelia Toilet Cleaner Liq",,"Undeposited Funds",2548.39,"",435177.96
,"Sales Receipt","28-08-2024","2911",,"Infinity Lines","Zelia Toilet Cleaner Liquid 5L","Cost of Goods Sold","Zelia Toilet Cleaner Liq",,"Undeposited Funds",893.47,"",436071.43
,"Sales Receipt","28-08-2024","2914",,"Towba Eastleigh foodstuffs","Zelia Toilet Cleaner Liquid 750ML","Cost of Goods Sold","Zelia Toilet Cleaner Liq",,"Undeposited Funds",2548.39,"",438619.82
,"Sales Receipt","29-08-2024","AT201",,"Cash Sales","Zelia Toilet Cleaner Liquid 750ML","Cost of Goods Sold","Zelia Toilet Cleaner Liq",,"Undeposited Funds",1057.50,"",439677.32
,"Sales Receipt","02-09-2024","3225",,"Purity Shop","Zelia Toilet Cleaner Liquid 12X750ML","Cost of Goods Sold","Zelia Toilet Cleaner Liq",,"Undeposited Funds",126.95,"",439804.27
,"Sales Receipt","02-09-2024","2916",,"Anne","Zelia Toilet Cleaner Liquid 12X750ML","Cost of Goods Sold","Zelia Toilet Cleaner Liq",,"Undeposited Funds",126.95,"",439931.22
,"Sales Receipt","02-09-2024","2923",,"Blossom Beauty","Zelia Toilet Cleaner Liquid 12X750ML","Cost of Goods Sold","Zelia Toilet Cleaner Liq",,"Undeposited Funds",761.74,"",440692.96
,"Sales Receipt","02-09-2024","2925",,"Sharma Shop","Zelia Toilet Cleaner Liquid 12X750ML","Cost of Goods Sold","Zelia Toilet Cleaner Liq",,"Undeposited Funds",1777.39,"",442470.35
,"Sales Receipt","02-09-2024","3006",,"Cash Sales","Zelia Toilet Cleaner Liquid 12X750ML","Cost of Goods Sold","Zelia Toilet Cleaner Liq",,"Undeposited Funds",380.87,"",442851.22
,"Sales Receipt","03-09-2024","2931",,"Jombs wholesalers","Zelia Toilet Cleaner Liquid 12X750ML","Cost of Goods Sold","Zelia Toilet Cleaner Liq",,"Undeposited Funds",761.74,"",443612.96
,"Sales Receipt","03-09-2024","2932",,"Mama Amina","Zelia Toilet Cleaner Liquid 12X750ML","Cost of Goods Sold","Zelia Toilet Cleaner Liq",,"Undeposited Funds",1777.39,"",445390.35
,"Sales Receipt","03-09-2024","3226",,"Soft Landing","Zelia Toilet Cleaner Liquid 4X5L","Cost of Goods Sold","Zelia Toilet Cleaner Liq",,"Undeposited Funds",465.36,"",445855.71
,"Sales Receipt","03-09-2024","2922",,"Cash Sales","Zelia Toilet Cleaner Liquid 12X750ML","Cost of Goods Sold","Zelia Toilet Cleaner Liq",,"Undeposited Funds",253.92,"",446109.63
,"Invoice","04-09-2024","MC06108",,"PRICE CHOPPER STORES LIMITED","Zelia Toilet Cleaner Liquid 750ML","Cost of Goods Sold","Zelia Toilet Cleaner Liq",,"Accounts Receivable",525.84,"",446635.47
,"Sales Receipt","04-09-2024","2937",,"Restoration Traders","Zelia Toilet Cleaner Liquid 12X750ML","Cost of Goods Sold","Zelia Toilet Cleaner Liq",,"Undeposited Funds",3554.76,"",450190.23
,"Sales Receipt","04-09-2024","3013",,"Ogena Matt","Zelia Toilet Cleaner Liquid 12X750ML","Cost of Goods Sold","Zelia Toilet Cleaner Liq",,"Undeposited Funds",634.78,"",450825.01
,"Sales Receipt","04-09-2024","3014",,"Gifted Hands","Zelia Toilet Cleaner Liquid 12X750ML","Cost of Goods Sold","Zelia Toilet Cleaner Liq",,"Undeposited Funds",507.82,"",451332.83
,"Sales Receipt","05-09-2024","2947",,"Ushirika Shop","Zelia Toilet Cleaner Liquid 12X750ML","Cost of Goods Sold","Zelia Toilet Cleaner Liq",,"Undeposited Funds",3554.76,"",454887.59
,"Sales Receipt","05-09-2024","2948",,"Jam Tower Shop","Zelia Toilet Cleaner Liquid 12X750ML","Cost of Goods Sold","Zelia Toilet Cleaner Liq",,"Undeposited Funds",1777.39,"",456664.98
,"Sales Receipt","05-09-2024","2967",,"Freshtake wholesalers","Zelia Toilet Cleaner Liquid 12X750ML","Cost of Goods Sold","Zelia Toilet Cleaner Liq",,"Undeposited Funds",3046.94,"",459711.92
,"Sales Receipt","05-09-2024","2944",,"Cash Sales","Zelia Toilet Cleaner Liquid 12X750ML","Cost of Goods Sold","Zelia Toilet Cleaner Liq",,"Undeposited Funds",253.92,"",459965.84
,"Sales Receipt","05-09-2024","2950",,"Cash Sales","Zelia Toilet Cleaner Liquid 12X750ML","Cost of Goods Sold","Zelia Toilet Cleaner Liq",,"Undeposited Funds",253.92,"",460219.76
,"Sales Receipt","05-09-2024","2955",,"Cash Sales","Zelia Toilet Cleaner Liquid 12X750ML","Cost of Goods Sold","Zelia Toilet Cleaner Liq",,"Undeposited Funds",253.92,"",460473.68
,"Sales Receipt","06-09-2024","2961",,"Gure Yare Shop","Zelia Toilet Cleaner Liquid 12X750ML","Cost of Goods Sold","Zelia Toilet Cleaner Liq",,"Undeposited Funds",3554.76,"",464028.44
,"Sales Receipt","08-09-2024","3227",,"Visina Stores","Zelia Toilet Cleaner Liquid 12X750ML","Cost of Goods Sold","Zelia Toilet Cleaner Liq",,"Undeposited Funds",4062.60,"",468091.04
,"Sales Receipt","09-09-2024","2968",,"Hidika Shop","Zelia Toilet Cleaner Liquid 12X750ML","Cost of Goods Sold","Zelia Toilet Cleaner Liq",,"Undeposited Funds",1523.47,"",469614.51
,"Sales Receipt","09-09-2024","2969",,"Elwak mart","Zelia Toilet Cleaner Liquid 12X750ML","Cost of Goods Sold","Zelia Toilet Cleaner Liq",,"Undeposited Funds",1523.47,"",471137.98
,"Sales Receipt","09-09-2024","2974",,"Soft Landing","Zelia Toilet Cleaner Liquid 12X750ML","Cost of Goods Sold","Zelia Toilet Cleaner Liq",,"Undeposited Funds",1777.39,"",472915.37
,"Sales Receipt","09-09-2024","2986",,"Pambazuka Mart (K) Limited","Zelia Toilet Cleaner Liquid 12X750ML","Cost of Goods Sold","Zelia Toilet Cleaner Liq",,"Undeposited Funds",1523.47,"",474438.84
,"Sales Receipt","09-09-2024","2971",,"Cash Sales","Zelia Toilet Cleaner Liquid 12X750ML","Cost of Goods Sold","Zelia Toilet Cleaner Liq",,"Undeposited Funds",126.95,"",474565.79
,"Sales Receipt","10-09-2024","2990",,"Maida Minimart","Zelia Toilet Cleaner Liquid 12X750ML","Cost of Goods Sold","Zelia Toilet Cleaner Liq",,"Undeposited Funds",660.55,"",475226.34
,"Sales Receipt","10-09-2024","2991",,"Nuclear Supermarket","Zelia Toilet Cleaner Liquid 12X750ML","Cost of Goods Sold","Zelia Toilet Cleaner Liq",,"Undeposited Funds",660.55,"",475886.89
,"Sales Receipt","10-09-2024","2992",,"Axis Lounge","Zelia Toilet Cleaner Liquid 12X750ML","Cost of Goods Sold","Zelia Toilet Cleaner Liq",,"Undeposited Funds",1541.28,"",477428.17
,"Sales Receipt","10-09-2024","2975",,"Cash Sales","Zelia Toilet Cleaner Liquid 12X750ML","Cost of Goods Sold","Zelia Toilet Cleaner Liq",,"Undeposited Funds",440.36,"",477868.53
,"Sales Receipt","10-09-2024","3015",,"Cash Sales","Zelia Toilet Cleaner Liquid 12X750ML","Cost of Goods Sold","Zelia Toilet Cleaner Liq",,"Undeposited Funds",110.09,"",477978.62
,"Sales Receipt","10-09-2024","2976",,"Cash Sales","Zelia Toilet Cleaner Liquid 12X750ML","Cost of Goods Sold","Zelia Toilet Cleaner Liq",,"Undeposited Funds",220.19,"",478198.81
,"Sales Receipt","11-09-2024","2994",,"Mutawakal Stores","Zelia Toilet Cleaner Liquid 12X750ML","Cost of Goods Sold","Zelia Toilet Cleaner Liq",,"Undeposited Funds",1403.33,"",479602.14
,"Sales Receipt","11-09-2024","2997",,"Domasco Wholesalers","-MULTIPLE-","Cost of Goods Sold","Zelia Toilet Cleaner Liq",,"Undeposited Funds",1030.95,"",480633.09
,"Sales Receipt","11-09-2024","3011",,"Warfa Wholesale","Zelia Toilet Cleaner Liquid 12X750ML","Cost of Goods Sold","Zelia Toilet Cleaner Liq",,"Undeposited Funds",4209.97,"",484843.06
,"Invoice","12-09-2024","MC06147",,"ZAIN SUPERMARKET LIMITED","Zelia Toilet Cleaner Liquid 12X750ML","Cost of Goods Sold","Zelia Toilet Cleaner Liq",,"Accounts Receivable",601.42,"",485444.48
,"Sales Receipt","12-09-2024","3021",,"Marwa Tower Shop","Zelia Toilet Cleaner Liquid 12X750ML","Cost of Goods Sold","Zelia Toilet Cleaner Liq",,"Undeposited Funds",1202.85,"",486647.33
,"Sales Receipt","12-09-2024","2987",,"Cash Sales","Zelia Toilet Cleaner Liquid 12X750ML","Cost of Goods Sold","Zelia Toilet Cleaner Liq",,"Undeposited Funds",400.95,"",487048.28
,"Sales Receipt","12-09-2024","3019",,"Cash Sales","Zelia Toilet Cleaner Liquid 12X750ML","Cost of Goods Sold","Zelia Toilet Cleaner Liq",,"Undeposited Funds",100.23,"",487148.51
,"Sales Receipt","13-09-2024","3029",,"Omari Store","Zelia Toilet Cleaner Liquid 12X750ML","Cost of Goods Sold","Zelia Toilet Cleaner Liq",,"Undeposited Funds",501.19,"",487649.70
,"Sales Receipt","13-09-2024","3032",,"Cash Sales","Zelia Toilet Cleaner Liquid 12X750ML","Cost of Goods Sold","Zelia Toilet Cleaner Liq",,"Undeposited Funds",200.48,"",487850.18
,"Sales Receipt","13-09-2024","3033",,"Cash Sales","Zelia Toilet Cleaner Liquid 12X750ML","Cost of Goods Sold","Zelia Toilet Cleaner Liq",,"Undeposited Funds",100.23,"",487950.41
,"Sales Receipt","14-09-2024","3041",,"Lekima Wholesale","Zelia Toilet Cleaner Liquid 12X750ML","Cost of Goods Sold","Zelia Toilet Cleaner Liq",,"Undeposited Funds",601.42,"",488551.83
,"Sales Receipt","14-09-2024","3043",,"Gladys Wholesalers","Zelia Toilet Cleaner Liquid 12X750ML","Cost of Goods Sold","Zelia Toilet Cleaner Liq",,"Undeposited Funds",601.42,"",489153.25
,"Sales Receipt","16-09-2024","3044",,"Afro Drip LTD","Zelia Toilet Cleaner Liquid 4X5L","Cost of Goods Sold","Zelia Toilet Cleaner Liq",,"Undeposited Funds",930.72,"",490083.97
,"Sales Receipt","16-09-2024","3045",,"Afro Drip LTD Reception","Zelia Toilet Cleaner Liquid 12X750ML","Cost of Goods Sold","Zelia Toilet Cleaner Liq",,"Undeposited Funds",100.23,"",490184.20
,"Sales Receipt","16-09-2024","3037",,"Cash Sales","Zelia Toilet Cleaner Liquid 4X5L","Cost of Goods Sold","Zelia Toilet Cleaner Liq",,"Undeposited Funds",465.36,"",490649.56
,"Sales Receipt","16-09-2024","3039",,"Cash Sales","Zelia Toilet Cleaner Liquid 12X750ML","Cost of Goods Sold","Zelia Toilet Cleaner Liq",,"Undeposited Funds",100.23,"",490749.79
,"Sales Receipt","16-09-2024","3040",,"Cash Sales","Zelia Toilet Cleaner Liquid 4X5L","Cost of Goods Sold","Zelia Toilet Cleaner Liq",,"Undeposited Funds",465.36,"",491215.15
,"Sales Receipt","17-09-2024","3050",,"Cash Sales","Zelia Toilet Cleaner Liquid 12X750ML","Cost of Goods Sold","Zelia Toilet Cleaner Liq",,"Undeposited Funds",200.48,"",491415.63
,"Sales Receipt","18-09-2024","3060",,"Faisel Wholesalers","Zelia Toilet Cleaner Liquid 12X750ML","Cost of Goods Sold","Zelia Toilet Cleaner Liq",,"Undeposited Funds",2405.69,"",493821.32
,"Sales Receipt","18-09-2024","3056",,"Cash Sales","Zelia Toilet Cleaner Liquid 12X750ML","Cost of Goods Sold","Zelia Toilet Cleaner Liq",,"Undeposited Funds",100.23,"",493921.55
,"Sales Receipt","20-09-2024","3094",,"Duto Rumo Store","Zelia Toilet Cleaner Liquid 12X750ML","Cost of Goods Sold","Zelia Toilet Cleaner Liq",,"Undeposited Funds",200.48,"",494122.03
,"Sales Receipt","20-09-2024","3204",,"Meghan Stores","Zelia Toilet Cleaner Liquid 12X750ML","Cost of Goods Sold","Zelia Toilet Cleaner Liq",,"Undeposited Funds",100.23,"",494222.26
,"Sales Receipt","23-09-2024","3087",,"Himilo General Store","Zelia Toilet Cleaner Liquid 12X750ML","Cost of Goods Sold","Zelia Toilet Cleaner Liq",,"Undeposited Funds",2691.86,"",496914.12
,"Invoice","24-09-2024","MC06194",,"OGENA PRIME DISTRIBUTORS LIMITED","Zelia Toilet Cleaner Liquid 12X750ML","Cost of Goods Sold","Zelia Toilet Cleaner Liq",,"Accounts Receivable",480.69,"",497394.81
,"Invoice","24-09-2024","MC06195",,"TAWALA SUPERMARKET LIMITED","Zelia Toilet Cleaner Liquid 12X750ML","Cost of Goods Sold","Zelia Toilet Cleaner Liq",,"Accounts Receivable",1153.66,"",498548.47
,"Invoice","24-09-2024","MC06196",,"KASAMAT INVESTMENTS LTD","Zelia Toilet Cleaner Liquid 12X750ML","Cost of Goods Sold","Zelia Toilet Cleaner Liq",,"Accounts Receivable",576.83,"",499125.30
,"Credit Note","24-09-2024","CN01069",,"OGENA PRIME DISTRIBUTORS LIMITED","Zelia Toilet Cleaner Liquid 12X750ML","Cost of Goods Sold","Zelia Toilet Cleaner Liq",,"Accounts Receivable","",480.69,498644.61
,"Sales Receipt","24-09-2024","3090",,"Elliane Wholesalers","Zelia Toilet Cleaner Liquid 12X750ML","Cost of Goods Sold","Zelia Toilet Cleaner Liq",,"Undeposited Funds",569.24,"",499213.85
,"Sales Receipt","24-09-2024","3234",,"Gifted Hands","Zelia Toilet Cleaner Liquid 12X750ML","Cost of Goods Sold","Zelia Toilet Cleaner Liq",,"Undeposited Funds",379.49,"",499593.34
,"Sales Receipt","24-09-2024","3078",,"Cash Sales","Zelia Toilet Cleaner Liquid 4X5L","Cost of Goods Sold","Zelia Toilet Cleaner Liq",,"Undeposited Funds",465.36,"",500058.70
,"Sales Receipt","24-09-2024","3079",,"Cash Sales","Zelia Toilet Cleaner Liquid 12X750ML","Cost of Goods Sold","Zelia Toilet Cleaner Liq",,"Undeposited Funds",189.75,"",500248.45
,"Sales Receipt","24-09-2024","3080",,"Cash Sales","Zelia Toilet Cleaner Liquid 12X750ML","Cost of Goods Sold","Zelia Toilet Cleaner Liq",,"Undeposited Funds",94.87,"",500343.32
,"Sales Receipt","24-09-2024","3091",,"Cash Sales","Zelia Toilet Cleaner Liquid 12X750ML","Cost of Goods Sold","Zelia Toilet Cleaner Liq",,"Undeposited Funds",94.87,"",500438.19
,"Sales Receipt","24-09-2024","3092",,"Cash Sales","Zelia Toilet Cleaner Liquid 12X750ML","Cost of Goods Sold","Zelia Toilet Cleaner Liq",,"Undeposited Funds",94.87,"",500533.06
,"Sales Receipt","25-09-2024","3096",,"Sharaazad Wholesalers","Zelia Toilet Cleaner Liquid 12X750ML","Cost of Goods Sold","Zelia Toilet Cleaner Liq",,"Undeposited Funds",2656.47,"",503189.53
,"Sales Receipt","25-09-2024","3099",,"Towba general stores Eastleigh","Zelia Toilet Cleaner Liquid 12X750ML","Cost of Goods Sold","Zelia Toilet Cleaner Liq",,"Undeposited Funds",2656.47,"",505846.00
,"Sales Receipt","25-09-2024","3095",,"Cash Sales","Zelia Toilet Cleaner Liquid 12X750ML","Cost of Goods Sold","Zelia Toilet Cleaner Liq",,"Undeposited Funds",94.87,"",505940.87
,"Sales Receipt","26-09-2024","3209",,"Cash Sales","Zelia Toilet Cleaner Liquid 12X750ML","Cost of Goods Sold","Zelia Toilet Cleaner Liq",,"Undeposited Funds",94.87,"",506035.74
,"Invoice","27-09-2024","MC06216",,"QUALITYMART SUPERMARKET LIMITED","Zelia Toilet Cleaner Liquid 12X750ML","Cost of Goods Sold","Zelia Toilet Cleaner Liq",,"Accounts Receivable",569.24,"",506604.98
,"Invoice","27-09-2024","MC06218",,"LUCKY MART SUPERMARKET LIMITED","Zelia Toilet Cleaner Liquid 12X750ML","Cost of Goods Sold","Zelia Toilet Cleaner Liq",,"Accounts Receivable",569.24,"",507174.22
,"Sales Receipt","27-09-2024","3215",,"Supaa Mart","Zelia Toilet Cleaner Liquid 12X750ML","Cost of Goods Sold","Zelia Toilet Cleaner Liq",,"Undeposited Funds",569.24,"",507743.46
,"Sales Receipt","27-09-2024","3214",,"Kenya Yetu Mart","Zelia Toilet Cleaner Liquid 12X750ML","Cost of Goods Sold","Zelia Toilet Cleaner Liq",,"Undeposited Funds",569.24,"",508312.70
,"Sales Receipt","27-09-2024","3213",,"DayBreak Shop","Zelia Toilet Cleaner Liquid 12X750ML","Cost of Goods Sold","Zelia Toilet Cleaner Liq",,"Undeposited Funds",284.62,"",508597.32
,"Sales Receipt","27-09-2024","3245",,"Florence Shop","Zelia Toilet Cleaner Liquid 12X750ML","Cost of Goods Sold","Zelia Toilet Cleaner Liq",,"Undeposited Funds",189.75,"",508787.07
,"Sales Receipt","27-09-2024","3212",,"Cash Sales","Zelia Toilet Cleaner Liquid 12X750ML","Cost of Goods Sold","Zelia Toilet Cleaner Liq",,"Undeposited Funds",94.87,"",508881.94
,"Sales Receipt","28-09-2024","3222",,"Gidesh Minimart","Zelia Toilet Cleaner Liquid 12X750ML","Cost of Goods Sold","Zelia Toilet Cleaner Liq",,"Undeposited Funds",1138.49,"",510020.43
,"Sales Receipt","28-09-2024","3221",,"Bulsho Wholesalers","Zelia Toilet Cleaner Liquid 12X750ML","Cost of Goods Sold","Zelia Toilet Cleaner Liq",,"Undeposited Funds",569.24,"",510589.67
,"Sales Receipt","30-09-2024","3223",,"Brightfood Nasra","Zelia Toilet Cleaner Liquid 12X750ML","Cost of Goods Sold","Zelia Toilet Cleaner Liq",,"Undeposited Funds",569.24,"",511158.91
,"Sales Receipt","01-10-2024","3220",,"Cash Sales","Zelia Toilet Cleaner Liquid 12X750ML","Cost of Goods Sold","Zelia Toilet Cleaner Liq",,"Undeposited Funds",81.32,"",511240.23
,"Sales Receipt","02-10-2024","3225",,"Cash Sales","Zelia Toilet Cleaner Liquid 750ML","Cost of Goods Sold","Zelia Toilet Cleaner Liq",,"Undeposited Funds",87.64,"",511327.87
,"Sales Receipt","02-10-2024","3225",,"Cash Sales","Zelia Toilet Cleaner Liquid 12X750ML","Cost of Goods Sold","Zelia Toilet Cleaner Liq",,"Undeposited Funds",94.87,"",511422.74
,"Sales Receipt","02-10-2024","3228",,"Cash Sales","Zelia Toilet Cleaner Liquid 12X750ML","Cost of Goods Sold","Zelia Toilet Cleaner Liq",,"Undeposited Funds",94.87,"",511517.61
,"Sales Receipt","02-10-2024","3234",,"Adam Boss","Zelia Toilet Cleaner Liquid 12X750ML","Cost of Goods Sold","Zelia Toilet Cleaner Liq",,"Undeposited Funds",2656.47,"",514174.08
,"Sales Receipt","03-10-2024","3250",,"Cash Sales","Zelia Toilet Cleaner Liquid 12X750ML","Cost of Goods Sold","Zelia Toilet Cleaner Liq",,"Undeposited Funds",94.87,"",514268.95
,"Sales Receipt","03-10-2024","3247",,"Warfa Wholesale","Zelia Toilet Cleaner Liquid 12X750ML","Cost of Goods Sold","Zelia Toilet Cleaner Liq",,"Undeposited Funds",5692.44,"",519961.39
,"Sales Receipt","03-10-2024","3248",,"Elwak Stores","Zelia Toilet Cleaner Liquid 12X750ML","Cost of Goods Sold","Zelia Toilet Cleaner Liq",,"Undeposited Funds",1138.49,"",521099.88
,"Sales Receipt","04-10-2024","3252",,"Cash Sales","Zelia Toilet Cleaner Liquid 12X750ML","Cost of Goods Sold","Zelia Toilet Cleaner Liq",,"Undeposited Funds",94.87,"",521194.75
,"Sales Receipt","05-10-2024","3420",,"Danaba Wholesallers","Zelia Toilet Cleaner Liquid 12X750ML","Cost of Goods Sold","Zelia Toilet Cleaner Liq",,"Undeposited Funds",1951.70,"",523146.45
,"Sales Receipt","06-10-2024","3184",,"Precious Mart","Zelia Toilet Cleaner Liquid 12X750ML","Cost of Goods Sold","Zelia Toilet Cleaner Liq",,"Undeposited Funds",284.62,"",523431.07
,"Sales Receipt","06-10-2024","3422",,"Mikara Shop","Zelia Toilet Cleaner Liquid 12X750ML","Cost of Goods Sold","Zelia Toilet Cleaner Liq",,"Undeposited Funds",189.75,"",523620.82
,"Sales Receipt","06-10-2024","3423",,"Jikweri Minimart","Zelia Toilet Cleaner Liquid 12X750ML","Cost of Goods Sold","Zelia Toilet Cleaner Liq",,"Undeposited Funds",569.24,"",524190.06
,"Sales Receipt","07-10-2024","3254",,"Cash Sales","Zelia Toilet Cleaner Liquid 12X750ML","Cost of Goods Sold","Zelia Toilet Cleaner Liq",,"Undeposited Funds",94.87,"",524284.93
,"Sales Receipt","07-10-2024","3288",,"Adurus Wholesallers","Zelia Toilet Cleaner Liquid 12X750ML","Cost of Goods Sold","Zelia Toilet Cleaner Liq",,"Undeposited Funds",2656.47,"",526941.40
,"Sales Receipt","07-10-2024","3259",,"Himilo General Store","Zelia Toilet Cleaner Liquid 12X750ML","Cost of Goods Sold","Zelia Toilet Cleaner Liq",,"Undeposited Funds",3984.71,"",530926.11
,"Invoice","08-10-2024","MC06237",,"MASABA DISCOUNT STORES LTD","Zelia Toilet Cleaner Liquid 12X750ML","Cost of Goods Sold","Zelia Toilet Cleaner Liq",,"Accounts Receivable",1138.49,"",532064.60
,"Sales Receipt","08-10-2024","3262",,"Cash Sales","Zelia Toilet Cleaner Liquid 4X5L","Cost of Goods Sold","Zelia Toilet Cleaner Liq",,"Undeposited Funds",930.72,"",532995.32
,"Sales Receipt","08-10-2024","3263",,"Cash Sales","Zelia Toilet Cleaner Liquid 4X5L","Cost of Goods Sold","Zelia Toilet Cleaner Liq",,"Undeposited Funds",465.36,"",533460.68
,"Sales Receipt","08-10-2024","3264",,"Cash Sales","Zelia Toilet Cleaner Liquid 12X750ML","Cost of Goods Sold","Zelia Toilet Cleaner Liq",,"Undeposited Funds",94.87,"",533555.55
,"Sales Receipt","08-10-2024","3269",,"Cash Sales","Zelia Toilet Cleaner Liquid 12X750ML","Cost of Goods Sold","Zelia Toilet Cleaner Liq",,"Undeposited Funds",94.87,"",533650.42
,"Sales Receipt","08-10-2024","3272",,"Nyipola Minimart","Zelia Toilet Cleaner Liquid 12X750ML","Cost of Goods Sold","Zelia Toilet Cleaner Liq",,"Undeposited Funds",569.24,"",534219.66
,"Sales Receipt","08-10-2024","3273",,"Safwan Wholesalers","Zelia Toilet Cleaner Liquid 12X750ML","Cost of Goods Sold","Zelia Toilet Cleaner Liq",,"Undeposited Funds",5312.95,"",539532.61
,"Invoice","09-10-2024","MC06246",,"MASABA DISCOUNT STORES LTD","Zelia Toilet Cleaner Liquid 12X750ML","Cost of Goods Sold","Zelia Toilet Cleaner Liq",,"Accounts Receivable",1138.49,"",540671.10
,"Sales Receipt","09-10-2024","3276",,"Cash Sales","-MULTIPLE-","Cost of Goods Sold","Zelia Toilet Cleaner Liq",,"Undeposited Funds",2167.85,"",542838.95
,"Sales Receipt","09-10-2024","3279",,"Cash Sales","Zelia Toilet Cleaner Liquid 4X5L","Cost of Goods Sold","Zelia Toilet Cleaner Liq",,"Undeposited Funds",465.36,"",543304.31
,"Sales Receipt","11-10-2024","3289",,"Cash Sales","Zelia Toilet Cleaner Liquid 4X5L","Cost of Goods Sold","Zelia Toilet Cleaner Liq",,"Undeposited Funds",465.36,"",543769.67
,"Sales Receipt","11-10-2024","3291",,"Cash Sales","Zelia Toilet Cleaner Liquid 12X750ML","Cost of Goods Sold","Zelia Toilet Cleaner Liq",,"Undeposited Funds",189.75,"",543959.42
,"Sales Receipt","11-10-2024","3292",,"Cash Sales","Zelia Toilet Cleaner Liquid 12X750ML","Cost of Goods Sold","Zelia Toilet Cleaner Liq",,"Undeposited Funds",189.75,"",544149.17
,"Sales Receipt","12-10-2024","3294",,"Afrodrip JKIA","Zelia Toilet Cleaner Liquid 4X5L","Cost of Goods Sold","Zelia Toilet Cleaner Liq",,"Undeposited Funds",465.36,"",544614.53
,"Sales Receipt","15-10-2024","3187",,"Big Fish Minimart","Zelia Toilet Cleaner Liquid 12X750ML","Cost of Goods Sold","Zelia Toilet Cleaner Liq",,"Undeposited Funds",284.62,"",544899.15
,"Sales Receipt","15-10-2024","3106",,"Amani Store","Zelia Toilet Cleaner Liquid 12X750ML","Cost of Goods Sold","Zelia Toilet Cleaner Liq",,"Undeposited Funds",1138.49,"",546037.64
,"Sales Receipt","16-10-2024","3110",,"Cash Sales","Zelia Toilet Cleaner Liquid 12X750ML","Cost of Goods Sold","Zelia Toilet Cleaner Liq",,"Undeposited Funds",189.75,"",546227.39
,"Sales Receipt","16-10-2024","3112",,"Ruksan Shop","Zelia Toilet Cleaner Liquid 12X750ML","Cost of Goods Sold","Zelia Toilet Cleaner Liq",,"Undeposited Funds",1138.49,"",547365.88
,"Sales Receipt","18-10-2024","3127",,"Cash Sales","Zelia Toilet Cleaner Liquid 12X750ML","Cost of Goods Sold","Zelia Toilet Cleaner Liq",,"Undeposited Funds",189.75,"",547555.63
,"Sales Receipt","19-10-2024","3180",,"Witgad Shop","Zelia Toilet Cleaner Liquid 12X750ML","Cost of Goods Sold","Zelia Toilet Cleaner Liq",,"Undeposited Funds",569.24,"",548124.87
,"Sales Receipt","22-10-2024","3133",,"tRIPPLE M","Zelia Toilet Cleaner Liquid 12X750ML","Cost of Goods Sold","Zelia Toilet Cleaner Liq",,"Undeposited Funds",379.49,"",548504.36
,"Sales Receipt","22-10-2024","3134",,"Zulu Enterprise","Zelia Toilet Cleaner Liquid 12X750ML","Cost of Goods Sold","Zelia Toilet Cleaner Liq",,"Undeposited Funds",1138.49,"",549642.85
,"Sales Receipt","23-10-2024","3136",,"Cash Sales","Zelia Toilet Cleaner Liquid 12X750ML","Cost of Goods Sold","Zelia Toilet Cleaner Liq",,"Undeposited Funds",189.75,"",549832.60
,"Sales Receipt","23-10-2024","3138",,"Cash Sales","Zelia Toilet Cleaner Liquid 4X5L","Cost of Goods Sold","Zelia Toilet Cleaner Liq",,"Undeposited Funds",456.44,"",550289.04
,"Sales Receipt","23-10-2024","3139",,"Cash Sales","Zelia Toilet Cleaner Liquid 12X750ML","Cost of Goods Sold","Zelia Toilet Cleaner Liq",,"Undeposited Funds",284.62,"",550573.66
,"Sales Receipt","23-10-2024","3142",,"Cash Sales","Zelia Toilet Cleaner Liquid 12X750ML","Cost of Goods Sold","Zelia Toilet Cleaner Liq",,"Undeposited Funds",94.87,"",550668.53
,"Sales Receipt","23-10-2024","3144",,"Cash Sales","Zelia Toilet Cleaner Liquid 12X750ML","Cost of Goods Sold","Zelia Toilet Cleaner Liq",,"Undeposited Funds",94.87,"",550763.40
,"Sales Receipt","23-10-2024","3141",,"Kibibi Wasai Store","Zelia Toilet Cleaner Liquid 12X750ML","Cost of Goods Sold","Zelia Toilet Cleaner Liq",,"Undeposited Funds",4553.95,"",555317.35
,"Sales Receipt","24-10-2024","3148",,"Cash Sales","Zelia Toilet Cleaner Liquid 12X750ML","Cost of Goods Sold","Zelia Toilet Cleaner Liq",,"Undeposited Funds",189.75,"",555507.10
,"Sales Receipt","24-10-2024","3154",,"Horn of Africa","Zelia Toilet Cleaner Liquid 12X750ML","Cost of Goods Sold","Zelia Toilet Cleaner Liq",,"Undeposited Funds",1328.24,"",556835.34
,"Sales Receipt","24-10-2024","3165",,"Mombasa Velvet","Zelia Toilet Cleaner Liquid 4X5L","Cost of Goods Sold","Zelia Toilet Cleaner Liq",,"Undeposited Funds",456.44,"",557291.78
,"Sales Receipt","24-10-2024","3153",,"Golden Store","Zelia Toilet Cleaner Liquid 12X750ML","Cost of Goods Sold","Zelia Toilet Cleaner Liq",,"Undeposited Funds",1328.24,"",558620.02
,"Invoice","25-10-2024","MC06300",,"HAPPY VIEW SUPERMARKET LIMITED","Zelia Toilet Cleaner Liquid 12X750ML  6Pcs @244","Cost of Goods Sold","Zelia Toilet Cleaner Liq",,"Accounts Receivable",569.24,"",559189.26
,"Sales Receipt","25-10-2024","3159",,"Marris Mini mart","Zelia Toilet Cleaner Liquid 12X750ML","Cost of Goods Sold","Zelia Toilet Cleaner Liq",,"Undeposited Funds",948.73,"",560137.99
,"Sales Receipt","26-10-2024","3161",,"Cash Sales","Zelia Toilet Cleaner Liquid 12X750ML","Cost of Goods Sold","Zelia Toilet Cleaner Liq",,"Undeposited Funds",189.75,"",560327.74
,"Invoice","28-10-2024","MC06309",,"MUHINDI MWEUSI SUPERMARKET LIMITED","Zelia Toilet Cleaner Liquid 12X750ML  6Pcs @244","Cost of Goods Sold","Zelia Toilet Cleaner Liq",,"Accounts Receivable",569.24,"",560896.98
,"Invoice","28-10-2024","MC06311",,"MUHINDI MWEUSI SUPERMARKET LIMITED","Zelia Toilet Cleaner Liquid 12X750ML","Cost of Goods Sold","Zelia Toilet Cleaner Liq",,"Accounts Receivable",1138.49,"",562035.47
,"Invoice","28-10-2024","MC06312",,"MUHINDI MWEUSI SUPERMARKET LIMITED","Zelia Toilet Cleaner Liquid 12X750ML","Cost of Goods Sold","Zelia Toilet Cleaner Liq",,"Accounts Receivable",1138.49,"",563173.96
,"Invoice","28-10-2024","MC06313",,"MUHINDI MWEUSI SUPERMARKET LIMITED","Zelia Toilet Cleaner Liquid 12X750ML","Cost of Goods Sold","Zelia Toilet Cleaner Liq",,"Accounts Receivable",1138.49,"",564312.45
,"Sales Receipt","28-10-2024","3173",,"Nasra Super stores","Zelia Toilet Cleaner Liquid 12X750ML","Cost of Goods Sold","Zelia Toilet Cleaner Liq",,"Undeposited Funds",569.24,"",564881.69
,"Sales Receipt","29-10-2024","3167",,"Cash Sales","Zelia Toilet Cleaner Liquid 12X750ML","Cost of Goods Sold","Zelia Toilet Cleaner Liq",,"Undeposited Funds",94.87,"",564976.56
,"Sales Receipt","29-10-2024","3169",,"Cash Sales","Zelia Toilet Cleaner Liquid 4X5L","Cost of Goods Sold","Zelia Toilet Cleaner Liq",,"Undeposited Funds",454.37,"",565430.93
,"Sales Receipt","29-10-2024","3705",,"Elliane Wholesalers","Zelia Toilet Cleaner Liquid 12X750ML","Cost of Goods Sold","Zelia Toilet Cleaner Liq",,"Undeposited Funds",284.62,"",565715.55
,"Sales Receipt","30-10-2024","3171",,"Cash Sales","Zelia Toilet Cleaner Liquid 4X5L","Cost of Goods Sold","Zelia Toilet Cleaner Liq",,"Undeposited Funds",454.37,"",566169.92
,"Sales Receipt","30-10-2024","3725",,"Safa Groceries","Zelia Toilet Cleaner Liquid 12X750ML","Cost of Goods Sold","Zelia Toilet Cleaner Liq",,"Undeposited Funds",1138.49,"",567308.41
,"Sales Receipt","30-10-2024","3727",,"Ellas Store","Zelia Toilet Cleaner Liquid 12X750ML","Cost of Goods Sold","Zelia Toilet Cleaner Liq",,"Undeposited Funds",1138.49,"",568446.90
,"Sales Receipt","04-11-2024","3709",,"Brinso Foodstufs","Zelia Toilet Cleaner Liquid 12X750ML","Cost of Goods Sold","Zelia Toilet Cleaner Liq",,"Undeposited Funds",2656.47,"",571103.37
,"Sales Receipt","05-11-2024","3198",,"Cash Sales","Zelia Toilet Cleaner Liquid 12X750ML","Cost of Goods Sold","Zelia Toilet Cleaner Liq",,"Undeposited Funds",189.75,"",571293.12
,"Sales Receipt","05-11-2024","3714",,"Marris Mini mart","Zelia Toilet Cleaner Liquid 12X750ML","Cost of Goods Sold","Zelia Toilet Cleaner Liq",,"Undeposited Funds",284.62,"",571577.74
,"Invoice","06-11-2024","MC06333",,"MUHINDI MWEUSI SUPERMARKET LIMITED","Zelia Toilet Cleaner Liquid 12X750ML  14Pcs @244","Cost of Goods Sold","Zelia Toilet Cleaner Liq",,"Accounts Receivable",1328.24,"",572905.98
,"Invoice","06-11-2024","MC06334",,"MUHINDI MWEUSI SUPERMARKET LIMITED","Zelia Toilet Cleaner Liquid 12X750ML  12Pcs @244","Cost of Goods Sold","Zelia Toilet Cleaner Liq",,"Accounts Receivable",1138.49,"",574044.47
,"Invoice","06-11-2024","MC06335",,"Guard Mart Supermarket Limited","Zelia Toilet Cleaner Liquid 12X750ML  1pc @250.56","Cost of Goods Sold","Zelia Toilet Cleaner Liq",,"Accounts Receivable",94.87,"",574139.34
,"Invoice","06-11-2024","MC06336",,"Ellas Store","Zelia Toilet Cleaner Liquid 12X750ML  12pc @250.56","Cost of Goods Sold","Zelia Toilet Cleaner Liq",,"Accounts Receivable",1138.49,"",575277.83
,"Sales Receipt","06-11-2024","3199",,"Cash Sales","Zelia Toilet Cleaner Liquid 12X750ML","Cost of Goods Sold","Zelia Toilet Cleaner Liq",,"Undeposited Funds",189.75,"",575467.58
,"Sales Receipt","06-11-2024","3200",,"Cash Sales","Zelia Toilet Cleaner Liquid 12X750ML","Cost of Goods Sold","Zelia Toilet Cleaner Liq",,"Undeposited Funds",94.87,"",575562.45
,"Sales Receipt","06-11-2024","3402",,"Cash Sales","Zelia Toilet Cleaner Liquid 12X750ML","Cost of Goods Sold","Zelia Toilet Cleaner Liq",,"Undeposited Funds",94.87,"",575657.32
,"Sales Receipt","06-11-2024","3403",,"Cash Sales","Zelia Toilet Cleaner Liquid 12X750ML","Cost of Goods Sold","Zelia Toilet Cleaner Liq",,"Undeposited Funds",94.87,"",575752.19
,"Sales Receipt","06-11-2024","3718",,"Towba foodstuffs","Zelia Toilet Cleaner Liquid 12X750ML","Cost of Goods Sold","Zelia Toilet Cleaner Liq",,"Undeposited Funds",2656.47,"",578408.66
,"Sales Receipt","07-11-2024","3416",,"Cash Sales","Zelia Toilet Cleaner Liquid 12X750ML","Cost of Goods Sold","Zelia Toilet Cleaner Liq",,"Undeposited Funds",284.62,"",578693.28
,"Sales Receipt","07-11-2024","3457",,"Dylyn Enterprise","Zelia Toilet Cleaner Liquid 12X750ML","Cost of Goods Sold","Zelia Toilet Cleaner Liq",,"Undeposited Funds",569.24,"",579262.52
,"Sales Receipt","08-11-2024","3409",,"Cash Sales","Zelia Toilet Cleaner Liquid 4X5L","Cost of Goods Sold","Zelia Toilet Cleaner Liq",,"Undeposited Funds",454.37,"",579716.89
,"Sales Receipt","08-11-2024","3414",,"Cash Sales","Zelia Toilet Cleaner Liquid 12X750ML","Cost of Goods Sold","Zelia Toilet Cleaner Liq",,"Undeposited Funds",94.87,"",579811.76
,"Sales Receipt","08-11-2024","3458",,"Mama Sam Shop","Zelia Toilet Cleaner Liquid 12X750ML","Cost of Goods Sold","Zelia Toilet Cleaner Liq",,"Undeposited Funds",569.24,"",580381.00
,"Sales Receipt","11-11-2024","3415",,"Cash Sales","Zelia Toilet Cleaner Liquid 12X750ML","Cost of Goods Sold","Zelia Toilet Cleaner Liq",,"Undeposited Funds",189.75,"",580570.75
,"Sales Receipt","11-11-2024","3420",,"Cash Sales","Zelia Toilet Cleaner Liquid 12X750ML","Cost of Goods Sold","Zelia Toilet Cleaner Liq",,"Undeposited Funds",284.62,"",580855.37
,"Sales Receipt","11-11-2024","3421",,"Cash Sales","Zelia Toilet Cleaner Liquid 12X750ML","Cost of Goods Sold","Zelia Toilet Cleaner Liq",,"Undeposited Funds",94.87,"",580950.24
,"Sales Receipt","11-11-2024","3456",,"RichMind Property","Zelia Toilet Cleaner Liquid 12X750ML","Cost of Goods Sold","Zelia Toilet Cleaner Liq",,"Undeposited Funds",189.75,"",581139.99
,"Sales Receipt","11-11-2024","3424",,"Himilo General Store","Zelia Toilet Cleaner Liquid 12X750ML","Cost of Goods Sold","Zelia Toilet Cleaner Liq",,"Undeposited Funds",5312.95,"",586452.94
,"Sales Receipt","11-11-2024","3427",,"Aidurus shop","Zelia Toilet Cleaner Liquid 12X750ML","Cost of Goods Sold","Zelia Toilet Cleaner Liq",,"Undeposited Funds",2656.47,"",589109.41
,"Sales Receipt","12-11-2024","3431",,"Cash Sales","-MULTIPLE-","Cost of Goods Sold","Zelia Toilet Cleaner Liq",,"Undeposited Funds",7604.81,"",596714.22
,"Sales Receipt","12-11-2024","3437",,"Jombs wholesalers","Zelia Toilet Cleaner Liquid 12X750ML","Cost of Goods Sold","Zelia Toilet Cleaner Liq",,"Undeposited Funds",284.62,"",596998.84
,"Sales Receipt","12-11-2024","3459",,"Dawa min mitt","Zelia Toilet Cleaner Liquid 12X750ML","Cost of Goods Sold","Zelia Toilet Cleaner Liq",,"Undeposited Funds",1138.49,"",598137.33
,"Sales Receipt","12-11-2024","3439",,"Maida Minimart","Zelia Toilet Cleaner Liquid 12X750ML","Cost of Goods Sold","Zelia Toilet Cleaner Liq",,"Undeposited Funds",569.24,"",598706.57
,"Invoice","13-11-2024","MC06356",,"Mumsha Supamat","Zelia Toilet Cleaner Liquid 12X750ML  6Pieces @243","Cost of Goods Sold","Zelia Toilet Cleaner Liq",,"Accounts Receivable",569.24,"",599275.81
,"Invoice","13-11-2024","MC06358",,"BETTER DEAL WHOLESALERS LIMITED","Zelia Toilet Cleaner Liquid 12X750ML","Cost of Goods Sold","Zelia Toilet Cleaner Liq",,"Accounts Receivable",6830.93,"",606106.74
,"Invoice","13-11-2024","MC06359",,"PRICE CHOPPER STORES LIMITED","Zelia Toilet Cleaner Liquid 12X750ML  6Pieces@243","Cost of Goods Sold","Zelia Toilet Cleaner Liq",,"Accounts Receivable",569.24,"",606675.98
,"Sales Receipt","13-11-2024","3440",,"Saacid Shop","Zelia Toilet Cleaner Liquid 12X750ML","Cost of Goods Sold","Zelia Toilet Cleaner Liq",,"Undeposited Funds",1328.24,"",608004.22
,"Sales Receipt","13-11-2024","3493",,"Mwambao Shop","Zelia Toilet Cleaner Liquid 12X750ML","Cost of Goods Sold","Zelia Toilet Cleaner Liq",,"Undeposited Funds",189.75,"",608193.97
,"Sales Receipt","13-11-2024","3460",,"Helly Supermarket","Zelia Toilet Cleaner Liquid 12X750ML","Cost of Goods Sold","Zelia Toilet Cleaner Liq",,"Undeposited Funds",569.24,"",608763.21
,"Sales Receipt","13-11-2024","3444",,"Mango Shop","Zelia Toilet Cleaner Liquid 12X750ML","Cost of Goods Sold","Zelia Toilet Cleaner Liq",,"Undeposited Funds",1328.24,"",610091.45
,"Sales Receipt","13-11-2024","3445",,"Gold mart Supermarket","Zelia Toilet Cleaner Liquid 12X750ML","Cost of Goods Sold","Zelia Toilet Cleaner Liq",,"Undeposited Funds",1328.24,"",611419.69
,"Sales Receipt","14-11-2024","3447",,"Amir Wholesalers","Zelia Toilet Cleaner Liquid 12X750ML","Cost of Goods Sold","Zelia Toilet Cleaner Liq",,"Undeposited Funds",569.24,"",611988.93
,"Invoice","15-11-2024","MC06366",,"MUHINDI MWEUSI SUPERMARKET LIMITED","Zelia Toilet Cleaner Liquid 12X750ML  12Pcs @244","Cost of Goods Sold","Zelia Toilet Cleaner Liq",,"Accounts Receivable",1138.49,"",613127.42
,"Sales Receipt","15-11-2024","3729",,"Cash Sales","Zelia Toilet Cleaner Liquid 12X750ML","Cost of Goods Sold","Zelia Toilet Cleaner Liq",,"Undeposited Funds",94.87,"",613222.29
,"Invoice","18-11-2024","MC06372",,"Guard Mart Supermarket Limited","Zelia Toilet Cleaner Liquid 12X750ML  12pc @250.56","Cost of Goods Sold","Zelia Toilet Cleaner Liq",,"Accounts Receivable",1138.49,"",614360.78
,"Credit Note","18-11-2024","CN01073",,"Guard Mart Supermarket Limited","Zelia Toilet Cleaner Liquid 12X750ML  1pc @250.56","Cost of Goods Sold","Zelia Toilet Cleaner Liq",,"Accounts Receivable","",94.87,614265.91
,"Sales Receipt","18-11-2024","3468",,"Cash Sales","Zelia Toilet Cleaner Liquid 12X750ML","Cost of Goods Sold","Zelia Toilet Cleaner Liq",,"Undeposited Funds",474.37,"",614740.28
,"Sales Receipt","18-11-2024","3473",,"Cash Sales","Zelia Toilet Cleaner Liquid 12X750ML","Cost of Goods Sold","Zelia Toilet Cleaner Liq",,"Undeposited Funds",94.87,"",614835.15
,"Sales Receipt","18-11-2024","3495",,"Murume Shop","Zelia Toilet Cleaner Liquid 12X750ML","Cost of Goods Sold","Zelia Toilet Cleaner Liq",,"Undeposited Funds",284.62,"",615119.77
,"Sales Receipt","18-11-2024","3463",,"Gifted Shop","Zelia Toilet Cleaner Liquid 12X750ML","Cost of Goods Sold","Zelia Toilet Cleaner Liq",,"Undeposited Funds",569.24,"",615689.01
,"Sales Receipt","18-11-2024","3464",,"Restoration Traders","Zelia Toilet Cleaner Liquid 12X750ML","Cost of Goods Sold","Zelia Toilet Cleaner Liq",,"Undeposited Funds",2656.47,"",618345.48
,"Sales Receipt","18-11-2024","3465",,"Gure Yare Shop","Zelia Toilet Cleaner Liquid 12X750ML","Cost of Goods Sold","Zelia Toilet Cleaner Liq",,"Undeposited Funds",2656.47,"",621001.95
,"Sales Receipt","18-11-2024","3466",,"Faisel Wholesale","Zelia Toilet Cleaner Liquid 12X750ML","Cost of Goods Sold","Zelia Toilet Cleaner Liq",,"Undeposited Funds",1138.49,"",622140.44
,"Sales Receipt","18-11-2024","3467",,"Mombasa Velvet","Zelia Toilet Cleaner Liquid 4X5L","Cost of Goods Sold","Zelia Toilet Cleaner Liq",,"Undeposited Funds",908.75,"",623049.19
,"Invoice","19-11-2024","MC06376",,"MUHINDI MWEUSI SUPERMARKET LIMITED","Zelia Toilet Cleaner Liquid 12X750ML  12Pcs @244","Cost of Goods Sold","Zelia Toilet Cleaner Liq",,"Accounts Receivable",1138.49,"",624187.68
,"Invoice","19-11-2024","MC06379",,"DALLAS SHOPRITE LTD","Zelia Toilet Cleaner Liquid 12X750ML  6Pcs@243","Cost of Goods Sold","Zelia Toilet Cleaner Liq",,"Accounts Receivable",569.24,"",624756.92
,"Sales Receipt","19-11-2024","3475",,"Cash Sales","Zelia Toilet Cleaner Liquid 12X750ML","Cost of Goods Sold","Zelia Toilet Cleaner Liq",,"Undeposited Funds",94.87,"",624851.79
,"Sales Receipt","19-11-2024","3301",,"Cash Sales","Zelia Toilet Cleaner Liquid 12X750ML","Cost of Goods Sold","Zelia Toilet Cleaner Liq",,"Undeposited Funds",189.75,"",625041.54
,"Sales Receipt","19-11-2024","3471",,"Kedulle Enterprises","Zelia Toilet Cleaner Liquid 12X750ML","Cost of Goods Sold","Zelia Toilet Cleaner Liq",,"Undeposited Funds",2656.47,"",627698.01
,"Sales Receipt","20-11-2024","3477",,"Cash Sales","Zelia Toilet Cleaner Liquid 12X750ML","Cost of Goods Sold","Zelia Toilet Cleaner Liq",,"Undeposited Funds",189.74,"",627887.75
,"Sales Receipt","20-11-2024","3497",,"032 minimart","Zelia Toilet Cleaner Liquid 12X750ML","Cost of Goods Sold","Zelia Toilet Cleaner Liq",,"Undeposited Funds",664.11,"",628551.86
,"Sales Receipt","21-11-2024","3496",,"infinity Store","Zelia Toilet Cleaner Liquid 4X5L","Cost of Goods Sold","Zelia Toilet Cleaner Liq",,"Undeposited Funds",908.75,"",629460.61
,"Sales Receipt","22-11-2024","3499",,"Cash Sales","-MULTIPLE-","Cost of Goods Sold","Zelia Toilet Cleaner Liq",,"Undeposited Funds",1098.50,"",630559.11
,"Sales Receipt","22-11-2024","3734",,"Cash Sales","Zelia Toilet Cleaner Liquid 12X750ML","Cost of Goods Sold","Zelia Toilet Cleaner Liq",,"Undeposited Funds",94.87,"",630653.98
,"Invoice","26-11-2024","MC06416",,"MUHINDI MWEUSI SUPERMARKET LIMITED","Zelia Toilet Cleaner Liquid 12X750ML  12Pcs @244","Cost of Goods Sold","Zelia Toilet Cleaner Liq",,"Accounts Receivable",1138.49,"",631792.47
,"Sales Receipt","26-11-2024","3740",,"Afrodrip JKIA","Zelia Toilet Cleaner Liquid 4X5L","Cost of Goods Sold","Zelia Toilet Cleaner Liq",,"Undeposited Funds",908.75,"",632701.22
,"Sales Receipt","27-11-2024","3743",,"Mama Amina","Zelia Toilet Cleaner Liquid 12X750ML","Cost of Goods Sold","Zelia Toilet Cleaner Liq",,"Undeposited Funds",1289.53,"",633990.75
,"Sales Receipt","27-11-2024","3744",,"ABM Grocery Shop","Zelia Toilet Cleaner Liquid 12X750ML","Cost of Goods Sold","Zelia Toilet Cleaner Liq",,"Undeposited Funds",1105.30,"",635096.05
,"Sales Receipt","27-11-2024","3764",,"Molly Shop","Zelia Toilet Cleaner Liquid 12X750ML","Cost of Goods Sold","Zelia Toilet Cleaner Liq",,"Undeposited Funds",552.65,"",635648.70
,"Sales Receipt","28-11-2024","3751",,"Cash Sales","Zelia Toilet Cleaner Liquid 4X5L","Cost of Goods Sold","Zelia Toilet Cleaner Liq",,"Undeposited Funds",454.37,"",636103.07
,"Sales Receipt","28-11-2024","3753",,"Cash Sales","Zelia Toilet Cleaner Liquid 12X750ML","Cost of Goods Sold","Zelia Toilet Cleaner Liq",,"Undeposited Funds",92.11,"",636195.18
,"Sales Receipt","29-11-2024","3789",,"Ubwete Shop","Zelia Toilet Cleaner Liquid 12X750ML","Cost of Goods Sold","Zelia Toilet Cleaner Liq",,"Undeposited Funds",1101.10,"",637296.28
,"Sales Receipt","02-12-2024","3761",,"Cash Sales","Zelia Toilet Cleaner Liquid 4X5L","Cost of Goods Sold","Zelia Toilet Cleaner Liq",,"Undeposited Funds",454.37,"",637750.65
,"Sales Receipt","02-12-2024","3767",,"Cash Sales","Zelia Toilet Cleaner Liquid 12X750ML","Cost of Goods Sold","Zelia Toilet Cleaner Liq",,"Undeposited Funds",91.75,"",637842.40
,"Sales Receipt","02-12-2024","3777",,"Cash Sales","Zelia Toilet Cleaner Liquid 12X750ML","Cost of Goods Sold","Zelia Toilet Cleaner Liq",,"Undeposited Funds",91.75,"",637934.15
,"Sales Receipt","02-12-2024","3773",,"Horn of Africa","Zelia Toilet Cleaner Liquid 12X750ML","Cost of Goods Sold","Zelia Toilet Cleaner Liq",,"Undeposited Funds",1284.62,"",639218.77
,"Sales Receipt","02-12-2024","3776",,"Elwak Stores","Zelia Toilet Cleaner Liquid 12X750ML","Cost of Goods Sold","Zelia Toilet Cleaner Liq",,"Undeposited Funds",1101.10,"",640319.87
,"Sales Receipt","03-12-2024","3782",,"Summer Outlets","Zelia Toilet Cleaner Liquid 12X750ML","Cost of Goods Sold","Zelia Toilet Cleaner Liq",,"Undeposited Funds",1101.10,"",641420.97
,"Invoice","04-12-2024","MC06436",,"LUCKY MART SUPERMARKET LIMITED","Zelia Toilet Cleaner Liquid 12X750ML  12Pcs@243","Cost of Goods Sold","Zelia Toilet Cleaner Liq",,"Accounts Receivable",1101.10,"",642522.07
,"Sales Receipt","04-12-2024","3784",,"Gure Yare Shop","Zelia Toilet Cleaner Liquid 12X750ML","Cost of Goods Sold","Zelia Toilet Cleaner Liq",,"Undeposited Funds",5138.45,"",647660.52
,"Sales Receipt","04-12-2024","3785",,"Towba Parkroad","Zelia Toilet Cleaner Liquid 12X750ML","Cost of Goods Sold","Zelia Toilet Cleaner Liq",,"Undeposited Funds",2569.22,"",650229.74
,"Invoice","05-12-2024","MC06447",,"NASRI MART LIMITED","Zelia Toilet Cleaner Liquid 12X750ML  12Pcs@244","Cost of Goods Sold","Zelia Toilet Cleaner Liq",,"Accounts Receivable",1101.10,"",651330.84
,"Sales Receipt","05-12-2024","3309",,"Freshfinds Mart","Zelia Toilet Cleaner Liquid 12X750ML","Cost of Goods Sold","Zelia Toilet Cleaner Liq",,"Undeposited Funds",550.55,"",651881.39
,"Sales Receipt","05-12-2024","3796",,"Towba Eastleigh","Zelia Toilet Cleaner Liquid 12X750ML","Cost of Goods Sold","Zelia Toilet Cleaner Liq",,"Undeposited Funds",2569.22,"",654450.61
,"Sales Receipt","05-12-2024","3797",,"Britco Wholesalers","Zelia Toilet Cleaner Liquid 12X750ML","Cost of Goods Sold","Zelia Toilet Cleaner Liq",,"Undeposited Funds",6423.05,"",660873.66
,"Sales Receipt","05-12-2024","3798",,"Mama G shop","Zelia Toilet Cleaner Liquid 12X750ML","Cost of Goods Sold","Zelia Toilet Cleaner Liq",,"Undeposited Funds",2202.19,"",663075.85
,"Sales Receipt","05-12-2024","3306",,"Corner Shop","Zelia Toilet Cleaner Liquid 12X750ML","Cost of Goods Sold","Zelia Toilet Cleaner Liq",,"Undeposited Funds",1284.62,"",664360.47
,"Sales Receipt","05-12-2024","3327",,"Macbellah Shop","Zelia Toilet Cleaner Liquid 12X750ML","Cost of Goods Sold","Zelia Toilet Cleaner Liq",,"Undeposited Funds",550.55,"",664911.02
,"Sales Receipt","10-12-2024","3321",,"Cash Sales","Zelia Toilet Cleaner Liquid 12X750ML","Cost of Goods Sold","Zelia Toilet Cleaner Liq",,"Undeposited Funds",550.55,"",665461.57
,"Sales Receipt","10-12-2024","3347",,"Beta Traders","Zelia Toilet Cleaner Liquid 12X750ML","Cost of Goods Sold","Zelia Toilet Cleaner Liq",,"Undeposited Funds",1284.62,"",666746.19
,"Sales Receipt","10-12-2024","3332",,"Amir Wholesalers","Zelia Toilet Cleaner Liquid 12X750ML","Cost of Goods Sold","Zelia Toilet Cleaner Liq",,"Undeposited Funds",550.55,"",667296.74
,"Sales Receipt","14-12-2024","3378",,"Egesa Shop","Zelia Toilet Cleaner Liquid 12X750ML","Cost of Goods Sold","Zelia Toilet Cleaner Liq",,"Undeposited Funds",367.03,"",667663.77
,"Sales Receipt","16-12-2024","3342",,"Cash Sales","Zelia Toilet Cleaner Liquid 12X750ML","Cost of Goods Sold","Zelia Toilet Cleaner Liq",,"Undeposited Funds",91.75,"",667755.52
,"Sales Receipt","16-12-2024","3345",,"Cash Sales","Zelia Toilet Cleaner Liquid 12X750ML","Cost of Goods Sold","Zelia Toilet Cleaner Liq",,"Undeposited Funds",183.52,"",667939.04
,"Sales Receipt","16-12-2024","3346",,"Cash Sales","Zelia Toilet Cleaner Liquid 4X5L","Cost of Goods Sold","Zelia Toilet Cleaner Liq",,"Undeposited Funds",908.75,"",668847.79
,"Sales Receipt","16-12-2024","3348",,"Cash Sales","Zelia Toilet Cleaner Liquid 4X5L","Cost of Goods Sold","Zelia Toilet Cleaner Liq",,"Undeposited Funds",454.37,"",669302.16
,"Invoice","17-12-2024","MC06475",,"MUHINDI MWEUSI SUPERMARKET LIMITED","Zelia Toilet Cleaner Liquid 12X750ML  14Pcs @244","Cost of Goods Sold","Zelia Toilet Cleaner Liq",,"Accounts Receivable",1284.62,"",670586.78
,"Sales Receipt","17-12-2024","3354",,"Cash Sales","Zelia Toilet Cleaner Liquid 12X750ML","Cost of Goods Sold","Zelia Toilet Cleaner Liq",,"Undeposited Funds",183.11,"",670769.89
,"Sales Receipt","17-12-2024","3357",,"Safwan Wholesalers","Zelia Toilet Cleaner Liquid 12X750ML","Cost of Goods Sold","Zelia Toilet Cleaner Liq",,"Undeposited Funds",6591.91,"",677361.80
,"Sales Receipt","18-12-2024","3363",,"Cash Sales","Zelia Toilet Cleaner Liquid 12X750ML","Cost of Goods Sold","Zelia Toilet Cleaner Liq",,"Undeposited Funds",91.40,"",677453.20
,"Sales Receipt","18-12-2024","3365",,"Mango Shop","Zelia Toilet Cleaner Liquid 12X750ML","Cost of Goods Sold","Zelia Toilet Cleaner Liq",,"Undeposited Funds",1279.62,"",678732.82
,"Sales Receipt","18-12-2024","3368",,"Warfa Wholesale","Zelia Toilet Cleaner Liquid 12X750ML","Cost of Goods Sold","Zelia Toilet Cleaner Liq",,"Undeposited Funds",6580.88,"",685313.70
"Total Zelia Toilet Cleaner Liq",,,,,,,,,,,713726.38,28412.68,685313.70
"Zelia Multipurpose Liquid Soap",,,,,,,,,,,,,""
,"Sales Receipt","03-01-2024","1592",,"Cash Sales","Zelia Green Multipurpose Liquid Detergent 500ML","Cost of Goods Sold","Zelia Multipurpose Liquid Soap",,"Undeposited Funds",31.58,"",31.58
,"Sales Receipt","03-01-2024","1593",,"Cash Sales","Zelia Green Multipurpose Liquid Detergent 5L","Cost of Goods Sold","Zelia Multipurpose Liquid Soap",,"Undeposited Funds",426.61,"",458.19
,"Sales Receipt","03-01-2024","1596",,"Cash Sales","-MULTIPLE-","Cost of Goods Sold","Zelia Multipurpose Liquid Soap",,"Undeposited Funds",1002.92,"",1461.11
,"Sales Receipt","03-01-2024","1597",,"Cash Sales","Zelia Green Multipurpose Liquid Detergent 5L","Cost of Goods Sold","Zelia Multipurpose Liquid Soap",,"Undeposited Funds",213.30,"",1674.41
,"Invoice","04-01-2024","MC05269",,"OFFSHORE GLOBAL LOGISTICS LIMITED","Zelia Green Multipurpose Liquid Detergent 20L","Cost of Goods Sold","Zelia Multipurpose Liquid Soap",,"Accounts Receivable",729.06,"",2403.47
,"Sales Receipt","04-01-2024","1704",,"Cash Sales","Zelia Green Multipurpose Liquid Detergent 500ML","Cost of Goods Sold","Zelia Multipurpose Liquid Soap",,"Undeposited Funds",31.58,"",2435.05
,"Sales Receipt","04-01-2024","1707",,"Mama Amina","Zelia Green Multipurpose Liquid Detergent 500ML","Cost of Goods Sold","Zelia Multipurpose Liquid Soap",,"Undeposited Funds",189.48,"",2624.53
,"Sales Receipt","04-01-2024","1709",,"Cash Sales","Zelia Green Multipurpose Liquid Detergent 5L","Cost of Goods Sold","Zelia Multipurpose Liquid Soap",,"Undeposited Funds",213.30,"",2837.83
,"Invoice","05-01-2024","MC05272",,"Mumsha Supamat","-MULTIPLE-","Cost of Goods Sold","Zelia Multipurpose Liquid Soap",,"Accounts Receivable",548.21,"",3386.04
,"Sales Receipt","05-01-2024","1711",,"Summer Outlets","Zelia Green Multipurpose Liquid Detergent 500ML","Cost of Goods Sold","Zelia Multipurpose Liquid Soap",,"Undeposited Funds",189.48,"",3575.52
,"Sales Receipt","05-01-2024","AT187",,"Cash Sales","Zelia Green Multipurpose Liquid Detergent 5L","Cost of Goods Sold","Zelia Multipurpose Liquid Soap",,"Undeposited Funds",4052.78,"",7628.30
,"Sales Receipt","07-01-2024","1714",,"Cash Sales","Zelia Green Multipurpose Liquid Detergent 5L","Cost of Goods Sold","Zelia Multipurpose Liquid Soap",,"Undeposited Funds",213.30,"",7841.60
,"Sales Receipt","08-01-2024","1719",,"Kwiksave supermarket","-MULTIPLE-","Cost of Goods Sold","Zelia Multipurpose Liquid Soap",,"Undeposited Funds",737.70,"",8579.30
,"Sales Receipt","09-01-2024","1716",,"Pambazuka Mart (K) Limited","Zelia Green Multipurpose Liquid Detergent Lite 20L","Cost of Goods Sold","Zelia Multipurpose Liquid Soap",,"Undeposited Funds",576.31,"",9155.61
,"Sales Receipt","09-01-2024","1720",,"Kwiksave supermarket","Zelia Green Multipurpose Liquid Detergent 500ML","Cost of Goods Sold","Zelia Multipurpose Liquid Soap",,"Undeposited Funds",378.97,"",9534.58
,"Sales Receipt","10-01-2024","1718",,"Memos Supermarket","Zelia Green Multipurpose Liquid Detergent 500ML","Cost of Goods Sold","Zelia Multipurpose Liquid Soap",,"Undeposited Funds",378.97,"",9913.55
,"Sales Receipt","10-01-2024","1722",,"Cash Sales","Zelia Green Multipurpose Liquid Detergent 20L","Cost of Goods Sold","Zelia Multipurpose Liquid Soap",,"Undeposited Funds",729.06,"",10642.61
,"Sales Receipt","11-01-2024","1723",,"Cash Sales","Zelia Green Multipurpose Liquid Detergent 5L","Cost of Goods Sold","Zelia Multipurpose Liquid Soap",,"Undeposited Funds",213.30,"",10855.91
,"Sales Receipt","11-01-2024","1724",,"Mashallah Foodstuffs","Zelia Green Multipurpose Liquid Detergent 500ML","Cost of Goods Sold","Zelia Multipurpose Liquid Soap",,"Undeposited Funds",757.93,"",11613.84
,"Invoice","12-01-2024","MC05299",,"MUHINDI MWEUSI SUPERMARKET LIMITED","Zelia Green Multipurpose Liquid Detergent 500ML","Cost of Goods Sold","Zelia Multipurpose Liquid Soap",,"Accounts Receivable",378.97,"",11992.81
,"Invoice","12-01-2024","MC05302",,"MUHINDI MWEUSI SUPERMARKET LIMITED","Zelia Green Multipurpose Liquid Detergent 500ML","Cost of Goods Sold","Zelia Multipurpose Liquid Soap",,"Accounts Receivable",189.48,"",12182.29
,"Invoice","12-01-2024","MC05306",,"Azaavi Collections Limited","Zelia 5L Green Multipurpose Liquid Detergent","Cost of Goods Sold","Zelia Multipurpose Liquid Soap",,"Accounts Receivable",213.30,"",12395.59
,"Invoice","15-01-2024","MC05307",,"THE REAL IPM COMPANY (KENYA)LIMITED","Zelia Green Multipurpose Liquid Detergent 20L","Cost of Goods Sold","Zelia Multipurpose Liquid Soap",,"Accounts Receivable",3645.32,"",16040.91
,"Invoice","15-01-2024","MC05308",,"MUHINDI MWEUSI SUPERMARKET LIMITED","Zelia Green Multipurpose Liquid Detergent 500ML","Cost of Goods Sold","Zelia Multipurpose Liquid Soap",,"Accounts Receivable",378.97,"",16419.88
,"Invoice","15-01-2024","MC05309",,"MUHINDI MWEUSI SUPERMARKET LIMITED","Zelia Green Multipurpose Liquid Detergent 500ML","Cost of Goods Sold","Zelia Multipurpose Liquid Soap",,"Accounts Receivable",378.97,"",16798.85
,"Invoice","15-01-2024","MC05315",,"MUHINDI MWEUSI SUPERMARKET LIMITED","-MULTIPLE-","Cost of Goods Sold","Zelia Multipurpose Liquid Soap",,"Accounts Receivable",1096.43,"",17895.28
,"Sales Receipt","15-01-2024","1728",,"Cash Sales","Zelia Green Multipurpose Liquid Detergent 5L","Cost of Goods Sold","Zelia Multipurpose Liquid Soap",,"Undeposited Funds",213.30,"",18108.58
,"Sales Receipt","15-01-2024","1729",,"Cash Sales","Zelia Green Multipurpose Liquid Detergent 1L","Cost of Goods Sold","Zelia Multipurpose Liquid Soap",,"Undeposited Funds",59.79,"",18168.37
,"Sales Receipt","15-01-2024","1731",,"RAZAQ AIRWAYS","-MULTIPLE-","Cost of Goods Sold","Zelia Multipurpose Liquid Soap",,"Undeposited Funds",1096.43,"",19264.80
,"Sales Receipt","16-01-2024","1753",,"Cash Sales","Zelia Green Multipurpose Liquid Detergent 5L","Cost of Goods Sold","Zelia Multipurpose Liquid Soap",,"Undeposited Funds",213.30,"",19478.10
,"Sales Receipt","17-01-2024","1734",,"Cash Sales","Zelia Green Multipurpose Liquid Detergent 5L","Cost of Goods Sold","Zelia Multipurpose Liquid Soap",,"Undeposited Funds",639.91,"",20118.01
,"Sales Receipt","18-01-2024","1741",,"Newclear Minimart Fedha","Zelia Green Multipurpose Liquid Detergent 500ML","Cost of Goods Sold","Zelia Multipurpose Liquid Soap",,"Undeposited Funds",189.48,"",20307.49
,"Sales Receipt","19-01-2024","1744",,"Cash Sales","-MULTIPLE-","Cost of Goods Sold","Zelia Multipurpose Liquid Soap",,"Undeposited Funds",8771.38,"",29078.87
,"Sales Receipt","19-01-2024","1746",,"Cash Sales","Zelia Green Multipurpose Liquid Detergent 500ML","Cost of Goods Sold","Zelia Multipurpose Liquid Soap",,"Undeposited Funds",31.58,"",29110.45
,"Sales Receipt","21-01-2024","AT186",,"Cash Sales","Zelia Green Multipurpose Liquid Detergent 5L","Cost of Goods Sold","Zelia Multipurpose Liquid Soap",,"Undeposited Funds",1279.83,"",30390.28
,"Invoice","23-01-2024","MC05342",,"Khetshi Dharamshi And Company Limited","Zelia Green Multipurpose Liquid Detergent Lite 20L","Cost of Goods Sold","Zelia Multipurpose Liquid Soap",,"Accounts Receivable",3457.86,"",33848.14
,"Invoice","23-01-2024","MC05343",,"MUHINDI MWEUSI SUPERMARKET LIMITED","-MULTIPLE-","Cost of Goods Sold","Zelia Multipurpose Liquid Soap",,"Accounts Receivable",1096.43,"",34944.57
,"Invoice","23-01-2024","MC05344",,"OFFSHORE GLOBAL LOGISTICS LIMITED","Zelia Green Multipurpose Liquid Detergent 20L","Cost of Goods Sold","Zelia Multipurpose Liquid Soap",,"Accounts Receivable",729.06,"",35673.63
,"Sales Receipt","23-01-2024","1749",,"Cash Sales","Zelia Green Multipurpose Liquid Detergent Lite 20L","Cost of Goods Sold","Zelia Multipurpose Liquid Soap",,"Undeposited Funds",576.31,"",36249.94
,"Invoice","24-01-2024","MC05345",,"THE REAL IPM COMPANY (KENYA)LIMITED","Zelia Green Multipurpose Liquid Detergent 20L","Cost of Goods Sold","Zelia Multipurpose Liquid Soap",,"Accounts Receivable",3645.32,"",39895.26
,"Invoice","24-01-2024","MC05348",,"MUHINDI MWEUSI SUPERMARKET LIMITED","Zelia Green Multipurpose Liquid Detergent 500ML","Cost of Goods Sold","Zelia Multipurpose Liquid Soap",,"Accounts Receivable",378.97,"",40274.23
,"Sales Receipt","24-01-2024","1755",,"Alma Mart","-MULTIPLE-","Cost of Goods Sold","Zelia Multipurpose Liquid Soap",,"Undeposited Funds",805.58,"",41079.81
,"Sales Receipt","24-01-2024","1756",,"Cash Sales","Zelia Green Multipurpose Liquid Detergent 5L","Cost of Goods Sold","Zelia Multipurpose Liquid Soap",,"Undeposited Funds",213.30,"",41293.11
,"Sales Receipt","25-01-2024","1758",,"Cash Sales","Zelia Green Multipurpose Liquid Detergent 5L","Cost of Goods Sold","Zelia Multipurpose Liquid Soap",,"Undeposited Funds",215.42,"",41508.53
,"Sales Receipt","29-01-2024","1759",,"Cash Sales","Zelia Green Multipurpose Liquid Detergent 500ML","Cost of Goods Sold","Zelia Multipurpose Liquid Soap",,"Undeposited Funds",191.56,"",41700.09
,"Sales Receipt","29-01-2024","1763",,"Cash Sales","Zelia Green Multipurpose Liquid Detergent 1L","Cost of Goods Sold","Zelia Multipurpose Liquid Soap",,"Undeposited Funds",59.79,"",41759.88
,"Sales Receipt","29-01-2024","1769",,"Cash Sales","-MULTIPLE-","Cost of Goods Sold","Zelia Multipurpose Liquid Soap",,"Undeposited Funds",91.72,"",41851.60
,"Sales Receipt","30-01-2024","1766",,"Cash Sales","Zelia Green Multipurpose Liquid Detergent 5L","Cost of Goods Sold","Zelia Multipurpose Liquid Soap",,"Undeposited Funds",430.84,"",42282.44
,"Sales Receipt","30-01-2024","1768",,"Cash Sales","Zelia Green Multipurpose Liquid Detergent 5L","Cost of Goods Sold","Zelia Multipurpose Liquid Soap",,"Undeposited Funds",215.42,"",42497.86
,"Sales Receipt","30-01-2024","1770",,"Pambazuka Mart (K) Limited","Zelia Green Multipurpose Liquid Detergent Lite 20L","Cost of Goods Sold","Zelia Multipurpose Liquid Soap",,"Undeposited Funds",576.31,"",43074.17
,"Sales Receipt","30-01-2024","1771",,"Arqam Savanna","-MULTIPLE-","Cost of Goods Sold","Zelia Multipurpose Liquid Soap",,"Undeposited Funds",1579.15,"",44653.32
,"Sales Receipt","30-01-2024","1772",,"Amina Shop","Zelia Green Multipurpose Liquid Detergent 500ML","Cost of Goods Sold","Zelia Multipurpose Liquid Soap",,"Undeposited Funds",383.13,"",45036.45
,"Sales Receipt","31-01-2024","1773",,"Cash Sales","Zelia Green Multipurpose Liquid Detergent 500ML","Cost of Goods Sold","Zelia Multipurpose Liquid Soap",,"Undeposited Funds",63.85,"",45100.30
,"Sales Receipt","01-02-2024","1775",,"Faisel Wholesale","-MULTIPLE-","Cost of Goods Sold","Zelia Multipurpose Liquid Soap",,"Undeposited Funds",1627.94,"",46728.24
,"Sales Receipt","01-02-2024","1776",,"FARMERS BEST GROCERY","Zelia Green Multipurpose Liquid Detergent 1L","Cost of Goods Sold","Zelia Multipurpose Liquid Soap",,"Undeposited Funds",717.46,"",47445.70
,"Sales Receipt","01-02-2024","1777",,"Cash Sales","Zelia Green Multipurpose Liquid Detergent 5L","Cost of Goods Sold","Zelia Multipurpose Liquid Soap",,"Undeposited Funds",215.42,"",47661.12
,"Sales Receipt","01-02-2024","1780",,"Cash Sales","Zelia Green Multipurpose Liquid Detergent 1L","Cost of Goods Sold","Zelia Multipurpose Liquid Soap",,"Undeposited Funds",59.79,"",47720.91
,"Invoice","02-02-2024","MC05378",,"MZOORI STORE LIMITED","Zelia Green Multipurpose Liquid Detergent 500ML","Cost of Goods Sold","Zelia Multipurpose Liquid Soap",,"Accounts Receivable",191.56,"",47912.47
,"Invoice","02-02-2024","MC05379",,"HOPEMART SELF SERVICES LTD","-MULTIPLE-","Cost of Goods Sold","Zelia Multipurpose Liquid Soap",,"Accounts Receivable",2273.66,"",50186.13
,"Build Assembly","02-02-2024","9572",,,,"Cost of Goods Sold","Zelia Multipurpose Liquid Soap","X","-SPLIT-",9.13,"",50195.26
,"Sales Receipt","02-02-2024","1783",,"Cheche Minimart","-MULTIPLE-","Cost of Goods Sold","Zelia Multipurpose Liquid Soap",,"Undeposited Funds",275.14,"",50470.40
,"Sales Receipt","02-02-2024","1785",,"Cash Sales","Zelia Green Multipurpose Liquid Detergent 5L","Cost of Goods Sold","Zelia Multipurpose Liquid Soap",,"Undeposited Funds",215.42,"",50685.82
,"Sales Receipt","02-02-2024","1786",,"Cash Sales","Zelia Green Multipurpose Liquid Detergent 5L","Cost of Goods Sold","Zelia Multipurpose Liquid Soap",,"Undeposited Funds",215.42,"",50901.24
,"Invoice","05-02-2024","MC05385",,"TAWALA SUPERMARKET LIMITED","-MULTIPLE-","Cost of Goods Sold","Zelia Multipurpose Liquid Soap",,"Accounts Receivable",1100.59,"",52001.83
,"Sales Receipt","05-02-2024","1787",,"Cash Sales","Zelia Green Multipurpose Liquid Detergent 500ML","Cost of Goods Sold","Zelia Multipurpose Liquid Soap",,"Undeposited Funds",31.93,"",52033.76
,"Sales Receipt","05-02-2024","1788",,"Cash Sales","Zelia Green Multipurpose Liquid Detergent 5L","Cost of Goods Sold","Zelia Multipurpose Liquid Soap",,"Undeposited Funds",215.42,"",52249.18
,"Sales Receipt","05-02-2024","1790",,"Cash Sales","Zelia Green Multipurpose Liquid Detergent 5L","Cost of Goods Sold","Zelia Multipurpose Liquid Soap",,"Undeposited Funds",8616.86,"",60866.04
,"Sales Receipt","05-02-2024","1791",,"The Hub Minimart","-MULTIPLE-","Cost of Goods Sold","Zelia Multipurpose Liquid Soap",,"Undeposited Funds",562.49,"",61428.53
,"Sales Receipt","06-02-2024","1797",,"Libin Minimart","Zelia Green Multipurpose Liquid Detergent 1L","Cost of Goods Sold","Zelia Multipurpose Liquid Soap",,"Undeposited Funds",1434.91,"",62863.44
,"Sales Receipt","06-02-2024","1800",,"Mama Amina","Zelia Green Multipurpose Liquid Detergent 500ML","Cost of Goods Sold","Zelia Multipurpose Liquid Soap",,"Undeposited Funds",191.56,"",63055.00
,"Sales Receipt","06-02-2024","1808",,"Cash Sales","Zelia Green Multipurpose Liquid Detergent 1L","Cost of Goods Sold","Zelia Multipurpose Liquid Soap",,"Undeposited Funds",59.79,"",63114.79
,"Sales Receipt","07-02-2024","1811",,"Cash Sales","Zelia Green Multipurpose Liquid Detergent 500ML","Cost of Goods Sold","Zelia Multipurpose Liquid Soap",,"Undeposited Funds",31.93,"",63146.72
,"Sales Receipt","08-02-2024","1814",,"Cash Sales","Zelia Green Multipurpose Liquid Detergent 500ML","Cost of Goods Sold","Zelia Multipurpose Liquid Soap",,"Undeposited Funds",31.93,"",63178.65
,"Sales Receipt","08-02-2024","1815",,"Cash Sales","Zelia Green Multipurpose Liquid Detergent 500ML","Cost of Goods Sold","Zelia Multipurpose Liquid Soap",,"Undeposited Funds",31.93,"",63210.58
,"Sales Receipt","08-02-2024","1816",,"Cash Sales","Zelia Green Multipurpose Liquid Detergent 1L","Cost of Goods Sold","Zelia Multipurpose Liquid Soap",,"Undeposited Funds",239.15,"",63449.73
,"Invoice","09-02-2024","MC05394",,"THE REAL IPM COMPANY (KENYA)LIMITED","Zelia Green Multipurpose Liquid Detergent 20L","Cost of Goods Sold","Zelia Multipurpose Liquid Soap",,"Accounts Receivable",3690.95,"",67140.68
,"Sales Receipt","09-02-2024","1819",,"Cash Sales","Zelia Green Multipurpose Liquid Detergent 5L","Cost of Goods Sold","Zelia Multipurpose Liquid Soap",,"Undeposited Funds",216.15,"",67356.83
,"Sales Receipt","10-02-2024","1821",,"Alma Mart","Zelia Green Multipurpose Liquid Detergent 500ML","Cost of Goods Sold","Zelia Multipurpose Liquid Soap",,"Undeposited Funds",191.56,"",67548.39
,"Invoice","12-02-2024","MC05396",,"OFFSHORE GLOBAL LOGISTICS LIMITED","-MULTIPLE-","Cost of Goods Sold","Zelia Multipurpose Liquid Soap",,"Accounts Receivable",954.34,"",68502.73
,"Sales Receipt","12-02-2024","1822",,"Deeps General Shop","Zelia Green Multipurpose Liquid Detergent 500ML","Cost of Goods Sold","Zelia Multipurpose Liquid Soap",,"Undeposited Funds",63.85,"",68566.58
,"Sales Receipt","12-02-2024","1823",,"INTEGRAL MEDIA LIMITED","Zelia Green Multipurpose Liquid Detergent 500ML","Cost of Goods Sold","Zelia Multipurpose Liquid Soap",,"Undeposited Funds",766.25,"",69332.83
,"Sales Receipt","12-02-2024","1829",,"Blue Wholesale","-MULTIPLE-","Cost of Goods Sold","Zelia Multipurpose Liquid Soap",,"Undeposited Funds",982.60,"",70315.43
,"Sales Receipt","13-02-2024","1832",,"Cash Sales","Zelia Green Multipurpose Liquid Detergent 5L","Cost of Goods Sold","Zelia Multipurpose Liquid Soap",,"Undeposited Funds",216.15,"",70531.58
,"Sales Receipt","14-02-2024","1835",,"Bismillahi Shop","Zelia Green Multipurpose Liquid Detergent 5L","Cost of Goods Sold","Zelia Multipurpose Liquid Soap",,"Undeposited Funds",864.62,"",71396.20
,"Sales Receipt","14-02-2024","1838",,"Cash Sales","Zelia Green Multipurpose Liquid Detergent 5L","Cost of Goods Sold","Zelia Multipurpose Liquid Soap",,"Undeposited Funds",432.31,"",71828.51
,"Sales Receipt","15-02-2024","1840",,"Cash Sales","Zelia Green Multipurpose Liquid Detergent 5L","Cost of Goods Sold","Zelia Multipurpose Liquid Soap",,"Undeposited Funds",216.15,"",72044.66
,"Sales Receipt","16-02-2024","1845",,"Cash Sales","Zelia Green Multipurpose Liquid Detergent 500ML","Cost of Goods Sold","Zelia Multipurpose Liquid Soap",,"Undeposited Funds",63.85,"",72108.51
,"Sales Receipt","17-02-2024","1851",,"MumsCereal and General Stores","Zelia Green Multipurpose Liquid Detergent 500ML","Cost of Goods Sold","Zelia Multipurpose Liquid Soap",,"Undeposited Funds",95.78,"",72204.29
,"Sales Receipt","19-02-2024","1850",,"Zamaridi wholesalers","Zelia Green Multipurpose Liquid Detergent 500ML","Cost of Goods Sold","Zelia Multipurpose Liquid Soap",,"Undeposited Funds",95.78,"",72300.07
,"Sales Receipt","20-02-2024","1854",,"Cash Sales","Zelia Green Multipurpose Liquid Detergent 5L","Cost of Goods Sold","Zelia Multipurpose Liquid Soap",,"Undeposited Funds",432.31,"",72732.38
,"Sales Receipt","21-02-2024","1855",,"Cash Sales","Zelia Green Multipurpose Liquid Detergent 1L","Cost of Goods Sold","Zelia Multipurpose Liquid Soap",,"Undeposited Funds",59.79,"",72792.17
,"Sales Receipt","21-02-2024","1856",,"Cash Sales","Zelia Green Multipurpose Liquid Detergent 1L","Cost of Goods Sold","Zelia Multipurpose Liquid Soap",,"Undeposited Funds",59.79,"",72851.96
,"Sales Receipt","21-02-2024","1859",,"Cash Sales","-MULTIPLE-","Cost of Goods Sold","Zelia Multipurpose Liquid Soap",,"Undeposited Funds",248.08,"",73100.04
,"Sales Receipt","21-02-2024","1860",,"Cash Sales","Zelia Green Multipurpose Liquid Detergent 500ML","Cost of Goods Sold","Zelia Multipurpose Liquid Soap",,"Undeposited Funds",95.78,"",73195.82
,"Sales Receipt","21-02-2024","1862",,"Ebenezer  Minimart","Zelia Green Multipurpose Liquid Detergent 5L","Cost of Goods Sold","Zelia Multipurpose Liquid Soap",,"Undeposited Funds",216.15,"",73411.97
,"Invoice","22-02-2024","MC05434",,"NASRI MART LIMITED","Zelia Green Multipurpose Liquid Detergent 500ML","Cost of Goods Sold","Zelia Multipurpose Liquid Soap",,"Accounts Receivable",159.64,"",73571.61
,"Sales Receipt","22-02-2024","1865",,"Cash Sales","Zelia Green Multipurpose Liquid Detergent 500ML","Cost of Goods Sold","Zelia Multipurpose Liquid Soap",,"Undeposited Funds",31.93,"",73603.54
,"Sales Receipt","22-02-2024","1866",,"Cash Sales","Zelia Green Multipurpose Liquid Detergent 1L","Cost of Goods Sold","Zelia Multipurpose Liquid Soap",,"Undeposited Funds",59.79,"",73663.33
,"Sales Receipt","22-02-2024","1868",,"Cash Sales","Zelia Green Multipurpose Liquid Detergent 1L","Cost of Goods Sold","Zelia Multipurpose Liquid Soap",,"Undeposited Funds",59.79,"",73723.12
,"Invoice","23-02-2024","MC05443",,"DAILY CHAMPIONS MINI SUPERMARKET LIMITED","Zelia Green Multipurpose Liquid Detergent 500ML","Cost of Goods Sold","Zelia Multipurpose Liquid Soap",,"Accounts Receivable",191.56,"",73914.68
,"Sales Receipt","23-02-2024","1869",,"Cash Sales","Zelia Green Multipurpose Liquid Detergent 5L","Cost of Goods Sold","Zelia Multipurpose Liquid Soap",,"Undeposited Funds",216.15,"",74130.83
,"Invoice","26-02-2024","MC05445",,"Mumsha Supamat","Zelia Green Multipurpose Liquid Detergent 1L","Cost of Goods Sold","Zelia Multipurpose Liquid Soap",,"Accounts Receivable",358.73,"",74489.56
,"Sales Receipt","26-02-2024","1874",,"Cash Sales","Zelia Green Multipurpose Liquid Detergent 500ML","Cost of Goods Sold","Zelia Multipurpose Liquid Soap",,"Undeposited Funds",95.78,"",74585.34
,"Invoice","27-02-2024","MC05446",,"THE REAL IPM COMPANY (KENYA)LIMITED","Zelia Green Multipurpose Liquid Detergent 20L","Cost of Goods Sold","Zelia Multipurpose Liquid Soap",,"Accounts Receivable",3690.95,"",78276.29
,"Sales Receipt","27-02-2024","1878",,"Cash Sales","Zelia Green Multipurpose Liquid Detergent 5L","Cost of Goods Sold","Zelia Multipurpose Liquid Soap",,"Undeposited Funds",648.46,"",78924.75
,"Sales Receipt","27-02-2024","1880",,"Cash Sales","Zelia Green Multipurpose Liquid Detergent 5L","Cost of Goods Sold","Zelia Multipurpose Liquid Soap",,"Undeposited Funds",216.15,"",79140.90
,"Sales Receipt","27-02-2024","1881",,"Gure Yare Shop Nasra","Zelia Green Multipurpose Liquid Detergent 5L","Cost of Goods Sold","Zelia Multipurpose Liquid Soap",,"Undeposited Funds",2593.85,"",81734.75
,"Sales Receipt","27-02-2024","1882",,"AIDURUS GENERAL SHOP","Zelia Green Multipurpose Liquid Detergent 500ML","Cost of Goods Sold","Zelia Multipurpose Liquid Soap",,"Undeposited Funds",383.13,"",82117.88
,"Sales Receipt","27-02-2024","1883",,"Cash Sales","Zelia Green Multipurpose Liquid Detergent 1L","Cost of Goods Sold","Zelia Multipurpose Liquid Soap",,"Undeposited Funds",59.79,"",82177.67
,"Sales Receipt","28-02-2024","1806",,"Beraccah Wholesallers","Zelia Green Multipurpose Liquid Detergent 500ML","Cost of Goods Sold","Zelia Multipurpose Liquid Soap",,"Undeposited Funds",191.56,"",82369.23
,"Sales Receipt","29-02-2024","1888",,"Cash Sales","Zelia Green Multipurpose Liquid Detergent 5L","Cost of Goods Sold","Zelia Multipurpose Liquid Soap",,"Undeposited Funds",216.15,"",82585.38
,"Sales Receipt","29-02-2024","1889",,"Cash Sales","Zelia Green Multipurpose Liquid Detergent 1L","Cost of Goods Sold","Zelia Multipurpose Liquid Soap",,"Undeposited Funds",59.79,"",82645.17
,"Sales Receipt","29-02-2024","1890",,"Cash Sales","-MULTIPLE-","Cost of Goods Sold","Zelia Multipurpose Liquid Soap",,"Undeposited Funds",1598.60,"",84243.77
,"Sales Receipt","29-02-2024","AT185",,"Cash Sales","-MULTIPLE-","Cost of Goods Sold","Zelia Multipurpose Liquid Soap",,"Undeposited Funds",2987.44,"",87231.21
,"Sales Receipt","29-02-2024","AT187",,"Cash Sales","Zelia Green Multipurpose Liquid Detergent 5L","Cost of Goods Sold","Zelia Multipurpose Liquid Soap",,"Undeposited Funds",216.15,"",87447.36
,"Sales Receipt","01-03-2024","AT191",,"Agnes","Zelia Green Multipurpose Liquid Detergent 5L","Cost of Goods Sold","Zelia Multipurpose Liquid Soap",,"Undeposited Funds",2161.54,"",89608.90
,"Sales Receipt","04-03-2024","1893",,"Print Parts Limited","Zelia Green Multipurpose Liquid Detergent 5L","Cost of Goods Sold","Zelia Multipurpose Liquid Soap",,"Undeposited Funds",864.62,"",90473.52
,"Sales Receipt","04-03-2024","1894",,"Cash Sales","Zelia Green Multipurpose Liquid Detergent 5L","Cost of Goods Sold","Zelia Multipurpose Liquid Soap",,"Undeposited Funds",216.15,"",90689.67
,"Sales Receipt","04-03-2024","1895",,"Cash Sales","Zelia Green Multipurpose Liquid Detergent 1L","Cost of Goods Sold","Zelia Multipurpose Liquid Soap",,"Undeposited Funds",60.47,"",90750.14
,"Sales Receipt","04-03-2024","1897",,"Cash Sales","Zelia Green Multipurpose Liquid Detergent 5L","Cost of Goods Sold","Zelia Multipurpose Liquid Soap",,"Undeposited Funds",432.31,"",91182.45
,"Sales Receipt","04-03-2024","1900",,"Dollar Signs Traders","Zelia Green Multipurpose Liquid Detergent 500ML","Cost of Goods Sold","Zelia Multipurpose Liquid Soap",,"Undeposited Funds",776.26,"",91958.71
,"Sales Receipt","04-03-2024","2003",,"Cash Sales","-MULTIPLE-","Cost of Goods Sold","Zelia Multipurpose Liquid Soap",,"Undeposited Funds",125.16,"",92083.87
,"Sales Receipt","04-03-2024","2005",,"Cash Sales","Zelia Green Multipurpose Liquid Detergent 5L","Cost of Goods Sold","Zelia Multipurpose Liquid Soap",,"Undeposited Funds",216.15,"",92300.02
,"Sales Receipt","05-03-2024","2008",,"Cash Sales","Zelia Green Multipurpose Liquid Detergent 1L","Cost of Goods Sold","Zelia Multipurpose Liquid Soap",,"Undeposited Funds",60.47,"",92360.49
,"Sales Receipt","05-03-2024","2010",,"Cash Sales","Zelia Green Multipurpose Liquid Detergent 20L","Cost of Goods Sold","Zelia Multipurpose Liquid Soap",,"Undeposited Funds",738.19,"",93098.68
,"Sales Receipt","05-03-2024","2011",,"Cash Sales","Zelia Green Multipurpose Liquid Detergent 5L","Cost of Goods Sold","Zelia Multipurpose Liquid Soap",,"Undeposited Funds",216.15,"",93314.83
,"Sales Receipt","05-03-2024","2012",,"Cash Sales","Zelia Green Multipurpose Liquid Detergent 5L","Cost of Goods Sold","Zelia Multipurpose Liquid Soap",,"Undeposited Funds",432.31,"",93747.14
,"Sales Receipt","06-03-2024","2016",,"Cash Sales","Zelia Green Multipurpose Liquid Detergent 5L","Cost of Goods Sold","Zelia Multipurpose Liquid Soap",,"Undeposited Funds",216.15,"",93963.29
,"Sales Receipt","06-03-2024","2017",,"Cash Sales","Zelia Green Multipurpose Liquid Detergent 20L","Cost of Goods Sold","Zelia Multipurpose Liquid Soap",,"Undeposited Funds",738.19,"",94701.48
,"Sales Receipt","06-03-2024","2019",,"Bismillahi Shop","-MULTIPLE-","Cost of Goods Sold","Zelia Multipurpose Liquid Soap",,"Undeposited Funds",919.74,"",95621.22
,"Sales Receipt","06-03-2024","2023",,"Kenafa Wholesalers","Zelia Green Multipurpose Liquid Detergent 500ML","Cost of Goods Sold","Zelia Multipurpose Liquid Soap",,"Undeposited Funds",388.13,"",96009.35
,"Sales Receipt","06-03-2024","2026",,"Mama Amina","-MULTIPLE-","Cost of Goods Sold","Zelia Multipurpose Liquid Soap",,"Undeposited Funds",556.90,"",96566.25
,"Invoice","07-03-2024","MC05473",,"Khetshi Dharamshi And Company Limited","Zelia Green Multipurpose Liquid Detergent Lite 20L","Cost of Goods Sold","Zelia Multipurpose Liquid Soap",,"Accounts Receivable",6077.59,"",102643.84
,"Invoice","07-03-2024","MC05477",,"OFFSHORE GLOBAL LOGISTICS LIMITED","Zelia Green Multipurpose Liquid Detergent 5L","Cost of Goods Sold","Zelia Multipurpose Liquid Soap",,"Accounts Receivable",864.62,"",103508.46
,"Sales Receipt","07-03-2024","2034",,"Cash Sales","Zelia Green Multipurpose Liquid Detergent 1L","Cost of Goods Sold","Zelia Multipurpose Liquid Soap",,"Undeposited Funds",60.47,"",103568.93
,"Sales Receipt","07-03-2024","2038",,"Cash Sales","Zelia Green Multipurpose Liquid Detergent 5L","Cost of Goods Sold","Zelia Multipurpose Liquid Soap",,"Undeposited Funds",216.15,"",103785.08
,"Sales Receipt","08-03-2024","2045",,"Cash Sales","Zelia Green Multipurpose Liquid Detergent 1L","Cost of Goods Sold","Zelia Multipurpose Liquid Soap",,"Undeposited Funds",241.89,"",104026.97
,"Invoice","11-03-2024","MC05484",,"MUHINDI MWEUSI SUPERMARKET LIMITED","-MULTIPLE-","Cost of Goods Sold","Zelia Multipurpose Liquid Soap",,"Accounts Receivable",556.90,"",104583.87
,"Sales Receipt","11-03-2024","2050",,"tRIPPLE M","Zelia Green Multipurpose Liquid Detergent 500ML","Cost of Goods Sold","Zelia Multipurpose Liquid Soap",,"Undeposited Funds",97.03,"",104680.90
,"Sales Receipt","11-03-2024","2053",,"Cash Sales","Zelia Green Multipurpose Liquid Detergent 5L","Cost of Goods Sold","Zelia Multipurpose Liquid Soap",,"Undeposited Funds",219.90,"",104900.80
,"Sales Receipt","11-03-2024","2056",,"Nasib Wholesallers","Zelia Green Multipurpose Liquid Detergent 500ML","Cost of Goods Sold","Zelia Multipurpose Liquid Soap",,"Undeposited Funds",776.26,"",105677.06
,"Invoice","12-03-2024","MC05492",,"DALLAS SHOPRITE LTD","Zelia Green Multipurpose Liquid Detergent 500ML","Cost of Goods Sold","Zelia Multipurpose Liquid Soap",,"Accounts Receivable",194.07,"",105871.13
,"Sales Receipt","13-03-2024","2059",,"Cash Sales","Zelia Green Multipurpose Liquid Detergent 1L","Cost of Goods Sold","Zelia Multipurpose Liquid Soap",,"Undeposited Funds",60.47,"",105931.60
,"Invoice","14-03-2024","MC05496",,"THE REAL IPM COMPANY (KENYA)LIMITED","Zelia Green Multipurpose Liquid Detergent 20L","Cost of Goods Sold","Zelia Multipurpose Liquid Soap",,"Accounts Receivable",3690.95,"",109622.55
,"Sales Receipt","14-03-2024","2063",,"Cash Sales","Zelia Green Multipurpose Liquid Detergent 1L","Cost of Goods Sold","Zelia Multipurpose Liquid Soap",,"Undeposited Funds",60.47,"",109683.02
,"Sales Receipt","14-03-2024","2067",,"Nzurimart wholesale","Zelia Green Multipurpose Liquid Detergent 5L","Cost of Goods Sold","Zelia Multipurpose Liquid Soap",,"Undeposited Funds",219.90,"",109902.92
,"Sales Receipt","15-03-2024","2069",,"Cash Sales","-MULTIPLE-","Cost of Goods Sold","Zelia Multipurpose Liquid Soap",,"Undeposited Funds",496.43,"",110399.35
,"Sales Receipt","18-03-2024","2072",,"Cash Sales","Zelia Green Multipurpose Liquid Detergent 5L","Cost of Goods Sold","Zelia Multipurpose Liquid Soap",,"Undeposited Funds",219.90,"",110619.25
,"Sales Receipt","18-03-2024","2073",,"Cash Sales","Zelia Green Multipurpose Liquid Detergent 5L","Cost of Goods Sold","Zelia Multipurpose Liquid Soap",,"Undeposited Funds",219.90,"",110839.15
,"Sales Receipt","18-03-2024","2073",,"Cash Sales","Zelia Green Multipurpose Liquid Detergent 5L","Cost of Goods Sold","Zelia Multipurpose Liquid Soap",,"Undeposited Funds",219.90,"",111059.05
,"Sales Receipt","18-03-2024","2074",,"Cash Sales","Zelia Green Multipurpose Liquid Detergent 5L","Cost of Goods Sold","Zelia Multipurpose Liquid Soap",,"Undeposited Funds",439.80,"",111498.85
,"Sales Receipt","18-03-2024","2077",,"Cash Sales","Zelia Green Multipurpose Liquid Detergent 1L","Cost of Goods Sold","Zelia Multipurpose Liquid Soap",,"Undeposited Funds",60.47,"",111559.32
,"Invoice","19-03-2024","MC05502",,"Tupo Mart Limited","Zelia Green Multipurpose Liquid Detergent 500ML","Cost of Goods Sold","Zelia Multipurpose Liquid Soap",,"Accounts Receivable",194.07,"",111753.39
,"Invoice","20-03-2024","MC05507",,"DAILY CHAMPIONS MINI SUPERMARKET LIMITED","Zelia Green Multipurpose Liquid Detergent 500ML","Cost of Goods Sold","Zelia Multipurpose Liquid Soap",,"Accounts Receivable",194.07,"",111947.46
,"Sales Receipt","20-03-2024","2081",,"Cash Sales","Zelia Green Multipurpose Liquid Detergent 20L","Cost of Goods Sold","Zelia Multipurpose Liquid Soap",,"Undeposited Funds",738.19,"",112685.65
,"Sales Receipt","20-03-2024","2082",,"Cash Sales","Zelia Green Multipurpose Liquid Detergent 20L","Cost of Goods Sold","Zelia Multipurpose Liquid Soap",,"Undeposited Funds",738.19,"",113423.84
,"Sales Receipt","20-03-2024","2084",,"Cash Sales","Zelia Green Multipurpose Liquid Detergent 5L","Cost of Goods Sold","Zelia Multipurpose Liquid Soap",,"Undeposited Funds",219.90,"",113643.74
,"Sales Receipt","20-03-2024","2086",,"Cash Sales","Zelia Green Multipurpose Liquid Detergent 500ML","Cost of Goods Sold","Zelia Multipurpose Liquid Soap",,"Undeposited Funds",32.34,"",113676.08
,"Sales Receipt","20-03-2024","2087",,"Pambazuka Mart (K) Limited","Zelia Green Multipurpose Liquid Detergent 500ML","Cost of Goods Sold","Zelia Multipurpose Liquid Soap",,"Undeposited Funds",776.26,"",114452.34
,"Sales Receipt","21-03-2024","2090",,"Cash Sales","Zelia Green Multipurpose Liquid Detergent 20L","Cost of Goods Sold","Zelia Multipurpose Liquid Soap",,"Undeposited Funds",738.19,"",115190.53
,"Sales Receipt","21-03-2024","2092",,"Norham Groceries","Zelia Green Multipurpose Liquid Detergent 500ML","Cost of Goods Sold","Zelia Multipurpose Liquid Soap",,"Undeposited Funds",194.07,"",115384.60
,"Sales Receipt","21-03-2024","2096",,"Cash Sales","Zelia Green Multipurpose Liquid Detergent 5L","Cost of Goods Sold","Zelia Multipurpose Liquid Soap",,"Undeposited Funds",219.90,"",115604.50
,"Sales Receipt","21-03-2024","2097",,"Cash Sales","Zelia Green Multipurpose Liquid Detergent 5L","Cost of Goods Sold","Zelia Multipurpose Liquid Soap",,"Undeposited Funds",219.90,"",115824.40
,"Sales Receipt","21-03-2024","2101",,"Raymart Minimart","Zelia Green Multipurpose Liquid Detergent 500ML","Cost of Goods Sold","Zelia Multipurpose Liquid Soap",,"Undeposited Funds",97.03,"",115921.43
,"Sales Receipt","21-03-2024","2104",,"Nuclear Supermarket","Zelia Green Multipurpose Liquid Detergent 500ML","Cost of Goods Sold","Zelia Multipurpose Liquid Soap",,"Undeposited Funds",194.07,"",116115.50
,"Sales Receipt","25-03-2024","2099",,"Cash Sales","Zelia Green Multipurpose Liquid Detergent 500ML","Cost of Goods Sold","Zelia Multipurpose Liquid Soap",,"Undeposited Funds",1552.53,"",117668.03
,"Invoice","25-03-2024","MC05530",,"KASAMAT INVESTMENTS LTD","Zelia Green Multipurpose Liquid Detergent 500ML","Cost of Goods Sold","Zelia Multipurpose Liquid Soap",,"Accounts Receivable",97.03,"",117765.06
,"Sales Receipt","25-03-2024","2107",,"Cash Sales","Zelia Green Multipurpose Liquid Detergent 5L","Cost of Goods Sold","Zelia Multipurpose Liquid Soap",,"Undeposited Funds",219.90,"",117984.96
,"Sales Receipt","27-03-2024","2117",,"Cash Sales","Zelia Green Multipurpose Liquid Detergent 5L","Cost of Goods Sold","Zelia Multipurpose Liquid Soap",,"Undeposited Funds",219.90,"",118204.86
,"Sales Receipt","28-03-2024","2118",,"Cash Sales","Zelia Green Multipurpose Liquid Detergent 5L","Cost of Goods Sold","Zelia Multipurpose Liquid Soap",,"Undeposited Funds",439.80,"",118644.66
,"Sales Receipt","28-03-2024","2126",,"Cash Sales","Zelia Green Multipurpose Liquid Detergent 5L","Cost of Goods Sold","Zelia Multipurpose Liquid Soap",,"Undeposited Funds",219.90,"",118864.56
,"Sales Receipt","28-03-2024","2127",,"Cash Sales","Zelia Green Multipurpose Liquid Detergent 500ML","Cost of Goods Sold","Zelia Multipurpose Liquid Soap",,"Undeposited Funds",32.34,"",118896.90
,"Sales Receipt","28-03-2024","2129",,"Cash Sales","Zelia Green Multipurpose Liquid Detergent 5L","Cost of Goods Sold","Zelia Multipurpose Liquid Soap",,"Undeposited Funds",439.80,"",119336.70
,"Credit","30-03-2024","0090543830000020104",,"General Plastics Limited","500 ml Multipurpose White bottle","Cost of Goods Sold","Zelia Multipurpose Liquid Soap",,"Accounts Payable","",0.87,119335.83
,"Sales Receipt","02-04-2024","2133",,"Cash Sales","Zelia Green Multipurpose Liquid Detergent 1L","Cost of Goods Sold","Zelia Multipurpose Liquid Soap",,"Undeposited Funds",241.89,"",119577.72
,"Invoice","03-04-2024","MC05553",,"THE REAL IPM COMPANY (KENYA)LIMITED","Zelia Green Multipurpose Liquid Detergent 20L","Cost of Goods Sold","Zelia Multipurpose Liquid Soap",,"Accounts Receivable",3690.95,"",123268.67
,"Sales Receipt","03-04-2024","2142",,"AIDURUS GENERAL SHOP","Zelia Green Multipurpose Liquid Detergent 1L","Cost of Goods Sold","Zelia Multipurpose Liquid Soap",,"Undeposited Funds",725.67,"",123994.34
,"Sales Receipt","03-04-2024","2147",,"Cash Sales","Zelia Green Multipurpose Liquid Detergent 5L","Cost of Goods Sold","Zelia Multipurpose Liquid Soap",,"Undeposited Funds",439.80,"",124434.14
,"Sales Receipt","03-04-2024","2148",,"Cash Sales","-MULTIPLE-","Cost of Goods Sold","Zelia Multipurpose Liquid Soap",,"Undeposited Funds",92.81,"",124526.95
,"Invoice","04-04-2024","MC05564",,"Azaavi Collections Limited","Zelia Green Multipurpose Liquid Detergent 5L","Cost of Goods Sold","Zelia Multipurpose Liquid Soap",,"Accounts Receivable",219.90,"",124746.85
,"Sales Receipt","04-04-2024","2143",,"Jubilee Candy  Shop","Zelia Green Multipurpose Liquid Detergent 5L","Cost of Goods Sold","Zelia Multipurpose Liquid Soap",,"Undeposited Funds",439.80,"",125186.65
,"Sales Receipt","04-04-2024","2153",,"Budget Store","-MULTIPLE-","Cost of Goods Sold","Zelia Multipurpose Liquid Soap",,"Undeposited Funds",556.90,"",125743.55
,"Invoice","05-04-2024","MC05576",,"Azaavi Collections Limited","Zelia Green Multipurpose Liquid Detergent 5L","Cost of Goods Sold","Zelia Multipurpose Liquid Soap",,"Accounts Receivable",219.90,"",125963.45
,"Sales Receipt","05-04-2024","2155",,"Nasib Wholesallers","Zelia Green Multipurpose Liquid Detergent 1L","Cost of Goods Sold","Zelia Multipurpose Liquid Soap",,"Undeposited Funds",725.67,"",126689.12
,"Sales Receipt","05-04-2024","2156",,"D -Madina Enterprise","Zelia Green Multipurpose Liquid Detergent 1L","Cost of Goods Sold","Zelia Multipurpose Liquid Soap",,"Undeposited Funds",1451.33,"",128140.45
,"Sales Receipt","05-04-2024","2159",,"Cash Sales","Zelia Green Multipurpose Liquid Detergent 1L","Cost of Goods Sold","Zelia Multipurpose Liquid Soap",,"Undeposited Funds",60.47,"",128200.92
,"Sales Receipt","05-04-2024","AT 194",,"Agnes","Zelia Green Multipurpose Liquid Detergent 5L","Cost of Goods Sold","Zelia Multipurpose Liquid Soap",,"Undeposited Funds",4398.00,"",132598.92
,"Sales Receipt","05-04-2024","AT 193",,"JUDY USENGE","-MULTIPLE-","Cost of Goods Sold","Zelia Multipurpose Liquid Soap",,"Undeposited Funds",24215.41,"",156814.33
,"Build Assembly","05-04-2024","10041",,,"24145","Cost of Goods Sold","Zelia Multipurpose Liquid Soap","X","-SPLIT-","",159.84,156654.49
,"Sales Receipt","08-04-2024","2164",,"Kangundo Briolly Bookshop","Zelia Green Multipurpose Liquid Detergent 500ML","Cost of Goods Sold","Zelia Multipurpose Liquid Soap",,"Undeposited Funds",31.61,"",156686.10
,"Sales Receipt","08-04-2024","2166",,"Cash Sales","Zelia Green Multipurpose Liquid Detergent 1L","Cost of Goods Sold","Zelia Multipurpose Liquid Soap",,"Undeposited Funds",115.02,"",156801.12
,"Sales Receipt","08-04-2024","2167",,"Cash Sales","Zelia Green Multipurpose Liquid Detergent 500ML","Cost of Goods Sold","Zelia Multipurpose Liquid Soap",,"Undeposited Funds",158.07,"",156959.19
,"Sales Receipt","11-04-2024","2173",,"Cash Sales","Zelia Green Multipurpose Liquid Detergent 5L","Cost of Goods Sold","Zelia Multipurpose Liquid Soap",,"Undeposited Funds",1099.50,"",158058.69
,"Sales Receipt","11-04-2024","2174",,"Cash Sales","Zelia Green Multipurpose Liquid Detergent Lite 20L","Cost of Goods Sold","Zelia Multipurpose Liquid Soap",,"Undeposited Funds",629.14,"",158687.83
,"Sales Receipt","11-04-2024","2204",,"Cash Sales","Zelia Green Multipurpose Liquid Detergent 5L","Cost of Goods Sold","Zelia Multipurpose Liquid Soap",,"Undeposited Funds",439.80,"",159127.63
,"Sales Receipt","11-04-2024","2205",,"Gure Yare Shop Nasra","Zelia Green Multipurpose Liquid Detergent 5L","Cost of Goods Sold","Zelia Multipurpose Liquid Soap",,"Undeposited Funds",2638.80,"",161766.43
,"Sales Receipt","11-04-2024","2208",,"Sultan Iman Shop","-MULTIPLE-","Cost of Goods Sold","Zelia Multipurpose Liquid Soap",,"Undeposited Funds",1448.90,"",163215.33
,"Sales Receipt","12-04-2024","2175",,"Tekonstruct LTD","Zelia Green Multipurpose Liquid Detergent 5L","Cost of Goods Sold","Zelia Multipurpose Liquid Soap",,"Undeposited Funds",219.90,"",163435.23
,"Sales Receipt","12-04-2024","2177",,"Cash Sales","Zelia Green Multipurpose Liquid Detergent 5L","Cost of Goods Sold","Zelia Multipurpose Liquid Soap",,"Undeposited Funds",219.90,"",163655.13
,"Sales Receipt","12-04-2024","2178",,"Cash Sales","Zelia Green Multipurpose Liquid Detergent 1L","Cost of Goods Sold","Zelia Multipurpose Liquid Soap",,"Undeposited Funds",57.51,"",163712.64
,"Sales Receipt","12-04-2024","2180",,"Elwak Stores Ltd","Zelia Green Multipurpose Liquid Detergent 1L","Cost of Goods Sold","Zelia Multipurpose Liquid Soap",,"Undeposited Funds",690.15,"",164402.79
,"Sales Receipt","12-04-2024","2182",,"Cheaper Cheap","Zelia Green Multipurpose Liquid Detergent 500ML","Cost of Goods Sold","Zelia Multipurpose Liquid Soap",,"Undeposited Funds",758.75,"",165161.54
,"Sales Receipt","12-04-2024","2183",,"Milimani  Stores","Zelia Green Multipurpose Liquid Detergent 500ML","Cost of Goods Sold","Zelia Multipurpose Liquid Soap",,"Undeposited Funds",379.38,"",165540.92
,"Sales Receipt","12-04-2024","2185",,"Mamken Minimart","Zelia Green Multipurpose Liquid Detergent 500ML","Cost of Goods Sold","Zelia Multipurpose Liquid Soap",,"Undeposited Funds",189.69,"",165730.61
,"Sales Receipt","12-04-2024","2186",,"Kandara minimart","Zelia Green Multipurpose Liquid Detergent 500ML","Cost of Goods Sold","Zelia Multipurpose Liquid Soap",,"Undeposited Funds",189.69,"",165920.30
,"Sales Receipt","12-04-2024","2187",,"Kikamart Minimart","Zelia Green Multipurpose Liquid Detergent 500ML","Cost of Goods Sold","Zelia Multipurpose Liquid Soap",,"Undeposited Funds",189.69,"",166109.99
,"Sales Receipt","15-04-2024","2188",,"Delta Mart","Zelia Green Multipurpose Liquid Detergent 500ML","Cost of Goods Sold","Zelia Multipurpose Liquid Soap",,"Undeposited Funds",63.23,"",166173.22
,"Sales Receipt","15-04-2024","2193",,"Diaspora Diaries","Zelia Green Multipurpose Liquid Detergent 5L","Cost of Goods Sold","Zelia Multipurpose Liquid Soap",,"Undeposited Funds",219.90,"",166393.12
,"Invoice","16-04-2024","MC05603",,"Riverwest Company Limited","Zelia Green Multipurpose Liquid Detergent 20L","Cost of Goods Sold","Zelia Multipurpose Liquid Soap",,"Accounts Receivable",1451.66,"",167844.78
,"Sales Receipt","17-04-2024","2214",,"Cash Sales","Zelia Green Multipurpose Liquid Detergent Lite 20L","Cost of Goods Sold","Zelia Multipurpose Liquid Soap",,"Undeposited Funds",1258.29,"",169103.07
,"Sales Receipt","17-04-2024","2215",,"Best Ratino Stores","Zelia Green Multipurpose Liquid Detergent 5L","Cost of Goods Sold","Zelia Multipurpose Liquid Soap",,"Undeposited Funds",857.42,"",169960.49
,"Sales Receipt","18-04-2024","2223",,"Cash Sales","Zelia Green Multipurpose Liquid Detergent 5L","Cost of Goods Sold","Zelia Multipurpose Liquid Soap",,"Undeposited Funds",210.39,"",170170.88
,"Sales Receipt","18-04-2024","2225",,"Cash Sales","Zelia Green Multipurpose Liquid Detergent 1L","Cost of Goods Sold","Zelia Multipurpose Liquid Soap",,"Undeposited Funds",57.51,"",170228.39
,"Sales Receipt","18-04-2024","2226",,"Zambia Shopping Centre","Zelia Green Multipurpose Liquid Detergent 500ML","Cost of Goods Sold","Zelia Multipurpose Liquid Soap",,"Undeposited Funds",189.69,"",170418.08
,"Sales Receipt","18-04-2024","2227",,"El Magina Store","Zelia Green Multipurpose Liquid Detergent 500ML","Cost of Goods Sold","Zelia Multipurpose Liquid Soap",,"Undeposited Funds",189.69,"",170607.77
,"Invoice","19-04-2024","MC05610",,"DISII TRADERS LTD","Zelia Green Multipurpose Liquid Detergent 500ML","Cost of Goods Sold","Zelia Multipurpose Liquid Soap",,"Accounts Receivable",379.38,"",170987.15
,"Sales Receipt","19-04-2024","2235",,"Publix Supermarket","Zelia Green Multipurpose Liquid Detergent 1L","Cost of Goods Sold","Zelia Multipurpose Liquid Soap",,"Undeposited Funds",349.95,"",171337.10
,"Sales Receipt","19-04-2024","2240",,"Cash Sales","Zelia Green Multipurpose Liquid Detergent 5L","Cost of Goods Sold","Zelia Multipurpose Liquid Soap",,"Undeposited Funds",208.17,"",171545.27
,"Invoice","22-04-2024","MC05622",,"KASAMAT INVESTMENTS LTD","Zelia Green Multipurpose Liquid Detergent 500ML","Cost of Goods Sold","Zelia Multipurpose Liquid Soap",,"Accounts Receivable",189.69,"",171734.96
,"Invoice","22-04-2024","MC05624",,"THE REAL IPM COMPANY (KENYA)LIMITED","Zelia Green Multipurpose Liquid Detergent 20L","Cost of Goods Sold","Zelia Multipurpose Liquid Soap",,"Accounts Receivable",3586.44,"",175321.40
,"Sales Receipt","22-04-2024","2241",,"Cash Sales","Zelia Green Multipurpose Liquid Detergent 500ML","Cost of Goods Sold","Zelia Multipurpose Liquid Soap",,"Undeposited Funds",189.69,"",175511.09
,"Sales Receipt","22-04-2024","2247",,"AL Zake minimart","Zelia Green Multipurpose Liquid Detergent 500ML","Cost of Goods Sold","Zelia Multipurpose Liquid Soap",,"Undeposited Funds",158.07,"",175669.16
,"Sales Receipt","23-04-2024","2252",,"Cash Sales","Zelia Green Multipurpose Liquid Detergent 500ML","Cost of Goods Sold","Zelia Multipurpose Liquid Soap",,"Undeposited Funds",31.61,"",175700.77
,"Sales Receipt","23-04-2024","2254",,"Cash Sales","Zelia Green Multipurpose Liquid Detergent 5L","Cost of Goods Sold","Zelia Multipurpose Liquid Soap",,"Undeposited Funds",208.17,"",175908.94
,"Invoice","24-04-2024","MC05636",,"Maji Asili Limited","-MULTIPLE-","Cost of Goods Sold","Zelia Multipurpose Liquid Soap",,"Accounts Receivable",2917.28,"",178826.22
,"Sales Receipt","24-04-2024","2255",,"Cash Sales","Zelia Green Multipurpose Liquid Detergent 1L","Cost of Goods Sold","Zelia Multipurpose Liquid Soap",,"Undeposited Funds",116.65,"",178942.87
,"Sales Receipt","24-04-2024","2256",,"Kimathi Store","Zelia Green Multipurpose Liquid Detergent 500ML","Cost of Goods Sold","Zelia Multipurpose Liquid Soap",,"Undeposited Funds",31.61,"",178974.48
,"Sales Receipt","24-04-2024","2259",,"Muleshe Wholesallers","-MULTIPLE-","Cost of Goods Sold","Zelia Multipurpose Liquid Soap",,"Undeposited Funds",1591.44,"",180565.92
,"Sales Receipt","24-04-2024","2260",,"Pambazuka Mart (K) Limited","Zelia Green Multipurpose Liquid Detergent Lite 20L","Cost of Goods Sold","Zelia Multipurpose Liquid Soap",,"Undeposited Funds",629.14,"",181195.06
,"Sales Receipt","25-04-2024","2261",,"Teyamo Enterprises","Zelia Green Multipurpose Liquid Detergent 500ML","Cost of Goods Sold","Zelia Multipurpose Liquid Soap",,"Undeposited Funds",63.23,"",181258.29
,"Sales Receipt","25-04-2024","2264",,"Memos Supermarket","-MULTIPLE-","Cost of Goods Sold","Zelia Multipurpose Liquid Soap",,"Undeposited Funds",1458.64,"",182716.93
,"Sales Receipt","25-04-2024","2263",,"Cash Sales","Zelia Green Multipurpose Liquid Detergent 5L","Cost of Goods Sold","Zelia Multipurpose Liquid Soap",,"Undeposited Funds",208.17,"",182925.10
,"Sales Receipt","25-04-2024","2266",,"Goldmart Supermarket","Zelia Green Multipurpose Liquid Detergent 500ML","Cost of Goods Sold","Zelia Multipurpose Liquid Soap",,"Undeposited Funds",189.69,"",183114.79
,"Sales Receipt","26-04-2024","2270",,"Cash Sales","Zelia Green Multipurpose Liquid Detergent 5L","Cost of Goods Sold","Zelia Multipurpose Liquid Soap",,"Undeposited Funds",416.35,"",183531.14
,"Sales Receipt","28-04-2024","2276",,"Zamu Wholesalers","Zelia Green Multipurpose Liquid Detergent 1L","Cost of Goods Sold","Zelia Multipurpose Liquid Soap",,"Undeposited Funds",1399.78,"",184930.92
,"Sales Receipt","29-04-2024","2273",,"Blessed Shop","Zelia Green Multipurpose Liquid Detergent 1L","Cost of Goods Sold","Zelia Multipurpose Liquid Soap",,"Undeposited Funds",116.65,"",185047.57
,"Credit Note","29-04-2024","CN01059",,"TAWALA SUPERMARKET LIMITED","Zelia Green Multipurpose Liquid Detergent 1L","Cost of Goods Sold","Zelia Multipurpose Liquid Soap",,"Accounts Receivable","",699.89,184347.68
,"Invoice","29-04-2024","MC05651",,"MUHINDI MWEUSI SUPERMARKET LIMITED","-MULTIPLE-","Cost of Goods Sold","Zelia Multipurpose Liquid Soap",,"Accounts Receivable",1458.64,"",185806.32
,"Sales Receipt","29-04-2024","2278",,"Hidika Shop","-MULTIPLE-","Cost of Goods Sold","Zelia Multipurpose Liquid Soap",,"Undeposited Funds",539.64,"",186345.96
,"Sales Receipt","29-04-2024","2279",,"Cash Sales","Zelia Green Multipurpose Liquid Detergent 5L","Cost of Goods Sold","Zelia Multipurpose Liquid Soap",,"Undeposited Funds",208.17,"",186554.13
,"Sales Receipt","29-04-2024","2280",,"Cash Sales","Zelia Green Multipurpose Liquid Detergent 5L","Cost of Goods Sold","Zelia Multipurpose Liquid Soap",,"Undeposited Funds",208.17,"",186762.30
,"Sales Receipt","30-04-2024","2281",,"Geoffrey Kangethe","Zelia Green Multipurpose Liquid Detergent 5L","Cost of Goods Sold","Zelia Multipurpose Liquid Soap",,"Undeposited Funds",208.17,"",186970.47
,"Invoice","30-04-2024","MC05652",,"OFFSHORE GLOBAL LOGISTICS LIMITED","-MULTIPLE-","Cost of Goods Sold","Zelia Multipurpose Liquid Soap",,"Accounts Receivable",925.46,"",187895.93
,"Sales Receipt","30-04-2024","2284",,"Cash Sales","Zelia Green Multipurpose Liquid Detergent 5L","Cost of Goods Sold","Zelia Multipurpose Liquid Soap",,"Undeposited Funds",416.35,"",188312.28
,"Sales Receipt","02-05-2024","2285",,"Cash Sales","Zelia Green Multipurpose Liquid Detergent 1L","Cost of Goods Sold","Zelia Multipurpose Liquid Soap",,"Undeposited Funds",58.32,"",188370.60
,"Sales Receipt","02-05-2024","2287",,"5pm Hotel","Zelia Green Multipurpose Liquid Detergent 1L","Cost of Goods Sold","Zelia Multipurpose Liquid Soap",,"Undeposited Funds",58.32,"",188428.92
,"Sales Receipt","02-05-2024","2293",,"Tuff Store","Zelia Green Multipurpose Liquid Detergent 500ML","Cost of Goods Sold","Zelia Multipurpose Liquid Soap",,"Undeposited Funds",189.69,"",188618.61
,"Sales Receipt","02-05-2024","2294",,"Cash Sales","Zelia Green Multipurpose Liquid Detergent 5L","Cost of Goods Sold","Zelia Multipurpose Liquid Soap",,"Undeposited Funds",208.17,"",188826.78
,"Sales Receipt","02-05-2024","2298",,"Cash Sales","Zelia Green Multipurpose Liquid Detergent 5L","Cost of Goods Sold","Zelia Multipurpose Liquid Soap",,"Undeposited Funds",208.17,"",189034.95
,"Sales Receipt","03-05-2024","2299",,"Cash Sales","Zelia Green Multipurpose Liquid Detergent 5L","Cost of Goods Sold","Zelia Multipurpose Liquid Soap",,"Undeposited Funds",416.35,"",189451.30
,"Sales Receipt","03-05-2024","2300",,"Cash Sales","Zelia Green Multipurpose Liquid Detergent 500ML","Cost of Goods Sold","Zelia Multipurpose Liquid Soap",,"Undeposited Funds",63.23,"",189514.53
,"Sales Receipt","03-05-2024","2301",,"Cash Sales","Zelia Green Multipurpose Liquid Detergent 1L","Cost of Goods Sold","Zelia Multipurpose Liquid Soap",,"Undeposited Funds",58.32,"",189572.85
,"Sales Receipt","03-05-2024","2302",,"Cash Sales","Zelia Green Multipurpose Liquid Detergent 20L","Cost of Goods Sold","Zelia Multipurpose Liquid Soap",,"Undeposited Funds",717.29,"",190290.14
,"Sales Receipt","03-05-2024","2303",,"Cash Sales","Zelia Green Multipurpose Liquid Detergent 1L","Cost of Goods Sold","Zelia Multipurpose Liquid Soap",,"Undeposited Funds",58.32,"",190348.46
,"Sales Receipt","03-05-2024","2306",,"Cash Sales","Zelia Green Multipurpose Liquid Detergent 1L","Cost of Goods Sold","Zelia Multipurpose Liquid Soap",,"Undeposited Funds",58.32,"",190406.78
,"Sales Receipt","05-05-2024","2308",,"Cash Sales","Zelia Green Multipurpose Liquid Detergent 1L","Cost of Goods Sold","Zelia Multipurpose Liquid Soap",,"Undeposited Funds",116.65,"",190523.43
,"Sales Receipt","06-05-2024","2309",,"Jackys Shop","Zelia Green Multipurpose Liquid Detergent 1L","Cost of Goods Sold","Zelia Multipurpose Liquid Soap",,"Undeposited Funds",58.32,"",190581.75
,"Sales Receipt","06-05-2024","2311",,"Cash Sales","Zelia Green Multipurpose Liquid Detergent 5L","Cost of Goods Sold","Zelia Multipurpose Liquid Soap",,"Undeposited Funds",208.17,"",190789.92
,"Sales Receipt","06-05-2024","2312",,"Cash Sales","Zelia Green Multipurpose Liquid Detergent 5L","Cost of Goods Sold","Zelia Multipurpose Liquid Soap",,"Undeposited Funds",624.52,"",191414.44
,"Sales Receipt","07-05-2024","2315",,"Cash Sales","Zelia Green Multipurpose Liquid Detergent 5L","Cost of Goods Sold","Zelia Multipurpose Liquid Soap",,"Undeposited Funds",208.17,"",191622.61
,"Invoice","08-05-2024","MC05681",,"THE REAL IPM COMPANY (KENYA)LIMITED","Zelia Green Multipurpose Liquid Detergent 20L","Cost of Goods Sold","Zelia Multipurpose Liquid Soap",,"Accounts Receivable",3586.44,"",195209.05
,"Sales Receipt","08-05-2024","2321",,"Cash Sales","Zelia Green Multipurpose Liquid Detergent 5L","Cost of Goods Sold","Zelia Multipurpose Liquid Soap",,"Undeposited Funds",208.17,"",195417.22
,"Sales Receipt","08-05-2024","2322",,"Cash Sales","Zelia Green Multipurpose Liquid Detergent 5L","Cost of Goods Sold","Zelia Multipurpose Liquid Soap",,"Undeposited Funds",624.52,"",196041.74
,"Sales Receipt","08-05-2024","2323",,"Cash Sales","Zelia Green Multipurpose Liquid Detergent 5L","Cost of Goods Sold","Zelia Multipurpose Liquid Soap",,"Undeposited Funds",208.17,"",196249.91
,"Sales Receipt","08-05-2024","2330",,"Neema Bei Nafuu Shop","Zelia Green Multipurpose Liquid Detergent 500ML","Cost of Goods Sold","Zelia Multipurpose Liquid Soap",,"Undeposited Funds",379.38,"",196629.29
,"Sales Receipt","09-05-2024","2333",,"RichMind Property","Zelia Green Multipurpose Liquid Detergent 5L","Cost of Goods Sold","Zelia Multipurpose Liquid Soap",,"Undeposited Funds",208.17,"",196837.46
,"Sales Receipt","09-05-2024","2334",,"Tuff Store","Zelia Green Multipurpose Liquid Detergent 500ML","Cost of Goods Sold","Zelia Multipurpose Liquid Soap",,"Undeposited Funds",189.69,"",197027.15
,"Sales Receipt","09-05-2024","2336",,"Donation","Zelia Green Multipurpose Liquid Detergent 500ML","Cost of Goods Sold","Zelia Multipurpose Liquid Soap",,"Undeposited Funds",2276.26,"",199303.41
,"Sales Receipt","09-05-2024","2341",,"Cash Sales","Zelia Green Multipurpose Liquid Detergent 500ML","Cost of Goods Sold","Zelia Multipurpose Liquid Soap",,"Undeposited Funds",63.23,"",199366.64
,"Sales Receipt","10-05-2024","1917",,"Cash Sales","Zelia Green Multipurpose Liquid Detergent 5L","Cost of Goods Sold","Zelia Multipurpose Liquid Soap",,"Undeposited Funds",208.17,"",199574.81
,"Sales Receipt","10-05-2024","1918",,"Cash Sales","-MULTIPLE-","Cost of Goods Sold","Zelia Multipurpose Liquid Soap",,"Undeposited Funds",833.94,"",200408.75
,"Sales Receipt","13-05-2024","2344",,"Cash Sales","Zelia Green Multipurpose Liquid Detergent 500ML","Cost of Goods Sold","Zelia Multipurpose Liquid Soap",,"Undeposited Funds",379.38,"",200788.13
,"Sales Receipt","13-05-2024","2346",,"Garumo Wholesallers","Zelia Green Multipurpose Liquid Detergent 500ML","Cost of Goods Sold","Zelia Multipurpose Liquid Soap",,"Undeposited Funds",758.75,"",201546.88
,"Sales Receipt","13-05-2024","2349",,"Arqam Savanna","Zelia Green Multipurpose Liquid Detergent 1L","Cost of Goods Sold","Zelia Multipurpose Liquid Soap",,"Undeposited Funds",699.89,"",202246.77
,"Sales Receipt","13-05-2024","1921",,"Cash Sales","Zelia Green Multipurpose Liquid Detergent 500ML","Cost of Goods Sold","Zelia Multipurpose Liquid Soap",,"Undeposited Funds",126.46,"",202373.23
,"Sales Receipt","14-05-2024","2358",,"Faisel Wholesale","-MULTIPLE-","Cost of Goods Sold","Zelia Multipurpose Liquid Soap",,"Undeposited Funds",1532.58,"",203905.81
,"Sales Receipt","14-05-2024","2360",,"Elwak Stores Ltd","-MULTIPLE-","Cost of Goods Sold","Zelia Multipurpose Liquid Soap",,"Undeposited Funds",1532.58,"",205438.39
,"Sales Receipt","15-05-2024","1927",,"Cash Sales","Zelia Green Multipurpose Liquid Detergent 1L","Cost of Goods Sold","Zelia Multipurpose Liquid Soap",,"Undeposited Funds",58.32,"",205496.71
,"Build Assembly","16-05-2024","10383",,,,"Cost of Goods Sold","Zelia Multipurpose Liquid Soap","X","-SPLIT-",22.94,"",205519.65
,"Sales Receipt","16-05-2024","2370",,"Imani General Store","Zelia Green Multipurpose Liquid Detergent 500ML","Cost of Goods Sold","Zelia Multipurpose Liquid Soap",,"Undeposited Funds",191.17,"",205710.82
,"Sales Receipt","16-05-2024","1930",,"Cash Sales","Zelia Green Multipurpose Liquid Detergent 5L","Cost of Goods Sold","Zelia Multipurpose Liquid Soap",,"Undeposited Funds",208.17,"",205918.99
,"Invoice","17-05-2024","MC05713",,"DISII TRADERS LTD","Zelia Green Multipurpose Liquid Detergent 500ML","Cost of Goods Sold","Zelia Multipurpose Liquid Soap",,"Accounts Receivable",764.67,"",206683.66
,"Sales Receipt","17-05-2024","1931",,"Cash Sales","Zelia Green Multipurpose Liquid Detergent 5L","Cost of Goods Sold","Zelia Multipurpose Liquid Soap",,"Undeposited Funds",208.17,"",206891.83
,"Sales Receipt","17-05-2024","1932",,"Cash Sales","Zelia Green Multipurpose Liquid Detergent 5L","Cost of Goods Sold","Zelia Multipurpose Liquid Soap",,"Undeposited Funds",208.17,"",207100.00
,"Sales Receipt","20-05-2024","1936",,"Cash Sales","Zelia Green Multipurpose Liquid Detergent 500ML","Cost of Goods Sold","Zelia Multipurpose Liquid Soap",,"Undeposited Funds",31.86,"",207131.86
,"Sales Receipt","21-05-2024","1942",,"Cash Sales","Zelia Green Multipurpose Liquid Detergent 5L","Cost of Goods Sold","Zelia Multipurpose Liquid Soap",,"Undeposited Funds",208.17,"",207340.03
,"Sales Receipt","21-05-2024","1945",,"Kinoko Store","Zelia Green Multipurpose Liquid Detergent 500ML","Cost of Goods Sold","Zelia Multipurpose Liquid Soap",,"Undeposited Funds",191.17,"",207531.20
,"Sales Receipt","21-05-2024","1948",,"Gure Yare Shop Nasra","Zelia Green Multipurpose Liquid Detergent 5L","Cost of Goods Sold","Zelia Multipurpose Liquid Soap",,"Undeposited Funds",832.69,"",208363.89
,"Invoice","22-05-2024","MC05730",,"THE REAL IPM COMPANY (KENYA)LIMITED","Zelia Green Multipurpose Liquid Detergent 20L","Cost of Goods Sold","Zelia Multipurpose Liquid Soap",,"Accounts Receivable",3544.50,"",211908.39
,"Sales Receipt","22-05-2024","2373",,"Danaba Wholesalers","-MULTIPLE-","Cost of Goods Sold","Zelia Multipurpose Liquid Soap",,"Undeposited Funds",1469.53,"",213377.92
,"Invoice","23-05-2024","MC05731",,"Khetshi Dharamshi And Company Limited","Zelia Green Multipurpose Liquid Detergent Lite 20L","Cost of Goods Sold","Zelia Multipurpose Liquid Soap",,"Accounts Receivable",3145.71,"",216523.63
,"Sales Receipt","23-05-2024","2377",,"Cash Sales","Zelia Green Multipurpose Liquid Detergent 5L","Cost of Goods Sold","Zelia Multipurpose Liquid Soap",,"Undeposited Funds",416.35,"",216939.98
,"Sales Receipt","23-05-2024","1953",,"Cash Sales","Zelia Green Multipurpose Liquid Detergent 5L","Cost of Goods Sold","Zelia Multipurpose Liquid Soap",,"Undeposited Funds",208.17,"",217148.15
,"Sales Receipt","23-05-2024","1956",,"Cash Sales","Zelia Green Multipurpose Liquid Detergent 5L","Cost of Goods Sold","Zelia Multipurpose Liquid Soap",,"Undeposited Funds",208.17,"",217356.32
,"Sales Receipt","23-05-2024","1965",,"Marris Minimart","Zelia Green Multipurpose Liquid Detergent 500ML","Cost of Goods Sold","Zelia Multipurpose Liquid Soap",,"Undeposited Funds",191.17,"",217547.49
,"Invoice","24-05-2024","MC05741",,"MUHINDI MWEUSI SUPERMARKET LIMITED","Zelia Green Multipurpose Liquid Detergent 500ML","Cost of Goods Sold","Zelia Multipurpose Liquid Soap",,"Accounts Receivable",382.34,"",217929.83
,"Invoice","24-05-2024","MC05748",,"MUHINDI MWEUSI SUPERMARKET LIMITED","Zelia Green Multipurpose Liquid Detergent 500ML","Cost of Goods Sold","Zelia Multipurpose Liquid Soap",,"Accounts Receivable",382.34,"",218312.17
,"Sales Receipt","24-05-2024","2380",,"Cash Sales","Zelia Green Multipurpose Liquid Detergent 5L","Cost of Goods Sold","Zelia Multipurpose Liquid Soap",,"Undeposited Funds",416.35,"",218728.52
,"Sales Receipt","24-05-2024","2382",,"Afrodrip LTD","Zelia Green Multipurpose Liquid Detergent 5L","Cost of Goods Sold","Zelia Multipurpose Liquid Soap",,"Undeposited Funds",416.35,"",219144.87
,"Invoice","28-05-2024","MC05761",,"MUHINDI MWEUSI SUPERMARKET LIMITED","Zelia Green Multipurpose Liquid Detergent 500ML","Cost of Goods Sold","Zelia Multipurpose Liquid Soap",,"Accounts Receivable",191.17,"",219336.04
,"Sales Receipt","29-05-2024","2390",,"Cash Sales","Zelia Green Multipurpose Liquid Detergent 1L","Cost of Goods Sold","Zelia Multipurpose Liquid Soap",,"Undeposited Funds",58.74,"",219394.78
,"Sales Receipt","29-05-2024","1971",,"Freshfinds Wholesale","Zelia Green Multipurpose Liquid Detergent 500ML","Cost of Goods Sold","Zelia Multipurpose Liquid Soap",,"Undeposited Funds",191.17,"",219585.95
,"Invoice","30-05-2024","MC05776",,"OFFSHORE GLOBAL LOGISTICS LIMITED","-MULTIPLE-","Cost of Goods Sold","Zelia Multipurpose Liquid Soap",,"Accounts Receivable",917.37,"",220503.32
,"Sales Receipt","30-05-2024","2395",,"Beta Traders","Zelia Green Multipurpose Liquid Detergent 500ML","Cost of Goods Sold","Zelia Multipurpose Liquid Soap",,"Undeposited Funds",254.89,"",220758.21
,"Sales Receipt","30-05-2024","1974",,"Cash Sales","Zelia Green Multipurpose Liquid Detergent 5L","Cost of Goods Sold","Zelia Multipurpose Liquid Soap",,"Undeposited Funds",208.47,"",220966.68
,"Sales Receipt","31-05-2024","1937",,"Island Gift Shop","Zelia Green Multipurpose Liquid Detergent 1L","Cost of Goods Sold","Zelia Multipurpose Liquid Soap",,"Undeposited Funds",117.48,"",221084.16
,"Sales Receipt","31-05-2024","1976",,"Cash Sales","Zelia Green Multipurpose Liquid Detergent 5L","Cost of Goods Sold","Zelia Multipurpose Liquid Soap",,"Undeposited Funds",208.47,"",221292.63
,"Sales Receipt","03-06-2024","2399",,"Cash Sales","Zelia Green Multipurpose Liquid Detergent 500ML","Cost of Goods Sold","Zelia Multipurpose Liquid Soap",,"Undeposited Funds",31.86,"",221324.49
,"Sales Receipt","03-06-2024","1974",,"Cash Sales","Zelia Green Multipurpose Liquid Detergent 5L","Cost of Goods Sold","Zelia Multipurpose Liquid Soap",,"Undeposited Funds",208.47,"",221532.96
,"Sales Receipt","03-06-2024","1978",,"Cash Sales","Zelia Green Multipurpose Liquid Detergent 5L","Cost of Goods Sold","Zelia Multipurpose Liquid Soap",,"Undeposited Funds",208.47,"",221741.43
,"Sales Receipt","03-06-2024","1979",,"Cash Sales","Zelia Green Multipurpose Liquid Detergent 5L","Cost of Goods Sold","Zelia Multipurpose Liquid Soap",,"Undeposited Funds",208.47,"",221949.90
,"Sales Receipt","03-06-2024","1984",,"Cash Sales","Zelia Green Multipurpose Liquid Detergent 1L","Cost of Goods Sold","Zelia Multipurpose Liquid Soap",,"Undeposited Funds",58.74,"",222008.64
,"Sales Receipt","03-06-2024","1983",,"Marris Mini mart","Zelia Green Multipurpose Liquid Detergent 500ML","Cost of Goods Sold","Zelia Multipurpose Liquid Soap",,"Undeposited Funds",191.17,"",222199.81
,"Sales Receipt","05-06-2024","1989",,"Cash Sales","Zelia Green Multipurpose Liquid Detergent 5L","Cost of Goods Sold","Zelia Multipurpose Liquid Soap",,"Undeposited Funds",208.47,"",222408.28
,"Sales Receipt","06-06-2024","2401",,"Cash Sales","Zelia Green Multipurpose Liquid Detergent 5L","Cost of Goods Sold","Zelia Multipurpose Liquid Soap",,"Undeposited Funds",833.88,"",223242.16
,"Sales Receipt","06-06-2024","1990",,"Cash Sales","Zelia Green Multipurpose Liquid Detergent 5L","Cost of Goods Sold","Zelia Multipurpose Liquid Soap",,"Undeposited Funds",208.47,"",223450.63
,"Sales Receipt","06-06-2024","2424",,"Bethel Store","Zelia Green Multipurpose Liquid Detergent 500ML","Cost of Goods Sold","Zelia Multipurpose Liquid Soap",,"Undeposited Funds",191.17,"",223641.80
,"Sales Receipt","06-06-2024","2423",,"Ekai moke wholesale","Zelia Green Multipurpose Liquid Detergent 500ML","Cost of Goods Sold","Zelia Multipurpose Liquid Soap",,"Undeposited Funds",191.17,"",223832.97
,"Sales Receipt","07-06-2024","1992",,"Cash Sales","Zelia Green Multipurpose Liquid Detergent 5L","Cost of Goods Sold","Zelia Multipurpose Liquid Soap",,"Undeposited Funds",208.47,"",224041.44
,"Sales Receipt","07-06-2024","1996",,"Cash Sales","Zelia Green Multipurpose Liquid Detergent 1L","Cost of Goods Sold","Zelia Multipurpose Liquid Soap",,"Undeposited Funds",176.21,"",224217.65
,"Sales Receipt","07-06-2024","2426",,"Cash Sales","Zelia Green Multipurpose Liquid Detergent 5L","Cost of Goods Sold","Zelia Multipurpose Liquid Soap",,"Undeposited Funds",625.41,"",224843.06
,"Sales Receipt","07-06-2024","2430",,"Cash Sales","Zelia Green Multipurpose Liquid Detergent 5L","Cost of Goods Sold","Zelia Multipurpose Liquid Soap",,"Undeposited Funds",208.47,"",225051.53
,"Sales Receipt","08-06-2024","2431",,"Cash Sales","Zelia Green Multipurpose Liquid Detergent 5L","Cost of Goods Sold","Zelia Multipurpose Liquid Soap",,"Undeposited Funds",1250.81,"",226302.34
,"Sales Receipt","08-06-2024","2432",,"Cash Sales","Zelia Green Multipurpose Liquid Detergent 500ML","Cost of Goods Sold","Zelia Multipurpose Liquid Soap",,"Undeposited Funds",191.17,"",226493.51
,"Sales Receipt","10-06-2024","1997",,"Cash Sales","Zelia Green Multipurpose Liquid Detergent 5L","Cost of Goods Sold","Zelia Multipurpose Liquid Soap",,"Undeposited Funds",208.47,"",226701.98
,"Sales Receipt","10-06-2024","1998",,"Cash Sales","Zelia Green Multipurpose Liquid Detergent 5L","Cost of Goods Sold","Zelia Multipurpose Liquid Soap",,"Undeposited Funds",208.47,"",226910.45
,"Sales Receipt","10-06-2024","2433",,"Cash Sales","Zelia Green Multipurpose Liquid Detergent 1L","Cost of Goods Sold","Zelia Multipurpose Liquid Soap",,"Undeposited Funds",58.74,"",226969.19
,"Sales Receipt","10-06-2024","2434",,"Cash Sales","Zelia Green Multipurpose Liquid Detergent 1L","Cost of Goods Sold","Zelia Multipurpose Liquid Soap",,"Undeposited Funds",117.48,"",227086.67
,"Invoice","11-06-2024","MC05810",,"KIRINYAGA FLOUR MILLS LIMITED","Zelia Green Multipurpose Liquid Detergent 20L","Cost of Goods Sold","Zelia Multipurpose Liquid Soap",,"Accounts Receivable",708.90,"",227795.57
,"Invoice","11-06-2024","MC05815",,"MADINA SUPERMARKET LIMITED","Zelia Green Multipurpose Liquid Detergent 500ML","Cost of Goods Sold","Zelia Multipurpose Liquid Soap",,"Accounts Receivable",191.17,"",227986.74
,"Sales Receipt","11-06-2024","2439",,"Cash Sales","Zelia Green Multipurpose Liquid Detergent 1L","Cost of Goods Sold","Zelia Multipurpose Liquid Soap",,"Undeposited Funds",58.74,"",228045.48
,"Sales Receipt","11-06-2024","2440",,"Cash Sales","Zelia Green Multipurpose Liquid Detergent 5L","Cost of Goods Sold","Zelia Multipurpose Liquid Soap",,"Undeposited Funds",208.47,"",228253.95
,"Sales Receipt","11-06-2024","2445",,"Cash Sales","Zelia Green Multipurpose Liquid Detergent 5L","Cost of Goods Sold","Zelia Multipurpose Liquid Soap",,"Undeposited Funds",208.47,"",228462.42
,"Sales Receipt","11-06-2024","2447",,"Cash Sales","Zelia Green Multipurpose Liquid Detergent 5L","Cost of Goods Sold","Zelia Multipurpose Liquid Soap",,"Undeposited Funds",208.47,"",228670.89
,"Invoice","12-06-2024","MC05818",,"KIRINYAGA FLOUR MILLS LIMITED","Zelia Green Multipurpose Liquid Detergent 20L","Cost of Goods Sold","Zelia Multipurpose Liquid Soap",,"Accounts Receivable",708.90,"",229379.79
,"Invoice","12-06-2024","MC05819",,"INTEGRAL MEDIA LIMITED","Zelia Green Multipurpose Liquid Detergent 1L","Cost of Goods Sold","Zelia Multipurpose Liquid Soap",,"Accounts Receivable",704.86,"",230084.65
,"Sales Receipt","12-06-2024","2450",,"Cash Sales","Zelia Green Multipurpose Liquid Detergent 5L","Cost of Goods Sold","Zelia Multipurpose Liquid Soap",,"Undeposited Funds",208.47,"",230293.12
,"Sales Receipt","12-06-2024","2449",,"Cash Sales","Zelia Green Multipurpose Liquid Detergent 1L","Cost of Goods Sold","Zelia Multipurpose Liquid Soap",,"Undeposited Funds",58.74,"",230351.86
,"Sales Receipt","12-06-2024","2451",,"Cash Sales","Zelia Green Multipurpose Liquid Detergent 5L","Cost of Goods Sold","Zelia Multipurpose Liquid Soap",,"Undeposited Funds",416.94,"",230768.80
,"Sales Receipt","12-06-2024","2452",,"Cash Sales","Zelia Green Multipurpose Liquid Detergent 5L","Cost of Goods Sold","Zelia Multipurpose Liquid Soap",,"Undeposited Funds",416.94,"",231185.74
,"Sales Receipt","12-06-2024","2453",,"Cash Sales","-MULTIPLE-","Cost of Goods Sold","Zelia Multipurpose Liquid Soap",,"Undeposited Funds",1511.36,"",232697.10
,"Sales Receipt","12-06-2024","2454",,"Cash Sales","Zelia Green Multipurpose Liquid Detergent 5L","Cost of Goods Sold","Zelia Multipurpose Liquid Soap",,"Undeposited Funds",208.47,"",232905.57
,"Sales Receipt","13-06-2024","2469",,"Cash Sales","Zelia Green Multipurpose Liquid Detergent 5L","Cost of Goods Sold","Zelia Multipurpose Liquid Soap",,"Undeposited Funds",208.47,"",233114.04
,"Sales Receipt","13-06-2024","2471",,"Cash Sales","Zelia Green Multipurpose Liquid Detergent 5L","Cost of Goods Sold","Zelia Multipurpose Liquid Soap",,"Undeposited Funds",416.94,"",233530.98
,"Sales Receipt","13-06-2024","2473",,"Horn of Africa","Zelia Green Multipurpose Liquid Detergent 500ML","Cost of Goods Sold","Zelia Multipurpose Liquid Soap",,"Undeposited Funds",382.34,"",233913.32
,"Sales Receipt","14-06-2024","2475",,"Cash Sales","Zelia Green Multipurpose Liquid Detergent 1L","Cost of Goods Sold","Zelia Multipurpose Liquid Soap",,"Undeposited Funds",176.21,"",234089.53
,"Sales Receipt","14-06-2024","2476",,"Cash Sales","Zelia Green Multipurpose Liquid Detergent 1L","Cost of Goods Sold","Zelia Multipurpose Liquid Soap",,"Undeposited Funds",58.74,"",234148.27
,"Sales Receipt","14-06-2024","2477",,"Cash Sales","Zelia Green Multipurpose Liquid Detergent 1L","Cost of Goods Sold","Zelia Multipurpose Liquid Soap",,"Undeposited Funds",117.48,"",234265.75
,"Sales Receipt","14-06-2024","2478",,"Cash Sales","Zelia Green Multipurpose Liquid Detergent 5L","Cost of Goods Sold","Zelia Multipurpose Liquid Soap",,"Undeposited Funds",416.94,"",234682.69
,"Sales Receipt","14-06-2024","2479",,"Cash Sales","Zelia Green Multipurpose Liquid Detergent 5L","Cost of Goods Sold","Zelia Multipurpose Liquid Soap",,"Undeposited Funds",208.47,"",234891.16
,"Sales Receipt","14-06-2024","2480",,"Cash Sales","Zelia Green Multipurpose Liquid Detergent 5L","Cost of Goods Sold","Zelia Multipurpose Liquid Soap",,"Undeposited Funds",208.47,"",235099.63
,"Sales Receipt","14-06-2024","2481",,"Cash Sales","Zelia Green Multipurpose Liquid Detergent 1L","Cost of Goods Sold","Zelia Multipurpose Liquid Soap",,"Undeposited Funds",58.74,"",235158.37
,"Sales Receipt","14-06-2024","2482",,"Cash Sales","Zelia Green Multipurpose Liquid Detergent 5L","Cost of Goods Sold","Zelia Multipurpose Liquid Soap",,"Undeposited Funds",208.47,"",235366.84
,"Sales Receipt","14-06-2024","2710",,"tRIPPLE M","Zelia Green Multipurpose Liquid Detergent 500ML","Cost of Goods Sold","Zelia Multipurpose Liquid Soap",,"Undeposited Funds",191.17,"",235558.01
,"Invoice","18-06-2024","MC05827",,"THE REAL IPM COMPANY (KENYA)LIMITED","Zelia Green Multipurpose Liquid Detergent 20L","Cost of Goods Sold","Zelia Multipurpose Liquid Soap",,"Accounts Receivable",2835.60,"",238393.61
,"Sales Receipt","18-06-2024","2703",,"Cash Sales","Zelia Green Multipurpose Liquid Detergent 5L","Cost of Goods Sold","Zelia Multipurpose Liquid Soap",,"Undeposited Funds",833.88,"",239227.49
,"Sales Receipt","18-06-2024","2702",,"Cash Sales","Zelia Green Multipurpose Liquid Detergent 5L","Cost of Goods Sold","Zelia Multipurpose Liquid Soap",,"Undeposited Funds",208.47,"",239435.96
,"Sales Receipt","18-06-2024","2712",,"Cash Sales","Zelia Green Multipurpose Liquid Detergent 500ML","Cost of Goods Sold","Zelia Multipurpose Liquid Soap",,"Undeposited Funds",31.86,"",239467.82
,"Sales Receipt","18-06-2024","2705",,"Freshtake wholesalers","-MULTIPLE-","Cost of Goods Sold","Zelia Multipurpose Liquid Soap",,"Undeposited Funds",1087.20,"",240555.02
,"Sales Receipt","19-06-2024","2483",,"Cash Sales","Zelia Green Multipurpose Liquid Detergent 500ML","Cost of Goods Sold","Zelia Multipurpose Liquid Soap",,"Undeposited Funds",31.86,"",240586.88
,"Sales Receipt","19-06-2024","2488",,"Cash Sales","Zelia Green Multipurpose Liquid Detergent 5L","Cost of Goods Sold","Zelia Multipurpose Liquid Soap",,"Undeposited Funds",416.94,"",241003.82
,"Sales Receipt","19-06-2024","2484",,"Cash Sales","Zelia Green Multipurpose Liquid Detergent 5L","Cost of Goods Sold","Zelia Multipurpose Liquid Soap",,"Undeposited Funds",416.94,"",241420.76
,"Sales Receipt","19-06-2024","2485",,"Cash Sales","Zelia Green Multipurpose Liquid Detergent 5L","Cost of Goods Sold","Zelia Multipurpose Liquid Soap",,"Undeposited Funds",208.47,"",241629.23
,"Invoice","20-06-2024","MC05842",,"HOPEMART SELF SERVICES LTD","Zelia Green Multipurpose Liquid Detergent 500ML","Cost of Goods Sold","Zelia Multipurpose Liquid Soap",,"Accounts Receivable",191.17,"",241820.40
,"Invoice","20-06-2024","MC05845",,"Azaavi Collections Limited","Zelia 5L Green Multipurpose Liquid Detergent","Cost of Goods Sold","Zelia Multipurpose Liquid Soap",,"Accounts Receivable",208.47,"",242028.87
,"Sales Receipt","20-06-2024","2493",,"Cash Sales","Zelia Green Multipurpose Liquid Detergent 1L","Cost of Goods Sold","Zelia Multipurpose Liquid Soap",,"Undeposited Funds",58.74,"",242087.61
,"Sales Receipt","20-06-2024","AT197",,"Cash Sales","-MULTIPLE-","Cost of Goods Sold","Zelia Multipurpose Liquid Soap",,"Undeposited Funds",2382.85,"",244470.46
,"Sales Receipt","21-06-2024","2716",,"Cash Sales","Zelia Green Multipurpose Liquid Detergent 5L","Cost of Goods Sold","Zelia Multipurpose Liquid Soap",,"Undeposited Funds",208.47,"",244678.93
,"Sales Receipt","21-06-2024","2721",,"Home Soko Minimart","Zelia Green Multipurpose Liquid Detergent 500ML","Cost of Goods Sold","Zelia Multipurpose Liquid Soap",,"Undeposited Funds",191.17,"",244870.10
,"Sales Receipt","22-06-2024","2131",,"Ekai moke wholesale","Zelia Green Multipurpose Liquid Detergent 500ML","Cost of Goods Sold","Zelia Multipurpose Liquid Soap",,"Undeposited Funds",382.34,"",245252.44
,"Sales Receipt","24-06-2024","2719",,"Cash Sales","Zelia Green Multipurpose Liquid Detergent 5L","Cost of Goods Sold","Zelia Multipurpose Liquid Soap",,"Undeposited Funds",208.47,"",245460.91
,"Sales Receipt","24-06-2024","2729",,"Natala Shop","Zelia Green Multipurpose Liquid Detergent 500ML","Cost of Goods Sold","Zelia Multipurpose Liquid Soap",,"Undeposited Funds",382.34,"",245843.25
,"Sales Receipt","24-06-2024","8960",,"Pambazuka Mart (K) Limited","-MULTIPLE-","Cost of Goods Sold","Zelia Multipurpose Liquid Soap",,"Undeposited Funds",2172.59,"",248015.84
,"Invoice","26-06-2024","MC05866",,"DISII TRADERS LTD","Zelia Green Multipurpose Liquid Detergent 500ML","Cost of Goods Sold","Zelia Multipurpose Liquid Soap",,"Accounts Receivable",191.17,"",248207.01
,"Sales Receipt","27-06-2024","2736",,"Cash Sales","Zelia Green Multipurpose Liquid Detergent 20L","Cost of Goods Sold","Zelia Multipurpose Liquid Soap",,"Undeposited Funds",703.96,"",248910.97
,"Sales Receipt","28-06-2024","2737",,"Cash Sales","Zelia Green Multipurpose Liquid Detergent 500ML","Cost of Goods Sold","Zelia Multipurpose Liquid Soap",,"Undeposited Funds",31.86,"",248942.83
,"Sales Receipt","28-06-2024","2739",,"Cash Sales","Zelia Green Multipurpose Liquid Detergent 5L","Cost of Goods Sold","Zelia Multipurpose Liquid Soap",,"Undeposited Funds",208.47,"",249151.30
,"Sales Receipt","28-06-2024","2744",,"Cash Sales","Zelia Green Multipurpose Liquid Detergent 5L","Cost of Goods Sold","Zelia Multipurpose Liquid Soap",,"Undeposited Funds",416.94,"",249568.24
,"Sales Receipt","28-06-2024","2745",,"Cash Sales","Zelia Green Multipurpose Liquid Detergent 5L","Cost of Goods Sold","Zelia Multipurpose Liquid Soap",,"Undeposited Funds",208.47,"",249776.71
,"Sales Receipt","28-06-2024","AT199",,"Cash Sales","Zelia Green Multipurpose Liquid Detergent 5L","Cost of Goods Sold","Zelia Multipurpose Liquid Soap",,"Undeposited Funds",2501.63,"",252278.34
,"Sales Receipt","01-07-2024","2746",,"Cash Sales","Zelia Green Multipurpose Liquid Detergent 5L","Cost of Goods Sold","Zelia Multipurpose Liquid Soap",,"Undeposited Funds",208.47,"",252486.81
,"Sales Receipt","01-07-2024","2764",,"Golden Save","Zelia Green Multipurpose Liquid Detergent 5L","Cost of Goods Sold","Zelia Multipurpose Liquid Soap",,"Undeposited Funds",4169.38,"",256656.19
,"Invoice","02-07-2024","MC05874",,"THE REAL IPM COMPANY (KENYA)LIMITED","Zelia Green Multipurpose Liquid Detergent 20L","Cost of Goods Sold","Zelia Multipurpose Liquid Soap",,"Accounts Receivable",3519.80,"",260175.99
,"Sales Receipt","02-07-2024","2757",,"Cash Sales","Zelia Green Multipurpose Liquid Detergent 5L","Cost of Goods Sold","Zelia Multipurpose Liquid Soap",,"Undeposited Funds",208.47,"",260384.46
,"Sales Receipt","02-07-2024","2760",,"Cash Sales","Zelia Green Multipurpose Liquid Detergent 1L","Cost of Goods Sold","Zelia Multipurpose Liquid Soap",,"Undeposited Funds",58.74,"",260443.20
,"Sales Receipt","02-07-2024","2554",,"RichMind Property","Zelia Green Multipurpose Liquid Detergent 5L","Cost of Goods Sold","Zelia Multipurpose Liquid Soap",,"Undeposited Funds",208.47,"",260651.67
,"Sales Receipt","03-07-2024","2761",,"Cash Sales","Zelia Green Multipurpose Liquid Detergent 500ML","Cost of Goods Sold","Zelia Multipurpose Liquid Soap",,"Undeposited Funds",191.17,"",260842.84
,"Sales Receipt","03-07-2024","2767",,"Cash Sales","Zelia Green Multipurpose Liquid Detergent 1L","Cost of Goods Sold","Zelia Multipurpose Liquid Soap",,"Undeposited Funds",58.74,"",260901.58
,"Sales Receipt","03-07-2024","2781",,"New shopWholesale","-MULTIPLE-","Cost of Goods Sold","Zelia Multipurpose Liquid Soap",,"Undeposited Funds",2939.06,"",263840.64
,"Sales Receipt","03-07-2024","2769",,"Asfa Shop","Zelia Green Multipurpose Liquid Detergent 500ML","Cost of Goods Sold","Zelia Multipurpose Liquid Soap",,"Undeposited Funds",191.17,"",264031.81
,"Sales Receipt","04-07-2024","2785",,"Cash Sales","Zelia Green Multipurpose Liquid Detergent 5L","Cost of Goods Sold","Zelia Multipurpose Liquid Soap",,"Undeposited Funds",210.86,"",264242.67
,"Sales Receipt","04-07-2024","2787",,"Cash Sales","Zelia Green Multipurpose Liquid Detergent 5L","Cost of Goods Sold","Zelia Multipurpose Liquid Soap",,"Undeposited Funds",421.72,"",264664.39
,"Sales Receipt","04-07-2024","2788",,"Cash Sales","Zelia Green Multipurpose Liquid Detergent 5L","Cost of Goods Sold","Zelia Multipurpose Liquid Soap",,"Undeposited Funds",210.86,"",264875.25
,"Sales Receipt","04-07-2024","2789",,"Cash Sales","Zelia Green Multipurpose Liquid Detergent 1L","Cost of Goods Sold","Zelia Multipurpose Liquid Soap",,"Undeposited Funds",58.74,"",264933.99
,"Sales Receipt","04-07-2024","2529",,"Al manaan","Zelia Green Multipurpose Liquid Detergent 5L","Cost of Goods Sold","Zelia Multipurpose Liquid Soap",,"Undeposited Funds",843.43,"",265777.42
,"Sales Receipt","05-07-2024","2790",,"Cash Sales","Zelia Green Multipurpose Liquid Detergent 5L","Cost of Goods Sold","Zelia Multipurpose Liquid Soap",,"Undeposited Funds",210.90,"",265988.32
,"Sales Receipt","05-07-2024","2791",,"Cash Sales","Zelia Green Multipurpose Liquid Detergent 5L","Cost of Goods Sold","Zelia Multipurpose Liquid Soap",,"Undeposited Funds",210.90,"",266199.22
,"Sales Receipt","05-07-2024","2797",,"Afro Drip LTD","Zelia Green Multipurpose Liquid Detergent 5L","Cost of Goods Sold","Zelia Multipurpose Liquid Soap",,"Undeposited Funds",1054.51,"",267253.73
,"Sales Receipt","05-07-2024","2800",,"Arqam minimart","Zelia Green Multipurpose Liquid Detergent 1L","Cost of Goods Sold","Zelia Multipurpose Liquid Soap",,"Undeposited Funds",704.86,"",267958.59
,"Sales Receipt","06-07-2024","2501",,"Cash Sales","Zelia Green Multipurpose Liquid Detergent 5L","Cost of Goods Sold","Zelia Multipurpose Liquid Soap",,"Undeposited Funds",421.81,"",268380.40
,"Sales Receipt","06-07-2024","2502",,"Cash Sales","Zelia Green Multipurpose Liquid Detergent 5L","Cost of Goods Sold","Zelia Multipurpose Liquid Soap",,"Undeposited Funds",210.90,"",268591.30
,"Sales Receipt","06-07-2024","2516",,"Baraka Cerials","Zelia Green Multipurpose Liquid Detergent 500ML","Cost of Goods Sold","Zelia Multipurpose Liquid Soap",,"Undeposited Funds",191.17,"",268782.47
,"Sales Receipt","08-07-2024","2504",,"Cash Sales","Zelia Green Multipurpose Liquid Detergent 5L","Cost of Goods Sold","Zelia Multipurpose Liquid Soap",,"Undeposited Funds",210.90,"",268993.37
,"Sales Receipt","08-07-2024","2507",,"Cash Sales","Zelia Green Multipurpose Liquid Detergent 5L","Cost of Goods Sold","Zelia Multipurpose Liquid Soap",,"Undeposited Funds",210.90,"",269204.27
,"Sales Receipt","08-07-2024","2528",,"Afro Drip LTD","Zelia Green Multipurpose Liquid Detergent 1L","Cost of Goods Sold","Zelia Multipurpose Liquid Soap",,"Undeposited Funds",117.48,"",269321.75
,"Sales Receipt","08-07-2024","1519",,"Gure Yare Shop","Zelia Green Multipurpose Liquid Detergent 5L","Cost of Goods Sold","Zelia Multipurpose Liquid Soap",,"Undeposited Funds",4218.06,"",273539.81
,"Sales Receipt","09-07-2024","2525",,"Cash Sales","-MULTIPLE-","Cost of Goods Sold","Zelia Multipurpose Liquid Soap",,"Undeposited Funds",1647.76,"",275187.57
,"Sales Receipt","09-07-2024","2523",,"Mama Amina","-MULTIPLE-","Cost of Goods Sold","Zelia Multipurpose Liquid Soap",,"Undeposited Funds",1087.20,"",276274.77
,"Invoice","11-07-2024","MC05910",,"Khetshi Dharamshi And Company Limited","Zelia Green Multipurpose Liquid Detergent Lite 20L","Cost of Goods Sold","Zelia Multipurpose Liquid Soap",,"Accounts Receivable",3849.71,"",280124.48
,"Sales Receipt","11-07-2024","2535",,"Cash Sales","Zelia Green Multipurpose Liquid Detergent 5L","Cost of Goods Sold","Zelia Multipurpose Liquid Soap",,"Undeposited Funds",210.90,"",280335.38
,"Sales Receipt","11-07-2024","2536",,"Cash Sales","Zelia Green Multipurpose Liquid Detergent 5L","Cost of Goods Sold","Zelia Multipurpose Liquid Soap",,"Undeposited Funds",210.90,"",280546.28
,"Sales Receipt","12-07-2024","2537",,"Cash Sales","Zelia Green Multipurpose Liquid Detergent 1L","Cost of Goods Sold","Zelia Multipurpose Liquid Soap",,"Undeposited Funds",58.74,"",280605.02
,"Sales Receipt","13-07-2024","2654",,"Damim Mart","Zelia Green Multipurpose Liquid Detergent 500ML","Cost of Goods Sold","Zelia Multipurpose Liquid Soap",,"Undeposited Funds",191.17,"",280796.19
,"Invoice","15-07-2024","MC05921",,"OFFSHORE GLOBAL LOGISTICS LIMITED","-MULTIPLE-","Cost of Goods Sold","Zelia Multipurpose Liquid Soap",,"Accounts Receivable",1125.77,"",281921.96
,"Invoice","15-07-2024","MC05924",,"Azaavi Collections Limited","Zelia 5L Green Multipurpose Liquid Detergent","Cost of Goods Sold","Zelia Multipurpose Liquid Soap",,"Accounts Receivable",421.81,"",282343.77
,"Invoice","15-07-2024","MC05931",,"KASAMAT INVESTMENTS LTD","-MULTIPLE-","Cost of Goods Sold","Zelia Multipurpose Liquid Soap",,"Accounts Receivable",271.79,"",282615.56
,"Invoice","15-07-2024","MC05933",,"MUHINDI MWEUSI SUPERMARKET LIMITED","Zelia Green Multipurpose Liquid Detergent 1L","Cost of Goods Sold","Zelia Multipurpose Liquid Soap",,"Accounts Receivable",704.86,"",283320.42
,"Sales Receipt","15-07-2024","2540",,"Cash Sales","Zelia Green Multipurpose Liquid Detergent 20L","Cost of Goods Sold","Zelia Multipurpose Liquid Soap",,"Undeposited Funds",703.96,"",284024.38
,"Sales Receipt","15-07-2024","2541",,"Cash Sales","Zelia Green Multipurpose Liquid Detergent 5L","Cost of Goods Sold","Zelia Multipurpose Liquid Soap",,"Undeposited Funds",421.81,"",284446.19
,"Sales Receipt","15-07-2024","2543",,"Cash Sales","Zelia Green Multipurpose Liquid Detergent 5L","Cost of Goods Sold","Zelia Multipurpose Liquid Soap",,"Undeposited Funds",210.90,"",284657.09
,"Sales Receipt","15-07-2024","2544",,"Cash Sales","Zelia Green Multipurpose Liquid Detergent 500ML","Cost of Goods Sold","Zelia Multipurpose Liquid Soap",,"Undeposited Funds",31.86,"",284688.95
,"Sales Receipt","15-07-2024","2548",,"Downtown Wholesalers","-MULTIPLE-","Cost of Goods Sold","Zelia Multipurpose Liquid Soap",,"Undeposited Funds",1087.20,"",285776.15
,"Invoice","17-07-2024","MC05938",,"DISII TRADERS LTD","Zelia Green Multipurpose Liquid Detergent 500ML","Cost of Goods Sold","Zelia Multipurpose Liquid Soap",,"Accounts Receivable",764.67,"",286540.82
,"Sales Receipt","18-07-2024","2565",,"Cash Sales","Zelia Green Multipurpose Liquid Detergent 5L","Cost of Goods Sold","Zelia Multipurpose Liquid Soap",,"Undeposited Funds",210.90,"",286751.72
,"Invoice","22-07-2024","MC05957",,"THE REAL IPM COMPANY (KENYA)LIMITED","Zelia Green Multipurpose Liquid Detergent 20L","Cost of Goods Sold","Zelia Multipurpose Liquid Soap",,"Accounts Receivable",3519.80,"",290271.52
,"Sales Receipt","22-07-2024","2574",,"Cash Sales","Zelia Green Multipurpose Liquid Detergent 5L","Cost of Goods Sold","Zelia Multipurpose Liquid Soap",,"Undeposited Funds",210.90,"",290482.42
,"Sales Receipt","22-07-2024","2570",,"Cash Sales","Zelia Green Multipurpose Liquid Detergent 500ML","Cost of Goods Sold","Zelia Multipurpose Liquid Soap",,"Undeposited Funds",31.86,"",290514.28
,"Sales Receipt","23-07-2024","2582",,"Cash Sales","Zelia Green Multipurpose Liquid Detergent 1L","Cost of Goods Sold","Zelia Multipurpose Liquid Soap",,"Undeposited Funds",58.74,"",290573.02
,"Sales Receipt","23-07-2024","2583",,"Cash Sales","Zelia Green Multipurpose Liquid Detergent 5L","Cost of Goods Sold","Zelia Multipurpose Liquid Soap",,"Undeposited Funds",210.90,"",290783.92
,"Sales Receipt","23-07-2024","2585",,"Cash Sales","Zelia Green Multipurpose Liquid Detergent 5L","Cost of Goods Sold","Zelia Multipurpose Liquid Soap",,"Undeposited Funds",210.90,"",290994.82
,"Sales Receipt","23-07-2024","2590",,"Cash Sales","Zelia Green Multipurpose Liquid Detergent 5L","Cost of Goods Sold","Zelia Multipurpose Liquid Soap",,"Undeposited Funds",210.90,"",291205.72
,"Sales Receipt","23-07-2024","2591",,"Cash Sales","Zelia Green Multipurpose Liquid Detergent 5L","Cost of Goods Sold","Zelia Multipurpose Liquid Soap",,"Undeposited Funds",210.90,"",291416.62
,"Sales Receipt","23-07-2024","2581",,"Cash Sales","Zelia Green Multipurpose Liquid Detergent 500ML","Cost of Goods Sold","Zelia Multipurpose Liquid Soap",,"Undeposited Funds",63.72,"",291480.34
,"Sales Receipt","23-07-2024","2607",,"Juli Mart","Zelia Green Multipurpose Liquid Detergent 500ML","Cost of Goods Sold","Zelia Multipurpose Liquid Soap",,"Undeposited Funds",95.58,"",291575.92
,"Sales Receipt","24-07-2024","2588",,"Cash Sales","Zelia Green Multipurpose Liquid Detergent 5L","Cost of Goods Sold","Zelia Multipurpose Liquid Soap",,"Undeposited Funds",210.90,"",291786.82
,"Sales Receipt","24-07-2024","2589",,"Cash Sales","Zelia Green Multipurpose Liquid Detergent 5L","Cost of Goods Sold","Zelia Multipurpose Liquid Soap",,"Undeposited Funds",210.90,"",291997.72
,"Sales Receipt","24-07-2024","2608",,"Capital Halal","Zelia Green Multipurpose Liquid Detergent 500ML","Cost of Goods Sold","Zelia Multipurpose Liquid Soap",,"Undeposited Funds",191.17,"",292188.89
,"Sales Receipt","26-07-2024","2690",,"Amani Store","Zelia Green Multipurpose Liquid Detergent 500ML","Cost of Goods Sold","Zelia Multipurpose Liquid Soap",,"Undeposited Funds",382.34,"",292571.23
,"Invoice","29-07-2024","MC05984",,"Mumsha Supamat","Zelia Green Multipurpose Liquid Detergent 1L","Cost of Goods Sold","Zelia Multipurpose Liquid Soap",,"Accounts Receivable",352.43,"",292923.66
,"Sales Receipt","29-07-2024","2613",,"Cash Sales","Zelia Green Multipurpose Liquid Detergent 5L","Cost of Goods Sold","Zelia Multipurpose Liquid Soap",,"Undeposited Funds",210.90,"",293134.56
,"Sales Receipt","29-07-2024","2616",,"Hidika Shop","Zelia Green Multipurpose Liquid Detergent 500ML","Cost of Goods Sold","Zelia Multipurpose Liquid Soap",,"Undeposited Funds",382.34,"",293516.90
,"Sales Receipt","30-07-2024","2618",,"Cash Sales","Zelia Green Multipurpose Liquid Detergent 5L","Cost of Goods Sold","Zelia Multipurpose Liquid Soap",,"Undeposited Funds",210.90,"",293727.80
,"Sales Receipt","30-07-2024","2619",,"Cash Sales","Zelia Green Multipurpose Liquid Detergent 1L","Cost of Goods Sold","Zelia Multipurpose Liquid Soap",,"Undeposited Funds",58.74,"",293786.54
,"Sales Receipt","30-07-2024","2620",,"Cash Sales","Zelia Green Multipurpose Liquid Detergent 1L","Cost of Goods Sold","Zelia Multipurpose Liquid Soap",,"Undeposited Funds",117.48,"",293904.02
,"Sales Receipt","30-07-2024","2625",,"Cash Sales","Zelia Green Multipurpose Liquid Detergent 20L","Cost of Goods Sold","Zelia Multipurpose Liquid Soap",,"Undeposited Funds",703.96,"",294607.98
,"Sales Receipt","30-07-2024","2629",,"Cash Sales","Zelia Green Multipurpose Liquid Detergent 5L","Cost of Goods Sold","Zelia Multipurpose Liquid Soap",,"Undeposited Funds",210.90,"",294818.88
,"Sales Receipt","30-07-2024","2622",,"Infinity Lines","Zelia Green Multipurpose Liquid Detergent 5L","Cost of Goods Sold","Zelia Multipurpose Liquid Soap",,"Undeposited Funds",421.81,"",295240.69
,"Sales Receipt","31-07-2024","AT200",,"Cash Sales","-MULTIPLE-","Cost of Goods Sold","Zelia Multipurpose Liquid Soap",,"Undeposited Funds",7737.86,"",302978.55
,"Sales Receipt","31-07-2024","2630",,"Cash Sales","Zelia Green Multipurpose Liquid Detergent 20L","Cost of Goods Sold","Zelia Multipurpose Liquid Soap",,"Undeposited Funds",3519.80,"",306498.35
,"Sales Receipt","31-07-2024","2631",,"Cash Sales","Zelia Green Multipurpose Liquid Detergent 5L","Cost of Goods Sold","Zelia Multipurpose Liquid Soap",,"Undeposited Funds",421.81,"",306920.16
,"Sales Receipt","31-07-2024","2635",,"Cash Sales","Zelia Green Multipurpose Liquid Detergent 5L","Cost of Goods Sold","Zelia Multipurpose Liquid Soap",,"Undeposited Funds",210.90,"",307131.06
,"Invoice","01-08-2024","MC05990",,"THE REAL IPM COMPANY (KENYA)LIMITED","Zelia Green Multipurpose Liquid Detergent 20L","Cost of Goods Sold","Zelia Multipurpose Liquid Soap",,"Accounts Receivable",3519.80,"",310650.86
,"Sales Receipt","01-08-2024","2691",,"Ubwere Store","Zelia Green Multipurpose Liquid Detergent 500ML","Cost of Goods Sold","Zelia Multipurpose Liquid Soap",,"Undeposited Funds",393.69,"",311044.55
,"Sales Receipt","02-08-2024","2643",,"Cash Sales","Zelia Green Multipurpose Liquid Detergent 5L","Cost of Goods Sold","Zelia Multipurpose Liquid Soap",,"Undeposited Funds",632.71,"",311677.26
,"Sales Receipt","02-08-2024","2646",,"Cash Sales","-MULTIPLE-","Cost of Goods Sold","Zelia Multipurpose Liquid Soap",,"Undeposited Funds",271.69,"",311948.95
,"Sales Receipt","02-08-2024","2650",,"Cash Sales","Zelia Green Multipurpose Liquid Detergent 1L","Cost of Goods Sold","Zelia Multipurpose Liquid Soap",,"Undeposited Funds",121.57,"",312070.52
,"Sales Receipt","05-08-2024","2658",,"Cash Sales","Zelia Green Multipurpose Liquid Detergent 5L","Cost of Goods Sold","Zelia Multipurpose Liquid Soap",,"Undeposited Funds",210.90,"",312281.42
,"Sales Receipt","05-08-2024","2679",,"Golden Save","Zelia Green Multipurpose Liquid Detergent 5L","Cost of Goods Sold","Zelia Multipurpose Liquid Soap",,"Undeposited Funds",4218.06,"",316499.48
,"Invoice","06-08-2024","MC06004",,"HAPPY VIEW SUPERMARKET LIMITED","Zelia Green Multipurpose Liquid Detergent 500ML","Cost of Goods Sold","Zelia Multipurpose Liquid Soap",,"Accounts Receivable",196.85,"",316696.33
,"Sales Receipt","06-08-2024","2659",,"Cash Sales","Zelia Green Multipurpose Liquid Detergent 5L","Cost of Goods Sold","Zelia Multipurpose Liquid Soap",,"Undeposited Funds",210.90,"",316907.23
,"Sales Receipt","06-08-2024","2680",,"Juja Minimart","-MULTIPLE-","Cost of Goods Sold","Zelia Multipurpose Liquid Soap",,"Undeposited Funds",1516.83,"",318424.06
,"Invoice","07-08-2024","MC06006",,"NASRI MART LIMITED","Zelia Green Multipurpose Liquid Detergent 500ML","Cost of Goods Sold","Zelia Multipurpose Liquid Soap",,"Accounts Receivable",196.85,"",318620.91
,"Sales Receipt","07-08-2024","2684",,"Cash Sales","Zelia Green Multipurpose Liquid Detergent 5L","Cost of Goods Sold","Zelia Multipurpose Liquid Soap",,"Undeposited Funds",210.90,"",318831.81
,"Invoice","08-08-2024","MC06016",,"DISII TRADERS LTD","Zelia Green Multipurpose Liquid Detergent 500ML","Cost of Goods Sold","Zelia Multipurpose Liquid Soap",,"Accounts Receivable",393.69,"",319225.50
,"Invoice","08-08-2024","MC06018",,"OFFSHORE GLOBAL LOGISTICS LIMITED","-MULTIPLE-","Cost of Goods Sold","Zelia Multipurpose Liquid Soap",,"Accounts Receivable",938.14,"",320163.64
,"Sales Receipt","08-08-2024","2672",,"Cash Sales","Zelia Green Multipurpose Liquid Detergent 1L","Cost of Goods Sold","Zelia Multipurpose Liquid Soap",,"Undeposited Funds",243.15,"",320406.79
,"Invoice","09-08-2024","MC06020",,"DALLAS SHOPRITE LTD","Zelia Green Multipurpose Liquid Detergent 500ML","Cost of Goods Sold","Zelia Multipurpose Liquid Soap",,"Accounts Receivable",393.69,"",320800.48
,"Sales Receipt","09-08-2024","2695",,"Cash Sales","Zelia Green Multipurpose Liquid Detergent 5L","Cost of Goods Sold","Zelia Multipurpose Liquid Soap",,"Undeposited Funds",210.90,"",321011.38
,"Sales Receipt","09-08-2024","2698",,"Cash Sales","Zelia Green Multipurpose Liquid Detergent 5L","Cost of Goods Sold","Zelia Multipurpose Liquid Soap",,"Undeposited Funds",210.90,"",321222.28
,"Sales Receipt","09-08-2024","2699",,"Cash Sales","Zelia Green Multipurpose Liquid Detergent 1L","Cost of Goods Sold","Zelia Multipurpose Liquid Soap",,"Undeposited Funds",60.79,"",321283.07
,"Invoice","12-08-2024","MC06031",,"KAVYA SUPERMARKET LIMITED","Zelia Green Multipurpose Liquid Detergent 500ML","Cost of Goods Sold","Zelia Multipurpose Liquid Soap",,"Accounts Receivable",787.39,"",322070.46
,"Sales Receipt","12-08-2024","2813",,"Mamken Minimart","-MULTIPLE-","Cost of Goods Sold","Zelia Multipurpose Liquid Soap",,"Undeposited Funds",561.57,"",322632.03
,"Sales Receipt","12-08-2024","2814",,"Asfa Shop","Zelia Green Multipurpose Liquid Detergent 500ML","Cost of Goods Sold","Zelia Multipurpose Liquid Soap",,"Undeposited Funds",196.85,"",322828.88
,"Sales Receipt","12-08-2024","2815",,"Kibibi Wasai Store","-MULTIPLE-","Cost of Goods Sold","Zelia Multipurpose Liquid Soap",,"Undeposited Funds",1573.05,"",324401.93
,"Sales Receipt","12-08-2024","2812",,"Bethel Store","Zelia Green Multipurpose Liquid Detergent 5L","Cost of Goods Sold","Zelia Multipurpose Liquid Soap",,"Undeposited Funds",421.81,"",324823.74
,"Sales Receipt","12-08-2024","2817",,"Gargar Foodstuffs","Zelia Green Multipurpose Liquid Detergent 5L","Cost of Goods Sold","Zelia Multipurpose Liquid Soap",,"Undeposited Funds",4218.06,"",329041.80
,"Sales Receipt","13-08-2024","2820",,"Cash Sales","Zelia Green Multipurpose Liquid Detergent 5L","Cost of Goods Sold","Zelia Multipurpose Liquid Soap",,"Undeposited Funds",210.90,"",329252.70
,"Sales Receipt","13-08-2024","2819",,"Tawakal Shop","Zelia Green Multipurpose Liquid Detergent 5L","Cost of Goods Sold","Zelia Multipurpose Liquid Soap",,"Undeposited Funds",210.90,"",329463.60
,"Sales Receipt","14-08-2024","2823",,"Cash Sales","Zelia Green Multipurpose Liquid Detergent 1L","Cost of Goods Sold","Zelia Multipurpose Liquid Soap",,"Undeposited Funds",121.57,"",329585.17
,"Sales Receipt","14-08-2024","2834",,"Milimani Store","Zelia Green Multipurpose Liquid Detergent 500ML","Cost of Goods Sold","Zelia Multipurpose Liquid Soap",,"Undeposited Funds",196.85,"",329782.02
,"Sales Receipt","14-08-2024","2832",,"Qudus Shop","Zelia Green Multipurpose Liquid Detergent 500ML","Cost of Goods Sold","Zelia Multipurpose Liquid Soap",,"Undeposited Funds",393.69,"",330175.71
,"Sales Receipt","15-08-2024","2824",,"Cash Sales","Zelia Green Multipurpose Liquid Detergent 5L","Cost of Goods Sold","Zelia Multipurpose Liquid Soap",,"Undeposited Funds",438.62,"",330614.33
,"Sales Receipt","16-08-2024","2851",,"Tahila Enterprises","-MULTIPLE-","Cost of Goods Sold","Zelia Multipurpose Liquid Soap",,"Undeposited Funds",280.78,"",330895.11
,"Invoice","19-08-2024","MC06050",,"Azaavi Collections Limited","Zelia 5L Green Multipurpose Liquid Detergent","Cost of Goods Sold","Zelia Multipurpose Liquid Soap",,"Accounts Receivable",219.31,"",331114.42
,"Sales Receipt","19-08-2024","2836",,"Cash Sales","Zelia Green Multipurpose Liquid Detergent 500ML","Cost of Goods Sold","Zelia Multipurpose Liquid Soap",,"Undeposited Funds",65.62,"",331180.04
,"Sales Receipt","19-08-2024","2839",,"Cash Sales","Zelia Green Multipurpose Liquid Detergent 500ML","Cost of Goods Sold","Zelia Multipurpose Liquid Soap",,"Undeposited Funds",65.62,"",331245.66
,"Sales Receipt","20-08-2024","2905",,"Cash Sales","Zelia Green Multipurpose Liquid Detergent 5L","Cost of Goods Sold","Zelia Multipurpose Liquid Soap",,"Undeposited Funds",219.31,"",331464.97
,"Sales Receipt","20-08-2024","2858",,"Home Soko Minimart","Zelia Green Multipurpose Liquid Detergent 5L","Cost of Goods Sold","Zelia Multipurpose Liquid Soap",,"Undeposited Funds",438.62,"",331903.59
,"Sales Receipt","20-08-2024","2859",,"Nzuri Supermarket","Zelia Green Multipurpose Liquid Detergent 5L","Cost of Goods Sold","Zelia Multipurpose Liquid Soap",,"Undeposited Funds",219.31,"",332122.90
,"Invoice","21-08-2024","MC06054",,"Khetshi Dharamshi And Company Limited","Zelia Green Multipurpose Liquid Detergent Lite 20L","Cost of Goods Sold","Zelia Multipurpose Liquid Soap",,"Accounts Receivable",3849.71,"",335972.61
,"Invoice","21-08-2024","MC06065",,"Muhaya & Rukundo Holdings Ltd","0001.12.00 Zelia Green Multipurpose Liquid Detergent 24X500ML","Cost of Goods Sold","Zelia Multipurpose Liquid Soap",,"Accounts Receivable",4032.50,"",340005.11
,"Sales Receipt","21-08-2024","MC06054",,"Cash Sales","Zelia Green Multipurpose Liquid Detergent Lite 20L","Cost of Goods Sold","Zelia Multipurpose Liquid Soap",,"Undeposited Funds",3849.71,"",343854.82
,"Sales Receipt","21-08-2024","MC06071",,"Cash Sales","Zelia Green Multipurpose Liquid Detergent 20L","Cost of Goods Sold","Zelia Multipurpose Liquid Soap",,"Undeposited Funds",727.24,"",344582.06
,"Sales Receipt","21-08-2024","2906",,"Cash Sales","Zelia Green Multipurpose Liquid Detergent 5L","Cost of Goods Sold","Zelia Multipurpose Liquid Soap",,"Undeposited Funds",219.31,"",344801.37
,"Sales Receipt","21-08-2024","2853",,"Cash Sales","Zelia Green Multipurpose Liquid Detergent 1L","Cost of Goods Sold","Zelia Multipurpose Liquid Soap",,"Undeposited Funds",60.79,"",344862.16
,"Sales Receipt","21-08-2024","2863",,"alhamdulilah shop","-MULTIPLE-","Cost of Goods Sold","Zelia Multipurpose Liquid Soap",,"Undeposited Funds",1123.13,"",345985.29
,"Sales Receipt","21-08-2024","2855",,"Homecare Enterprise","Zelia Green Multipurpose Liquid Detergent 5L","Cost of Goods Sold","Zelia Multipurpose Liquid Soap",,"Undeposited Funds",219.31,"",346204.60
,"Build Assembly","21-08-2024","11299",,,,"Cost of Goods Sold","Zelia Multipurpose Liquid Soap","X","-SPLIT-",112.55,"",346317.15
,"Invoice","22-08-2024","MC06066",,"Cash Sales","Zelia Green Multipurpose Liquid Detergent 5L","Cost of Goods Sold","Zelia Multipurpose Liquid Soap",,"Accounts Receivable",219.31,"",346536.46
,"Invoice","22-08-2024","MC06067",,"Cash Sales","Zelia Green Multipurpose Liquid Detergent 5L","Cost of Goods Sold","Zelia Multipurpose Liquid Soap",,"Accounts Receivable",438.62,"",346975.08
,"Credit Note","22-08-2024","CN01065",,"Cash Sales","Zelia Green Multipurpose Liquid Detergent 5L","Cost of Goods Sold","Zelia Multipurpose Liquid Soap",,"Accounts Receivable","",219.31,346755.77
,"Credit Note","22-08-2024","CN01066",,"Cash Sales","Zelia Green Multipurpose Liquid Detergent 5L","Cost of Goods Sold","Zelia Multipurpose Liquid Soap",,"Accounts Receivable","",438.62,346317.15
,"Sales Receipt","22-08-2024","2868",,"Cash Sales","Zelia Green Multipurpose Liquid Detergent 5L","Cost of Goods Sold","Zelia Multipurpose Liquid Soap",,"Undeposited Funds",219.31,"",346536.46
,"Sales Receipt","22-08-2024","2867",,"Sultan Iman Shop","Zelia Green Multipurpose Liquid Detergent 1L","Cost of Goods Sold","Zelia Multipurpose Liquid Soap",,"Undeposited Funds",1458.88,"",347995.34
,"Invoice","23-08-2024","MC06071",,"KIRINYAGA FLOUR MILLS LIMITED","Zelia Green Multipurpose Liquid Detergent 20L","Cost of Goods Sold","Zelia Multipurpose Liquid Soap",,"Accounts Receivable",727.24,"",348722.58
,"Sales Receipt","23-08-2024","2877",,"Cash Sales","Zelia Green Multipurpose Liquid Detergent 1L","Cost of Goods Sold","Zelia Multipurpose Liquid Soap",,"Undeposited Funds",60.79,"",348783.37
,"Sales Receipt","23-08-2024","2880",,"Cash Sales","Zelia Green Multipurpose Liquid Detergent 5L","Cost of Goods Sold","Zelia Multipurpose Liquid Soap",,"Undeposited Funds",219.31,"",349002.68
,"Sales Receipt","23-08-2024","2881",,"Cash Sales","Zelia Green Multipurpose Liquid Detergent 5L","Cost of Goods Sold","Zelia Multipurpose Liquid Soap",,"Undeposited Funds",438.62,"",349441.30
,"Sales Receipt","23-08-2024","2921",,"Cash Sales","Zelia Green Multipurpose Liquid Detergent 5L","Cost of Goods Sold","Zelia Multipurpose Liquid Soap",,"Undeposited Funds",219.31,"",349660.61
,"Sales Receipt","24-08-2024","2887",,"Brightfood Nasra","Zelia Green Multipurpose Liquid Detergent 500ML","Cost of Goods Sold","Zelia Multipurpose Liquid Soap",,"Undeposited Funds",196.85,"",349857.46
,"Invoice","26-08-2024","MC06081",,"THE REAL IPM COMPANY (KENYA)LIMITED","Zelia Green Multipurpose Liquid Detergent 20L","Cost of Goods Sold","Zelia Multipurpose Liquid Soap",,"Accounts Receivable",3636.20,"",353493.66
,"Sales Receipt","26-08-2024","2865",,"Cash Sales","Zelia Green Multipurpose Liquid Detergent 1L","Cost of Goods Sold","Zelia Multipurpose Liquid Soap",,"Undeposited Funds",121.57,"",353615.23
,"Sales Receipt","26-08-2024","2883",,"Cash Sales","Zelia Green Multipurpose Liquid Detergent 5L","Cost of Goods Sold","Zelia Multipurpose Liquid Soap",,"Undeposited Funds",438.62,"",354053.85
,"Sales Receipt","26-08-2024","2884",,"Cash Sales","Zelia Green Multipurpose Liquid Detergent 5L","Cost of Goods Sold","Zelia Multipurpose Liquid Soap",,"Undeposited Funds",877.24,"",354931.09
,"Sales Receipt","26-08-2024","2888",,"Asfa Shop","Zelia Green Multipurpose Liquid Detergent 5L","Cost of Goods Sold","Zelia Multipurpose Liquid Soap",,"Undeposited Funds",438.62,"",355369.71
,"Sales Receipt","27-08-2024","2894",,"Cash Sales","Zelia Green Multipurpose Liquid Detergent 5L","Cost of Goods Sold","Zelia Multipurpose Liquid Soap",,"Undeposited Funds",438.62,"",355808.33
,"Sales Receipt","28-08-2024","2911",,"Infinity Lines","Zelia Green Multipurpose Liquid Detergent 5L","Cost of Goods Sold","Zelia Multipurpose Liquid Soap",,"Undeposited Funds",657.93,"",356466.26
,"Sales Receipt","29-08-2024","AT201",,"Cash Sales","Zelia Green Multipurpose Liquid Detergent 5L","Cost of Goods Sold","Zelia Multipurpose Liquid Soap",,"Undeposited Funds",2631.71,"",359097.97
,"Sales Receipt","29-08-2024","965",,"Mombasa Velvet","Zelia Green Multipurpose Liquid Detergent 5L","Cost of Goods Sold","Zelia Multipurpose Liquid Soap",,"Undeposited Funds",219.31,"",359317.28
,"Sales Receipt","30-08-2024","2922",,"Cash Sales","Zelia Green Multipurpose Liquid Detergent 5L","Cost of Goods Sold","Zelia Multipurpose Liquid Soap",,"Undeposited Funds",219.31,"",359536.59
,"Sales Receipt","02-09-2024","3225",,"Purity Shop","Zelia Green Multipurpose Liquid 24X500ML","Cost of Goods Sold","Zelia Multipurpose Liquid Soap",,"Undeposited Funds",33.61,"",359570.20
,"Sales Receipt","02-09-2024","2923",,"Blossom Beauty","Zelia Green Multipurpose Liquid 24X500ML","Cost of Goods Sold","Zelia Multipurpose Liquid Soap",,"Undeposited Funds",201.63,"",359771.83
,"Sales Receipt","02-09-2024","2928",,"Beta Traders","Zelia Green Multipurpose Liquid 24X500ML","Cost of Goods Sold","Zelia Multipurpose Liquid Soap",,"Undeposited Funds",403.25,"",360175.08
,"Sales Receipt","02-09-2024","2972",,"Muleshe Wholesallers","Zelia Green Multipurpose Liquid 4X5L","Cost of Goods Sold","Zelia Multipurpose Liquid Soap",,"Undeposited Funds",1772.88,"",361947.96
,"Sales Receipt","02-09-2024","3004",,"Cash Sales","Zelia Green Multipurpose Liquid 4X5L","Cost of Goods Sold","Zelia Multipurpose Liquid Soap",,"Undeposited Funds",221.61,"",362169.57
,"Sales Receipt","02-09-2024","3005",,"Cash Sales","Zelia Green Multipurpose Liquid 4X5L","Cost of Goods Sold","Zelia Multipurpose Liquid Soap",,"Undeposited Funds",221.61,"",362391.18
,"Sales Receipt","02-09-2024","3006",,"Cash Sales","Zelia Green Multipurpose Liquid 20L","Cost of Goods Sold","Zelia Multipurpose Liquid Soap",,"Undeposited Funds",727.24,"",363118.42
,"Sales Receipt","02-09-2024","3008",,"Cash Sales","Zelia Green Multipurpose Liquid 4X5L","Cost of Goods Sold","Zelia Multipurpose Liquid Soap",,"Undeposited Funds",221.61,"",363340.03
,"Sales Receipt","02-09-2024","3010",,"Cash Sales","Zelia Green Multipurpose Liquid 12X1L","Cost of Goods Sold","Zelia Multipurpose Liquid Soap",,"Undeposited Funds",122.57,"",363462.60
,"Sales Receipt","03-09-2024","2922",,"Cash Sales","Zelia Green Multipurpose Liquid 12X1L","Cost of Goods Sold","Zelia Multipurpose Liquid Soap",,"Undeposited Funds",122.57,"",363585.17
,"Sales Receipt","04-09-2024","2932",,"Cash Sales","Zelia Green Multipurpose Liquid 4X5L","Cost of Goods Sold","Zelia Multipurpose Liquid Soap",,"Undeposited Funds",221.61,"",363806.78
,"Sales Receipt","04-09-2024","2933",,"Cash Sales","Zelia Green Multipurpose Liquid 4X5L","Cost of Goods Sold","Zelia Multipurpose Liquid Soap",,"Undeposited Funds",221.61,"",364028.39
,"Sales Receipt","05-09-2024","2944",,"Cash Sales","-MULTIPLE-","Cost of Goods Sold","Zelia Multipurpose Liquid Soap",,"Undeposited Funds",948.85,"",364977.24
,"Sales Receipt","05-09-2024","2949",,"Cash Sales","Zelia Green Multipurpose Liquid 12X1L","Cost of Goods Sold","Zelia Multipurpose Liquid Soap",,"Undeposited Funds",61.28,"",365038.52
,"Sales Receipt","05-09-2024","2950",,"Cash Sales","Zelia Green Multipurpose Liquid 12X1L","Cost of Goods Sold","Zelia Multipurpose Liquid Soap",,"Undeposited Funds",122.57,"",365161.09
,"Sales Receipt","05-09-2024","2954",,"Cash Sales","Zelia Green Multipurpose Liquid 4X5L","Cost of Goods Sold","Zelia Multipurpose Liquid Soap",,"Undeposited Funds",221.61,"",365382.70
,"Sales Receipt","05-09-2024","2955",,"Cash Sales","Zelia Green Multipurpose Liquid 4X5L","Cost of Goods Sold","Zelia Multipurpose Liquid Soap",,"Undeposited Funds",221.61,"",365604.31
,"Sales Receipt","06-09-2024","2957",,"Cash Sales","Zelia Green Multipurpose Liquid 4X5L","Cost of Goods Sold","Zelia Multipurpose Liquid Soap",,"Undeposited Funds",221.61,"",365825.92
,"Sales Receipt","09-09-2024","2969",,"Elwak mart","Zelia Green Multipurpose Liquid 4X5L","Cost of Goods Sold","Zelia Multipurpose Liquid Soap",,"Undeposited Funds",886.44,"",366712.36
,"Sales Receipt","09-09-2024","2960",,"Mizpa Minimart","Zelia Green Multipurpose Liquid 12X1L","Cost of Goods Sold","Zelia Multipurpose Liquid Soap",,"Undeposited Funds",61.69,"",366774.05
,"Sales Receipt","09-09-2024","2986",,"Pambazuka Mart (K) Limited","-MULTIPLE-","Cost of Goods Sold","Zelia Multipurpose Liquid Soap",,"Undeposited Funds",2194.85,"",368968.90
,"Sales Receipt","10-09-2024","2992",,"Axis Lounge","Zelia Green Multipurpose Liquid 20L","Cost of Goods Sold","Zelia Multipurpose Liquid Soap",,"Undeposited Funds",727.08,"",369695.98
,"Sales Receipt","10-09-2024","2973",,"Cash Sales","Zelia Green Multipurpose Liquid 20L","Cost of Goods Sold","Zelia Multipurpose Liquid Soap",,"Undeposited Funds",727.08,"",370423.06
,"Sales Receipt","10-09-2024","2975",,"Cash Sales","Zelia Green Multipurpose Liquid 12X1L","Cost of Goods Sold","Zelia Multipurpose Liquid Soap",,"Undeposited Funds",246.97,"",370670.03
,"Sales Receipt","10-09-2024","2977",,"Cash Sales","Zelia Green Multipurpose Liquid 24X500ML","Cost of Goods Sold","Zelia Multipurpose Liquid Soap",,"Undeposited Funds",34.23,"",370704.26
,"Sales Receipt","10-09-2024","2979",,"Cash Sales","Zelia Green Multipurpose Liquid 4X5L","Cost of Goods Sold","Zelia Multipurpose Liquid Soap",,"Undeposited Funds",221.61,"",370925.87
,"Sales Receipt","10-09-2024","3015",,"Cash Sales","Zelia Green Multipurpose Liquid 12X1L","Cost of Goods Sold","Zelia Multipurpose Liquid Soap",,"Undeposited Funds",61.74,"",370987.61
,"Sales Receipt","10-09-2024","2976",,"Cash Sales","Zelia Green Multipurpose Liquid 12X1L","Cost of Goods Sold","Zelia Multipurpose Liquid Soap",,"Undeposited Funds",123.49,"",371111.10
,"Sales Receipt","10-09-2024","3237",,"Cash Sales","Zelia Green Multipurpose Liquid 12X1L","Cost of Goods Sold","Zelia Multipurpose Liquid Soap",,"Undeposited Funds",61.74,"",371172.84
,"Invoice","11-09-2024","MC06136",,"THE REAL IPM COMPANY (KENYA)LIMITED","Zelia Green Multipurpose Liquid Detergent 20L","Cost of Goods Sold","Zelia Multipurpose Liquid Soap",,"Accounts Receivable",3635.38,"",374808.22
,"Sales Receipt","11-09-2024","2985",,"Cash Sales","Zelia Green Multipurpose Liquid 4X5L","Cost of Goods Sold","Zelia Multipurpose Liquid Soap",,"Undeposited Funds",221.61,"",375029.83
,"Sales Receipt","12-09-2024","2987",,"Cash Sales","Zelia Green Multipurpose Liquid 4X5L","Cost of Goods Sold","Zelia Multipurpose Liquid Soap",,"Undeposited Funds",229.37,"",375259.20
,"Sales Receipt","12-09-2024","3019",,"Cash Sales","Zelia Green Multipurpose Liquid 12X1L","Cost of Goods Sold","Zelia Multipurpose Liquid Soap",,"Undeposited Funds",61.74,"",375320.94
,"Sales Receipt","12-09-2024","3023",,"Cash Sales","Zelia Green Multipurpose Liquid 12X1L","Cost of Goods Sold","Zelia Multipurpose Liquid Soap",,"Undeposited Funds",61.74,"",375382.68
,"Sales Receipt","13-09-2024","3030",,"Cash Sales","Zelia Green Multipurpose Liquid 4X5L","Cost of Goods Sold","Zelia Multipurpose Liquid Soap",,"Undeposited Funds",229.37,"",375612.05
,"Sales Receipt","13-09-2024","3032",,"Cash Sales","Zelia Green Multipurpose Liquid 4X5L","Cost of Goods Sold","Zelia Multipurpose Liquid Soap",,"Undeposited Funds",229.37,"",375841.42
,"Sales Receipt","13-09-2024","3033",,"Cash Sales","Zelia Green Multipurpose Liquid 4X5L","Cost of Goods Sold","Zelia Multipurpose Liquid Soap",,"Undeposited Funds",458.74,"",376300.16
,"Sales Receipt","13-09-2024","3036",,"Cash Sales","Zelia Green Multipurpose Liquid 4X5L","Cost of Goods Sold","Zelia Multipurpose Liquid Soap",,"Undeposited Funds",229.37,"",376529.53
,"Sales Receipt","14-09-2024","3043",,"Gladys Wholesalers","Zelia Green Multipurpose Liquid 12X1L","Cost of Goods Sold","Zelia Multipurpose Liquid Soap",,"Undeposited Funds",123.49,"",376653.02
,"Sales Receipt","16-09-2024","3044",,"Afro Drip LTD","Zelia Green Multipurpose Liquid 4X5L","Cost of Goods Sold","Zelia Multipurpose Liquid Soap",,"Undeposited Funds",688.11,"",377341.13
,"Sales Receipt","16-09-2024","3045",,"Afro Drip LTD Reception","Zelia Green Multipurpose Liquid 12X1L","Cost of Goods Sold","Zelia Multipurpose Liquid Soap",,"Undeposited Funds",123.49,"",377464.62
,"Sales Receipt","16-09-2024","3037",,"Cash Sales","Zelia Green Multipurpose Liquid 4X5L","Cost of Goods Sold","Zelia Multipurpose Liquid Soap",,"Undeposited Funds",229.37,"",377693.99
,"Sales Receipt","16-09-2024","3038",,"Cash Sales","Zelia Green Multipurpose Liquid 12X1L","Cost of Goods Sold","Zelia Multipurpose Liquid Soap",,"Undeposited Funds",123.49,"",377817.48
,"Sales Receipt","16-09-2024","3039",,"Cash Sales","Zelia Green Multipurpose Liquid 4X5L","Cost of Goods Sold","Zelia Multipurpose Liquid Soap",,"Undeposited Funds",229.37,"",378046.85
,"Sales Receipt","17-09-2024","3048",,"Cash Sales","Zelia Green Multipurpose Liquid 4X5L","Cost of Goods Sold","Zelia Multipurpose Liquid Soap",,"Undeposited Funds",229.37,"",378276.22
,"Sales Receipt","17-09-2024","3049",,"Cash Sales","Zelia Green Multipurpose Liquid 4X5L","Cost of Goods Sold","Zelia Multipurpose Liquid Soap",,"Undeposited Funds",229.37,"",378505.59
,"Sales Receipt","17-09-2024","3051",,"Cash Sales","Zelia Green Multipurpose Liquid 4X5L","Cost of Goods Sold","Zelia Multipurpose Liquid Soap",,"Undeposited Funds",229.37,"",378734.96
,"Sales Receipt","18-09-2024","3057",,"Jimos Wholesalers","-MULTIPLE-","Cost of Goods Sold","Zelia Multipurpose Liquid Soap",,"Undeposited Funds",664.09,"",379399.05
,"Sales Receipt","18-09-2024","3056",,"Cash Sales","Zelia Green Multipurpose Liquid 12X1L","Cost of Goods Sold","Zelia Multipurpose Liquid Soap",,"Undeposited Funds",61.74,"",379460.79
,"Sales Receipt","19-09-2024","570",,"Revs Spares","Zelia Green Multipurpose Liquid 4X5L","Cost of Goods Sold","Zelia Multipurpose Liquid Soap",,"Undeposited Funds",229.37,"",379690.16
,"Invoice","20-09-2024","MC06179",,"OFFSHORE GLOBAL LOGISTICS LIMITED","Zelia Green Multipurpose Liquid Detergent 20L","Cost of Goods Sold","Zelia Multipurpose Liquid Soap",,"Accounts Receivable",727.08,"",380417.24
,"Sales Receipt","20-09-2024","3069",,"Cash Sales","Zelia Green Multipurpose Liquid 4X5L","Cost of Goods Sold","Zelia Multipurpose Liquid Soap",,"Undeposited Funds",229.37,"",380646.61
,"Sales Receipt","21-09-2024","3077",,"Horn of Africa","Zelia Green Multipurpose Liquid 24X500ML","Cost of Goods Sold","Zelia Multipurpose Liquid Soap",,"Undeposited Funds",821.42,"",381468.03
,"Sales Receipt","23-09-2024","3087",,"Himilo General Store","-MULTIPLE-","Cost of Goods Sold","Zelia Multipurpose Liquid Soap",,"Undeposited Funds",1151.62,"",382619.65
,"Sales Receipt","23-09-2024","3072",,"Cash Sales","Zelia Green Multipurpose Liquid 12X1L","Cost of Goods Sold","Zelia Multipurpose Liquid Soap",,"Undeposited Funds",61.74,"",382681.39
,"Sales Receipt","24-09-2024","3234",,"Gifted Hands","Zelia Green Multipurpose Liquid 24X500ML","Cost of Goods Sold","Zelia Multipurpose Liquid Soap",,"Undeposited Funds",102.68,"",382784.07
,"Sales Receipt","24-09-2024","3083",,"Kibibi Wasai Store","Zelia Green Multipurpose Liquid 24X500ML","Cost of Goods Sold","Zelia Multipurpose Liquid Soap",,"Undeposited Funds",205.35,"",382989.42
,"Sales Receipt","24-09-2024","3078",,"Cash Sales","Zelia Green Multipurpose Liquid 4X5L","Cost of Goods Sold","Zelia Multipurpose Liquid Soap",,"Undeposited Funds",229.37,"",383218.79
,"Sales Receipt","24-09-2024","3079",,"Cash Sales","Zelia Green Multipurpose Liquid 4X5L","Cost of Goods Sold","Zelia Multipurpose Liquid Soap",,"Undeposited Funds",688.11,"",383906.90
,"Sales Receipt","24-09-2024","3080",,"Cash Sales","Zelia Green Multipurpose Liquid 12X1L","Cost of Goods Sold","Zelia Multipurpose Liquid Soap",,"Undeposited Funds",61.74,"",383968.64
,"Invoice","25-09-2024","MC06197",,"Khetshi Dharamshi And Company Limited","Zelia Green Multipurpose Liquid Detergent Lite 20L","Cost of Goods Sold","Zelia Multipurpose Liquid Soap",,"Accounts Receivable",3728.66,"",387697.30
,"Sales Receipt","25-09-2024","3095",,"Cash Sales","Zelia Green Multipurpose Liquid 4X5L","Cost of Goods Sold","Zelia Multipurpose Liquid Soap",,"Undeposited Funds",229.37,"",387926.67
,"Invoice","26-09-2024","MC06205",,"OFFSHORE GLOBAL LOGISTICS LIMITED","-MULTIPLE-","Cost of Goods Sold","Zelia Multipurpose Liquid Soap",,"Accounts Receivable",956.45,"",388883.12
,"Sales Receipt","26-09-2024","3209",,"Cash Sales","Zelia Green Multipurpose Liquid 4X5L","Cost of Goods Sold","Zelia Multipurpose Liquid Soap",,"Undeposited Funds",229.37,"",389112.49
,"Invoice","27-09-2024","MC06216",,"QUALITYMART SUPERMARKET LIMITED","-MULTIPLE-","Cost of Goods Sold","Zelia Multipurpose Liquid Soap",,"Accounts Receivable",575.80,"",389688.29
,"Sales Receipt","27-09-2024","3215",,"Supaa Mart","-MULTIPLE-","Cost of Goods Sold","Zelia Multipurpose Liquid Soap",,"Undeposited Funds",575.80,"",390264.09
,"Sales Receipt","27-09-2024","3211",,"Cash Sales","Zelia Green Multipurpose Liquid 4X5L","Cost of Goods Sold","Zelia Multipurpose Liquid Soap",,"Undeposited Funds",229.37,"",390493.46
,"Sales Receipt","27-09-2024","3212",,"Cash Sales","Zelia Green Multipurpose Liquid 12X1L","Cost of Goods Sold","Zelia Multipurpose Liquid Soap",,"Undeposited Funds",61.74,"",390555.20
,"Sales Receipt","27-09-2024","3216",,"Cash Sales","Zelia Green Multipurpose Liquid 4X5L","Cost of Goods Sold","Zelia Multipurpose Liquid Soap",,"Undeposited Funds",458.74,"",391013.94
,"Sales Receipt","01-10-2024","3224",,"Cash Sales","Zelia Green Multipurpose Liquid 12X1L","Cost of Goods Sold","Zelia Multipurpose Liquid Soap",,"Undeposited Funds",61.74,"",391075.68
,"Sales Receipt","01-10-2024","3224",,"Cash Sales","Zelia Green Multipurpose Liquid 12X1L","Cost of Goods Sold","Zelia Multipurpose Liquid Soap",,"Undeposited Funds",61.74,"",391137.42
,"Sales Receipt","02-10-2024","3225",,"Cash Sales","Zelia Green Multipurpose Liquid Detergent 500ML","Cost of Goods Sold","Zelia Multipurpose Liquid Soap",,"Undeposited Funds",65.62,"",391203.04
,"Sales Receipt","02-10-2024","3225",,"Cash Sales","Zelia Green Multipurpose Liquid 24X500ML","Cost of Goods Sold","Zelia Multipurpose Liquid Soap",,"Undeposited Funds",68.45,"",391271.49
,"Sales Receipt","02-10-2024","3226",,"Cash Sales","Zelia Green Multipurpose Liquid 4X5L","Cost of Goods Sold","Zelia Multipurpose Liquid Soap",,"Undeposited Funds",229.37,"",391500.86
,"Sales Receipt","02-10-2024","3227",,"Cash Sales","Zelia Green Multipurpose Liquid 4X5L","Cost of Goods Sold","Zelia Multipurpose Liquid Soap",,"Undeposited Funds",229.37,"",391730.23
,"Sales Receipt","02-10-2024","3228",,"Cash Sales","Zelia Green Multipurpose Liquid 12X1L","Cost of Goods Sold","Zelia Multipurpose Liquid Soap",,"Undeposited Funds",246.97,"",391977.20
,"Invoice","03-10-2024","MC06224",,"THE REAL IPM COMPANY (KENYA)LIMITED","Zelia Green Multipurpose Liquid Detergent 20L","Cost of Goods Sold","Zelia Multipurpose Liquid Soap",,"Accounts Receivable",3635.38,"",395612.58
,"Sales Receipt","03-10-2024","3241",,"Cash Sales","Zelia Green Multipurpose Liquid 4X5L","Cost of Goods Sold","Zelia Multipurpose Liquid Soap",,"Undeposited Funds",229.37,"",395841.95
,"Sales Receipt","03-10-2024","3243",,"Cash Sales","Zelia Green Multipurpose Liquid 4X5L","Cost of Goods Sold","Zelia Multipurpose Liquid Soap",,"Undeposited Funds",229.37,"",396071.32
,"Sales Receipt","04-10-2024","3253",,"Cash Sales","Zelia Green Multipurpose Liquid 12X1L","Cost of Goods Sold","Zelia Multipurpose Liquid Soap",,"Undeposited Funds",61.74,"",396133.06
,"Sales Receipt","06-10-2024","3184",,"Precious Mart","Zelia Green Multipurpose Liquid 24X500ML","Cost of Goods Sold","Zelia Multipurpose Liquid Soap",,"Undeposited Funds",102.68,"",396235.74
,"Sales Receipt","06-10-2024","3422",,"Mikara Shop","Zelia Green Multipurpose Liquid 12X1L","Cost of Goods Sold","Zelia Multipurpose Liquid Soap",,"Undeposited Funds",123.49,"",396359.23
,"Sales Receipt","06-10-2024","3423",,"Jikweri Minimart","Zelia Green Multipurpose Liquid 24X500ML","Cost of Goods Sold","Zelia Multipurpose Liquid Soap",,"Undeposited Funds",68.45,"",396427.68
,"Sales Receipt","07-10-2024","3255",,"Cash Sales","Zelia Green Multipurpose Liquid 4X5L","Cost of Goods Sold","Zelia Multipurpose Liquid Soap",,"Undeposited Funds",688.11,"",397115.79
,"Sales Receipt","08-10-2024","3261",,"Cash Sales","Zelia Green Multipurpose Liquid 4X5L","Cost of Goods Sold","Zelia Multipurpose Liquid Soap",,"Undeposited Funds",470.44,"",397586.23
,"Sales Receipt","08-10-2024","3263",,"Cash Sales","Zelia Green Multipurpose Liquid 4X5L","Cost of Goods Sold","Zelia Multipurpose Liquid Soap",,"Undeposited Funds",470.44,"",398056.67
,"Sales Receipt","08-10-2024","3264",,"Cash Sales","Zelia Green Multipurpose Liquid 4X5L","Cost of Goods Sold","Zelia Multipurpose Liquid Soap",,"Undeposited Funds",235.22,"",398291.89
,"Sales Receipt","08-10-2024","3267",,"Cash Sales","Zelia Green Multipurpose Liquid 4X5L","Cost of Goods Sold","Zelia Multipurpose Liquid Soap",,"Undeposited Funds",235.22,"",398527.11
,"Sales Receipt","08-10-2024","3270",,"Cash Sales","Zelia Green Multipurpose Liquid 24X500ML","Cost of Goods Sold","Zelia Multipurpose Liquid Soap",,"Undeposited Funds",34.23,"",398561.34
,"Sales Receipt","09-10-2024","3274",,"Cash Sales","Zelia Green Multipurpose Liquid 4X5L","Cost of Goods Sold","Zelia Multipurpose Liquid Soap",,"Undeposited Funds",0.00,"",398561.34
,"Sales Receipt","09-10-2024","3275",,"Cash Sales","Zelia Green Multipurpose Liquid 4X5L","Cost of Goods Sold","Zelia Multipurpose Liquid Soap",,"Undeposited Funds",235.22,"",398796.56
,"Sales Receipt","09-10-2024","3276",,"Cash Sales","Zelia Green Multipurpose Liquid 12X1L","Cost of Goods Sold","Zelia Multipurpose Liquid Soap",,"Undeposited Funds",61.74,"",398858.30
,"Sales Receipt","09-10-2024","3279",,"Cash Sales","Zelia Green Multipurpose Liquid 4X5L","Cost of Goods Sold","Zelia Multipurpose Liquid Soap",,"Undeposited Funds",235.22,"",399093.52
,"Invoice","11-10-2024","MC06251",,"HOPEMART SELF SERVICES LTD","Zelia Green Multipurpose Liquid 12X1L  6 Pieces @183.28","Cost of Goods Sold","Zelia Multipurpose Liquid Soap",,"Accounts Receivable",370.45,"",399463.97
,"Sales Receipt","11-10-2024","3289",,"Cash Sales","Zelia Green Multipurpose Liquid 4X5L","Cost of Goods Sold","Zelia Multipurpose Liquid Soap",,"Undeposited Funds",235.22,"",399699.19
,"Sales Receipt","11-10-2024","3291",,"Cash Sales","Zelia Green Multipurpose Liquid 12X1L","Cost of Goods Sold","Zelia Multipurpose Liquid Soap",,"Undeposited Funds",123.49,"",399822.68
,"Sales Receipt","12-10-2024","3294",,"Afrodrip JKIA","Zelia Green Multipurpose Liquid 4X5L","Cost of Goods Sold","Zelia Multipurpose Liquid Soap",,"Undeposited Funds",940.88,"",400763.56
,"Sales Receipt","14-10-2024","3297",,"Cash Sales","Zelia Green Multipurpose Liquid 4X5L","Cost of Goods Sold","Zelia Multipurpose Liquid Soap",,"Undeposited Funds",470.44,"",401234.00
,"Sales Receipt","14-10-2024","3102",,"Cash Sales","Zelia Green Multipurpose Liquid 12X1L","Cost of Goods Sold","Zelia Multipurpose Liquid Soap",,"Undeposited Funds",61.74,"",401295.74
,"Sales Receipt","14-10-2024","3103",,"Cash Sales","Zelia Green Multipurpose Liquid 4X5L","Cost of Goods Sold","Zelia Multipurpose Liquid Soap",,"Undeposited Funds",235.22,"",401530.96
,"Sales Receipt","14-10-2024","3178",,"Adam Mart","Zelia Green Multipurpose Liquid 24X500ML","Cost of Goods Sold","Zelia Multipurpose Liquid Soap",,"Undeposited Funds",410.71,"",401941.67
,"Sales Receipt","15-10-2024","3187",,"Big Fish Minimart","Zelia Green Multipurpose Liquid 12X1L","Cost of Goods Sold","Zelia Multipurpose Liquid Soap",,"Undeposited Funds",185.23,"",402126.90
,"Sales Receipt","16-10-2024","3109",,"Cash Sales","Zelia Green Multipurpose Liquid 4X5L","Cost of Goods Sold","Zelia Multipurpose Liquid Soap",,"Undeposited Funds",235.22,"",402362.12
,"Sales Receipt","16-10-2024","3114",,"Bismillahi Shop","Zelia Green Multipurpose Liquid 24X500ML","Cost of Goods Sold","Zelia Multipurpose Liquid Soap",,"Undeposited Funds",410.71,"",402772.83
,"Invoice","17-10-2024","MC06269",,"MUHINDI MWEUSI SUPERMARKET LIMITED","-MULTIPLE-","Cost of Goods Sold","Zelia Multipurpose Liquid Soap",,"Accounts Receivable",1151.62,"",403924.45
,"Sales Receipt","17-10-2024","3116",,"Cash Sales","Zelia Green Multipurpose Liquid 24X500ML","Cost of Goods Sold","Zelia Multipurpose Liquid Soap",,"Undeposited Funds",68.45,"",403992.90
,"Sales Receipt","17-10-2024","3120",,"Cash Sales","Zelia Green Multipurpose Liquid 24X500ML","Cost of Goods Sold","Zelia Multipurpose Liquid Soap",,"Undeposited Funds",1642.84,"",405635.74
,"Sales Receipt","18-10-2024","3121",,"Cash Sales","Zelia Green Multipurpose Liquid 4X5L","Cost of Goods Sold","Zelia Multipurpose Liquid Soap",,"Undeposited Funds",235.22,"",405870.96
,"Sales Receipt","18-10-2024","3125",,"Cash Sales","Zelia Green Multipurpose Liquid 12X1L","Cost of Goods Sold","Zelia Multipurpose Liquid Soap",,"Undeposited Funds",61.74,"",405932.70
,"Sales Receipt","18-10-2024","3129",,"Cash Sales","Zelia Green Multipurpose Liquid 4X5L","Cost of Goods Sold","Zelia Multipurpose Liquid Soap",,"Undeposited Funds",235.22,"",406167.92
,"Sales Receipt","19-10-2024","3179",,"Kweli Shop","-MULTIPLE-","Cost of Goods Sold","Zelia Multipurpose Liquid Soap",,"Undeposited Funds",496.61,"",406664.53
,"Sales Receipt","22-10-2024","3131",,"Cash Sales","Zelia Green Multipurpose Liquid 4X5L","Cost of Goods Sold","Zelia Multipurpose Liquid Soap",,"Undeposited Funds",235.22,"",406899.75
,"Sales Receipt","23-10-2024","3136",,"Cash Sales","Zelia Green Multipurpose Liquid 4X5L","Cost of Goods Sold","Zelia Multipurpose Liquid Soap",,"Undeposited Funds",235.22,"",407134.97
,"Sales Receipt","23-10-2024","3138",,"Cash Sales","Zelia Green Multipurpose Liquid 4X5L","Cost of Goods Sold","Zelia Multipurpose Liquid Soap",,"Undeposited Funds",235.22,"",407370.19
,"Sales Receipt","23-10-2024","3142",,"Cash Sales","Zelia Green Multipurpose Liquid 12X1L","Cost of Goods Sold","Zelia Multipurpose Liquid Soap",,"Undeposited Funds",61.74,"",407431.93
,"Sales Receipt","23-10-2024","3144",,"Cash Sales","Zelia Green Multipurpose Liquid 12X1L","Cost of Goods Sold","Zelia Multipurpose Liquid Soap",,"Undeposited Funds",61.74,"",407493.67
,"Sales Receipt","23-10-2024","3145",,"Cash Sales","Zelia Green Multipurpose Liquid 24X500ML","Cost of Goods Sold","Zelia Multipurpose Liquid Soap",,"Undeposited Funds",34.23,"",407527.90
,"Sales Receipt","23-10-2024","3141",,"Kibibi Wasai Store","Zelia Green Multipurpose Liquid 12X1L","Cost of Goods Sold","Zelia Multipurpose Liquid Soap",,"Undeposited Funds",1605.30,"",409133.20
,"Invoice","24-10-2024","MC06290",,"THE REAL IPM COMPANY (KENYA)LIMITED","Zelia Green Multipurpose Liquid Detergent 20L","Cost of Goods Sold","Zelia Multipurpose Liquid Soap",,"Accounts Receivable",3663.99,"",412797.19
,"Sales Receipt","24-10-2024","3147",,"Cash Sales","Zelia Green Multipurpose Liquid 4X5L","Cost of Goods Sold","Zelia Multipurpose Liquid Soap",,"Undeposited Funds",235.22,"",413032.41
,"Sales Receipt","24-10-2024","3148",,"Cash Sales","Zelia Green Multipurpose Liquid 4X5L","Cost of Goods Sold","Zelia Multipurpose Liquid Soap",,"Undeposited Funds",235.22,"",413267.63
,"Sales Receipt","24-10-2024","3165",,"Mombasa Velvet","Zelia Green Multipurpose Liquid 4X5L","Cost of Goods Sold","Zelia Multipurpose Liquid Soap",,"Undeposited Funds",235.22,"",413502.85
,"Sales Receipt","24-10-2024","3153",,"Golden Store","Zelia Green Multipurpose Liquid 12X1L","Cost of Goods Sold","Zelia Multipurpose Liquid Soap",,"Undeposited Funds",1481.81,"",414984.66
,"Invoice","25-10-2024","MC06300",,"HAPPY VIEW SUPERMARKET LIMITED","Zelia Green Multipurpose Liquid 24X500ML  6Pcs @102","Cost of Goods Sold","Zelia Multipurpose Liquid Soap",,"Accounts Receivable",205.35,"",415190.01
,"Sales Receipt","25-10-2024","3159",,"Marris Mini mart","Zelia Green Multipurpose Liquid 24X500ML","Cost of Goods Sold","Zelia Multipurpose Liquid Soap",,"Undeposited Funds",102.68,"",415292.69
,"Sales Receipt","26-10-2024","3161",,"Cash Sales","Zelia Green Multipurpose Liquid 4X5L","Cost of Goods Sold","Zelia Multipurpose Liquid Soap",,"Undeposited Funds",235.22,"",415527.91
,"Invoice","28-10-2024","MC06313",,"MUHINDI MWEUSI SUPERMARKET LIMITED","-MULTIPLE-","Cost of Goods Sold","Zelia Multipurpose Liquid Soap",,"Accounts Receivable",1151.62,"",416679.53
,"Sales Receipt","28-10-2024","3166",,"Cash Sales","Zelia Green Multipurpose Liquid 4X5L","Cost of Goods Sold","Zelia Multipurpose Liquid Soap",,"Undeposited Funds",235.22,"",416914.75
,"Sales Receipt","28-10-2024","3181",,"Mahitaji Store","Zelia Green Multipurpose Liquid 12X1L","Cost of Goods Sold","Zelia Multipurpose Liquid Soap",,"Undeposited Funds",308.71,"",417223.46
,"Sales Receipt","29-10-2024","3169",,"Cash Sales","Zelia Green Multipurpose Liquid 4X5L","Cost of Goods Sold","Zelia Multipurpose Liquid Soap",,"Undeposited Funds",235.22,"",417458.68
,"Sales Receipt","29-10-2024","3170",,"Cash Sales","Zelia Green Multipurpose Liquid 12X1L","Cost of Goods Sold","Zelia Multipurpose Liquid Soap",,"Undeposited Funds",61.74,"",417520.42
,"Sales Receipt","29-10-2024","3704",,"Home Soko Minimart","-MULTIPLE-","Cost of Goods Sold","Zelia Multipurpose Liquid Soap",,"Undeposited Funds",524.52,"",418044.94
,"Invoice","30-10-2024","MC06322",,"OFFSHORE GLOBAL LOGISTICS LIMITED","-MULTIPLE-","Cost of Goods Sold","Zelia Multipurpose Liquid Soap",,"Accounts Receivable",968.02,"",419012.96
,"Sales Receipt","31-10-2024","3192",,"Cash Sales","Zelia Green Multipurpose Liquid 4X5L","Cost of Goods Sold","Zelia Multipurpose Liquid Soap",,"Undeposited Funds",705.66,"",419718.62
,"Sales Receipt","01-11-2024","3417",,"Cash Sales","Zelia Green Multipurpose Liquid 4X5L","Cost of Goods Sold","Zelia Multipurpose Liquid Soap",,"Undeposited Funds",705.66,"",420424.28
,"Sales Receipt","04-11-2024","3708",,"Gure Yare Shop","Zelia Green Multipurpose Liquid 4X5L","Cost of Goods Sold","Zelia Multipurpose Liquid Soap",,"Undeposited Funds",2822.63,"",423246.91
,"Sales Receipt","04-11-2024","3453",,"Zambia Shopping Centre","Zelia Green Multipurpose Liquid 24X500ML","Cost of Goods Sold","Zelia Multipurpose Liquid Soap",,"Undeposited Funds",416.27,"",423663.18
,"Sales Receipt","05-11-2024","3714",,"Marris Mini mart","Zelia Green Multipurpose Liquid 24X500ML","Cost of Goods Sold","Zelia Multipurpose Liquid Soap",,"Undeposited Funds",104.07,"",423767.25
,"Invoice","06-11-2024","MC06335",,"Guard Mart Supermarket Limited","-MULTIPLE-","Cost of Goods Sold","Zelia Multipurpose Liquid Soap",,"Accounts Receivable",96.43,"",423863.68
,"Sales Receipt","06-11-2024","3199",,"Cash Sales","Zelia Green Multipurpose Liquid 12X1L","Cost of Goods Sold","Zelia Multipurpose Liquid Soap",,"Undeposited Funds",123.49,"",423987.17
,"Sales Receipt","06-11-2024","3402",,"Cash Sales","-MULTIPLE-","Cost of Goods Sold","Zelia Multipurpose Liquid Soap",,"Undeposited Funds",443.35,"",424430.52
,"Sales Receipt","06-11-2024","3715",,"Mama Amina","Zelia Green Multipurpose Liquid 12X1L","Cost of Goods Sold","Zelia Multipurpose Liquid Soap",,"Undeposited Funds",740.91,"",425171.43
,"Invoice","07-11-2024","MC06338",,"Khetshi Dharamshi And Company Limited","Zelia Green Multipurpose Liquid Detergent Lite 20L","Cost of Goods Sold","Zelia Multipurpose Liquid Soap",,"Accounts Receivable",3784.74,"",428956.17
,"Sales Receipt","07-11-2024","3406",,"Cash Sales","Zelia Green Multipurpose Liquid 4X5L","Cost of Goods Sold","Zelia Multipurpose Liquid Soap",,"Undeposited Funds",235.22,"",429191.39
,"Sales Receipt","07-11-2024","3239",,"Cash Sales","Zelia Green Multipurpose Liquid 4X5L","Cost of Goods Sold","Zelia Multipurpose Liquid Soap",,"Undeposited Funds",940.88,"",430132.27
,"Sales Receipt","07-11-2024","3457",,"Dylyn Enterprise","Zelia Green Multipurpose Liquid 12X1L","Cost of Goods Sold","Zelia Multipurpose Liquid Soap",,"Undeposited Funds",246.97,"",430379.24
,"Invoice","08-11-2024","MC06346",,"KIRINYAGA FLOUR MILLS LIMITED","Zelia Green Multipurpose Liquid Detergent 20L","Cost of Goods Sold","Zelia Multipurpose Liquid Soap",,"Accounts Receivable",732.80,"",431112.04
,"Sales Receipt","08-11-2024","3408",,"Cash Sales","Zelia Green Multipurpose Liquid 4X5L","Cost of Goods Sold","Zelia Multipurpose Liquid Soap",,"Undeposited Funds",235.22,"",431347.26
,"Sales Receipt","08-11-2024","3409",,"Cash Sales","Zelia Green Multipurpose Liquid 4X5L","Cost of Goods Sold","Zelia Multipurpose Liquid Soap",,"Undeposited Funds",470.44,"",431817.70
,"Sales Receipt","08-11-2024","3410",,"Cash Sales","Zelia Green Multipurpose Liquid 4X5L","Cost of Goods Sold","Zelia Multipurpose Liquid Soap",,"Undeposited Funds",940.88,"",432758.58
,"Sales Receipt","08-11-2024","3458",,"Mama Sam Shop","Zelia Green Multipurpose Liquid 24X500ML","Cost of Goods Sold","Zelia Multipurpose Liquid Soap",,"Undeposited Funds",173.44,"",432932.02
,"Sales Receipt","11-11-2024","3420",,"Cash Sales","Zelia Green Multipurpose Liquid 20L","Cost of Goods Sold","Zelia Multipurpose Liquid Soap",,"Undeposited Funds",732.80,"",433664.82
,"Sales Receipt","11-11-2024","3456",,"RichMind Property","Zelia Green Multipurpose Liquid 4X5L","Cost of Goods Sold","Zelia Multipurpose Liquid Soap",,"Undeposited Funds",235.22,"",433900.04
,"Sales Receipt","12-11-2024","3431",,"Cash Sales","-MULTIPLE-","Cost of Goods Sold","Zelia Multipurpose Liquid Soap",,"Undeposited Funds",13643.53,"",447543.57
,"Invoice","13-11-2024","MC06356",,"Mumsha Supamat","Zelia Green Multipurpose Liquid 24X500ML  6Pieces @105","Cost of Goods Sold","Zelia Multipurpose Liquid Soap",,"Accounts Receivable",208.13,"",447751.70
,"Sales Receipt","13-11-2024","3434",,"Cash Sales","Zelia Green Multipurpose Liquid 4X5L","Cost of Goods Sold","Zelia Multipurpose Liquid Soap",,"Undeposited Funds",470.44,"",448222.14
,"Sales Receipt","15-11-2024","3448",,"Cash Sales","Zelia Green Multipurpose Liquid 4X5L","Cost of Goods Sold","Zelia Multipurpose Liquid Soap",,"Undeposited Funds",235.22,"",448457.36
,"Sales Receipt","15-11-2024","3732",,"Cash Sales","Zelia Green Multipurpose Liquid 4X5L","Cost of Goods Sold","Zelia Multipurpose Liquid Soap",,"Undeposited Funds",235.22,"",448692.58
,"Invoice","18-11-2024","MC06372",,"Guard Mart Supermarket Limited","-MULTIPLE-","Cost of Goods Sold","Zelia Multipurpose Liquid Soap",,"Accounts Receivable",1573.45,"",450266.03
,"Credit Note","18-11-2024","CN01073",,"Guard Mart Supermarket Limited","-MULTIPLE-","Cost of Goods Sold","Zelia Multipurpose Liquid Soap",,"Accounts Receivable","",96.43,450169.60
,"Sales Receipt","18-11-2024","AT200",,"Cash Sales","Zelia Green Multipurpose Liquid 20L","Cost of Goods Sold","Zelia Multipurpose Liquid Soap",,"Undeposited Funds",3663.99,"",453833.59
,"Sales Receipt","18-11-2024","3451",,"Cash Sales","Zelia Green Multipurpose Liquid 12X1L","Cost of Goods Sold","Zelia Multipurpose Liquid Soap",,"Undeposited Funds",61.74,"",453895.33
,"Sales Receipt","18-11-2024","3468",,"Cash Sales","Zelia Green Multipurpose Liquid 4X5L","Cost of Goods Sold","Zelia Multipurpose Liquid Soap",,"Undeposited Funds",470.44,"",454365.77
,"Sales Receipt","18-11-2024","3469",,"Cash Sales","Zelia Green Multipurpose Liquid 24X500ML","Cost of Goods Sold","Zelia Multipurpose Liquid Soap",,"Undeposited Funds",34.69,"",454400.46
,"Sales Receipt","18-11-2024","3472",,"Cash Sales","Zelia Green Multipurpose Liquid 4X5L","Cost of Goods Sold","Zelia Multipurpose Liquid Soap",,"Undeposited Funds",235.22,"",454635.68
,"Sales Receipt","18-11-2024","3473",,"Cash Sales","Zelia Green Multipurpose Liquid 24X500ML","Cost of Goods Sold","Zelia Multipurpose Liquid Soap",,"Undeposited Funds",34.69,"",454670.37
,"Sales Receipt","18-11-2024","3495",,"Murume Shop","-MULTIPLE-","Cost of Goods Sold","Zelia Multipurpose Liquid Soap",,"Undeposited Funds",289.30,"",454959.67
,"Sales Receipt","18-11-2024","3463",,"Gifted Shop","Zelia Green Multipurpose Liquid 12X1L","Cost of Goods Sold","Zelia Multipurpose Liquid Soap",,"Undeposited Funds",246.97,"",455206.64
,"Invoice","19-11-2024","MC06377",,"THE REAL IPM COMPANY (KENYA)LIMITED","Zelia Green Multipurpose Liquid Detergent 20L","Cost of Goods Sold","Zelia Multipurpose Liquid Soap",,"Accounts Receivable",3663.99,"",458870.63
,"Sales Receipt","20-11-2024","3477",,"Cash Sales","Zelia Green Multipurpose Liquid 24X500ML","Cost of Goods Sold","Zelia Multipurpose Liquid Soap",,"Undeposited Funds",34.69,"",458905.32
,"Sales Receipt","21-11-2024","3483",,"Cash Sales","Zelia Green Multipurpose Liquid 4X5L","Cost of Goods Sold","Zelia Multipurpose Liquid Soap",,"Undeposited Funds",235.22,"",459140.54
,"Sales Receipt","21-11-2024","3496",,"infinity Store","Zelia Green Multipurpose Liquid 4X5L","Cost of Goods Sold","Zelia Multipurpose Liquid Soap",,"Undeposited Funds",705.66,"",459846.20
,"Sales Receipt","22-11-2024","3484",,"Cash Sales","Zelia Green Multipurpose Liquid 4X5L","Cost of Goods Sold","Zelia Multipurpose Liquid Soap",,"Undeposited Funds",235.22,"",460081.42
,"Sales Receipt","22-11-2024","3486",,"Cash Sales","Zelia Green Multipurpose Liquid 12X1L","Cost of Goods Sold","Zelia Multipurpose Liquid Soap",,"Undeposited Funds",61.74,"",460143.16
,"Sales Receipt","22-11-2024","3488",,"Cash Sales","Zelia Green Multipurpose Liquid 24X500ML","Cost of Goods Sold","Zelia Multipurpose Liquid Soap",,"Undeposited Funds",208.13,"",460351.29
,"Sales Receipt","22-11-2024","3499",,"Cash Sales","Zelia Green Multipurpose Liquid 4X5L","Cost of Goods Sold","Zelia Multipurpose Liquid Soap",,"Undeposited Funds",470.44,"",460821.73
,"Sales Receipt","22-11-2024","3302",,"Cash Sales","Zelia Green Multipurpose Liquid 12X1L","Cost of Goods Sold","Zelia Multipurpose Liquid Soap",,"Undeposited Funds",61.74,"",460883.47
,"Sales Receipt","22-11-2024","3734",,"Cash Sales","Zelia Green Multipurpose Liquid 24X500ML","Cost of Goods Sold","Zelia Multipurpose Liquid Soap",,"Undeposited Funds",34.69,"",460918.16
,"Sales Receipt","22-11-2024","3735",,"Cash Sales","Zelia Green Multipurpose Liquid 4X5L","Cost of Goods Sold","Zelia Multipurpose Liquid Soap",,"Undeposited Funds",235.22,"",461153.38
,"Sales Receipt","22-11-2024","3494",,"Asfa Shop","-MULTIPLE-","Cost of Goods Sold","Zelia Multipurpose Liquid Soap",,"Undeposited Funds",289.30,"",461442.68
,"Sales Receipt","25-11-2024","3763",,"Domie Shop","Zelia Green Multipurpose Liquid 24X500ML","Cost of Goods Sold","Zelia Multipurpose Liquid Soap",,"Undeposited Funds",138.76,"",461581.44
,"Sales Receipt","26-11-2024","3737",,"Cash Sales","Zelia Green Multipurpose Liquid 4X5L","Cost of Goods Sold","Zelia Multipurpose Liquid Soap",,"Undeposited Funds",235.22,"",461816.66
,"Sales Receipt","26-11-2024","3500",,"Cash Sales","Zelia Green Multipurpose Liquid 4X5L","Cost of Goods Sold","Zelia Multipurpose Liquid Soap",,"Undeposited Funds",235.22,"",462051.88
,"Sales Receipt","26-11-2024","3740",,"Afrodrip JKIA","Zelia Green Multipurpose Liquid 4X5L","Cost of Goods Sold","Zelia Multipurpose Liquid Soap",,"Undeposited Funds",1176.10,"",463227.98
,"Sales Receipt","27-11-2024","3742",,"Cash Sales","Zelia Green Multipurpose Liquid 4X5L","Cost of Goods Sold","Zelia Multipurpose Liquid Soap",,"Undeposited Funds",470.44,"",463698.42
,"Sales Receipt","27-11-2024","3739",,"Eugombe Enterprises","Zelia Green Multipurpose Liquid 24X500ML","Cost of Goods Sold","Zelia Multipurpose Liquid Soap",,"Undeposited Funds",832.54,"",464530.96
,"Sales Receipt","28-11-2024","3750",,"Cash Sales","Zelia Green Multipurpose Liquid 4X5L","Cost of Goods Sold","Zelia Multipurpose Liquid Soap",,"Undeposited Funds",470.44,"",465001.40
,"Invoice","29-11-2024","MC06427",,"THE REAL IPM COMPANY (KENYA)LIMITED","Zelia Green Multipurpose Liquid Detergent 20L","Cost of Goods Sold","Zelia Multipurpose Liquid Soap",,"Accounts Receivable",3663.99,"",468665.39
,"Sales Receipt","29-11-2024","3754",,"Cash Sales","Zelia Green Multipurpose Liquid 12X1L","Cost of Goods Sold","Zelia Multipurpose Liquid Soap",,"Undeposited Funds",61.74,"",468727.13
,"Sales Receipt","29-11-2024","3755",,"Cash Sales","Zelia Green Multipurpose Liquid 4X5L","Cost of Goods Sold","Zelia Multipurpose Liquid Soap",,"Undeposited Funds",235.22,"",468962.35
,"Sales Receipt","29-11-2024","3757",,"Cash Sales","Zelia Green Multipurpose Liquid 4X5L","Cost of Goods Sold","Zelia Multipurpose Liquid Soap",,"Undeposited Funds",235.22,"",469197.57
,"Sales Receipt","29-11-2024","3758",,"Cash Sales","Zelia Green Multipurpose Liquid 20L","Cost of Goods Sold","Zelia Multipurpose Liquid Soap",,"Undeposited Funds",732.80,"",469930.37
,"Sales Receipt","29-11-2024","3789",,"Ubwete Shop","-MULTIPLE-","Cost of Goods Sold","Zelia Multipurpose Liquid Soap",,"Undeposited Funds",578.58,"",470508.95
,"Sales Receipt","30-11-2024","3760",,"Cash Sales","Zelia Green Multipurpose Liquid 12X1L","Cost of Goods Sold","Zelia Multipurpose Liquid Soap",,"Undeposited Funds",123.49,"",470632.44
,"Sales Receipt","30-11-2024","AT203",,"Cash Sales","Zelia Green Multipurpose Liquid 4X5L","Cost of Goods Sold","Zelia Multipurpose Liquid Soap",,"Undeposited Funds",5645.27,"",476277.71
,"Sales Receipt","02-12-2024","3761",,"Cash Sales","Zelia Green Multipurpose Liquid 4X5L","Cost of Goods Sold","Zelia Multipurpose Liquid Soap",,"Undeposited Funds",235.22,"",476512.93
,"Sales Receipt","02-12-2024","3767",,"Cash Sales","Zelia Green Multipurpose Liquid 4X5L","Cost of Goods Sold","Zelia Multipurpose Liquid Soap",,"Undeposited Funds",235.22,"",476748.15
,"Sales Receipt","02-12-2024","3778",,"Cash Sales","Zelia Green Multipurpose Liquid 4X5L","Cost of Goods Sold","Zelia Multipurpose Liquid Soap",,"Undeposited Funds",235.22,"",476983.37
,"Invoice","03-12-2024","MC06435",,"KIRINYAGA FLOUR MILLS LIMITED","Zelia Green Multipurpose Liquid Detergent 20L","Cost of Goods Sold","Zelia Multipurpose Liquid Soap",,"Accounts Receivable",732.80,"",477716.17
,"Invoice","05-12-2024","MC06447",,"NASRI MART LIMITED","Zelia Green Multipurpose Liquid 24X500Ml  6Pcs@116","Cost of Goods Sold","Zelia Multipurpose Liquid Soap",,"Accounts Receivable",208.13,"",477924.30
,"Invoice","09-12-2024","MC06452",,"DISII TRADERS LTD","Zelia Green Multipurpose Liquid 24X500ML  12Pcs @102","Cost of Goods Sold","Zelia Multipurpose Liquid Soap",,"Accounts Receivable",416.27,"",478340.57
,"Invoice","09-12-2024","MC06454",,"THE REAL IPM COMPANY (KENYA)LIMITED","Zelia Green Multipurpose Liquid Detergent 20L","Cost of Goods Sold","Zelia Multipurpose Liquid Soap",,"Accounts Receivable",3663.99,"",482004.56
,"Invoice","09-12-2024","MC06456",,"OFFSHORE GLOBAL LOGISTICS LIMITED","-MULTIPLE-","Cost of Goods Sold","Zelia Multipurpose Liquid Soap",,"Accounts Receivable",968.04,"",482972.60
,"Sales Receipt","09-12-2024","3313",,"Cash Sales","Zelia Green Multipurpose Liquid 4X5L","Cost of Goods Sold","Zelia Multipurpose Liquid Soap",,"Undeposited Funds",470.47,"",483443.07
,"Sales Receipt","09-12-2024","3316",,"Cash Sales","Zelia Green Multipurpose Liquid 4X5L","Cost of Goods Sold","Zelia Multipurpose Liquid Soap",,"Undeposited Funds",235.24,"",483678.31
,"Sales Receipt","09-12-2024","3317",,"Cash Sales","Zelia Green Multipurpose Liquid 12X1L","Cost of Goods Sold","Zelia Multipurpose Liquid Soap",,"Undeposited Funds",61.74,"",483740.05
,"Sales Receipt","09-12-2024","3318",,"Cash Sales","Zelia Green Multipurpose Liquid 4X5L","Cost of Goods Sold","Zelia Multipurpose Liquid Soap",,"Undeposited Funds",470.47,"",484210.52
,"Sales Receipt","09-12-2024","3315",,"Shop 5","-MULTIPLE-","Cost of Goods Sold","Zelia Multipurpose Liquid Soap",,"Undeposited Funds",1573.45,"",485783.97
,"Sales Receipt","10-12-2024","3347",,"Beta Traders","Zelia Green Multipurpose Liquid 24X500ML","Cost of Goods Sold","Zelia Multipurpose Liquid Soap",,"Undeposited Funds",416.27,"",486200.24
,"Sales Receipt","12-12-2024","3337",,"Mombasa Velvet","Zelia Green Multipurpose Liquid 4X5L","Cost of Goods Sold","Zelia Multipurpose Liquid Soap",,"Undeposited Funds",470.47,"",486670.71
,"Sales Receipt","13-12-2024","3340",,"Cash Sales","Zelia Green Multipurpose Liquid 4X5L","Cost of Goods Sold","Zelia Multipurpose Liquid Soap",,"Undeposited Funds",235.24,"",486905.95
,"Sales Receipt","14-12-2024","3378",,"Egesa Shop","Zelia Green Multipurpose Liquid 12X1L","Cost of Goods Sold","Zelia Multipurpose Liquid Soap",,"Undeposited Funds",185.23,"",487091.18
,"Sales Receipt","16-12-2024","3342",,"Cash Sales","Zelia Green Multipurpose Liquid 12X1L","Cost of Goods Sold","Zelia Multipurpose Liquid Soap",,"Undeposited Funds",61.74,"",487152.92
,"Sales Receipt","16-12-2024","3345",,"Cash Sales","-MULTIPLE-","Cost of Goods Sold","Zelia Multipurpose Liquid Soap",,"Undeposited Funds",296.98,"",487449.90
,"Sales Receipt","16-12-2024","3348",,"Cash Sales","Zelia Green Multipurpose Liquid 4X5L","Cost of Goods Sold","Zelia Multipurpose Liquid Soap",,"Undeposited Funds",235.24,"",487685.14
,"Sales Receipt","16-12-2024","3353",,"Cash Sales","Zelia Green Multipurpose Liquid 4X5L","Cost of Goods Sold","Zelia Multipurpose Liquid Soap",,"Undeposited Funds",470.47,"",488155.61
,"Invoice","17-12-2024","MC06476",,"MUHINDI MWEUSI SUPERMARKET LIMITED","-MULTIPLE-","Cost of Goods Sold","Zelia Multipurpose Liquid Soap",,"Accounts Receivable",1157.18,"",489312.79
,"Invoice","17-12-2024","MC06477",,"OFFSHORE GLOBAL LOGISTICS LIMITED","Zelia Green Multipurpose Liquid 4X5L","Cost of Goods Sold","Zelia Multipurpose Liquid Soap",,"Accounts Receivable",470.47,"",489783.26
,"Sales Receipt","18-12-2024","3360",,"Cash Sales","Zelia Green Multipurpose Liquid 4X5L","Cost of Goods Sold","Zelia Multipurpose Liquid Soap",,"Undeposited Funds",235.24,"",490018.50
,"Sales Receipt","18-12-2024","3361",,"Cash Sales","Zelia Green Multipurpose Liquid 4X5L","Cost of Goods Sold","Zelia Multipurpose Liquid Soap",,"Undeposited Funds",235.24,"",490253.74
,"Sales Receipt","18-12-2024","3362",,"Cash Sales","Zelia Green Multipurpose Liquid 4X5L","Cost of Goods Sold","Zelia Multipurpose Liquid Soap",,"Undeposited Funds",235.24,"",490488.98
,"Sales Receipt","18-12-2024","3363",,"Cash Sales","Zelia Green Multipurpose Liquid 12X1L","Cost of Goods Sold","Zelia Multipurpose Liquid Soap",,"Undeposited Funds",185.23,"",490674.21
,"Sales Receipt","18-12-2024","3372",,"Cash Sales","Zelia Green Multipurpose Liquid 4X5L","Cost of Goods Sold","Zelia Multipurpose Liquid Soap",,"Undeposited Funds",7057.05,"",497731.26
,"Sales Receipt","18-12-2024","3364",,"Gold mart Supermarket","Zelia Green Multipurpose Liquid 24X500ML","Cost of Goods Sold","Zelia Multipurpose Liquid Soap",,"Undeposited Funds",208.13,"",497939.39
,"Sales Receipt","19-12-2024","3373",,"Cash Sales","Zelia Green Multipurpose Liquid 4X5L","Cost of Goods Sold","Zelia Multipurpose Liquid Soap",,"Undeposited Funds",235.24,"",498174.63
,"Sales Receipt","20-12-2024","3376",,"Cash Sales","Zelia Green Multipurpose Liquid 4X5L","Cost of Goods Sold","Zelia Multipurpose Liquid Soap",,"Undeposited Funds",235.24,"",498409.87
,"Invoice","21-12-2024","MC06496",,"KIRINYAGA FLOUR MILLS LIMITED","Zelia Green Multipurpose Liquid Detergent 20L","Cost of Goods Sold","Zelia Multipurpose Liquid Soap",,"Accounts Receivable",732.80,"",499142.67
,"Invoice","23-12-2024","MC06497",,"KIRINYAGA FLOUR MILLS LIMITED","Zelia Green Multipurpose Liquid Detergent 20L","Cost of Goods Sold","Zelia Multipurpose Liquid Soap",,"Accounts Receivable",732.80,"",499875.47
,"Invoice","31-12-2024","MC06517",,"THE REAL IPM COMPANY (KENYA)LIMITED","Zelia Green Multipurpose Liquid Detergent 20L","Cost of Goods Sold","Zelia Multipurpose Liquid Soap",,"Accounts Receivable",3663.99,"",503539.46
"Total Zelia Multipurpose Liquid Soap",,,,,,,,,,,505154.42,1614.96,503539.46
"Zelia Handwash Liquid",,,,,,,,,,,,,""
,"Sales Receipt","03-01-2024","1592",,"Cash Sales","Zelia Apple Handwash Liquid 500ML","Cost of Goods Sold","Zelia Handwash Liquid",,"Undeposited Funds",170.87,"",170.87
,"Sales Receipt","03-01-2024","1594",,"ROYAL SEALS SUPERMARKET","-MULTIPLE-","Cost of Goods Sold","Zelia Handwash Liquid",,"Undeposited Funds",843.82,"",1014.69
,"Invoice","04-01-2024","MC05269",,"OFFSHORE GLOBAL LOGISTICS LIMITED","Zelia Strawberry Handwash Liquid 5L","Cost of Goods Sold","Zelia Handwash Liquid",,"Accounts Receivable",452.65,"",1467.34
,"Sales Receipt","04-01-2024","1704",,"Cash Sales","-MULTIPLE-","Cost of Goods Sold","Zelia Handwash Liquid",,"Undeposited Funds",112.60,"",1579.94
,"Sales Receipt","04-01-2024","1707",,"Mama Amina","-MULTIPLE-","Cost of Goods Sold","Zelia Handwash Liquid",,"Undeposited Funds",562.99,"",2142.93
,"Sales Receipt","05-01-2024","1711",,"Summer Outlets","-MULTIPLE-","Cost of Goods Sold","Zelia Handwash Liquid",,"Undeposited Funds",675.58,"",2818.51
,"Sales Receipt","07-01-2024","1714",,"Cash Sales","Zelia Strawberry Handwash Liquid 500ML","Cost of Goods Sold","Zelia Handwash Liquid",,"Undeposited Funds",55.64,"",2874.15
,"Sales Receipt","08-01-2024","1713",,"Cash Sales","Zelia Strawberry Handwash Liquid 5L","Cost of Goods Sold","Zelia Handwash Liquid",,"Undeposited Funds",226.33,"",3100.48
,"Sales Receipt","10-01-2024","1718",,"Memos Supermarket","-MULTIPLE-","Cost of Goods Sold","Zelia Handwash Liquid",,"Undeposited Funds",675.58,"",3776.06
,"Sales Receipt","12-01-2024","1733",,"Cash Sales","-MULTIPLE-","Cost of Goods Sold","Zelia Handwash Liquid",,"Undeposited Funds",281.97,"",4058.03
,"Invoice","15-01-2024","MC05311",,"Seasons lane Mart","-MULTIPLE-","Cost of Goods Sold","Zelia Handwash Liquid",,"Accounts Receivable",675.58,"",4733.61
,"Invoice","15-01-2024","MC05312",,"KASAMAT INVESTMENTS LTD","-MULTIPLE-","Cost of Goods Sold","Zelia Handwash Liquid",,"Accounts Receivable",337.80,"",5071.41
,"Sales Receipt","15-01-2024","1729",,"Cash Sales","Zelia Apple Handwash Liquid 500ML","Cost of Goods Sold","Zelia Handwash Liquid",,"Undeposited Funds",56.96,"",5128.37
,"Sales Receipt","15-01-2024","1730",,"tRIPPLE M","-MULTIPLE-","Cost of Goods Sold","Zelia Handwash Liquid",,"Undeposited Funds",337.80,"",5466.17
,"Sales Receipt","15-01-2024","1731",,"RAZAQ AIRWAYS","-MULTIPLE-","Cost of Goods Sold","Zelia Handwash Liquid",,"Undeposited Funds",2585.07,"",8051.24
,"Sales Receipt","15-01-2024","1732",,"Somo 1","-MULTIPLE-","Cost of Goods Sold","Zelia Handwash Liquid",,"Undeposited Funds",843.82,"",8895.06
,"Sales Receipt","16-01-2024","1740",,"Cash Sales","Zelia Strawberry Handwash Liquid 500ML","Cost of Goods Sold","Zelia Handwash Liquid",,"Undeposited Funds",55.64,"",8950.70
,"Sales Receipt","17-01-2024","1734",,"Cash Sales","Zelia Strawberry Handwash Liquid 5L","Cost of Goods Sold","Zelia Handwash Liquid",,"Undeposited Funds",678.98,"",9629.68
,"Sales Receipt","17-01-2024","1748",,"Yasin Shop","Zelia Apple Handwash Liquid 500ML","Cost of Goods Sold","Zelia Handwash Liquid",,"Undeposited Funds",56.96,"",9686.64
,"Invoice","19-01-2024","MC05331",,"Zenith Steel Fabricators Ltd","Zelia Strawberry Handwash Liquid 5L","Cost of Goods Sold","Zelia Handwash Liquid",,"Accounts Receivable",4526.53,"",14213.17
,"Sales Receipt","19-01-2024","1739",,"Cash Sales","-MULTIPLE-","Cost of Goods Sold","Zelia Handwash Liquid",,"Undeposited Funds",112.60,"",14325.77
,"Sales Receipt","19-01-2024","1744",,"Cash Sales","-MULTIPLE-","Cost of Goods Sold","Zelia Handwash Liquid",,"Undeposited Funds",1726.21,"",16051.98
,"Sales Receipt","19-01-2024","1747",,"Nyipola Minimart","-MULTIPLE-","Cost of Goods Sold","Zelia Handwash Liquid",,"Undeposited Funds",843.82,"",16895.80
,"Invoice","24-01-2024","MC05346",,"Qways Supermarket","-MULTIPLE-","Cost of Goods Sold","Zelia Handwash Liquid",,"Accounts Receivable",843.82,"",17739.62
,"Invoice","25-01-2024","MC05350",,"Drychem Kenya Solutions Limited","Zelia Strawberry Handwash Liquid 5L","Cost of Goods Sold","Zelia Handwash Liquid",,"Accounts Receivable",452.65,"",18192.27
,"Sales Receipt","25-01-2024","1758",,"Cash Sales","Zelia Strawberry Handwash Liquid 5L","Cost of Goods Sold","Zelia Handwash Liquid",,"Undeposited Funds",451.88,"",18644.15
,"Sales Receipt","29-01-2024","1759",,"Cash Sales","-MULTIPLE-","Cost of Goods Sold","Zelia Handwash Liquid",,"Undeposited Funds",337.80,"",18981.95
,"Sales Receipt","30-01-2024","1767",,"Cash Sales","Zelia Strawberry Handwash Liquid 500ML","Cost of Goods Sold","Zelia Handwash Liquid",,"Undeposited Funds",111.28,"",19093.23
,"Sales Receipt","30-01-2024","1770",,"Pambazuka Mart (K) Limited","-MULTIPLE-","Cost of Goods Sold","Zelia Handwash Liquid",,"Undeposited Funds",843.82,"",19937.05
,"Sales Receipt","31-01-2024","1773",,"Cash Sales","-MULTIPLE-","Cost of Goods Sold","Zelia Handwash Liquid",,"Undeposited Funds",225.19,"",20162.24
,"Sales Receipt","01-02-2024","1776",,"FARMERS BEST GROCERY","Zelia Apple Handwash Liquid 500ML","Cost of Goods Sold","Zelia Handwash Liquid",,"Undeposited Funds",341.73,"",20503.97
,"Invoice","02-02-2024","MC05378",,"MZOORI STORE LIMITED","Zelia Strawberry Handwash Liquid 500ML","Cost of Goods Sold","Zelia Handwash Liquid",,"Accounts Receivable",333.85,"",20837.82
,"Invoice","02-02-2024","MC05379",,"HOPEMART SELF SERVICES LTD","-MULTIPLE-","Cost of Goods Sold","Zelia Handwash Liquid",,"Accounts Receivable",1688.96,"",22526.78
,"Sales Receipt","02-02-2024","1783",,"Cheche Minimart","-MULTIPLE-","Cost of Goods Sold","Zelia Handwash Liquid",,"Undeposited Funds",337.80,"",22864.58
,"Sales Receipt","02-02-2024","1784",,"Kandara minimart","-MULTIPLE-","Cost of Goods Sold","Zelia Handwash Liquid",,"Undeposited Funds",337.80,"",23202.38
,"Sales Receipt","03-02-2024","1792",,"Soimo Minimart","-MULTIPLE-","Cost of Goods Sold","Zelia Handwash Liquid",,"Undeposited Funds",337.80,"",23540.18
,"Invoice","05-02-2024","MC05384",,"INTEGRAL MEDIA LIMITED","-MULTIPLE-","Cost of Goods Sold","Zelia Handwash Liquid",,"Accounts Receivable",1687.64,"",25227.82
,"Invoice","05-02-2024","MC05385",,"TAWALA SUPERMARKET LIMITED","-MULTIPLE-","Cost of Goods Sold","Zelia Handwash Liquid",,"Accounts Receivable",1351.16,"",26578.98
,"Sales Receipt","05-02-2024","1787",,"Cash Sales","Zelia Strawberry Handwash Liquid 500ML","Cost of Goods Sold","Zelia Handwash Liquid",,"Undeposited Funds",55.64,"",26634.62
,"Sales Receipt","05-02-2024","1791",,"The Hub Minimart","-MULTIPLE-","Cost of Goods Sold","Zelia Handwash Liquid",,"Undeposited Funds",225.19,"",26859.81
,"Sales Receipt","06-02-2024","1808",,"Cash Sales","Zelia Strawberry Handwash Liquid 500ML","Cost of Goods Sold","Zelia Handwash Liquid",,"Undeposited Funds",55.64,"",26915.45
,"Sales Receipt","08-02-2024","1814",,"Cash Sales","Zelia Strawberry Handwash Liquid 500ML","Cost of Goods Sold","Zelia Handwash Liquid",,"Undeposited Funds",55.64,"",26971.09
,"Sales Receipt","08-02-2024","1815",,"Cash Sales","Zelia Strawberry Handwash Liquid 500ML","Cost of Goods Sold","Zelia Handwash Liquid",,"Undeposited Funds",111.28,"",27082.37
,"Sales Receipt","09-02-2024","1828",,"Kwa Zulu Wholesale Utawala","Zelia Strawberry Handwash Liquid 500ML","Cost of Goods Sold","Zelia Handwash Liquid",,"Undeposited Funds",667.70,"",27750.07
,"Sales Receipt","10-02-2024","1821",,"Alma Mart","-MULTIPLE-","Cost of Goods Sold","Zelia Handwash Liquid",,"Undeposited Funds",337.80,"",28087.87
,"Invoice","12-02-2024","MC05396",,"OFFSHORE GLOBAL LOGISTICS LIMITED","Zelia Strawberry Handwash Liquid 20L","Cost of Goods Sold","Zelia Handwash Liquid",,"Accounts Receivable",786.52,"",28874.39
,"Invoice","12-02-2024","MC05400",,"KASAMAT INVESTMENTS LTD","Zelia Apple Handwash Liquid 500ML","Cost of Goods Sold","Zelia Handwash Liquid",,"Accounts Receivable",170.87,"",29045.26
,"Sales Receipt","12-02-2024","1822",,"Deeps General Shop","Zelia Strawberry Handwash Liquid 500ML","Cost of Goods Sold","Zelia Handwash Liquid",,"Undeposited Funds",111.28,"",29156.54
,"Sales Receipt","12-02-2024","1823",,"INTEGRAL MEDIA LIMITED","-MULTIPLE-","Cost of Goods Sold","Zelia Handwash Liquid",,"Undeposited Funds",2531.46,"",31688.00
,"Invoice","14-02-2024","MC05407",,"Qways Supermarket","-MULTIPLE-","Cost of Goods Sold","Zelia Handwash Liquid",,"Accounts Receivable",1351.16,"",33039.16
,"Sales Receipt","14-02-2024","1835",,"Bismillahi Shop","-MULTIPLE-","Cost of Goods Sold","Zelia Handwash Liquid",,"Undeposited Funds",675.58,"",33714.74
,"Sales Receipt","14-02-2024","1838",,"Cash Sales","Zelia Strawberry Handwash Liquid 5L","Cost of Goods Sold","Zelia Handwash Liquid",,"Undeposited Funds",225.54,"",33940.28
,"Sales Receipt","15-02-2024","1842",,"Gacal Wholesale","-MULTIPLE-","Cost of Goods Sold","Zelia Handwash Liquid",,"Undeposited Funds",675.58,"",34615.86
,"Sales Receipt","16-02-2024","1845",,"Cash Sales","Zelia Strawberry Handwash Liquid 500ML","Cost of Goods Sold","Zelia Handwash Liquid",,"Undeposited Funds",111.28,"",34727.14
,"Sales Receipt","16-02-2024","1847",,"Gidesh Supermarket","-MULTIPLE-","Cost of Goods Sold","Zelia Handwash Liquid",,"Undeposited Funds",675.58,"",35402.72
,"Sales Receipt","16-02-2024","1848",,"Cash Sales","Zelia Apple Handwash Liquid 500ML","Cost of Goods Sold","Zelia Handwash Liquid",,"Undeposited Funds",56.96,"",35459.68
,"Sales Receipt","19-02-2024","1850",,"Zamaridi wholesalers","-MULTIPLE-","Cost of Goods Sold","Zelia Handwash Liquid",,"Undeposited Funds",168.24,"",35627.92
,"Sales Receipt","20-02-2024","1854",,"Cash Sales","Zelia Strawberry Handwash Liquid 5L","Cost of Goods Sold","Zelia Handwash Liquid",,"Undeposited Funds",225.54,"",35853.46
,"Sales Receipt","21-02-2024","1855",,"Cash Sales","Zelia Apple Handwash Liquid 500ML","Cost of Goods Sold","Zelia Handwash Liquid",,"Undeposited Funds",56.96,"",35910.42
,"Sales Receipt","21-02-2024","1859",,"Cash Sales","Zelia Strawberry Handwash Liquid 500ML","Cost of Goods Sold","Zelia Handwash Liquid",,"Undeposited Funds",111.28,"",36021.70
,"Sales Receipt","21-02-2024","1860",,"Cash Sales","-MULTIPLE-","Cost of Goods Sold","Zelia Handwash Liquid",,"Undeposited Funds",337.80,"",36359.50
,"Sales Receipt","21-02-2024","1862",,"Ebenezer  Minimart","-MULTIPLE-","Cost of Goods Sold","Zelia Handwash Liquid",,"Undeposited Funds",337.80,"",36697.30
,"Sales Receipt","21-02-2024","1863",,"CLJ Baraka Enterprise","-MULTIPLE-","Cost of Goods Sold","Zelia Handwash Liquid",,"Undeposited Funds",675.58,"",37372.88
,"Invoice","22-02-2024","MC05429",,"INTEGRAL MEDIA LIMITED","-MULTIPLE-","Cost of Goods Sold","Zelia Handwash Liquid",,"Accounts Receivable",845.13,"",38218.01
,"Invoice","22-02-2024","MC05434",,"NASRI MART LIMITED","-MULTIPLE-","Cost of Goods Sold","Zelia Handwash Liquid",,"Accounts Receivable",562.99,"",38781.00
,"Invoice","23-02-2024","MC05443",,"DAILY CHAMPIONS MINI SUPERMARKET LIMITED","-MULTIPLE-","Cost of Goods Sold","Zelia Handwash Liquid",,"Accounts Receivable",843.82,"",39624.82
,"Sales Receipt","23-02-2024","1870",,"Home Cell Minimart","-MULTIPLE-","Cost of Goods Sold","Zelia Handwash Liquid",,"Undeposited Funds",337.80,"",39962.62
,"Sales Receipt","23-02-2024","1871",,"Leelan Bookshop","-MULTIPLE-","Cost of Goods Sold","Zelia Handwash Liquid",,"Undeposited Funds",1351.16,"",41313.78
,"Invoice","26-02-2024","MC05444",,"The Joymai Blessed Stores Limited","-MULTIPLE-","Cost of Goods Sold","Zelia Handwash Liquid",,"Accounts Receivable",675.58,"",41989.36
,"Invoice","26-02-2024","MC05445",,"Mumsha Supamat","-MULTIPLE-","Cost of Goods Sold","Zelia Handwash Liquid",,"Accounts Receivable",337.80,"",42327.16
,"Sales Receipt","26-02-2024","1872",,"Jombs wholesalers","-MULTIPLE-","Cost of Goods Sold","Zelia Handwash Liquid",,"Undeposited Funds",112.60,"",42439.76
,"Sales Receipt","26-02-2024","1873",,"mamkon minimart","-MULTIPLE-","Cost of Goods Sold","Zelia Handwash Liquid",,"Undeposited Funds",112.60,"",42552.36
,"Sales Receipt","26-02-2024","1875",,"Cash Sales","Zelia Strawberry Handwash Liquid 500ML","Cost of Goods Sold","Zelia Handwash Liquid",,"Undeposited Funds",278.21,"",42830.57
,"Sales Receipt","27-02-2024","1878",,"Cash Sales","Zelia Strawberry Handwash Liquid 5L","Cost of Goods Sold","Zelia Handwash Liquid",,"Undeposited Funds",225.54,"",43056.11
,"Sales Receipt","28-02-2024","1885",,"Amulqura Shop","-MULTIPLE-","Cost of Goods Sold","Zelia Handwash Liquid",,"Undeposited Funds",847.50,"",43903.61
,"Sales Receipt","29-02-2024","1889",,"Cash Sales","Zelia Apple Handwash Liquid 500ML","Cost of Goods Sold","Zelia Handwash Liquid",,"Undeposited Funds",56.96,"",43960.57
,"Sales Receipt","29-02-2024","1890",,"Cash Sales","-MULTIPLE-","Cost of Goods Sold","Zelia Handwash Liquid",,"Undeposited Funds",1904.95,"",45865.52
,"Invoice","01-03-2024","MC05459",,"THE BRIGHT STAR SUPERMARKET LIMITED","-MULTIPLE-","Cost of Goods Sold","Zelia Handwash Liquid",,"Accounts Receivable",675.58,"",46541.10
,"Sales Receipt","01-03-2024","1892",,"Ilyas Retail Shop","-MULTIPLE-","Cost of Goods Sold","Zelia Handwash Liquid",,"Undeposited Funds",1351.16,"",47892.26
,"Sales Receipt","04-03-2024","1894",,"Cash Sales","Zelia Strawberry Handwash Liquid 5L","Cost of Goods Sold","Zelia Handwash Liquid",,"Undeposited Funds",225.54,"",48117.80
,"Sales Receipt","04-03-2024","1899",,"Faisel Wholesale","-MULTIPLE-","Cost of Goods Sold","Zelia Handwash Liquid",,"Undeposited Funds",845.13,"",48962.93
,"Invoice","05-03-2024","MC05471",,"PRICE CHOPPER STORES LIMITED","-MULTIPLE-","Cost of Goods Sold","Zelia Handwash Liquid",,"Accounts Receivable",675.58,"",49638.51
,"Sales Receipt","05-03-2024","2008",,"Cash Sales","Zelia Strawberry Handwash Liquid 500ML","Cost of Goods Sold","Zelia Handwash Liquid",,"Undeposited Funds",55.64,"",49694.15
,"Sales Receipt","05-03-2024","2011",,"Cash Sales","Zelia Strawberry Handwash Liquid 500ML","Cost of Goods Sold","Zelia Handwash Liquid",,"Undeposited Funds",111.28,"",49805.43
,"Sales Receipt","05-03-2024","2013",,"Summer Outlets","-MULTIPLE-","Cost of Goods Sold","Zelia Handwash Liquid",,"Undeposited Funds",675.58,"",50481.01
,"Sales Receipt","05-03-2024","2014",,"Maida Minimart","-MULTIPLE-","Cost of Goods Sold","Zelia Handwash Liquid",,"Undeposited Funds",450.39,"",50931.40
,"Sales Receipt","05-03-2024","2015",,"AL MANAN","-MULTIPLE-","Cost of Goods Sold","Zelia Handwash Liquid",,"Undeposited Funds",1351.16,"",52282.56
,"Sales Receipt","06-03-2024","2021",,"Farhan Wholesellers","-MULTIPLE-","Cost of Goods Sold","Zelia Handwash Liquid",,"Undeposited Funds",1688.96,"",53971.52
,"Sales Receipt","06-03-2024","2022",,"Libin Minimart","-MULTIPLE-","Cost of Goods Sold","Zelia Handwash Liquid",,"Undeposited Funds",2532.78,"",56504.30
,"Sales Receipt","07-03-2024","2029",,"Cash Sales","Zelia Strawberry Handwash Liquid 500ML","Cost of Goods Sold","Zelia Handwash Liquid",,"Undeposited Funds",55.64,"",56559.94
,"Sales Receipt","08-03-2024","2042",,"Fahal Wholesalers","-MULTIPLE-","Cost of Goods Sold","Zelia Handwash Liquid",,"Undeposited Funds",8385.68,"",64945.62
,"Sales Receipt","08-03-2024","2043",,"Raage mart","-MULTIPLE-","Cost of Goods Sold","Zelia Handwash Liquid",,"Undeposited Funds",3350.33,"",68295.95
,"Sales Receipt","11-03-2024","2048",,"Bon Bon Minimart","-MULTIPLE-","Cost of Goods Sold","Zelia Handwash Liquid",,"Undeposited Funds",337.80,"",68633.75
,"Sales Receipt","11-03-2024","2050",,"tRIPPLE M","-MULTIPLE-","Cost of Goods Sold","Zelia Handwash Liquid",,"Undeposited Funds",337.80,"",68971.55
,"Sales Receipt","11-03-2024","2052",,"Cash Sales","Zelia Strawberry Handwash Liquid 5L","Cost of Goods Sold","Zelia Handwash Liquid",,"Undeposited Funds",225.54,"",69197.09
,"Sales Receipt","11-03-2024","2054",,"Dalwo Wholesallers","-MULTIPLE-","Cost of Goods Sold","Zelia Handwash Liquid",,"Undeposited Funds",843.82,"",70040.91
,"Sales Receipt","11-03-2024","2055",,"Beta Traders","-MULTIPLE-","Cost of Goods Sold","Zelia Handwash Liquid",,"Undeposited Funds",675.58,"",70716.49
,"Sales Receipt","11-03-2024","2056",,"Nasib Wholesallers","-MULTIPLE-","Cost of Goods Sold","Zelia Handwash Liquid",,"Undeposited Funds",843.82,"",71560.31
,"Invoice","12-03-2024","MC05492",,"DALLAS SHOPRITE LTD","-MULTIPLE-","Cost of Goods Sold","Zelia Handwash Liquid",,"Accounts Receivable",337.80,"",71898.11
,"Sales Receipt","13-03-2024","2059",,"Cash Sales","-MULTIPLE-","Cost of Goods Sold","Zelia Handwash Liquid",,"Undeposited Funds",112.60,"",72010.71
,"Sales Receipt","13-03-2024","2061",,"Al Manir Wholesale","-MULTIPLE-","Cost of Goods Sold","Zelia Handwash Liquid",,"Undeposited Funds",845.13,"",72855.84
,"Sales Receipt","14-03-2024","2063",,"Cash Sales","Zelia Strawberry Handwash Liquid 500ML","Cost of Goods Sold","Zelia Handwash Liquid",,"Undeposited Funds",55.64,"",72911.48
,"Sales Receipt","14-03-2024","2067",,"Nzurimart wholesale","Zelia Strawberry Handwash Liquid 500ML","Cost of Goods Sold","Zelia Handwash Liquid",,"Undeposited Funds",55.64,"",72967.12
,"Sales Receipt","15-03-2024","2069",,"Cash Sales","Zelia Strawberry Handwash Liquid 500ML","Cost of Goods Sold","Zelia Handwash Liquid",,"Undeposited Funds",834.63,"",73801.75
,"Sales Receipt","15-03-2024","2079",,"Perfect Enterprise","-MULTIPLE-","Cost of Goods Sold","Zelia Handwash Liquid",,"Undeposited Funds",841.20,"",74642.95
,"Sales Receipt","18-03-2024","2076",,"Cash Sales","Zelia Strawberry Handwash Liquid 500ML","Cost of Goods Sold","Zelia Handwash Liquid",,"Undeposited Funds",111.28,"",74754.23
,"Invoice","19-03-2024","MC05499",,"EASEBYYTTE SUPERMARKET LIMITED","-MULTIPLE-","Cost of Goods Sold","Zelia Handwash Liquid",,"Accounts Receivable",675.58,"",75429.81
,"Invoice","19-03-2024","MC05502",,"Tupo Mart Limited","-MULTIPLE-","Cost of Goods Sold","Zelia Handwash Liquid",,"Accounts Receivable",675.58,"",76105.39
,"Invoice","19-03-2024","MC05503",,"LUCKY MART SUPERMARKET LIMITED","-MULTIPLE-","Cost of Goods Sold","Zelia Handwash Liquid",,"Accounts Receivable",675.58,"",76780.97
,"Invoice","20-03-2024","MC05504",,"Zenith Steel Fabricators Ltd","Zelia 20L Antibacterial Handwash Liquid","Cost of Goods Sold","Zelia Handwash Liquid",,"Accounts Receivable",3932.61,"",80713.58
,"Invoice","20-03-2024","MC05507",,"DAILY CHAMPIONS MINI SUPERMARKET LIMITED","Zelia Strawberry Handwash Liquid 500ML","Cost of Goods Sold","Zelia Handwash Liquid",,"Accounts Receivable",667.70,"",81381.28
,"Sales Receipt","20-03-2024","2087",,"Pambazuka Mart (K) Limited","Zelia Strawberry Handwash Liquid 500ML","Cost of Goods Sold","Zelia Handwash Liquid",,"Undeposited Funds",834.63,"",82215.91
,"Sales Receipt","20-03-2024","2088",,"Labook Enterprises","Zelia Strawberry Handwash Liquid 500ML","Cost of Goods Sold","Zelia Handwash Liquid",,"Undeposited Funds",834.63,"",83050.54
,"Sales Receipt","20-03-2024","2089",,"Restoration Traders","Zelia Strawberry Handwash Liquid 500ML","Cost of Goods Sold","Zelia Handwash Liquid",,"Undeposited Funds",834.63,"",83885.17
,"Sales Receipt","21-03-2024","2092",,"Norham Groceries","Zelia Strawberry Handwash Liquid 500ML","Cost of Goods Sold","Zelia Handwash Liquid",,"Undeposited Funds",667.70,"",84552.87
,"Sales Receipt","21-03-2024","2101",,"Raymart Minimart","Zelia Strawberry Handwash Liquid 500ML","Cost of Goods Sold","Zelia Handwash Liquid",,"Undeposited Funds",333.85,"",84886.72
,"Sales Receipt","21-03-2024","2102",,"Umushan Shop","Zelia Strawberry Handwash Liquid 500ML","Cost of Goods Sold","Zelia Handwash Liquid",,"Undeposited Funds",667.70,"",85554.42
,"Sales Receipt","21-03-2024","2103",,"Ilyes Gas and Water ltd","Zelia Strawberry Handwash Liquid 500ML","Cost of Goods Sold","Zelia Handwash Liquid",,"Undeposited Funds",834.63,"",86389.05
,"Sales Receipt","25-03-2024","2094",,"Instanbul Shop","Zelia Strawberry Handwash Liquid 500ML","Cost of Goods Sold","Zelia Handwash Liquid",,"Undeposited Funds",667.70,"",87056.75
,"Invoice","25-03-2024","MC05530",,"KASAMAT INVESTMENTS LTD","-MULTIPLE-","Cost of Goods Sold","Zelia Handwash Liquid",,"Accounts Receivable",337.80,"",87394.55
,"Sales Receipt","26-03-2024","2109",,"Cash Sales","Zelia Strawberry Handwash Liquid 5L","Cost of Goods Sold","Zelia Handwash Liquid",,"Undeposited Funds",225.54,"",87620.09
,"Sales Receipt","26-03-2024","2113",,"AL MANAN","Zelia Strawberry Handwash Liquid 500ML","Cost of Goods Sold","Zelia Handwash Liquid",,"Undeposited Funds",1669.25,"",89289.34
,"Sales Receipt","27-03-2024","2110",,"Toyokom Wholesallers","Zelia Strawberry Handwash Liquid 500ML","Cost of Goods Sold","Zelia Handwash Liquid",,"Undeposited Funds",3338.51,"",92627.85
,"Sales Receipt","27-03-2024","2114",,"Freshtake Wholesallers","Zelia Strawberry Handwash Liquid 500ML","Cost of Goods Sold","Zelia Handwash Liquid",,"Undeposited Funds",834.63,"",93462.48
,"Sales Receipt","27-03-2024","2115",,"Jumaira Wholesalers","Zelia Strawberry Handwash Liquid 500ML","Cost of Goods Sold","Zelia Handwash Liquid",,"Undeposited Funds",834.63,"",94297.11
,"Build Assembly","27-03-2024","10049",,,,"Cost of Goods Sold","Zelia Handwash Liquid","X","-SPLIT-","",1226.57,93070.54
,"Sales Receipt","28-03-2024","2118",,"Cash Sales","Zelia Strawberry Handwash Liquid 5L","Cost of Goods Sold","Zelia Handwash Liquid",,"Undeposited Funds",225.54,"",93296.08
,"Sales Receipt","28-03-2024","2123",,"ALHAMDULILAH","Zelia Strawberry Handwash Liquid 500ML","Cost of Goods Sold","Zelia Handwash Liquid",,"Undeposited Funds",834.63,"",94130.71
,"Sales Receipt","28-03-2024","2124",,"First Choice Shop","Zelia Strawberry Handwash Liquid 500ML","Cost of Goods Sold","Zelia Handwash Liquid",,"Undeposited Funds",834.63,"",94965.34
,"Sales Receipt","28-03-2024","2127",,"Cash Sales","Zelia Strawberry Handwash Liquid 500ML","Cost of Goods Sold","Zelia Handwash Liquid",,"Undeposited Funds",55.64,"",95020.98
,"Sales Receipt","28-03-2024","2129",,"Cash Sales","Zelia Strawberry Handwash Liquid 5L","Cost of Goods Sold","Zelia Handwash Liquid",,"Undeposited Funds",225.54,"",95246.52
,"Build Assembly","02-04-2024","10018",,,"24142","Cost of Goods Sold","Zelia Handwash Liquid","X","-SPLIT-","",1966.31,93280.21
,"Sales Receipt","03-04-2024","2137",,"Gacal Wholesale","Zelia Strawberry Handwash Liquid 500ML","Cost of Goods Sold","Zelia Handwash Liquid",,"Undeposited Funds",649.15,"",93929.36
,"Sales Receipt","03-04-2024","2138",,"B Shop","Zelia Strawberry Handwash Liquid 500ML","Cost of Goods Sold","Zelia Handwash Liquid",,"Undeposited Funds",1298.31,"",95227.67
,"Sales Receipt","03-04-2024","2140",,"Dacaad Wholesalers","Zelia Strawberry Handwash Liquid 500ML","Cost of Goods Sold","Zelia Handwash Liquid",,"Undeposited Funds",2596.61,"",97824.28
,"Sales Receipt","03-04-2024","2142",,"AIDURUS GENERAL SHOP","Zelia Strawberry Handwash Liquid 500ML","Cost of Goods Sold","Zelia Handwash Liquid",,"Undeposited Funds",649.15,"",98473.43
,"Build Assembly","03-04-2024","10019",,,"24143","Cost of Goods Sold","Zelia Handwash Liquid","X","-SPLIT-","",0.16,98473.27
,"Sales Receipt","04-04-2024","2143",,"Jubilee Candy  Shop","Zelia Strawberry Handwash Liquid 500ML","Cost of Goods Sold","Zelia Handwash Liquid",,"Undeposited Funds",86.55,"",98559.82
,"Sales Receipt","04-04-2024","2152",,"Hanad Shop","Zelia Strawberry Handwash Liquid 500ML","Cost of Goods Sold","Zelia Handwash Liquid",,"Undeposited Funds",649.13,"",99208.95
,"Sales Receipt","05-04-2024","2155",,"Nasib Wholesallers","Zelia Strawberry Handwash Liquid 500ML","Cost of Goods Sold","Zelia Handwash Liquid",,"Undeposited Funds",649.13,"",99858.08
,"Sales Receipt","05-04-2024","2158",,"Cash Sales","Zelia Strawberry Handwash Liquid 500ML","Cost of Goods Sold","Zelia Handwash Liquid",,"Undeposited Funds",43.28,"",99901.36
,"Sales Receipt","05-04-2024","AT 193",,"JUDY USENGE","Zelia Strawberry Handwash Liquid 500ML","Cost of Goods Sold","Zelia Handwash Liquid",,"Undeposited Funds",3894.76,"",103796.12
,"Sales Receipt","06-04-2024","2209",,"RAZAQ AIRWAYS","-MULTIPLE-","Cost of Goods Sold","Zelia Handwash Liquid",,"Undeposited Funds",717.53,"",104513.65
,"Sales Receipt","08-04-2024","2164",,"Kangundo Briolly Bookshop","Zelia Strawberry Handwash Liquid 500ML","Cost of Goods Sold","Zelia Handwash Liquid",,"Undeposited Funds",259.65,"",104773.30
,"Sales Receipt","08-04-2024","2166",,"Cash Sales","Zelia Strawberry Handwash Liquid 500ML","Cost of Goods Sold","Zelia Handwash Liquid",,"Undeposited Funds",86.55,"",104859.85
,"Sales Receipt","08-04-2024","2168",,"Rowdha Minimart","-MULTIPLE-","Cost of Goods Sold","Zelia Handwash Liquid",,"Undeposited Funds",692.13,"",105551.98
,"Sales Receipt","08-04-2024","2170",,"Antic Wholesallers","-MULTIPLE-","Cost of Goods Sold","Zelia Handwash Liquid",,"Undeposited Funds",1378.89,"",106930.87
,"Sales Receipt","08-04-2024","2171",,"Raage mart","-MULTIPLE-","Cost of Goods Sold","Zelia Handwash Liquid",,"Undeposited Funds",3406.89,"",110337.76
,"Sales Receipt","08-04-2024","2201",,"City Save Wave","-MULTIPLE-","Cost of Goods Sold","Zelia Handwash Liquid",,"Undeposited Funds",676.00,"",111013.76
,"Sales Receipt","09-04-2024","2172",,"Cash Sales","Zelia Strawberry Handwash Liquid 500ML","Cost of Goods Sold","Zelia Handwash Liquid",,"Undeposited Funds",43.28,"",111057.04
,"Sales Receipt","11-04-2024","2206",,"Mumtaz Shop","-MULTIPLE-","Cost of Goods Sold","Zelia Handwash Liquid",,"Undeposited Funds",683.03,"",111740.07
,"Sales Receipt","11-04-2024","2207",,"Kenafa Wholesalers","-MULTIPLE-","Cost of Goods Sold","Zelia Handwash Liquid",,"Undeposited Funds",683.03,"",112423.10
,"Sales Receipt","11-04-2024","2208",,"Sultan Iman Shop","-MULTIPLE-","Cost of Goods Sold","Zelia Handwash Liquid",,"Undeposited Funds",1370.93,"",113794.03
,"Sales Receipt","11-04-2024","2210",,"Jumaira Wholesalers","-MULTIPLE-","Cost of Goods Sold","Zelia Handwash Liquid",,"Undeposited Funds",678.15,"",114472.18
,"Sales Receipt","12-04-2024","2175",,"Tekonstruct LTD","Zelia Strawberry Handwash Liquid 5L","Cost of Goods Sold","Zelia Handwash Liquid",,"Undeposited Funds",218.34,"",114690.52
,"Sales Receipt","12-04-2024","2180",,"Elwak Stores Ltd","Zelia Strawberry Handwash Liquid 500ML","Cost of Goods Sold","Zelia Handwash Liquid",,"Undeposited Funds",648.88,"",115339.40
,"Sales Receipt","12-04-2024","2182",,"Cheaper Cheap","Zelia Strawberry Handwash Stickers 500ml","Cost of Goods Sold","Zelia Handwash Liquid",,"Undeposited Funds",14.74,"",115354.14
,"Sales Receipt","12-04-2024","2183",,"Milimani  Stores","-MULTIPLE-","Cost of Goods Sold","Zelia Handwash Liquid",,"Undeposited Funds",548.37,"",115902.51
,"Sales Receipt","12-04-2024","2185",,"Mamken Minimart","Zelia Strawberry Handwash Liquid 500ML","Cost of Goods Sold","Zelia Handwash Liquid",,"Undeposited Funds",259.55,"",116162.06
,"Sales Receipt","12-04-2024","2186",,"Kandara minimart","Zelia Strawberry Handwash Liquid 500ML","Cost of Goods Sold","Zelia Handwash Liquid",,"Undeposited Funds",346.07,"",116508.13
,"Sales Receipt","12-04-2024","2246",,"Skype Traders","-MULTIPLE-","Cost of Goods Sold","Zelia Handwash Liquid",,"Undeposited Funds",3390.74,"",119898.87
,"Sales Receipt","15-04-2024","2192",,"Sakina Minimart","-MULTIPLE-","Cost of Goods Sold","Zelia Handwash Liquid",,"Undeposited Funds",698.84,"",120597.71
,"Sales Receipt","15-04-2024","2195",,"Zulu Enterprises","Zelia Apple Handwash Liquid 500ML","Cost of Goods Sold","Zelia Handwash Liquid",,"Undeposited Funds",302.37,"",120900.08
,"Sales Receipt","15-04-2024","2196",,"Ebenezer  Minimart","Zelia Apple Handwash Liquid 500ML","Cost of Goods Sold","Zelia Handwash Liquid",,"Undeposited Funds",151.19,"",121051.27
,"Sales Receipt","15-04-2024","2198",,"Rio Deli Wholesallers","-MULTIPLE-","Cost of Goods Sold","Zelia Handwash Liquid",,"Undeposited Funds",698.84,"",121750.11
,"Sales Receipt","15-04-2024","2199",,"Sharma Shop","-MULTIPLE-","Cost of Goods Sold","Zelia Handwash Liquid",,"Undeposited Funds",698.84,"",122448.95
,"Sales Receipt","16-04-2024","2212",,"Cash Sales","Zelia Strawberry Handwash Liquid 500ML","Cost of Goods Sold","Zelia Handwash Liquid",,"Undeposited Funds",86.52,"",122535.47
,"Sales Receipt","17-04-2024","2218",,"Maida Minimart","-MULTIPLE-","Cost of Goods Sold","Zelia Handwash Liquid",,"Undeposited Funds",561.92,"",123097.39
,"Sales Receipt","18-04-2024","2220",,"Towba General Store","-MULTIPLE-","Cost of Goods Sold","Zelia Handwash Liquid",,"Undeposited Funds",1416.92,"",124514.31
,"Sales Receipt","18-04-2024","2223",,"Cash Sales","Zelia Strawberry Handwash Liquid 500ML","Cost of Goods Sold","Zelia Handwash Liquid",,"Undeposited Funds",43.26,"",124557.57
,"Sales Receipt","18-04-2024","2224",,"Cash Sales","Zelia Strawberry Handwash Liquid 500ML","Cost of Goods Sold","Zelia Handwash Liquid",,"Undeposited Funds",86.52,"",124644.09
,"Sales Receipt","18-04-2024","2229",,"Maasai One","-MULTIPLE-","Cost of Goods Sold","Zelia Handwash Liquid",,"Undeposited Funds",326.65,"",124970.74
,"Sales Receipt","18-04-2024","2230",,"Ngomei Shop","-MULTIPLE-","Cost of Goods Sold","Zelia Handwash Liquid",,"Undeposited Funds",1416.92,"",126387.66
,"Invoice","19-04-2024","MC05610",,"DISII TRADERS LTD","-MULTIPLE-","Cost of Goods Sold","Zelia Handwash Liquid",,"Accounts Receivable",688.60,"",127076.26
,"Invoice","19-04-2024","MC05613",,"HAPPY VIEW SUPERMARKET LIMITED","-MULTIPLE-","Cost of Goods Sold","Zelia Handwash Liquid",,"Accounts Receivable",566.77,"",127643.03
,"Sales Receipt","19-04-2024","2232",,"Zonal Minimart","Zelia Apple Handwash Liquid 500ML","Cost of Goods Sold","Zelia Handwash Liquid",,"Undeposited Funds",307.22,"",127950.25
,"Sales Receipt","19-04-2024","2233",,"Hogol Wholesallers","-MULTIPLE-","Cost of Goods Sold","Zelia Handwash Liquid",,"Undeposited Funds",1802.38,"",129752.63
,"Sales Receipt","19-04-2024","2234",,"Nasra wholesale","-MULTIPLE-","Cost of Goods Sold","Zelia Handwash Liquid",,"Undeposited Funds",704.49,"",130457.12
,"Sales Receipt","19-04-2024","2235",,"Publix Supermarket","Zelia Apple Handwash Liquid 500ML","Cost of Goods Sold","Zelia Handwash Liquid",,"Undeposited Funds",307.22,"",130764.34
,"Sales Receipt","19-04-2024","2237",,"Garumo Wholesallers","-MULTIPLE-","Cost of Goods Sold","Zelia Handwash Liquid",,"Undeposited Funds",1416.92,"",132181.26
,"Sales Receipt","19-04-2024","2238",,"Hometime Minimart","-MULTIPLE-","Cost of Goods Sold","Zelia Handwash Liquid",,"Undeposited Funds",283.39,"",132464.65
,"Sales Receipt","19-04-2024","2239",,"Beraccah Wholesallers","-MULTIPLE-","Cost of Goods Sold","Zelia Handwash Liquid",,"Undeposited Funds",696.55,"",133161.20
,"Sales Receipt","20-04-2024","2243",,"Horn of Africa","-MULTIPLE-","Cost of Goods Sold","Zelia Handwash Liquid",,"Undeposited Funds",704.49,"",133865.69
,"Invoice","22-04-2024","MC05622",,"KASAMAT INVESTMENTS LTD","Zelia Strawberry Handwash Liquid 500ML","Cost of Goods Sold","Zelia Handwash Liquid",,"Accounts Receivable",259.55,"",134125.24
,"Sales Receipt","22-04-2024","2241",,"Cash Sales","-MULTIPLE-","Cost of Goods Sold","Zelia Handwash Liquid",,"Undeposited Funds",283.52,"",134408.76
,"Sales Receipt","22-04-2024","2242",,"tRIPPLE M","-MULTIPLE-","Cost of Goods Sold","Zelia Handwash Liquid",,"Undeposited Funds",472.53,"",134881.29
,"Sales Receipt","22-04-2024","2244",,"MWASPART AIRWAYS","-MULTIPLE-","Cost of Goods Sold","Zelia Handwash Liquid",,"Undeposited Funds",567.03,"",135448.32
,"Sales Receipt","22-04-2024","2245",,"Bon Bon Minimart","-MULTIPLE-","Cost of Goods Sold","Zelia Handwash Liquid",,"Undeposited Funds",283.52,"",135731.84
,"Sales Receipt","22-04-2024","2247",,"AL Zake minimart","-MULTIPLE-","Cost of Goods Sold","Zelia Handwash Liquid",,"Undeposited Funds",712.79,"",136444.63
,"Sales Receipt","22-04-2024","2248",,"Himilo Wholesalers","-MULTIPLE-","Cost of Goods Sold","Zelia Handwash Liquid",,"Undeposited Funds",704.80,"",137149.43
,"Sales Receipt","22-04-2024","2250",,"Brightfood Nasra","-MULTIPLE-","Cost of Goods Sold","Zelia Handwash Liquid",,"Undeposited Funds",283.52,"",137432.95
,"Sales Receipt","23-04-2024","2251",,"Cash Sales","Zelia Apple Handwash Liquid 500ML","Cost of Goods Sold","Zelia Handwash Liquid",,"Undeposited Funds",51.25,"",137484.20
,"Sales Receipt","23-04-2024","2253",,"Summer Outlets","-MULTIPLE-","Cost of Goods Sold","Zelia Handwash Liquid",,"Undeposited Funds",1138.41,"",138622.61
,"Sales Receipt","23-04-2024","2254",,"Cash Sales","Zelia Strawberry Handwash Liquid 5L","Cost of Goods Sold","Zelia Handwash Liquid",,"Undeposited Funds",218.34,"",138840.95
,"Invoice","24-04-2024","MC05630",,"Mumsha Supamat","-MULTIPLE-","Cost of Goods Sold","Zelia Handwash Liquid",,"Accounts Receivable",569.20,"",139410.15
,"Invoice","24-04-2024","MC05631",,"PRICE CHOPPER STORES LIMITED","Zelia Apple Handwash Liquid 500ML","Cost of Goods Sold","Zelia Handwash Liquid",,"Accounts Receivable",307.48,"",139717.63
,"Invoice","24-04-2024","MC05636",,"Maji Asili Limited","-MULTIPLE-","Cost of Goods Sold","Zelia Handwash Liquid",,"Accounts Receivable",707.69,"",140425.32
,"Sales Receipt","24-04-2024","2255",,"Cash Sales","-MULTIPLE-","Cost of Goods Sold","Zelia Handwash Liquid",,"Undeposited Funds",94.87,"",140520.19
,"Sales Receipt","24-04-2024","2256",,"Kimathi Store","-MULTIPLE-","Cost of Goods Sold","Zelia Handwash Liquid",,"Undeposited Funds",328.22,"",140848.41
,"Sales Receipt","24-04-2024","2260",,"Pambazuka Mart (K) Limited","-MULTIPLE-","Cost of Goods Sold","Zelia Handwash Liquid",,"Undeposited Funds",707.69,"",141556.10
,"Sales Receipt","25-04-2024","2262",,"Kiembeni Grocery","-MULTIPLE-","Cost of Goods Sold","Zelia Handwash Liquid",,"Undeposited Funds",1423.01,"",142979.11
,"Sales Receipt","25-04-2024","2263",,"Cash Sales","Zelia Strawberry Handwash Liquid 5L","Cost of Goods Sold","Zelia Handwash Liquid",,"Undeposited Funds",218.34,"",143197.45
,"Sales Receipt","26-04-2024","2270",,"Cash Sales","-MULTIPLE-","Cost of Goods Sold","Zelia Handwash Liquid",,"Undeposited Funds",313.21,"",143510.66
,"Sales Receipt","28-04-2024","2276",,"Zamu Wholesalers","-MULTIPLE-","Cost of Goods Sold","Zelia Handwash Liquid",,"Undeposited Funds",707.69,"",144218.35
,"Sales Receipt","29-04-2024","2273",,"Blessed Shop","-MULTIPLE-","Cost of Goods Sold","Zelia Handwash Liquid",,"Undeposited Funds",94.87,"",144313.22
,"Credit Note","29-04-2024","CN01058",,"INTEGRAL MEDIA LIMITED","-MULTIPLE-","Cost of Goods Sold","Zelia Handwash Liquid",,"Accounts Receivable","",1415.38,142897.84
,"Sales Receipt","29-04-2024","2280",,"Cash Sales","Zelia Strawberry Handwash Liquid 500ML","Cost of Goods Sold","Zelia Handwash Liquid",,"Undeposited Funds",43.62,"",142941.46
,"Sales Receipt","30-04-2024","2281",,"Geoffrey Kangethe","-MULTIPLE-","Cost of Goods Sold","Zelia Handwash Liquid",,"Undeposited Funds",941.28,"",143882.74
,"Invoice","30-04-2024","MC05652",,"OFFSHORE GLOBAL LOGISTICS LIMITED","Zelia Strawberry Handwash Liquid 5L","Cost of Goods Sold","Zelia Handwash Liquid",,"Accounts Receivable",218.34,"",144101.08
,"Sales Receipt","30-04-2024","2282",,"Budget Store","-MULTIPLE-","Cost of Goods Sold","Zelia Handwash Liquid",,"Undeposited Funds",692.44,"",144793.52
,"Sales Receipt","30-04-2024","2286",,"Homecare Enterprise","-MULTIPLE-","Cost of Goods Sold","Zelia Handwash Liquid",,"Undeposited Funds",284.60,"",145078.12
,"Sales Receipt","30-04-2024","2288",,"Simester General Stores","-MULTIPLE-","Cost of Goods Sold","Zelia Handwash Liquid",,"Undeposited Funds",284.60,"",145362.72
,"Sales Receipt","02-05-2024","2293",,"Tuff Store","-MULTIPLE-","Cost of Goods Sold","Zelia Handwash Liquid",,"Undeposited Funds",240.98,"",145603.70
,"Sales Receipt","02-05-2024","2295",,"New Ali Yare","-MULTIPLE-","Cost of Goods Sold","Zelia Handwash Liquid",,"Undeposited Funds",707.69,"",146311.39
,"Sales Receipt","02-05-2024","2297",,"D Madina Store","-MULTIPLE-","Cost of Goods Sold","Zelia Handwash Liquid",,"Undeposited Funds",2077.31,"",148388.70
,"Sales Receipt","03-05-2024","2300",,"Cash Sales","Zelia Strawberry Handwash Liquid 500ML","Cost of Goods Sold","Zelia Handwash Liquid",,"Undeposited Funds",87.24,"",148475.94
,"Sales Receipt","03-05-2024","2305",,"Zuri Mart","-MULTIPLE-","Cost of Goods Sold","Zelia Handwash Liquid",,"Undeposited Funds",284.60,"",148760.54
,"Sales Receipt","05-05-2024","2308",,"Cash Sales","-MULTIPLE-","Cost of Goods Sold","Zelia Handwash Liquid",,"Undeposited Funds",261.96,"",149022.50
,"Sales Receipt","06-05-2024","2309",,"Jackys Shop","-MULTIPLE-","Cost of Goods Sold","Zelia Handwash Liquid",,"Undeposited Funds",233.36,"",149255.86
,"Sales Receipt","06-05-2024","2310",,"Razia Wholesalers","-MULTIPLE-","Cost of Goods Sold","Zelia Handwash Liquid",,"Undeposited Funds",240.98,"",149496.84
,"Sales Receipt","06-05-2024","2311",,"Cash Sales","Zelia Strawberry Handwash Liquid 5L","Cost of Goods Sold","Zelia Handwash Liquid",,"Undeposited Funds",218.34,"",149715.18
,"Sales Receipt","06-05-2024","2312",,"Cash Sales","Zelia Strawberry Handwash Liquid 5L","Cost of Goods Sold","Zelia Handwash Liquid",,"Undeposited Funds",655.02,"",150370.20
,"Sales Receipt","06-05-2024","2314",,"Gargar Foodstuffs","-MULTIPLE-","Cost of Goods Sold","Zelia Handwash Liquid",,"Undeposited Funds",7115.19,"",157485.39
,"Invoice","08-05-2024","MC05676",,"LUCKY MART SUPERMARKET LIMITED","-MULTIPLE-","Cost of Goods Sold","Zelia Handwash Liquid",,"Accounts Receivable",707.71,"",158193.10
,"Sales Receipt","08-05-2024","2318",,"Adurus Wholesallers","Zelia Apple Handwash Liquid 500ML","Cost of Goods Sold","Zelia Handwash Liquid",,"Undeposited Funds",614.97,"",158808.07
,"Sales Receipt","08-05-2024","2319",,"Lekima Royal Merchants","-MULTIPLE-","Cost of Goods Sold","Zelia Handwash Liquid",,"Undeposited Funds",707.71,"",159515.78
,"Sales Receipt","08-05-2024","2320",,"Johns Shop","-MULTIPLE-","Cost of Goods Sold","Zelia Handwash Liquid",,"Undeposited Funds",569.21,"",160084.99
,"Sales Receipt","08-05-2024","2321",,"Cash Sales","-MULTIPLE-","Cost of Goods Sold","Zelia Handwash Liquid",,"Undeposited Funds",94.87,"",160179.86
,"Sales Receipt","08-05-2024","2324",,"Qudus Shop","-MULTIPLE-","Cost of Goods Sold","Zelia Handwash Liquid",,"Undeposited Funds",569.21,"",160749.07
,"Sales Receipt","09-05-2024","2333",,"RichMind Property","-MULTIPLE-","Cost of Goods Sold","Zelia Handwash Liquid",,"Undeposited Funds",94.87,"",160843.94
,"Sales Receipt","09-05-2024","2334",,"Tuff Store","-MULTIPLE-","Cost of Goods Sold","Zelia Handwash Liquid",,"Undeposited Funds",233.36,"",161077.30
,"Sales Receipt","09-05-2024","2335",,"County Wholesallers","Zelia Strawberry Handwash Liquid 500ML","Cost of Goods Sold","Zelia Handwash Liquid",,"Undeposited Funds",654.33,"",161731.63
,"Sales Receipt","09-05-2024","2337",,"Cash Sales","Zelia Apple Handwash Liquid 5L","Cost of Goods Sold","Zelia Handwash Liquid",,"Undeposited Funds",232.25,"",161963.88
,"Sales Receipt","09-05-2024","2338",,"Cash Sales","Zelia Strawberry Handwash Liquid 5L","Cost of Goods Sold","Zelia Handwash Liquid",,"Undeposited Funds",218.34,"",162182.22
,"Sales Receipt","09-05-2024","2339",,"Cash Sales","Zelia Apple Handwash Liquid 500ML","Cost of Goods Sold","Zelia Handwash Liquid",,"Undeposited Funds",102.49,"",162284.71
,"Sales Receipt","09-05-2024","2340",,"Cash Sales","Zelia Apple Handwash Liquid 500ML","Cost of Goods Sold","Zelia Handwash Liquid",,"Undeposited Funds",51.25,"",162335.96
,"Sales Receipt","09-05-2024","2341",,"Cash Sales","-MULTIPLE-","Cost of Goods Sold","Zelia Handwash Liquid",,"Undeposited Funds",94.87,"",162430.83
,"Sales Receipt","13-05-2024","2345",,"Katani Foodstore","-MULTIPLE-","Cost of Goods Sold","Zelia Handwash Liquid",,"Undeposited Funds",707.71,"",163138.54
,"Sales Receipt","13-05-2024","2347",,"Sharma Shop","Zelia Apple Handwash Liquid 500ML","Cost of Goods Sold","Zelia Handwash Liquid",,"Undeposited Funds",768.71,"",163907.25
,"Sales Receipt","13-05-2024","2348",,"Gargar Foodstuffs","-MULTIPLE-","Cost of Goods Sold","Zelia Handwash Liquid",,"Undeposited Funds",1423.04,"",165330.29
,"Sales Receipt","13-05-2024","2350",,"Aymat Wholesalers","-MULTIPLE-","Cost of Goods Sold","Zelia Handwash Liquid",,"Undeposited Funds",1423.04,"",166753.33
,"Sales Receipt","13-05-2024","2352",,"Himilo Wholesalers","-MULTIPLE-","Cost of Goods Sold","Zelia Handwash Liquid",,"Undeposited Funds",1423.04,"",168176.37
,"Sales Receipt","13-05-2024","2353",,"Jumaira Wholesalers","-MULTIPLE-","Cost of Goods Sold","Zelia Handwash Liquid",,"Undeposited Funds",1423.04,"",169599.41
,"Sales Receipt","13-05-2024","1921",,"Cash Sales","-MULTIPLE-","Cost of Goods Sold","Zelia Handwash Liquid",,"Undeposited Funds",189.73,"",169789.14
,"Sales Receipt","13-05-2024","1922",,"Cash Sales","Zelia Strawberry Handwash Liquid 5L","Cost of Goods Sold","Zelia Handwash Liquid",,"Undeposited Funds",218.34,"",170007.48
,"Sales Receipt","13-05-2024","1923",,"Cash Sales","Zelia Strawberry Handwash Liquid 5L","Cost of Goods Sold","Zelia Handwash Liquid",,"Undeposited Funds",218.34,"",170225.82
,"Sales Receipt","14-05-2024","2357",,"Horn of Africa","-MULTIPLE-","Cost of Goods Sold","Zelia Handwash Liquid",,"Undeposited Funds",707.71,"",170933.53
,"Sales Receipt","14-05-2024","2358",,"Faisel Wholesale","-MULTIPLE-","Cost of Goods Sold","Zelia Handwash Liquid",,"Undeposited Funds",1423.04,"",172356.57
,"Invoice","15-05-2024","MC05702",,"Seasons lane Mart","-MULTIPLE-","Cost of Goods Sold","Zelia Handwash Liquid",,"Accounts Receivable",715.34,"",173071.91
,"Sales Receipt","15-05-2024","2362",,"Cash Sales","Zelia Strawberry Handwash Liquid 5L","Cost of Goods Sold","Zelia Handwash Liquid",,"Undeposited Funds",218.34,"",173290.25
,"Sales Receipt","16-05-2024","2363",,"Corner Shop","-MULTIPLE-","Cost of Goods Sold","Zelia Handwash Liquid",,"Undeposited Funds",1421.96,"",174712.21
,"Sales Receipt","16-05-2024","2364",,"Mashallah Foodstuffs","-MULTIPLE-","Cost of Goods Sold","Zelia Handwash Liquid",,"Undeposited Funds",707.13,"",175419.34
,"Sales Receipt","16-05-2024","2367",,"Khare Wholesalers","-MULTIPLE-","Cost of Goods Sold","Zelia Handwash Liquid",,"Undeposited Funds",707.13,"",176126.47
,"Sales Receipt","16-05-2024","2368",,"Rehoji Shop","-MULTIPLE-","Cost of Goods Sold","Zelia Handwash Liquid",,"Undeposited Funds",707.13,"",176833.60
,"Sales Receipt","16-05-2024","2370",,"Imani General Store","-MULTIPLE-","Cost of Goods Sold","Zelia Handwash Liquid",,"Undeposited Funds",284.39,"",177117.99
,"Invoice","17-05-2024","MC05712",,"Maji Asili Limited","Zelia Apple Handwash Liquid 500ML","Cost of Goods Sold","Zelia Handwash Liquid",,"Accounts Receivable",768.71,"",177886.70
,"Invoice","17-05-2024","MC05713",,"DISII TRADERS LTD","-MULTIPLE-","Cost of Goods Sold","Zelia Handwash Liquid",,"Accounts Receivable",707.13,"",178593.83
,"Sales Receipt","17-05-2024","2372",,"Danaba Wholesalers","-MULTIPLE-","Cost of Goods Sold","Zelia Handwash Liquid",,"Undeposited Funds",706.80,"",179300.63
,"Sales Receipt","20-05-2024","1939",,"Nuclear Supermarket","Zelia Apple Handwash Liquid 500ML","Cost of Goods Sold","Zelia Handwash Liquid",,"Undeposited Funds",50.88,"",179351.51
,"Sales Receipt","20-05-2024","1941",,"Jumaira Wholesalers","-MULTIPLE-","Cost of Goods Sold","Zelia Handwash Liquid",,"Undeposited Funds",1415.87,"",180767.38
,"Sales Receipt","21-05-2024","1942",,"Cash Sales","-MULTIPLE-","Cost of Goods Sold","Zelia Handwash Liquid",,"Undeposited Funds",94.39,"",180861.77
,"Sales Receipt","21-05-2024","1943",,"Smart Choice","-MULTIPLE-","Cost of Goods Sold","Zelia Handwash Liquid",,"Undeposited Funds",689.50,"",181551.27
,"Sales Receipt","21-05-2024","1944",,"Mt. Kenya","-MULTIPLE-","Cost of Goods Sold","Zelia Handwash Liquid",,"Undeposited Funds",566.35,"",182117.62
,"Sales Receipt","21-05-2024","1947",,"Minara Shop","-MULTIPLE-","Cost of Goods Sold","Zelia Handwash Liquid",,"Undeposited Funds",1415.87,"",183533.49
,"Sales Receipt","21-05-2024","1950",,"Downtown Wholesalers","-MULTIPLE-","Cost of Goods Sold","Zelia Handwash Liquid",,"Undeposited Funds",1415.87,"",184949.36
,"Sales Receipt","21-05-2024","1951",,"Gidesh Supermarket","-MULTIPLE-","Cost of Goods Sold","Zelia Handwash Liquid",,"Undeposited Funds",704.25,"",185653.61
,"Sales Receipt","22-05-2024","2373",,"Danaba Wholesalers","Zelia Strawberry Handwash Liquid 500ML","Cost of Goods Sold","Zelia Handwash Liquid",,"Undeposited Funds",43.51,"",185697.12
,"Sales Receipt","22-05-2024","2374",,"Al maca","-MULTIPLE-","Cost of Goods Sold","Zelia Handwash Liquid",,"Undeposited Funds",704.25,"",186401.37
,"Sales Receipt","22-05-2024","2376",,"Towfiqq Shop","-MULTIPLE-","Cost of Goods Sold","Zelia Handwash Liquid",,"Undeposited Funds",566.35,"",186967.72
,"Sales Receipt","23-05-2024","2378",,"Cash Sales","-MULTIPLE-","Cost of Goods Sold","Zelia Handwash Liquid",,"Undeposited Funds",145.28,"",187113.00
,"Sales Receipt","23-05-2024","1960",,"Shukri Shop","-MULTIPLE-","Cost of Goods Sold","Zelia Handwash Liquid",,"Undeposited Funds",566.35,"",187679.35
,"Sales Receipt","23-05-2024","1962",,"Anab Shop","-MULTIPLE-","Cost of Goods Sold","Zelia Handwash Liquid",,"Undeposited Funds",283.18,"",187962.53
,"Sales Receipt","23-05-2024","1966",,"Libin Minimart","-MULTIPLE-","Cost of Goods Sold","Zelia Handwash Liquid",,"Undeposited Funds",1415.87,"",189378.40
,"Invoice","24-05-2024","MC05747",,"NASRI MART LIMITED","Zelia Strawberry Handwash Liquid 500ML","Cost of Goods Sold","Zelia Handwash Liquid",,"Accounts Receivable",261.05,"",189639.45
,"Sales Receipt","24-05-2024","2380",,"Cash Sales","Zelia Strawberry Handwash Liquid 5L","Cost of Goods Sold","Zelia Handwash Liquid",,"Undeposited Funds",873.37,"",190512.82
,"Sales Receipt","27-05-2024","2383",,"Abby Mart","-MULTIPLE-","Cost of Goods Sold","Zelia Handwash Liquid",,"Undeposited Funds",471.95,"",190984.77
,"Sales Receipt","27-05-2024","2384",,"Dream light Supermarket","-MULTIPLE-","Cost of Goods Sold","Zelia Handwash Liquid",,"Undeposited Funds",137.90,"",191122.67
,"Invoice","28-05-2024","MC05758",,"Zenith Steel Fabricators Ltd","Zelia Strawberry Handwash Liquid 5L","Cost of Goods Sold","Zelia Handwash Liquid",,"Accounts Receivable",4366.83,"",195489.50
,"Invoice","28-05-2024","MC05763",,"Mumsha Supamat","-MULTIPLE-","Cost of Goods Sold","Zelia Handwash Liquid",,"Accounts Receivable",566.35,"",196055.85
,"Sales Receipt","28-05-2024","2389",,"Restoration Traders","-MULTIPLE-","Cost of Goods Sold","Zelia Handwash Liquid",,"Undeposited Funds",704.25,"",196760.10
,"Sales Receipt","29-05-2024","1972",,"Farhan Wholesellers","-MULTIPLE-","Cost of Goods Sold","Zelia Handwash Liquid",,"Undeposited Funds",1415.87,"",198175.97
,"Sales Receipt","29-05-2024","1973",,"Marwan Shop","-MULTIPLE-","Cost of Goods Sold","Zelia Handwash Liquid",,"Undeposited Funds",704.25,"",198880.22
,"Invoice","30-05-2024","MC05775",,"INTEGRAL MEDIA LIMITED","-MULTIPLE-","Cost of Goods Sold","Zelia Handwash Liquid",,"Accounts Receivable",711.62,"",199591.84
,"Sales Receipt","30-05-2024","2397",,"Rio Deli Wholesallers","-MULTIPLE-","Cost of Goods Sold","Zelia Handwash Liquid",,"Undeposited Funds",1415.87,"",201007.71
,"Sales Receipt","31-05-2024","1937",,"Island Gift Shop","-MULTIPLE-","Cost of Goods Sold","Zelia Handwash Liquid",,"Undeposited Funds",188.79,"",201196.50
,"Sales Receipt","03-06-2024","2398",,"Cash Sales","Zelia Strawberry Handwash Liquid 500ML","Cost of Goods Sold","Zelia Handwash Liquid",,"Undeposited Funds",43.51,"",201240.01
,"Sales Receipt","03-06-2024","2410",,"Hidika Shop","-MULTIPLE-","Cost of Goods Sold","Zelia Handwash Liquid",,"Undeposited Funds",566.35,"",201806.36
,"Sales Receipt","03-06-2024","2411",,"Gure Yare Shop","-MULTIPLE-","Cost of Goods Sold","Zelia Handwash Liquid",,"Undeposited Funds",2831.74,"",204638.10
,"Sales Receipt","03-06-2024","1982",,"Lekima Minimart","-MULTIPLE-","Cost of Goods Sold","Zelia Handwash Liquid",,"Undeposited Funds",1415.87,"",206053.97
,"Sales Receipt","04-06-2024","2413",,"Horn of Africa","-MULTIPLE-","Cost of Goods Sold","Zelia Handwash Liquid",,"Undeposited Funds",566.35,"",206620.32
,"Sales Receipt","04-06-2024","2742",,"Arwa Wholesale","-MULTIPLE-","Cost of Goods Sold","Zelia Handwash Liquid",,"Undeposited Funds",704.25,"",207324.57
,"Sales Receipt","04-06-2024","2741",,"Sasa Wholesalers","-MULTIPLE-","Cost of Goods Sold","Zelia Handwash Liquid",,"Undeposited Funds",2831.74,"",210156.31
,"Sales Receipt","04-06-2024","2740",,"Mash-B Wholesale","-MULTIPLE-","Cost of Goods Sold","Zelia Handwash Liquid",,"Undeposited Funds",1415.87,"",211572.18
,"Sales Receipt","05-06-2024","2416",,"Amir shop","-MULTIPLE-","Cost of Goods Sold","Zelia Handwash Liquid",,"Undeposited Funds",1416.16,"",212988.34
,"Sales Receipt","05-06-2024","2417",,"D-Madina Enterprise","-MULTIPLE-","Cost of Goods Sold","Zelia Handwash Liquid",,"Undeposited Funds",1416.16,"",214404.50
,"Sales Receipt","05-06-2024","2418",,"Saacid Shop","-MULTIPLE-","Cost of Goods Sold","Zelia Handwash Liquid",,"Undeposited Funds",704.41,"",215108.91
,"Invoice","06-06-2024","MC05790",,"Karia Supermarkets Limited","-MULTIPLE-","Cost of Goods Sold","Zelia Handwash Liquid",,"Accounts Receivable",2265.87,"",217374.78
,"Sales Receipt","06-06-2024","2429",,"Cash Sales","Zelia Strawberry Handwash Liquid 500ML","Cost of Goods Sold","Zelia Handwash Liquid",,"Undeposited Funds",43.53,"",217418.31
,"Sales Receipt","06-06-2024","2424",,"Bethel Store","-MULTIPLE-","Cost of Goods Sold","Zelia Handwash Liquid",,"Undeposited Funds",283.23,"",217701.54
,"Sales Receipt","06-06-2024","2718",,"Mama G Wholesale","-MULTIPLE-","Cost of Goods Sold","Zelia Handwash Liquid",,"Undeposited Funds",704.41,"",218405.95
,"Sales Receipt","06-06-2024","2423",,"Ekai moke wholesale","-MULTIPLE-","Cost of Goods Sold","Zelia Handwash Liquid",,"Undeposited Funds",704.41,"",219110.36
,"Sales Receipt","06-06-2024","2422",,"Tender Store Limited","-MULTIPLE-","Cost of Goods Sold","Zelia Handwash Liquid",,"Undeposited Funds",1416.16,"",220526.52
,"Sales Receipt","07-06-2024","1993",,"Cash Sales","Zelia Strawberry Handwash Liquid 5L","Cost of Goods Sold","Zelia Handwash Liquid",,"Undeposited Funds",221.00,"",220747.52
,"Sales Receipt","07-06-2024","1996",,"Cash Sales","Zelia Apple Handwash Liquid 500ML","Cost of Goods Sold","Zelia Handwash Liquid",,"Undeposited Funds",152.65,"",220900.17
,"Sales Receipt","08-06-2024","2432",,"Cash Sales","Zelia Strawberry Handwash Liquid 500ML","Cost of Goods Sold","Zelia Handwash Liquid",,"Undeposited Funds",261.17,"",221161.34
,"Sales Receipt","10-06-2024","2434",,"Cash Sales","Zelia Strawberry Handwash Liquid 500ML","Cost of Goods Sold","Zelia Handwash Liquid",,"Undeposited Funds",43.53,"",221204.87
,"Sales Receipt","10-06-2024","2437",,"Al Mubarak Wholesalers","-MULTIPLE-","Cost of Goods Sold","Zelia Handwash Liquid",,"Undeposited Funds",1342.44,"",222547.31
,"Invoice","11-06-2024","MC05815",,"MADINA SUPERMARKET LIMITED","-MULTIPLE-","Cost of Goods Sold","Zelia Handwash Liquid",,"Accounts Receivable",268.48,"",222815.79
,"Sales Receipt","11-06-2024","2439",,"Cash Sales","Zelia Strawberry Handwash Liquid 500ML","Cost of Goods Sold","Zelia Handwash Liquid",,"Undeposited Funds",43.53,"",222859.32
,"Sales Receipt","11-06-2024","2440",,"Cash Sales","Zelia Strawberry Handwash Liquid 500ML","Cost of Goods Sold","Zelia Handwash Liquid",,"Undeposited Funds",43.53,"",222902.85
,"Sales Receipt","11-06-2024","2447",,"Cash Sales","Zelia Strawberry Handwash Liquid 5L","Cost of Goods Sold","Zelia Handwash Liquid",,"Undeposited Funds",221.00,"",223123.85
,"Sales Receipt","11-06-2024","2715",,"Asfa Shop","-MULTIPLE-","Cost of Goods Sold","Zelia Handwash Liquid",,"Undeposited Funds",266.05,"",223389.90
,"Sales Receipt","11-06-2024","2448",,"Farmwell Enterprises","-MULTIPLE-","Cost of Goods Sold","Zelia Handwash Liquid",,"Undeposited Funds",268.48,"",223658.38
,"Invoice","12-06-2024","MC05819",,"INTEGRAL MEDIA LIMITED","-MULTIPLE-","Cost of Goods Sold","Zelia Handwash Liquid",,"Accounts Receivable",672.45,"",224330.83
,"Sales Receipt","12-06-2024","2449",,"Cash Sales","Zelia Apple Handwash Liquid 500ML","Cost of Goods Sold","Zelia Handwash Liquid",,"Undeposited Funds",45.97,"",224376.80
,"Sales Receipt","12-06-2024","2453",,"Cash Sales","-MULTIPLE-","Cost of Goods Sold","Zelia Handwash Liquid",,"Undeposited Funds",1962.13,"",226338.93
,"Sales Receipt","12-06-2024","2462",,"Mama Amina","-MULTIPLE-","Cost of Goods Sold","Zelia Handwash Liquid",,"Undeposited Funds",670.01,"",227008.94
,"Invoice","13-06-2024","MC05820",,"ZAIN SUPERMARKET LIMITED","-MULTIPLE-","Cost of Goods Sold","Zelia Handwash Liquid",,"Accounts Receivable",536.98,"",227545.92
,"Sales Receipt","13-06-2024","2464",,"Cash Sales","Zelia Apple Handwash Liquid 500ML","Cost of Goods Sold","Zelia Handwash Liquid",,"Undeposited Funds",45.97,"",227591.89
,"Sales Receipt","13-06-2024","2474",,"Fahma Qali","-MULTIPLE-","Cost of Goods Sold","Zelia Handwash Liquid",,"Undeposited Funds",670.01,"",228261.90
,"Sales Receipt","14-06-2024","2477",,"Cash Sales","Zelia Apple Handwash Liquid 500ML","Cost of Goods Sold","Zelia Handwash Liquid",,"Undeposited Funds",91.94,"",228353.84
,"Sales Receipt","14-06-2024","2480",,"Cash Sales","Zelia Apple Handwash Liquid 500ML","Cost of Goods Sold","Zelia Handwash Liquid",,"Undeposited Funds",91.94,"",228445.78
,"Sales Receipt","14-06-2024","2481",,"Cash Sales","-MULTIPLE-","Cost of Goods Sold","Zelia Handwash Liquid",,"Undeposited Funds",89.50,"",228535.28
,"Sales Receipt","14-06-2024","2713",,"032 minimart","-MULTIPLE-","Cost of Goods Sold","Zelia Handwash Liquid",,"Undeposited Funds",670.01,"",229205.29
,"Sales Receipt","14-06-2024","2710",,"tRIPPLE M","Zelia Strawberry Handwash Liquid 500ML","Cost of Goods Sold","Zelia Handwash Liquid",,"Undeposited Funds",261.17,"",229466.46
,"Sales Receipt","14-06-2024","2709",,"mwaspart","-MULTIPLE-","Cost of Goods Sold","Zelia Handwash Liquid",,"Undeposited Funds",536.98,"",230003.44
,"Sales Receipt","18-06-2024","2711",,"Cash Sales","Zelia Strawberry Handwash Liquid 500ML","Cost of Goods Sold","Zelia Handwash Liquid",,"Undeposited Funds",43.53,"",230046.97
,"Sales Receipt","18-06-2024","2500",,"Al Hamdu shop","-MULTIPLE-","Cost of Goods Sold","Zelia Handwash Liquid",,"Undeposited Funds",268.48,"",230315.45
,"Sales Receipt","18-06-2024","2704",,"Himilo Wholesallers","-MULTIPLE-","Cost of Goods Sold","Zelia Handwash Liquid",,"Undeposited Funds",1342.44,"",231657.89
,"Sales Receipt","19-06-2024","2484",,"Cash Sales","Zelia Strawberry Handwash Liquid 5L","Cost of Goods Sold","Zelia Handwash Liquid",,"Undeposited Funds",221.00,"",231878.89
,"Invoice","20-06-2024","MC05842",,"HOPEMART SELF SERVICES LTD","-MULTIPLE-","Cost of Goods Sold","Zelia Handwash Liquid",,"Accounts Receivable",1342.44,"",233221.33
,"Invoice","20-06-2024","MC05845",,"Azaavi Collections Limited","Zelia Apple Handwash Liquid 500ML","Cost of Goods Sold","Zelia Handwash Liquid",,"Accounts Receivable",45.97,"",233267.30
,"Sales Receipt","20-06-2024","2493",,"Cash Sales","-MULTIPLE-","Cost of Goods Sold","Zelia Handwash Liquid",,"Undeposited Funds",89.50,"",233356.80
,"Sales Receipt","20-06-2024","AT197",,"Cash Sales","-MULTIPLE-","Cost of Goods Sold","Zelia Handwash Liquid",,"Undeposited Funds",2147.92,"",235504.72
,"Sales Receipt","20-06-2024","AT198",,"Cash Sales","-MULTIPLE-","Cost of Goods Sold","Zelia Handwash Liquid",,"Undeposited Funds",1094.92,"",236599.64
,"Sales Receipt","20-06-2024","2494",,"Restoration Traders","-MULTIPLE-","Cost of Goods Sold","Zelia Handwash Liquid",,"Undeposited Funds",1342.44,"",237942.08
,"Sales Receipt","20-06-2024","2495",,"Nabcom Stores","-MULTIPLE-","Cost of Goods Sold","Zelia Handwash Liquid",,"Undeposited Funds",670.01,"",238612.09
,"Sales Receipt","20-06-2024","2498",,"Mamken Minimart","Zelia Apple Handwash Liquid 500ML","Cost of Goods Sold","Zelia Handwash Liquid",,"Undeposited Funds",275.81,"",238887.90
,"Sales Receipt","21-06-2024","2722",,"Kika Mart","-MULTIPLE-","Cost of Goods Sold","Zelia Handwash Liquid",,"Undeposited Funds",268.48,"",239156.38
,"Sales Receipt","21-06-2024","2724",,"Hypermart","-MULTIPLE-","Cost of Goods Sold","Zelia Handwash Liquid",,"Undeposited Funds",268.48,"",239424.86
,"Sales Receipt","21-06-2024","2725",,"Marris Mini mart","-MULTIPLE-","Cost of Goods Sold","Zelia Handwash Liquid",,"Undeposited Funds",268.48,"",239693.34
,"Invoice","24-06-2024","MC05851",,"SUMM SUPERMARKET LIMITED","Zelia Apple Handwash Liquid 500ML","Cost of Goods Sold","Zelia Handwash Liquid",,"Accounts Receivable",275.81,"",239969.15
,"Sales Receipt","24-06-2024","2730",,"Neema Bei Nafuu","-MULTIPLE-","Cost of Goods Sold","Zelia Handwash Liquid",,"Undeposited Funds",670.01,"",240639.16
,"Sales Receipt","24-06-2024","2729",,"Natala Shop","-MULTIPLE-","Cost of Goods Sold","Zelia Handwash Liquid",,"Undeposited Funds",268.48,"",240907.64
,"Sales Receipt","24-06-2024","2720",,"Cheaper Cheap","Zelia Apple Handwash Liquid 500ML","Cost of Goods Sold","Zelia Handwash Liquid",,"Undeposited Funds",321.78,"",241229.42
,"Sales Receipt","24-06-2024","2728",,"Gidesh Supermarket","-MULTIPLE-","Cost of Goods Sold","Zelia Handwash Liquid",,"Undeposited Funds",1342.44,"",242571.86
,"Sales Receipt","24-06-2024","8960",,"Pambazuka Mart (K) Limited","-MULTIPLE-","Cost of Goods Sold","Zelia Handwash Liquid",,"Undeposited Funds",1073.96,"",243645.82
,"Invoice","26-06-2024","MC05861",,"TAWALA SUPERMARKET LIMITED","-MULTIPLE-","Cost of Goods Sold","Zelia Handwash Liquid",,"Accounts Receivable",670.01,"",244315.83
,"Invoice","26-06-2024","MC05862",,"LUCKY MART SUPERMARKET LIMITED","-MULTIPLE-","Cost of Goods Sold","Zelia Handwash Liquid",,"Accounts Receivable",536.98,"",244852.81
,"Invoice","26-06-2024","MC05863",,"Tupo Mart Limited","-MULTIPLE-","Cost of Goods Sold","Zelia Handwash Liquid",,"Accounts Receivable",536.98,"",245389.79
,"Invoice","26-06-2024","MC05865",,"KASAMAT INVESTMENTS LTD","Zelia Apple Handwash Liquid 500ML","Cost of Goods Sold","Zelia Handwash Liquid",,"Accounts Receivable",137.90,"",245527.69
,"Invoice","26-06-2024","MC05866",,"DISII TRADERS LTD","Zelia Apple Handwash Liquid 500ML","Cost of Goods Sold","Zelia Handwash Liquid",,"Accounts Receivable",275.81,"",245803.50
,"Sales Receipt","26-06-2024","2734",,"Wadajir Wholesalers","-MULTIPLE-","Cost of Goods Sold","Zelia Handwash Liquid",,"Undeposited Funds",4027.34,"",249830.84
,"Sales Receipt","27-06-2024","2736",,"Cash Sales","Zelia Strawberry Handwash Liquid 5L","Cost of Goods Sold","Zelia Handwash Liquid",,"Undeposited Funds",221.00,"",250051.84
,"Sales Receipt","28-06-2024","2738",,"Cash Sales","Zelia Strawberry Handwash Liquid 5L","Cost of Goods Sold","Zelia Handwash Liquid",,"Undeposited Funds",221.00,"",250272.84
,"Sales Receipt","28-06-2024","2744",,"Cash Sales","-MULTIPLE-","Cost of Goods Sold","Zelia Handwash Liquid",,"Undeposited Funds",89.50,"",250362.34
,"Sales Receipt","01-07-2024","2553",,"Soko Store","Zelia Apple Handwash Liquid 500ML","Cost of Goods Sold","Zelia Handwash Liquid",,"Undeposited Funds",321.78,"",250684.12
,"Sales Receipt","02-07-2024","2760",,"Cash Sales","Zelia Apple Handwash Liquid 500ML","Cost of Goods Sold","Zelia Handwash Liquid",,"Undeposited Funds",45.97,"",250730.09
,"Invoice","03-07-2024","MC05880",,"SECUTOR LIMITED","Zelia Apple Handwash Liquid 500ML","Cost of Goods Sold","Zelia Handwash Liquid",,"Accounts Receivable",45.97,"",250776.06
,"Sales Receipt","03-07-2024","2761",,"Cash Sales","-MULTIPLE-","Cost of Goods Sold","Zelia Handwash Liquid",,"Undeposited Funds",268.48,"",251044.54
,"Sales Receipt","03-07-2024","2767",,"Cash Sales","-MULTIPLE-","Cost of Goods Sold","Zelia Handwash Liquid",,"Undeposited Funds",89.50,"",251134.04
,"Sales Receipt","03-07-2024","2772",,"Ahlam Shop","-MULTIPLE-","Cost of Goods Sold","Zelia Handwash Liquid",,"Undeposited Funds",670.01,"",251804.05
,"Sales Receipt","03-07-2024","2773",,"Muleshe Wholesallers","-MULTIPLE-","Cost of Goods Sold","Zelia Handwash Liquid",,"Undeposited Funds",1342.44,"",253146.49
,"Sales Receipt","03-07-2024","2774",,"Warfa Wholesale","-MULTIPLE-","Cost of Goods Sold","Zelia Handwash Liquid",,"Undeposited Funds",1342.44,"",254488.93
,"Sales Receipt","03-07-2024","2777",,"Farhan Wholesallers","-MULTIPLE-","Cost of Goods Sold","Zelia Handwash Liquid",,"Undeposited Funds",2684.90,"",257173.83
,"Sales Receipt","03-07-2024","2780",,"Adno shop","-MULTIPLE-","Cost of Goods Sold","Zelia Handwash Liquid",,"Undeposited Funds",670.01,"",257843.84
,"Sales Receipt","03-07-2024","2770",,"Tayamo Wholesalers","Zelia Apple Handwash Liquid 500ML","Cost of Goods Sold","Zelia Handwash Liquid",,"Undeposited Funds",45.97,"",257889.81
,"Sales Receipt","05-07-2024","2798",,"Two Boys Shop","-MULTIPLE-","Cost of Goods Sold","Zelia Handwash Liquid",,"Undeposited Funds",536.98,"",258426.79
,"Sales Receipt","05-07-2024","2799",,"Milimani Store","-MULTIPLE-","Cost of Goods Sold","Zelia Handwash Liquid",,"Undeposited Funds",268.48,"",258695.27
,"Sales Receipt","05-07-2024","2514",,"Tender Store Limited","-MULTIPLE-","Cost of Goods Sold","Zelia Handwash Liquid",,"Undeposited Funds",2684.90,"",261380.17
,"Sales Receipt","06-07-2024","2515",,"Horn of Africa","-MULTIPLE-","Cost of Goods Sold","Zelia Handwash Liquid",,"Undeposited Funds",670.01,"",262050.18
,"Sales Receipt","06-07-2024","2516",,"Baraka Cerials","-MULTIPLE-","Cost of Goods Sold","Zelia Handwash Liquid",,"Undeposited Funds",268.48,"",262318.66
,"Sales Receipt","08-07-2024","2527",,"Afro Drip LTD","-MULTIPLE-","Cost of Goods Sold","Zelia Handwash Liquid",,"Undeposited Funds",130.45,"",262449.11
,"Sales Receipt","08-07-2024","2506",,"Gargar Foodstuffs","Zelia Apple Handwash Liquid 500ML","Cost of Goods Sold","Zelia Handwash Liquid",,"Undeposited Funds",651.89,"",263101.00
,"Sales Receipt","09-07-2024","2510",,"Cash Sales","Zelia Apple Handwash Liquid 500ML","Cost of Goods Sold","Zelia Handwash Liquid",,"Undeposited Funds",43.35,"",263144.35
,"Sales Receipt","09-07-2024","2526",,"Cash Sales","-MULTIPLE-","Cost of Goods Sold","Zelia Handwash Liquid",,"Undeposited Funds",86.88,"",263231.23
,"Sales Receipt","09-07-2024","2569",,"Al Hamdu shop","-MULTIPLE-","Cost of Goods Sold","Zelia Handwash Liquid",,"Undeposited Funds",651.53,"",263882.76
,"Sales Receipt","10-07-2024","2556",,"Ekai moke wholesale","-MULTIPLE-","Cost of Goods Sold","Zelia Handwash Liquid",,"Undeposited Funds",1303.22,"",265185.98
,"Sales Receipt","12-07-2024","2537",,"Cash Sales","Zelia Apple Handwash Liquid 500ML","Cost of Goods Sold","Zelia Handwash Liquid",,"Undeposited Funds",86.71,"",265272.69
,"Invoice","15-07-2024","MC05921",,"OFFSHORE GLOBAL LOGISTICS LIMITED","Zelia Apple Handwash Liquid 5L","Cost of Goods Sold","Zelia Handwash Liquid",,"Accounts Receivable",224.27,"",265496.96
,"Invoice","15-07-2024","MC05924",,"Azaavi Collections Limited","Zelia Strawberry Handwash Liquid 500ML","Cost of Goods Sold","Zelia Handwash Liquid",,"Accounts Receivable",43.53,"",265540.49
,"Invoice","15-07-2024","MC05931",,"KASAMAT INVESTMENTS LTD","-MULTIPLE-","Cost of Goods Sold","Zelia Handwash Liquid",,"Accounts Receivable",521.29,"",266061.78
,"Invoice","15-07-2024","MC05932",,"ROYMATT SUPERMARKET LIMITED","-MULTIPLE-","Cost of Goods Sold","Zelia Handwash Liquid",,"Accounts Receivable",260.64,"",266322.42
,"Sales Receipt","15-07-2024","2546",,"Brinso Foodstufs","-MULTIPLE-","Cost of Goods Sold","Zelia Handwash Liquid",,"Undeposited Funds",651.53,"",266973.95
,"Sales Receipt","15-07-2024","2549",,"Himilo General Store","-MULTIPLE-","Cost of Goods Sold","Zelia Handwash Liquid",,"Undeposited Funds",2606.46,"",269580.41
,"Sales Receipt","16-07-2024","2550",,"Summer Outlets","-MULTIPLE-","Cost of Goods Sold","Zelia Handwash Liquid",,"Undeposited Funds",651.70,"",270232.11
,"Sales Receipt","16-07-2024","2557",,"Somo 1 Mowlem","-MULTIPLE-","Cost of Goods Sold","Zelia Handwash Liquid",,"Undeposited Funds",651.70,"",270883.81
,"Sales Receipt","16-07-2024","2563",,"Zulu Enterprise","-MULTIPLE-","Cost of Goods Sold","Zelia Handwash Liquid",,"Undeposited Funds",651.70,"",271535.51
,"Invoice","17-07-2024","MC05940",,"Maji Asili Limited","-MULTIPLE-","Cost of Goods Sold","Zelia Handwash Liquid",,"Accounts Receivable",1303.22,"",272838.73
,"Invoice","17-07-2024","MC05941",,"Ck Upscales Limited","-MULTIPLE-","Cost of Goods Sold","Zelia Handwash Liquid",,"Accounts Receivable",434.41,"",273273.14
,"Sales Receipt","17-07-2024","2551",,"Cash Sales","Zelia Apple Handwash Liquid 500ML","Cost of Goods Sold","Zelia Handwash Liquid",,"Undeposited Funds",260.12,"",273533.26
,"Sales Receipt","17-07-2024","2561",,"Mama G shop","-MULTIPLE-","Cost of Goods Sold","Zelia Handwash Liquid",,"Undeposited Funds",1303.22,"",274836.48
,"Sales Receipt","17-07-2024","2559",,"Libin Minimart","-MULTIPLE-","Cost of Goods Sold","Zelia Handwash Liquid",,"Undeposited Funds",1303.22,"",276139.70
,"Sales Receipt","18-07-2024","2604",,"Qudus Wholesale","-MULTIPLE-","Cost of Goods Sold","Zelia Handwash Liquid",,"Undeposited Funds",651.70,"",276791.40
,"Sales Receipt","18-07-2024","2576",,"Mizpa Minimart","-MULTIPLE-","Cost of Goods Sold","Zelia Handwash Liquid",,"Undeposited Funds",173.77,"",276965.17
,"Sales Receipt","19-07-2024","2605",,"Restoration Traders","-MULTIPLE-","Cost of Goods Sold","Zelia Handwash Liquid",,"Undeposited Funds",1303.22,"",278268.39
,"Sales Receipt","22-07-2024","2575",,"Cash Sales","-MULTIPLE-","Cost of Goods Sold","Zelia Handwash Liquid",,"Undeposited Funds",651.70,"",278920.09
,"Sales Receipt","22-07-2024","2570",,"Cash Sales","-MULTIPLE-","Cost of Goods Sold","Zelia Handwash Liquid",,"Undeposited Funds",86.88,"",279006.97
,"Sales Receipt","22-07-2024","2606",,"Skype Traders","-MULTIPLE-","Cost of Goods Sold","Zelia Handwash Liquid",,"Undeposited Funds",2606.46,"",281613.43
,"Sales Receipt","23-07-2024","2580",,"Cash Sales","-MULTIPLE-","Cost of Goods Sold","Zelia Handwash Liquid",,"Undeposited Funds",86.88,"",281700.31
,"Sales Receipt","23-07-2024","2582",,"Cash Sales","-MULTIPLE-","Cost of Goods Sold","Zelia Handwash Liquid",,"Undeposited Funds",173.77,"",281874.08
,"Sales Receipt","23-07-2024","2591",,"Cash Sales","Zelia Strawberry Handwash Liquid 5L","Cost of Goods Sold","Zelia Handwash Liquid",,"Undeposited Funds",221.00,"",282095.08
,"Sales Receipt","23-07-2024","2581",,"Cash Sales","-MULTIPLE-","Cost of Goods Sold","Zelia Handwash Liquid",,"Undeposited Funds",217.12,"",282312.20
,"Sales Receipt","23-07-2024","2607",,"Juli Mart","-MULTIPLE-","Cost of Goods Sold","Zelia Handwash Liquid",,"Undeposited Funds",260.64,"",282572.84
,"Sales Receipt","24-07-2024","2588",,"Cash Sales","Zelia Strawberry Handwash Liquid 5L","Cost of Goods Sold","Zelia Handwash Liquid",,"Undeposited Funds",221.00,"",282793.84
,"Sales Receipt","24-07-2024","2593",,"Cash Sales","Zelia Apple Handwash Liquid 500ML","Cost of Goods Sold","Zelia Handwash Liquid",,"Undeposited Funds",1734.14,"",284527.98
,"Sales Receipt","24-07-2024","2587",,"Cash Sales","Zelia Strawberry Handwash Liquid 5L","Cost of Goods Sold","Zelia Handwash Liquid",,"Undeposited Funds",221.00,"",284748.98
,"Sales Receipt","24-07-2024","2597",,"Neema Supermarket","-MULTIPLE-","Cost of Goods Sold","Zelia Handwash Liquid",,"Undeposited Funds",651.70,"",285400.68
,"Sales Receipt","24-07-2024","2608",,"Capital Halal","-MULTIPLE-","Cost of Goods Sold","Zelia Handwash Liquid",,"Undeposited Funds",260.64,"",285661.32
,"Sales Receipt","25-07-2024","2592",,"Cash Sales","Zelia Strawberry Handwash Liquid 5L","Cost of Goods Sold","Zelia Handwash Liquid",,"Undeposited Funds",221.00,"",285882.32
,"Sales Receipt","25-07-2024","2609",,"Zebra Minimart","-MULTIPLE-","Cost of Goods Sold","Zelia Handwash Liquid",,"Undeposited Funds",260.64,"",286142.96
,"Invoice","26-07-2024","MC05976",,"SUMM SUPERMARKET LIMITED","-MULTIPLE-","Cost of Goods Sold","Zelia Handwash Liquid",,"Accounts Receivable",391.23,"",286534.19
,"Sales Receipt","27-07-2024","2653",,"Danaba Wholesallers","-MULTIPLE-","Cost of Goods Sold","Zelia Handwash Liquid",,"Undeposited Funds",1282.85,"",287817.04
,"Sales Receipt","27-07-2024","2652",,"Mash-B Wholesale","-MULTIPLE-","Cost of Goods Sold","Zelia Handwash Liquid",,"Undeposited Funds",640.83,"",288457.87
,"Invoice","29-07-2024","MC05983",,"Muhaya & Rukundo Holdings Ltd","0001.12.00 Zelia Apple Handwash Liquid 15X500ML","Cost of Goods Sold","Zelia Handwash Liquid",,"Accounts Receivable",1392.94,"",289850.81
,"Invoice","29-07-2024","MC05984",,"Mumsha Supamat","-MULTIPLE-","Cost of Goods Sold","Zelia Handwash Liquid",,"Accounts Receivable",513.14,"",290363.95
,"Sales Receipt","29-07-2024","2602",,"Cash Sales","-MULTIPLE-","Cost of Goods Sold","Zelia Handwash Liquid",,"Undeposited Funds",85.52,"",290449.47
,"Sales Receipt","29-07-2024","2610",,"Cash Sales","Zelia Apple Handwash Liquid 500ML","Cost of Goods Sold","Zelia Handwash Liquid",,"Undeposited Funds",650.30,"",291099.77
,"Sales Receipt","29-07-2024","2614",,"Rio Deli Wholesalers","-MULTIPLE-","Cost of Goods Sold","Zelia Handwash Liquid",,"Undeposited Funds",1282.85,"",292382.62
,"Sales Receipt","29-07-2024","2615",,"Sharma Shop","-MULTIPLE-","Cost of Goods Sold","Zelia Handwash Liquid",,"Undeposited Funds",640.83,"",293023.45
,"Build Assembly","29-07-2024","11037",,,,"Cost of Goods Sold","Zelia Handwash Liquid","X","-SPLIT-","",35.17,292988.28
,"Sales Receipt","29-07-2024","2922",,"Muhaya & Rukundo Holdings Ltd","Zelia Apple Handwash Liquid 15X500ML","Cost of Goods Sold","Zelia Handwash Liquid",,"Undeposited Funds",1392.94,"",294381.22
,"Invoice","30-07-2024","MC05985",,"LUCKY MART SUPERMARKET LIMITED","Zelia Strawberry Handwash Liquid 500ML","Cost of Goods Sold","Zelia Handwash Liquid",,"Accounts Receivable",252.82,"",294634.04
,"Sales Receipt","30-07-2024","2619",,"Cash Sales","Zelia Strawberry Handwash Liquid 500ML","Cost of Goods Sold","Zelia Handwash Liquid",,"Undeposited Funds",42.14,"",294676.18
,"Sales Receipt","30-07-2024","2620",,"Cash Sales","Zelia Strawberry Handwash Liquid 500ML","Cost of Goods Sold","Zelia Handwash Liquid",,"Undeposited Funds",126.41,"",294802.59
,"Sales Receipt","30-07-2024","2629",,"Cash Sales","Zelia Strawberry Handwash Liquid 5L","Cost of Goods Sold","Zelia Handwash Liquid",,"Undeposited Funds",221.00,"",295023.59
,"Sales Receipt","30-07-2024","2627",,"Elliane Wholesalers","-MULTIPLE-","Cost of Goods Sold","Zelia Handwash Liquid",,"Undeposited Funds",256.47,"",295280.06
,"Sales Receipt","30-07-2024","2626",,"Nzuri Supermarket","-MULTIPLE-","Cost of Goods Sold","Zelia Handwash Liquid",,"Undeposited Funds",256.47,"",295536.53
,"Sales Receipt","30-07-2024","2689",,"Mt Kenya  mart","-MULTIPLE-","Cost of Goods Sold","Zelia Handwash Liquid",,"Undeposited Funds",512.94,"",296049.47
,"Sales Receipt","31-07-2024","2631",,"Cash Sales","Zelia Strawberry Handwash Liquid 5L","Cost of Goods Sold","Zelia Handwash Liquid",,"Undeposited Funds",442.00,"",296491.47
,"Sales Receipt","31-07-2024","2635",,"Cash Sales","Zelia Strawberry Handwash Liquid 5L","Cost of Goods Sold","Zelia Handwash Liquid",,"Undeposited Funds",221.00,"",296712.47
,"Sales Receipt","31-07-2024","2633",,"Sharazad Wholesalers","-MULTIPLE-","Cost of Goods Sold","Zelia Handwash Liquid",,"Undeposited Funds",640.57,"",297353.04
,"Sales Receipt","31-07-2024","2634",,"Ushirika Shop","-MULTIPLE-","Cost of Goods Sold","Zelia Handwash Liquid",,"Undeposited Funds",1914.41,"",299267.45
,"Sales Receipt","01-08-2024","4353",,"Goldmart Supermarket","-MULTIPLE-","Cost of Goods Sold","Zelia Handwash Liquid",,"Undeposited Funds",640.57,"",299908.02
,"Sales Receipt","01-08-2024","2638",,"BCB Shop","-MULTIPLE-","Cost of Goods Sold","Zelia Handwash Liquid",,"Undeposited Funds",640.57,"",300548.59
,"Sales Receipt","01-08-2024","2691",,"Ubwere Store","-MULTIPLE-","Cost of Goods Sold","Zelia Handwash Liquid",,"Undeposited Funds",512.94,"",301061.53
,"Sales Receipt","01-08-2024","2664",,"Mkulima Supermarket","-MULTIPLE-","Cost of Goods Sold","Zelia Handwash Liquid",,"Undeposited Funds",1025.88,"",302087.41
,"Sales Receipt","02-08-2024","2644",,"Cash Sales","Zelia Strawberry Handwash Liquid 500ML","Cost of Goods Sold","Zelia Handwash Liquid",,"Undeposited Funds",42.14,"",302129.55
,"Sales Receipt","02-08-2024","2650",,"Cash Sales","Zelia Apple Handwash Liquid 500ML","Cost of Goods Sold","Zelia Handwash Liquid",,"Undeposited Funds",43.35,"",302172.90
,"Sales Receipt","02-08-2024","2666",,"Mama Amina","-MULTIPLE-","Cost of Goods Sold","Zelia Handwash Liquid",,"Undeposited Funds",640.57,"",302813.47
,"Sales Receipt","03-08-2024","2670",,"Gacal Wholesale","-MULTIPLE-","Cost of Goods Sold","Zelia Handwash Liquid",,"Undeposited Funds",640.57,"",303454.04
,"Sales Receipt","03-08-2024","2668",,"Freshtake wholesalers","-MULTIPLE-","Cost of Goods Sold","Zelia Handwash Liquid",,"Undeposited Funds",640.57,"",304094.61
,"Sales Receipt","05-08-2024","2657",,"Cash Sales","Zelia Strawberry Handwash Liquid 500ML","Cost of Goods Sold","Zelia Handwash Liquid",,"Undeposited Funds",632.06,"",304726.67
,"Sales Receipt","05-08-2024","2671",,"Hidika Shop","-MULTIPLE-","Cost of Goods Sold","Zelia Handwash Liquid",,"Undeposited Funds",640.57,"",305367.24
,"Sales Receipt","05-08-2024","2679",,"Golden Save","-MULTIPLE-","Cost of Goods Sold","Zelia Handwash Liquid",,"Undeposited Funds",4452.72,"",309819.96
,"Sales Receipt","05-08-2024","2673",,"Gure Yare Shop","-MULTIPLE-","Cost of Goods Sold","Zelia Handwash Liquid",,"Undeposited Funds",2564.72,"",312384.68
,"Invoice","06-08-2024","MC06004",,"HAPPY VIEW SUPERMARKET LIMITED","-MULTIPLE-","Cost of Goods Sold","Zelia Handwash Liquid",,"Accounts Receivable",512.94,"",312897.62
,"Invoice","06-08-2024","MC06005",,"TAWALA SUPERMARKET LIMITED","-MULTIPLE-","Cost of Goods Sold","Zelia Handwash Liquid",,"Accounts Receivable",640.57,"",313538.19
,"Sales Receipt","06-08-2024","2659",,"Cash Sales","Zelia Strawberry Handwash Liquid 5L","Cost of Goods Sold","Zelia Handwash Liquid",,"Undeposited Funds",221.00,"",313759.19
,"Sales Receipt","06-08-2024","2674",,"Cash Sales","Zelia Strawberry Handwash Liquid 500ML","Cost of Goods Sold","Zelia Handwash Liquid",,"Undeposited Funds",42.14,"",313801.33
,"Sales Receipt","06-08-2024","2676",,"Warfa Wholesale","-MULTIPLE-","Cost of Goods Sold","Zelia Handwash Liquid",,"Undeposited Funds",1282.36,"",315083.69
,"Sales Receipt","06-08-2024","2680",,"Juja Minimart","-MULTIPLE-","Cost of Goods Sold","Zelia Handwash Liquid",,"Undeposited Funds",640.57,"",315724.26
,"Sales Receipt","07-08-2024","2683",,"Marris Mini mart","Zelia Apple Handwash Liquid 500ML","Cost of Goods Sold","Zelia Handwash Liquid",,"Undeposited Funds",260.12,"",315984.38
,"Sales Receipt","07-08-2024","2686",,"Soimo Minimart","-MULTIPLE-","Cost of Goods Sold","Zelia Handwash Liquid",,"Undeposited Funds",256.47,"",316240.85
,"Sales Receipt","07-08-2024","2809",,"Safa Mart Wholesalers","-MULTIPLE-","Cost of Goods Sold","Zelia Handwash Liquid",,"Undeposited Funds",640.57,"",316881.42
,"Invoice","08-08-2024","MC06016",,"DISII TRADERS LTD","-MULTIPLE-","Cost of Goods Sold","Zelia Handwash Liquid",,"Accounts Receivable",512.94,"",317394.36
,"Invoice","08-08-2024","MC06017",,"INTEGRAL MEDIA LIMITED","Zelia Apple Handwash Liquid 5L","Cost of Goods Sold","Zelia Handwash Liquid",,"Accounts Receivable",224.27,"",317618.63
,"Sales Receipt","08-08-2024","2694",,"mwaspart","-MULTIPLE-","Cost of Goods Sold","Zelia Handwash Liquid",,"Undeposited Funds",640.57,"",318259.20
,"Invoice","09-08-2024","MC06019",,"ROYMATT SUPERMARKET LIMITED","-MULTIPLE-","Cost of Goods Sold","Zelia Handwash Liquid",,"Accounts Receivable",640.57,"",318899.77
,"Invoice","09-08-2024","MC06020",,"DALLAS SHOPRITE LTD","-MULTIPLE-","Cost of Goods Sold","Zelia Handwash Liquid",,"Accounts Receivable",512.94,"",319412.71
,"Sales Receipt","09-08-2024","2696",,"Cash Sales","Zelia Strawberry Handwash Liquid 500ML","Cost of Goods Sold","Zelia Handwash Liquid",,"Undeposited Funds",42.14,"",319454.85
,"Sales Receipt","09-08-2024","2699",,"Cash Sales","Zelia Strawberry Handwash Liquid 500ML","Cost of Goods Sold","Zelia Handwash Liquid",,"Undeposited Funds",42.14,"",319496.99
,"Sales Receipt","09-08-2024","2811",,"SK Groceries","-MULTIPLE-","Cost of Goods Sold","Zelia Handwash Liquid",,"Undeposited Funds",640.57,"",320137.56
,"Sales Receipt","09-08-2024","2697",,"Bismillah shop","-MULTIPLE-","Cost of Goods Sold","Zelia Handwash Liquid",,"Undeposited Funds",341.96,"",320479.52
,"Invoice","12-08-2024","MC06030",,"MASABA DISCOUNT STORES LTD","-MULTIPLE-","Cost of Goods Sold","Zelia Handwash Liquid",,"Accounts Receivable",1290.53,"",321770.05
,"Invoice","12-08-2024","MC06031",,"KAVYA SUPERMARKET LIMITED","-MULTIPLE-","Cost of Goods Sold","Zelia Handwash Liquid",,"Accounts Receivable",1290.53,"",323060.58
,"Sales Receipt","12-08-2024","2700",,"Vane Wholesalers","-MULTIPLE-","Cost of Goods Sold","Zelia Handwash Liquid",,"Undeposited Funds",644.39,"",323704.97
,"Sales Receipt","12-08-2024","2802",,"Sylas Store","-MULTIPLE-","Cost of Goods Sold","Zelia Handwash Liquid",,"Undeposited Funds",6452.65,"",330157.62
,"Sales Receipt","12-08-2024","2803",,"Diamond Shop","-MULTIPLE-","Cost of Goods Sold","Zelia Handwash Liquid",,"Undeposited Funds",258.10,"",330415.72
,"Sales Receipt","12-08-2024","2805",,"Misin Shop","-MULTIPLE-","Cost of Goods Sold","Zelia Handwash Liquid",,"Undeposited Funds",1202.74,"",331618.46
,"Sales Receipt","12-08-2024","2806",,"Riverside Hotel","-MULTIPLE-","Cost of Goods Sold","Zelia Handwash Liquid",,"Undeposited Funds",646.15,"",332264.61
,"Sales Receipt","12-08-2024","2813",,"Mamken Minimart","Zelia Strawberry Handwash Liquid 500ML","Cost of Goods Sold","Zelia Handwash Liquid",,"Undeposited Funds",252.82,"",332517.43
,"Sales Receipt","12-08-2024","2814",,"Asfa Shop","-MULTIPLE-","Cost of Goods Sold","Zelia Handwash Liquid",,"Undeposited Funds",258.10,"",332775.53
,"Sales Receipt","12-08-2024","2815",,"Kibibi Wasai Store","-MULTIPLE-","Cost of Goods Sold","Zelia Handwash Liquid",,"Undeposited Funds",644.39,"",333419.92
,"Sales Receipt","12-08-2024","2818",,"Rumi Wholesalers","-MULTIPLE-","Cost of Goods Sold","Zelia Handwash Liquid",,"Undeposited Funds",1290.53,"",334710.45
,"Sales Receipt","13-08-2024","2848",,"Discount Traders","-MULTIPLE-","Cost of Goods Sold","Zelia Handwash Liquid",,"Undeposited Funds",644.96,"",335355.41
,"Sales Receipt","14-08-2024","MC06017",,"Cash Sales","Zelia Strawberry Handwash Liquid 5L","Cost of Goods Sold","Zelia Handwash Liquid",,"Undeposited Funds",221.00,"",335576.41
,"Sales Receipt","14-08-2024","2842",,"Kibibi Wasai Store","-MULTIPLE-","Cost of Goods Sold","Zelia Handwash Liquid",,"Undeposited Funds",445.27,"",336021.68
,"Sales Receipt","15-08-2024","2828",,"Nabcom Wholesalers","-MULTIPLE-","Cost of Goods Sold","Zelia Handwash Liquid",,"Undeposited Funds",650.34,"",336672.02
,"Sales Receipt","15-08-2024","2892",,"Makueni Store","Zelia Strawberry Handwash Liquid 500ML","Cost of Goods Sold","Zelia Handwash Liquid",,"Undeposited Funds",42.79,"",336714.81
,"Sales Receipt","15-08-2024","2846",,"Hogol Wholesale","-MULTIPLE-","Cost of Goods Sold","Zelia Handwash Liquid",,"Undeposited Funds",5099.34,"",341814.15
,"Sales Receipt","16-08-2024","2901",,"Cash Sales","-MULTIPLE-","Cost of Goods Sold","Zelia Handwash Liquid",,"Undeposited Funds",86.79,"",341900.94
,"Sales Receipt","16-08-2024","2850",,"Hawkers Paradise","-MULTIPLE-","Cost of Goods Sold","Zelia Handwash Liquid",,"Undeposited Funds",173.59,"",342074.53
,"Sales Receipt","16-08-2024","2851",,"Tahila Enterprises","-MULTIPLE-","Cost of Goods Sold","Zelia Handwash Liquid",,"Undeposited Funds",260.38,"",342334.91
,"Sales Receipt","16-08-2024","2852",,"032 Mart","Zelia Strawberry Handwash Liquid 500ML","Cost of Goods Sold","Zelia Handwash Liquid",,"Undeposited Funds",256.73,"",342591.64
,"Sales Receipt","16-08-2024","2919",,"Mwananchi","-MULTIPLE-","Cost of Goods Sold","Zelia Handwash Liquid",,"Undeposited Funds",650.34,"",343241.98
,"Sales Receipt","19-08-2024","2839",,"Cash Sales","Zelia Strawberry Handwash Liquid 500ML","Cost of Goods Sold","Zelia Handwash Liquid",,"Undeposited Funds",85.58,"",343327.56
,"Sales Receipt","19-08-2024","2840",,"Cash Sales","Zelia Apple Handwash Liquid 500ML","Cost of Goods Sold","Zelia Handwash Liquid",,"Undeposited Funds",44.02,"",343371.58
,"Sales Receipt","19-08-2024","2835",,"Jombs Wholesale","-MULTIPLE-","Cost of Goods Sold","Zelia Handwash Liquid",,"Undeposited Funds",130.83,"",343502.41
,"Sales Receipt","20-08-2024","2858",,"Home Soko Minimart","Zelia Strawberry Handwash Liquid 500ML","Cost of Goods Sold","Zelia Handwash Liquid",,"Undeposited Funds",256.73,"",343759.14
,"Credit Note","21-08-2024","CN01064",,"Muhaya & Rukundo Holdings Ltd","0001.12.00 Zelia Apple Handwash Liquid 15X500ML","Cost of Goods Sold","Zelia Handwash Liquid",,"Accounts Receivable","",1392.94,342366.20
,"Invoice","21-08-2024","MC06061",,"Muhaya & Rukundo Holdings Ltd","-MULTIPLE-","Cost of Goods Sold","Zelia Handwash Liquid",,"Accounts Receivable",155976.84,"",498343.04
,"Invoice","21-08-2024","MC06062",,"Muhaya & Rukundo Holdings Ltd","0001.12.00 Outer Handwash Strawberry/Apple 15x500ML","Cost of Goods Sold","Zelia Handwash Liquid",,"Accounts Receivable",285.78,"",498628.82
,"Sales Receipt","21-08-2024","2870",,"Soft Landing","Zelia Apple Handwash Liquid 500ML","Cost of Goods Sold","Zelia Handwash Liquid",,"Undeposited Funds",660.34,"",499289.16
,"Sales Receipt","21-08-2024","2860",,"Marris Mini mart","Zelia Strawberry Handwash Liquid 500ML","Cost of Goods Sold","Zelia Handwash Liquid",,"Undeposited Funds",256.73,"",499545.89
,"Sales Receipt","21-08-2024","2861",,"Al Towba Shop","-MULTIPLE-","Cost of Goods Sold","Zelia Handwash Liquid",,"Undeposited Funds",520.86,"",500066.75
,"Sales Receipt","21-08-2024","2864",,"Safwan Wholesalers","-MULTIPLE-","Cost of Goods Sold","Zelia Handwash Liquid",,"Undeposited Funds",2604.33,"",502671.08
,"Sales Receipt","21-08-2024","2866",,"Budget Busket","-MULTIPLE-","Cost of Goods Sold","Zelia Handwash Liquid",,"Undeposited Funds",650.47,"",503321.55
,"Sales Receipt","21-08-2024","2855",,"Homecare Enterprise","Zelia Strawberry Handwash Liquid 5L","Cost of Goods Sold","Zelia Handwash Liquid",,"Undeposited Funds",221.00,"",503542.55
,"Build Assembly","21-08-2024","11293",,,,"Cost of Goods Sold","Zelia Handwash Liquid","X","-SPLIT-","",1299.86,502242.69
,"Build Assembly","21-08-2024","11294",,,,"Cost of Goods Sold","Zelia Handwash Liquid","X","-SPLIT-","",2663.62,499579.07
,"Invoice","22-08-2024","MC06066",,"Cash Sales","Zelia Apple Handwash Liquid 500ML","Cost of Goods Sold","Zelia Handwash Liquid",,"Accounts Receivable",44.02,"",499623.09
,"Credit Note","22-08-2024","CN01065",,"Cash Sales","Zelia Apple Handwash Liquid 500ML","Cost of Goods Sold","Zelia Handwash Liquid",,"Accounts Receivable","",44.02,499579.07
,"Invoice","22-08-2024","MC06068",,"BLUEMART SUPERMARKET LIMITED","-MULTIPLE-","Cost of Goods Sold","Zelia Handwash Liquid",,"Accounts Receivable",260.44,"",499839.51
,"Invoice","22-08-2024","MC06070",,"LUCKY MART SUPERMARKET LIMITED","-MULTIPLE-","Cost of Goods Sold","Zelia Handwash Liquid",,"Accounts Receivable",650.47,"",500489.98
,"Sales Receipt","22-08-2024","2867",,"Sultan Iman Shop","Zelia Apple Handwash Liquid 500ML","Cost of Goods Sold","Zelia Handwash Liquid",,"Undeposited Funds",660.34,"",501150.32
,"Sales Receipt","22-08-2024","2875",,"Maida Minimart","-MULTIPLE-","Cost of Goods Sold","Zelia Handwash Liquid",,"Undeposited Funds",650.47,"",501800.79
,"Sales Receipt","22-08-2024","2897",,"Hayan Wholesalers","-MULTIPLE-","Cost of Goods Sold","Zelia Handwash Liquid",,"Undeposited Funds",1302.17,"",503102.96
,"Sales Receipt","22-08-2024","1135",,"Ebenezer Minimart","-MULTIPLE-","Cost of Goods Sold","Zelia Handwash Liquid",,"Undeposited Funds",260.44,"",503363.40
,"Sales Receipt","22-08-2024","1206",,"Tangents Minimart","-MULTIPLE-","Cost of Goods Sold","Zelia Handwash Liquid",,"Undeposited Funds",173.62,"",503537.02
,"Sales Receipt","23-08-2024","2877",,"Cash Sales","Zelia Apple Handwash Liquid 500ML","Cost of Goods Sold","Zelia Handwash Liquid",,"Undeposited Funds",44.02,"",503581.04
,"Sales Receipt","23-08-2024","2880",,"Cash Sales","Zelia Apple Handwash Liquid 500ML","Cost of Goods Sold","Zelia Handwash Liquid",,"Undeposited Funds",44.02,"",503625.06
,"Sales Receipt","23-08-2024","2881",,"Cash Sales","Zelia Strawberry Handwash Liquid 5L","Cost of Goods Sold","Zelia Handwash Liquid",,"Undeposited Funds",231.09,"",503856.15
,"Sales Receipt","23-08-2024","2899",,"Beraccah Syokimau","-MULTIPLE-","Cost of Goods Sold","Zelia Handwash Liquid",,"Undeposited Funds",523.33,"",504379.48
,"Credit","24-08-2024","0110611760000004475",,"Brenntag Kenya Limited","Cocamide Diethanolamine","Cost of Goods Sold","Zelia Handwash Liquid",,"Accounts Payable","",33.68,504345.80
,"Sales Receipt","26-08-2024","2865",,"Cash Sales","Zelia Strawberry Handwash Liquid 500ML","Cost of Goods Sold","Zelia Handwash Liquid",,"Undeposited Funds",42.79,"",504388.59
,"Sales Receipt","26-08-2024","2882",,"Cash Sales","Zelia Apple Handwash Liquid 500ML","Cost of Goods Sold","Zelia Handwash Liquid",,"Undeposited Funds",44.02,"",504432.61
,"Sales Receipt","26-08-2024","2883",,"Cash Sales","Zelia Strawberry Handwash Liquid 500ML","Cost of Goods Sold","Zelia Handwash Liquid",,"Undeposited Funds",128.37,"",504560.98
,"Sales Receipt","26-08-2024","2900",,"Al- Zake Shop","-MULTIPLE-","Cost of Goods Sold","Zelia Handwash Liquid",,"Undeposited Funds",650.47,"",505211.45
,"Sales Receipt","26-08-2024","2908",,"Himilo General Store","-MULTIPLE-","Cost of Goods Sold","Zelia Handwash Liquid",,"Undeposited Funds",2604.33,"",507815.78
,"Sales Receipt","26-08-2024","1207",,"Kemera Discount","-MULTIPLE-","Cost of Goods Sold","Zelia Handwash Liquid",,"Undeposited Funds",1302.17,"",509117.95
,"Sales Receipt","27-08-2024","2915",,"Cash Sales","Zelia Strawberry Handwash Liquid 5L","Cost of Goods Sold","Zelia Handwash Liquid",,"Undeposited Funds",231.09,"",509349.04
,"Sales Receipt","27-08-2024","2910",,"Milele Shop","-MULTIPLE-","Cost of Goods Sold","Zelia Handwash Liquid",,"Undeposited Funds",654.24,"",510003.28
,"Sales Receipt","28-08-2024","2912",,"Libin Minimart","-MULTIPLE-","Cost of Goods Sold","Zelia Handwash Liquid",,"Undeposited Funds",1315.26,"",511318.54
,"Sales Receipt","29-08-2024","AT201",,"Cash Sales","-MULTIPLE-","Cost of Goods Sold","Zelia Handwash Liquid",,"Undeposited Funds",438.42,"",511756.96
,"Sales Receipt","02-09-2024","3225",,"Purity Shop","-MULTIPLE-","Cost of Goods Sold","Zelia Handwash Liquid",,"Undeposited Funds",142.92,"",511899.88
,"Sales Receipt","02-09-2024","2923",,"Blossom Beauty","-MULTIPLE-","Cost of Goods Sold","Zelia Handwash Liquid",,"Undeposited Funds",568.06,"",512467.94
,"Sales Receipt","02-09-2024","2924",,"Rio Deli Wholesalers","-MULTIPLE-","Cost of Goods Sold","Zelia Handwash Liquid",,"Undeposited Funds",710.98,"",513178.92
,"Sales Receipt","02-09-2024","2928",,"Beta Traders","-MULTIPLE-","Cost of Goods Sold","Zelia Handwash Liquid",,"Undeposited Funds",710.98,"",513889.90
,"Sales Receipt","02-09-2024","2926",,"Gacal Wholesale","-MULTIPLE-","Cost of Goods Sold","Zelia Handwash Liquid",,"Undeposited Funds",3563.98,"",517453.88
,"Sales Receipt","03-09-2024","2930",,"Horn of Africa","-MULTIPLE-","Cost of Goods Sold","Zelia Handwash Liquid",,"Undeposited Funds",709.17,"",518163.05
,"Sales Receipt","03-09-2024","2931",,"Jombs wholesalers","Zelia Strawberry Handwash Liquid 15x500ML","Cost of Goods Sold","Zelia Handwash Liquid",,"Undeposited Funds",289.47,"",518452.52
,"Sales Receipt","03-09-2024","3228",,"Hogol  E Wholesale","Zelia Strawberry Handwash Liquid 15x500ML","Cost of Goods Sold","Zelia Handwash Liquid",,"Undeposited Funds",3618.40,"",522070.92
,"Sales Receipt","03-09-2024","2927",,"Cash Sales","Zelia Apple Handwash Liquid 15X500ML","Cost of Goods Sold","Zelia Handwash Liquid",,"Undeposited Funds",46.43,"",522117.35
,"Sales Receipt","03-09-2024","2922",,"Cash Sales","Zelia Strawberry Handwash Liquid 15x500ML","Cost of Goods Sold","Zelia Handwash Liquid",,"Undeposited Funds",96.49,"",522213.84
,"Invoice","04-09-2024","MC06107",,"Tupo Mart Limited","-MULTIPLE-","Cost of Goods Sold","Zelia Handwash Liquid",,"Accounts Receivable",657.81,"",522871.65
,"Invoice","04-09-2024","MC06108",,"PRICE CHOPPER STORES LIMITED","Zelia Apple Handwash Liquid 500ML","Cost of Goods Sold","Zelia Handwash Liquid",,"Accounts Receivable",528.26,"",523399.91
,"Invoice","04-09-2024","MC06116",,"Zenith Steel Fabricators Ltd","Zelia Strawberry Handwash Liquid 5L","Cost of Goods Sold","Zelia Handwash Liquid",,"Accounts Receivable",4621.70,"",528021.61
,"Sales Receipt","04-09-2024","2937",,"Restoration Traders","-MULTIPLE-","Cost of Goods Sold","Zelia Handwash Liquid",,"Undeposited Funds",1416.09,"",529437.70
,"Sales Receipt","04-09-2024","2938",,"D-Madina Enterprise","-MULTIPLE-","Cost of Goods Sold","Zelia Handwash Liquid",,"Undeposited Funds",1416.09,"",530853.79
,"Sales Receipt","04-09-2024","2939",,"Qudus Shop","-MULTIPLE-","Cost of Goods Sold","Zelia Handwash Liquid",,"Undeposited Funds",707.28,"",531561.07
,"Sales Receipt","04-09-2024","3013",,"Ogena Matt","Zelia Apple Handwash Liquid 15X500ML","Cost of Goods Sold","Zelia Handwash Liquid",,"Undeposited Funds",696.47,"",532257.54
,"Sales Receipt","04-09-2024","3014",,"Gifted Hands","-MULTIPLE-","Cost of Goods Sold","Zelia Handwash Liquid",,"Undeposited Funds",188.81,"",532446.35
,"Sales Receipt","04-09-2024","2942",,"SK Groceries","-MULTIPLE-","Cost of Goods Sold","Zelia Handwash Liquid",,"Undeposited Funds",707.28,"",533153.63
,"Invoice","05-09-2024","MC06121",,"THE BRIGHT STAR SUPERMARKET LIMITED","-MULTIPLE-","Cost of Goods Sold","Zelia Handwash Liquid",,"Accounts Receivable",657.45,"",533811.08
,"Invoice","05-09-2024","MC06122",,"NASRI MART LIMITED","-MULTIPLE-","Cost of Goods Sold","Zelia Handwash Liquid",,"Accounts Receivable",876.83,"",534687.91
,"Credit Note","05-09-2024","CN01067",,"MASABA DISCOUNT STORES LTD","-MULTIPLE-","Cost of Goods Sold","Zelia Handwash Liquid",,"Accounts Receivable","",1315.26,533372.65
,"Invoice","05-09-2024","MC06123",,"MASABA DISCOUNT STORES LTD","-MULTIPLE-","Cost of Goods Sold","Zelia Handwash Liquid",,"Accounts Receivable",1315.26,"",534687.91
,"Sales Receipt","05-09-2024","2948",,"Jam Tower Shop","-MULTIPLE-","Cost of Goods Sold","Zelia Handwash Liquid",,"Undeposited Funds",709.97,"",535397.88
,"Sales Receipt","05-09-2024","2950",,"Cash Sales","Zelia Apple Handwash Liquid 15X500ML","Cost of Goods Sold","Zelia Handwash Liquid",,"Undeposited Funds",46.60,"",535444.48
,"Sales Receipt","05-09-2024","2955",,"Cash Sales","-MULTIPLE-","Cost of Goods Sold","Zelia Handwash Liquid",,"Undeposited Funds",297.43,"",535741.91
,"Sales Receipt","05-09-2024","2952",,"Cash Sales","Zelia Strawberry Handwash Liquid 15x500ML","Cost of Goods Sold","Zelia Handwash Liquid",,"Undeposited Funds",143.92,"",535885.83
,"Sales Receipt","06-09-2024","2961",,"Gure Yare Shop","-MULTIPLE-","Cost of Goods Sold","Zelia Handwash Liquid",,"Undeposited Funds",2837.00,"",538722.83
,"Sales Receipt","08-09-2024","3227",,"Visina Stores","-MULTIPLE-","Cost of Goods Sold","Zelia Handwash Liquid",,"Undeposited Funds",3548.29,"",542271.12
,"Sales Receipt","08-09-2024","2959",,"Cash Sales","Zelia Strawberry Handwash Liquid 4x5L","Cost of Goods Sold","Zelia Handwash Liquid",,"Undeposited Funds",250.83,"",542521.95
,"Sales Receipt","09-09-2024","2964",,"Dalwo Wholesalers","-MULTIPLE-","Cost of Goods Sold","Zelia Handwash Liquid",,"Undeposited Funds",1418.50,"",543940.45
,"Sales Receipt","09-09-2024","2960",,"Mizpa Minimart","-MULTIPLE-","Cost of Goods Sold","Zelia Handwash Liquid",,"Undeposited Funds",283.70,"",544224.15
,"Sales Receipt","09-09-2024","2986",,"Pambazuka Mart (K) Limited","-MULTIPLE-","Cost of Goods Sold","Zelia Handwash Liquid",,"Undeposited Funds",1418.50,"",545642.65
,"Sales Receipt","09-09-2024","2970",,"Cash Sales","Zelia Apple Handwash Liquid 15X500ML","Cost of Goods Sold","Zelia Handwash Liquid",,"Undeposited Funds",46.61,"",545689.26
,"Sales Receipt","10-09-2024","2980",,"Bei Nafuu Shop","-MULTIPLE-","Cost of Goods Sold","Zelia Handwash Liquid",,"Undeposited Funds",709.93,"",546399.19
,"Sales Receipt","10-09-2024","2983",,"Summer Outlets","-MULTIPLE-","Cost of Goods Sold","Zelia Handwash Liquid",,"Undeposited Funds",1418.50,"",547817.69
,"Sales Receipt","10-09-2024","2984",,"Al manaan","-MULTIPLE-","Cost of Goods Sold","Zelia Handwash Liquid",,"Undeposited Funds",1134.81,"",548952.50
,"Sales Receipt","10-09-2024","2975",,"Cash Sales","Zelia Strawberry Handwash Liquid 15x500ML","Cost of Goods Sold","Zelia Handwash Liquid",,"Undeposited Funds",191.86,"",549144.36
,"Sales Receipt","10-09-2024","3015",,"Cash Sales","Zelia Strawberry Handwash Liquid 15x500ML","Cost of Goods Sold","Zelia Handwash Liquid",,"Undeposited Funds",95.93,"",549240.29
,"Sales Receipt","10-09-2024","3237",,"Cash Sales","-MULTIPLE-","Cost of Goods Sold","Zelia Handwash Liquid",,"Undeposited Funds",94.58,"",549334.87
,"Sales Receipt","11-09-2024","2996",,"Freshfinds Mart","-MULTIPLE-","Cost of Goods Sold","Zelia Handwash Liquid",,"Undeposited Funds",708.57,"",550043.44
,"Sales Receipt","11-09-2024","2997",,"Domasco Wholesalers","-MULTIPLE-","Cost of Goods Sold","Zelia Handwash Liquid",,"Undeposited Funds",708.57,"",550752.01
,"Sales Receipt","11-09-2024","2999",,"Anab Shop","-MULTIPLE-","Cost of Goods Sold","Zelia Handwash Liquid",,"Undeposited Funds",708.57,"",551460.58
,"Sales Receipt","11-09-2024","3000",,"Ushirika Shop","-MULTIPLE-","Cost of Goods Sold","Zelia Handwash Liquid",,"Undeposited Funds",2837.00,"",554297.58
,"Sales Receipt","11-09-2024","2998",,"Mumtaz Shop","-MULTIPLE-","Cost of Goods Sold","Zelia Handwash Liquid",,"Undeposited Funds",567.40,"",554864.98
,"Sales Receipt","11-09-2024","3011",,"Warfa Wholesale","-MULTIPLE-","Cost of Goods Sold","Zelia Handwash Liquid",,"Undeposited Funds",1418.50,"",556283.48
,"Invoice","12-09-2024","MC06143",,"Karia Supermarkets Limited","-MULTIPLE-","Cost of Goods Sold","Zelia Handwash Liquid",,"Accounts Receivable",2269.60,"",558553.08
,"Invoice","12-09-2024","MC06147",,"ZAIN SUPERMARKET LIMITED","Zelia Apple Handwash Liquid 15X500ML","Cost of Goods Sold","Zelia Handwash Liquid",,"Accounts Receivable",279.62,"",558832.70
,"Sales Receipt","12-09-2024","3055",,"Mubarak Shop","-MULTIPLE-","Cost of Goods Sold","Zelia Handwash Liquid",,"Undeposited Funds",567.40,"",559400.10
,"Sales Receipt","12-09-2024","2988",,"Kumlliye Shop","-MULTIPLE-","Cost of Goods Sold","Zelia Handwash Liquid",,"Undeposited Funds",8511.01,"",567911.11
,"Sales Receipt","12-09-2024","3020",,"Kamau Shop","-MULTIPLE-","Cost of Goods Sold","Zelia Handwash Liquid",,"Undeposited Funds",708.57,"",568619.68
,"Sales Receipt","12-09-2024","3021",,"Marwa Tower Shop","-MULTIPLE-","Cost of Goods Sold","Zelia Handwash Liquid",,"Undeposited Funds",567.40,"",569187.08
,"Sales Receipt","12-09-2024","1845",,"Daniel Shop","-MULTIPLE-","Cost of Goods Sold","Zelia Handwash Liquid",,"Undeposited Funds",708.57,"",569895.65
,"Sales Receipt","12-09-2024","3026",,"Hemali Shop","-MULTIPLE-","Cost of Goods Sold","Zelia Handwash Liquid",,"Undeposited Funds",945.67,"",570841.32
,"Sales Receipt","12-09-2024","2987",,"Cash Sales","Zelia Strawberry Handwash Liquid 4x5L","Cost of Goods Sold","Zelia Handwash Liquid",,"Undeposited Funds",752.48,"",571593.80
,"Sales Receipt","13-09-2024","3034",,"Milele Shop","-MULTIPLE-","Cost of Goods Sold","Zelia Handwash Liquid",,"Undeposited Funds",1418.50,"",573012.30
,"Sales Receipt","13-09-2024","3032",,"Cash Sales","Zelia Strawberry Handwash Liquid 15x500ML","Cost of Goods Sold","Zelia Handwash Liquid",,"Undeposited Funds",95.93,"",573108.23
,"Sales Receipt","13-09-2024","3033",,"Cash Sales","Zelia Strawberry Handwash Liquid 15x500ML","Cost of Goods Sold","Zelia Handwash Liquid",,"Undeposited Funds",95.93,"",573204.16
,"Sales Receipt","14-09-2024","3041",,"Lekima Wholesale","-MULTIPLE-","Cost of Goods Sold","Zelia Handwash Liquid",,"Undeposited Funds",570.12,"",573774.28
,"Sales Receipt","14-09-2024","3042",,"mwaspart","-MULTIPLE-","Cost of Goods Sold","Zelia Handwash Liquid",,"Undeposited Funds",564.68,"",574338.96
,"Sales Receipt","14-09-2024","3043",,"Gladys Wholesalers","-MULTIPLE-","Cost of Goods Sold","Zelia Handwash Liquid",,"Undeposited Funds",378.27,"",574717.23
,"Sales Receipt","16-09-2024","3045",,"Afro Drip LTD Reception","Zelia Strawberry Handwash Liquid 15x500ML","Cost of Goods Sold","Zelia Handwash Liquid",,"Undeposited Funds",47.97,"",574765.20
,"Sales Receipt","16-09-2024","3037",,"Cash Sales","Zelia Strawberry Handwash Liquid 4x5L","Cost of Goods Sold","Zelia Handwash Liquid",,"Undeposited Funds",250.83,"",575016.03
,"Sales Receipt","16-09-2024","3039",,"Cash Sales","Zelia Strawberry Handwash Liquid 4x5L","Cost of Goods Sold","Zelia Handwash Liquid",,"Undeposited Funds",250.83,"",575266.86
,"Sales Receipt","16-09-2024","3040",,"Cash Sales","Zelia Strawberry Handwash Liquid 4x5L","Cost of Goods Sold","Zelia Handwash Liquid",,"Undeposited Funds",250.83,"",575517.69
,"Invoice","18-09-2024","MC06164",,"MKULIMA WANGIGE SUPERMARKET","-MULTIPLE-","Cost of Goods Sold","Zelia Handwash Liquid",,"Accounts Receivable",567.40,"",576085.09
,"Invoice","18-09-2024","MC06165",,"MKULIMA MUCHATHA","-MULTIPLE-","Cost of Goods Sold","Zelia Handwash Liquid",,"Accounts Receivable",567.40,"",576652.49
,"Sales Receipt","18-09-2024","3058",,"Primeken Shop","-MULTIPLE-","Cost of Goods Sold","Zelia Handwash Liquid",,"Undeposited Funds",709.93,"",577362.42
,"Sales Receipt","18-09-2024","3059",,"Farhan Shop","-MULTIPLE-","Cost of Goods Sold","Zelia Handwash Liquid",,"Undeposited Funds",708.57,"",578070.99
,"Sales Receipt","18-09-2024","3056",,"Cash Sales","Zelia Strawberry Handwash Liquid 15x500ML","Cost of Goods Sold","Zelia Handwash Liquid",,"Undeposited Funds",47.97,"",578118.96
,"Sales Receipt","19-09-2024","3093",,"Komondi Store","-MULTIPLE-","Cost of Goods Sold","Zelia Handwash Liquid",,"Undeposited Funds",1418.50,"",579537.46
,"Sales Receipt","19-09-2024","3065",,"Britco Wholesalers","-MULTIPLE-","Cost of Goods Sold","Zelia Handwash Liquid",,"Undeposited Funds",3536.04,"",583073.50
,"Invoice","20-09-2024","MC06179",,"OFFSHORE GLOBAL LOGISTICS LIMITED","Zelia Strawberry Handwash Liquid 4x5L","Cost of Goods Sold","Zelia Handwash Liquid",,"Accounts Receivable",1003.30,"",584076.80
,"Sales Receipt","20-09-2024","3094",,"Duto Rumo Store","-MULTIPLE-","Cost of Goods Sold","Zelia Handwash Liquid",,"Undeposited Funds",283.70,"",584360.50
,"Sales Receipt","20-09-2024","3203",,"Bei Poa","-MULTIPLE-","Cost of Goods Sold","Zelia Handwash Liquid",,"Undeposited Funds",1418.50,"",585779.00
,"Sales Receipt","20-09-2024","3075",,"Arqam minimart","-MULTIPLE-","Cost of Goods Sold","Zelia Handwash Liquid",,"Undeposited Funds",708.57,"",586487.57
,"Sales Receipt","20-09-2024","3204",,"Meghan Stores","-MULTIPLE-","Cost of Goods Sold","Zelia Handwash Liquid",,"Undeposited Funds",756.53,"",587244.10
,"Sales Receipt","20-09-2024","3205",,"Omundo Discount","-MULTIPLE-","Cost of Goods Sold","Zelia Handwash Liquid",,"Undeposited Funds",1418.50,"",588662.60
,"Sales Receipt","20-09-2024","3229",,"Kwetu Shop","-MULTIPLE-","Cost of Goods Sold","Zelia Handwash Liquid",,"Undeposited Funds",283.70,"",588946.30
,"Sales Receipt","21-09-2024","3244",,"Gladys Wholesalers","-MULTIPLE-","Cost of Goods Sold","Zelia Handwash Liquid",,"Undeposited Funds",1040.23,"",589986.53
,"Sales Receipt","22-09-2024","3230",,"Kamau Shop","-MULTIPLE-","Cost of Goods Sold","Zelia Handwash Liquid",,"Undeposited Funds",709.93,"",590696.46
,"Sales Receipt","22-09-2024","3231",,"Hemali Shop","-MULTIPLE-","Cost of Goods Sold","Zelia Handwash Liquid",,"Undeposited Funds",472.83,"",591169.29
,"Sales Receipt","23-09-2024","3085",,"Downtown Wholesalers","-MULTIPLE-","Cost of Goods Sold","Zelia Handwash Liquid",,"Undeposited Funds",702.31,"",591871.60
,"Sales Receipt","23-09-2024","3086",,"Brinso Foodstufs","-MULTIPLE-","Cost of Goods Sold","Zelia Handwash Liquid",,"Undeposited Funds",702.31,"",592573.91
,"Sales Receipt","23-09-2024","3074",,"Cash Sales","Zelia Strawberry Handwash Liquid 15x500ML","Cost of Goods Sold","Zelia Handwash Liquid",,"Undeposited Funds",47.07,"",592620.98
,"Invoice","24-09-2024","MC06194",,"OGENA PRIME DISTRIBUTORS LIMITED","Zelia Apple Handwash Liquid 15X500ML","Cost of Goods Sold","Zelia Handwash Liquid",,"Accounts Receivable",699.04,"",593320.02
,"Invoice","24-09-2024","MC06195",,"TAWALA SUPERMARKET LIMITED","-MULTIPLE-","Cost of Goods Sold","Zelia Handwash Liquid",,"Accounts Receivable",1405.08,"",594725.10
,"Invoice","24-09-2024","MC06196",,"KASAMAT INVESTMENTS LTD","Zelia Apple Handwash Liquid 15X500ML","Cost of Goods Sold","Zelia Handwash Liquid",,"Accounts Receivable",279.62,"",595004.72
,"Credit Note","24-09-2024","CN01069",,"OGENA PRIME DISTRIBUTORS LIMITED","Zelia Apple Handwash Liquid 15X500ML","Cost of Goods Sold","Zelia Handwash Liquid",,"Accounts Receivable","",699.04,594305.68
,"Sales Receipt","24-09-2024","3090",,"Elliane Wholesalers","Zelia Strawberry Handwash Liquid 15x500ML","Cost of Goods Sold","Zelia Handwash Liquid",,"Undeposited Funds",282.39,"",594588.07
,"Sales Receipt","24-09-2024","3234",,"Gifted Hands","Zelia Strawberry Handwash Liquid 15x500ML","Cost of Goods Sold","Zelia Handwash Liquid",,"Undeposited Funds",188.26,"",594776.33
,"Sales Receipt","24-09-2024","3083",,"Kibibi Wasai Store","Zelia Strawberry Handwash Liquid 5L","Cost of Goods Sold","Zelia Handwash Liquid",,"Undeposited Funds",231.09,"",595007.42
,"Invoice","25-09-2024","MC06197",,"Khetshi Dharamshi And Company Limited","Zelia Strawberry Handwash Liquid 4x5L","Cost of Goods Sold","Zelia Handwash Liquid",,"Accounts Receivable",1003.30,"",596010.72
,"Sales Receipt","25-09-2024","3100",,"Al- Malik Wholesalers","-MULTIPLE-","Cost of Goods Sold","Zelia Handwash Liquid",,"Undeposited Funds",1405.02,"",597415.74
,"Sales Receipt","25-09-2024","3201",,"Salama Shop","-MULTIPLE-","Cost of Goods Sold","Zelia Handwash Liquid",,"Undeposited Funds",702.74,"",598118.48
,"Sales Receipt","25-09-2024","3218",,"Mary Super Store","-MULTIPLE-","Cost of Goods Sold","Zelia Handwash Liquid",,"Undeposited Funds",1405.02,"",599523.50
,"Invoice","26-09-2024","MC06206",,"INTEGRAL MEDIA LIMITED","-MULTIPLE-","Cost of Goods Sold","Zelia Handwash Liquid",,"Accounts Receivable",2107.31,"",601630.81
,"Sales Receipt","26-09-2024","3210",,"Rehoji Shop","-MULTIPLE-","Cost of Goods Sold","Zelia Handwash Liquid",,"Undeposited Funds",702.74,"",602333.55
,"Sales Receipt","26-09-2024","3207",,"Kimu Shop","-MULTIPLE-","Cost of Goods Sold","Zelia Handwash Liquid",,"Undeposited Funds",421.27,"",602754.82
,"Sales Receipt","26-09-2024","3235",,"Oyugis Discount","-MULTIPLE-","Cost of Goods Sold","Zelia Handwash Liquid",,"Undeposited Funds",2810.05,"",605564.87
,"Sales Receipt","26-09-2024","3209",,"Cash Sales","Zelia Apple Handwash Liquid 15X500ML","Cost of Goods Sold","Zelia Handwash Liquid",,"Undeposited Funds",93.20,"",605658.07
,"Invoice","27-09-2024","MC06216",,"QUALITYMART SUPERMARKET LIMITED","-MULTIPLE-","Cost of Goods Sold","Zelia Handwash Liquid",,"Accounts Receivable",702.74,"",606360.81
,"Invoice","27-09-2024","MC06217",,"Mumsha Supamat","-MULTIPLE-","Cost of Goods Sold","Zelia Handwash Liquid",,"Accounts Receivable",702.74,"",607063.55
,"Invoice","27-09-2024","MC06218",,"LUCKY MART SUPERMARKET LIMITED","-MULTIPLE-","Cost of Goods Sold","Zelia Handwash Liquid",,"Accounts Receivable",1405.02,"",608468.57
,"Sales Receipt","27-09-2024","3215",,"Supaa Mart","-MULTIPLE-","Cost of Goods Sold","Zelia Handwash Liquid",,"Undeposited Funds",562.01,"",609030.58
,"Sales Receipt","27-09-2024","3214",,"Kenya Yetu Mart","-MULTIPLE-","Cost of Goods Sold","Zelia Handwash Liquid",,"Undeposited Funds",562.01,"",609592.59
,"Sales Receipt","27-09-2024","3213",,"DayBreak Shop","-MULTIPLE-","Cost of Goods Sold","Zelia Handwash Liquid",,"Undeposited Funds",281.01,"",609873.60
,"Sales Receipt","27-09-2024","3245",,"Florence Shop","-MULTIPLE-","Cost of Goods Sold","Zelia Handwash Liquid",,"Undeposited Funds",140.27,"",610013.87
,"Sales Receipt","27-09-2024","3216",,"Cash Sales","Zelia Strawberry Handwash Liquid 15x500ML","Cost of Goods Sold","Zelia Handwash Liquid",,"Undeposited Funds",94.13,"",610108.00
,"Sales Receipt","28-09-2024","3246",,"Gidesh Minimart","Zelia Strawberry Handwash Liquid 15x500ML","Cost of Goods Sold","Zelia Handwash Liquid",,"Undeposited Funds",282.39,"",610390.39
,"Sales Receipt","28-09-2024","3222",,"Gidesh Minimart","Zelia Apple Handwash Liquid 15X500ML","Cost of Goods Sold","Zelia Handwash Liquid",,"Undeposited Funds",279.62,"",610670.01
,"Sales Receipt","28-09-2024","3247",,"Milan Shop","-MULTIPLE-","Cost of Goods Sold","Zelia Handwash Liquid",,"Undeposited Funds",468.33,"",611138.34
,"Sales Receipt","01-10-2024","3224",,"Cash Sales","Zelia Apple Handwash Liquid 15X500ML","Cost of Goods Sold","Zelia Handwash Liquid",,"Undeposited Funds",46.61,"",611184.95
,"Sales Receipt","01-10-2024","3217",,"Cash Sales","Zelia Strawberry Handwash Liquid 4x5L","Cost of Goods Sold","Zelia Handwash Liquid",,"Undeposited Funds",250.83,"",611435.78
,"Sales Receipt","01-10-2024","3224",,"Cash Sales","Zelia Apple Handwash Liquid 15X500ML","Cost of Goods Sold","Zelia Handwash Liquid",,"Undeposited Funds",46.61,"",611482.39
,"Sales Receipt","01-10-2024","3418",,"Duto Rumo Store","-MULTIPLE-","Cost of Goods Sold","Zelia Handwash Liquid",,"Undeposited Funds",468.33,"",611950.72
,"Sales Receipt","01-10-2024","3257",,"Rio Deli Wholesalers","-MULTIPLE-","Cost of Goods Sold","Zelia Handwash Liquid",,"Undeposited Funds",1405.02,"",613355.74
,"Sales Receipt","02-10-2024","3228",,"Cash Sales","Zelia Strawberry Handwash Liquid 15x500ML","Cost of Goods Sold","Zelia Handwash Liquid",,"Undeposited Funds",176.49,"",613532.23
,"Sales Receipt","02-10-2024","3229",,"Towba general stores Parkroad","-MULTIPLE-","Cost of Goods Sold","Zelia Handwash Liquid",,"Undeposited Funds",1405.02,"",614937.25
,"Sales Receipt","02-10-2024","3230",,"Mama Amina","-MULTIPLE-","Cost of Goods Sold","Zelia Handwash Liquid",,"Undeposited Funds",702.28,"",615639.53
,"Sales Receipt","02-10-2024","3419",,"Norhani Groceries","-MULTIPLE-","Cost of Goods Sold","Zelia Handwash Liquid",,"Undeposited Funds",1408.72,"",617048.25
,"Sales Receipt","02-10-2024","3244",,"B-Shop","-MULTIPLE-","Cost of Goods Sold","Zelia Handwash Liquid",,"Undeposited Funds",2104.06,"",619152.31
,"Sales Receipt","02-10-2024","3237",,"Farhan Wholesallers","-MULTIPLE-","Cost of Goods Sold","Zelia Handwash Liquid",,"Undeposited Funds",2810.05,"",621962.36
,"Sales Receipt","02-10-2024","3238",,"Libin Minimart","-MULTIPLE-","Cost of Goods Sold","Zelia Handwash Liquid",,"Undeposited Funds",1405.02,"",623367.38
,"Invoice","03-10-2024","MC06231",,"MASABA DISCOUNT STORES LTD","-MULTIPLE-","Cost of Goods Sold","Zelia Handwash Liquid",,"Accounts Receivable",3516.03,"",626883.41
,"Sales Receipt","03-10-2024","3246",,"Fahan Foodstuff","-MULTIPLE-","Cost of Goods Sold","Zelia Handwash Liquid",,"Undeposited Funds",3511.40,"",630394.81
,"Sales Receipt","03-10-2024","3248",,"Elwak Stores","-MULTIPLE-","Cost of Goods Sold","Zelia Handwash Liquid",,"Undeposited Funds",702.28,"",631097.09
,"Sales Receipt","05-10-2024","3420",,"Danaba Wholesallers","-MULTIPLE-","Cost of Goods Sold","Zelia Handwash Liquid",,"Undeposited Funds",4917.35,"",636014.44
,"Sales Receipt","06-10-2024","3184",,"Precious Mart","-MULTIPLE-","Cost of Goods Sold","Zelia Handwash Liquid",,"Undeposited Funds",702.28,"",636716.72
,"Sales Receipt","06-10-2024","3422",,"Mikara Shop","Zelia Apple Handwash Liquid 15X500ML","Cost of Goods Sold","Zelia Handwash Liquid",,"Undeposited Funds",699.04,"",637415.76
,"Sales Receipt","06-10-2024","3423",,"Jikweri Minimart","-MULTIPLE-","Cost of Goods Sold","Zelia Handwash Liquid",,"Undeposited Funds",468.33,"",637884.09
,"Sales Receipt","07-10-2024","2923",,"Cash Sales","Peach Perfume","Cost of Goods Sold","Zelia Handwash Liquid",,"Undeposited Funds",8160.94,"",646045.03
,"Sales Receipt","07-10-2024","3254",,"Cash Sales","Zelia Strawberry Handwash Liquid 15x500ML","Cost of Goods Sold","Zelia Handwash Liquid",,"Undeposited Funds",94.13,"",646139.16
,"Sales Receipt","07-10-2024","3118",,"Sugar meats &Groceries","-MULTIPLE-","Cost of Goods Sold","Zelia Handwash Liquid",,"Undeposited Funds",562.01,"",646701.17
,"Sales Receipt","07-10-2024","3260",,"Sharma Shop","-MULTIPLE-","Cost of Goods Sold","Zelia Handwash Liquid",,"Undeposited Funds",702.28,"",647403.45
,"Sales Receipt","07-10-2024","3288",,"Adurus Wholesallers","-MULTIPLE-","Cost of Goods Sold","Zelia Handwash Liquid",,"Undeposited Funds",1405.02,"",648808.47
,"Invoice","08-10-2024","MC06241",,"OFFSHORE GLOBAL LOGISTICS LIMITED","Zelia Strawberry Handwash Liquid 4x5L","Cost of Goods Sold","Zelia Handwash Liquid",,"Accounts Receivable",1003.30,"",649811.77
,"Sales Receipt","08-10-2024","3271",,"Horn of Africa","-MULTIPLE-","Cost of Goods Sold","Zelia Handwash Liquid",,"Undeposited Funds",707.18,"",650518.95
,"Sales Receipt","08-10-2024","3272",,"Nyipola Minimart","-MULTIPLE-","Cost of Goods Sold","Zelia Handwash Liquid",,"Undeposited Funds",707.18,"",651226.13
,"Invoice","09-10-2024","MC06242",,"BLUEMART SUPERMARKET LIMITED","-MULTIPLE-","Cost of Goods Sold","Zelia Handwash Liquid",,"Accounts Receivable",565.81,"",651791.94
,"Sales Receipt","09-10-2024","3276",,"Cash Sales","Zelia Apple Handwash Liquid 15X500ML","Cost of Goods Sold","Zelia Handwash Liquid",,"Undeposited Funds",47.24,"",651839.18
,"Sales Receipt","09-10-2024","3279",,"Cash Sales","Zelia Strawberry Handwash Liquid 4x5L","Cost of Goods Sold","Zelia Handwash Liquid",,"Undeposited Funds",250.83,"",652090.01
,"Sales Receipt","09-10-2024","3280",,"Cash Sales","Zelia Strawberry Handwash Liquid 15x500ML","Cost of Goods Sold","Zelia Handwash Liquid",,"Undeposited Funds",47.07,"",652137.08
,"Sales Receipt","09-10-2024","3277",,"Kibibi Wasai Store","Zelia Strawberry Handwash Liquid 20L","Cost of Goods Sold","Zelia Handwash Liquid",,"Undeposited Funds",786.52,"",652923.60
,"Sales Receipt","09-10-2024","3287",,"Baba Ali Shop","-MULTIPLE-","Cost of Goods Sold","Zelia Handwash Liquid",,"Undeposited Funds",707.18,"",653630.78
,"Sales Receipt","09-10-2024","3286",,"Mumtaz Shop","-MULTIPLE-","Cost of Goods Sold","Zelia Handwash Liquid",,"Undeposited Funds",707.18,"",654337.96
,"Sales Receipt","11-10-2024","3289",,"Cash Sales","Zelia Strawberry Handwash Liquid 15x500ML","Cost of Goods Sold","Zelia Handwash Liquid",,"Undeposited Funds",47.07,"",654385.03
,"Sales Receipt","11-10-2024","3296",,"Restoration Traders","-MULTIPLE-","Cost of Goods Sold","Zelia Handwash Liquid",,"Undeposited Funds",1414.52,"",655799.55
,"Sales Receipt","11-10-2024","3174",,"Ethiopian Store","-MULTIPLE-","Cost of Goods Sold","Zelia Handwash Liquid",,"Undeposited Funds",1414.52,"",657214.07
,"Sales Receipt","11-10-2024","3175",,"Garissa Mini mart","-MULTIPLE-","Cost of Goods Sold","Zelia Handwash Liquid",,"Undeposited Funds",707.18,"",657921.25
,"Sales Receipt","12-10-2024","3294",,"Afrodrip JKIA","-MULTIPLE-","Cost of Goods Sold","Zelia Handwash Liquid",,"Undeposited Funds",94.31,"",658015.56
,"Sales Receipt","12-10-2024","3176",,"Hawkers Wholesale","-MULTIPLE-","Cost of Goods Sold","Zelia Handwash Liquid",,"Undeposited Funds",471.50,"",658487.06
,"Sales Receipt","12-10-2024","3177",,"Aggy Malimali shop","-MULTIPLE-","Cost of Goods Sold","Zelia Handwash Liquid",,"Undeposited Funds",660.12,"",659147.18
,"Sales Receipt","14-10-2024","3178",,"Adam Mart","-MULTIPLE-","Cost of Goods Sold","Zelia Handwash Liquid",,"Undeposited Funds",660.12,"",659807.30
,"Sales Receipt","16-10-2024","3114",,"Bismillahi Shop","-MULTIPLE-","Cost of Goods Sold","Zelia Handwash Liquid",,"Undeposited Funds",707.35,"",660514.65
,"Sales Receipt","16-10-2024","3113",,"Himilo General Store","-MULTIPLE-","Cost of Goods Sold","Zelia Handwash Liquid",,"Undeposited Funds",4243.57,"",664758.22
,"Sales Receipt","16-10-2024","3111",,"Everlast Shop","-MULTIPLE-","Cost of Goods Sold","Zelia Handwash Liquid",,"Undeposited Funds",707.18,"",665465.40
,"Sales Receipt","17-10-2024","3119",,"Cash Sales","Zelia Apple Handwash Liquid 15X500ML","Cost of Goods Sold","Zelia Handwash Liquid",,"Undeposited Funds",47.24,"",665512.64
,"Sales Receipt","17-10-2024","3120",,"Cash Sales","-MULTIPLE-","Cost of Goods Sold","Zelia Handwash Liquid",,"Undeposited Funds",1414.52,"",666927.16
,"Sales Receipt","18-10-2024","3122",,"Cash Sales","Zelia Strawberry Handwash Liquid 15x500ML","Cost of Goods Sold","Zelia Handwash Liquid",,"Undeposited Funds",47.07,"",666974.23
,"Sales Receipt","18-10-2024","3126",,"Cash Sales","Zelia Apple Handwash Liquid 15X500ML","Cost of Goods Sold","Zelia Handwash Liquid",,"Undeposited Funds",94.47,"",667068.70
,"Sales Receipt","19-10-2024","3186",,"Dans Shop","-MULTIPLE-","Cost of Goods Sold","Zelia Handwash Liquid",,"Undeposited Funds",1414.52,"",668483.22
,"Sales Receipt","19-10-2024","3180",,"Witgad Shop","-MULTIPLE-","Cost of Goods Sold","Zelia Handwash Liquid",,"Undeposited Funds",282.91,"",668766.13
,"Sales Receipt","19-10-2024","3185",,"Golden Shop","-MULTIPLE-","Cost of Goods Sold","Zelia Handwash Liquid",,"Undeposited Funds",1414.52,"",670180.65
,"Sales Receipt","22-10-2024","3130",,"Cash Sales","Zelia Strawberry Handwash Liquid 15x500ML","Cost of Goods Sold","Zelia Handwash Liquid",,"Undeposited Funds",141.20,"",670321.85
,"Sales Receipt","22-10-2024","3132",,"Hidika Shop","-MULTIPLE-","Cost of Goods Sold","Zelia Handwash Liquid",,"Undeposited Funds",707.35,"",671029.20
,"Sales Receipt","22-10-2024","3133",,"tRIPPLE M","-MULTIPLE-","Cost of Goods Sold","Zelia Handwash Liquid",,"Undeposited Funds",707.35,"",671736.55
,"Sales Receipt","22-10-2024","3134",,"Zulu Enterprise","-MULTIPLE-","Cost of Goods Sold","Zelia Handwash Liquid",,"Undeposited Funds",707.35,"",672443.90
,"Sales Receipt","22-10-2024","3135",,"Discount Traders","-MULTIPLE-","Cost of Goods Sold","Zelia Handwash Liquid",,"Undeposited Funds",1414.52,"",673858.42
,"Sales Receipt","23-10-2024","3139",,"Cash Sales","Zelia Apple Handwash Liquid 15X500ML","Cost of Goods Sold","Zelia Handwash Liquid",,"Undeposited Funds",94.47,"",673952.89
,"Sales Receipt","23-10-2024","3144",,"Cash Sales","Zelia Strawberry Handwash Liquid 4x5L","Cost of Goods Sold","Zelia Handwash Liquid",,"Undeposited Funds",250.83,"",674203.72
,"Sales Receipt","23-10-2024","3146",,"Libin Minimart","-MULTIPLE-","Cost of Goods Sold","Zelia Handwash Liquid",,"Undeposited Funds",1414.52,"",675618.24
,"Sales Receipt","23-10-2024","3141",,"Kibibi Wasai Store","-MULTIPLE-","Cost of Goods Sold","Zelia Handwash Liquid",,"Undeposited Funds",1414.52,"",677032.76
,"Sales Receipt","24-10-2024","3147",,"Cash Sales","-MULTIPLE-","Cost of Goods Sold","Zelia Handwash Liquid",,"Undeposited Funds",391.35,"",677424.11
,"Sales Receipt","24-10-2024","3148",,"Cash Sales","Zelia Strawberry Handwash Liquid 15x500ML","Cost of Goods Sold","Zelia Handwash Liquid",,"Undeposited Funds",93.68,"",677517.79
,"Sales Receipt","24-10-2024","3149",,"Cash Sales","Zelia Apple Handwash Liquid 15X500ML","Cost of Goods Sold","Zelia Handwash Liquid",,"Undeposited Funds",47.24,"",677565.03
,"Sales Receipt","24-10-2024","3152",,"Aisha Collections","-MULTIPLE-","Cost of Goods Sold","Zelia Handwash Liquid",,"Undeposited Funds",704.59,"",678269.62
,"Invoice","25-10-2024","MC06299",,"THE BRIGHT STAR SUPERMARKET LIMITED","-MULTIPLE-","Cost of Goods Sold","Zelia Handwash Liquid",,"Accounts Receivable",1128.92,"",679398.54
,"Invoice","25-10-2024","MC06300",,"HAPPY VIEW SUPERMARKET LIMITED","-MULTIPLE-","Cost of Goods Sold","Zelia Handwash Liquid",,"Accounts Receivable",564.46,"",679963.00
,"Sales Receipt","25-10-2024","3155",,"Cash Sales","Zelia Strawberry Handwash Liquid 4x5L","Cost of Goods Sold","Zelia Handwash Liquid",,"Undeposited Funds",1003.30,"",680966.30
,"Sales Receipt","25-10-2024","3159",,"Marris Mini mart","-MULTIPLE-","Cost of Goods Sold","Zelia Handwash Liquid",,"Undeposited Funds",282.38,"",681248.68
,"Sales Receipt","25-10-2024","3157",,"Mamken Minimart","-MULTIPLE-","Cost of Goods Sold","Zelia Handwash Liquid",,"Undeposited Funds",706.17,"",681954.85
,"Sales Receipt","26-10-2024","3161",,"Cash Sales","Zelia Apple Handwash Liquid 15X500ML","Cost of Goods Sold","Zelia Handwash Liquid",,"Undeposited Funds",94.57,"",682049.42
,"Sales Receipt","26-10-2024","3193",,"032 minimart","-MULTIPLE-","Cost of Goods Sold","Zelia Handwash Liquid",,"Undeposited Funds",564.76,"",682614.18
,"Sales Receipt","26-10-2024","3183",,"Tosha Matt","-MULTIPLE-","Cost of Goods Sold","Zelia Handwash Liquid",,"Undeposited Funds",1411.90,"",684026.08
,"Sales Receipt","26-10-2024","3182",,"Nyaugenya Mini Matt","-MULTIPLE-","Cost of Goods Sold","Zelia Handwash Liquid",,"Undeposited Funds",1411.90,"",685437.98
,"Sales Receipt","28-10-2024","3181",,"Mahitaji Store","-MULTIPLE-","Cost of Goods Sold","Zelia Handwash Liquid",,"Undeposited Funds",1411.90,"",686849.88
,"Sales Receipt","29-10-2024","3169",,"Cash Sales","Zelia Apple Handwash Liquid 4x5L","Cost of Goods Sold","Zelia Handwash Liquid",,"Undeposited Funds",258.30,"",687108.18
,"Sales Receipt","29-10-2024","3704",,"Home Soko Minimart","Zelia Apple Handwash Liquid 15X500ML","Cost of Goods Sold","Zelia Handwash Liquid",,"Undeposited Funds",283.72,"",687391.90
,"Invoice","30-10-2024","MC06322",,"OFFSHORE GLOBAL LOGISTICS LIMITED","Zelia Strawberry Handwash Liquid 4x5L","Cost of Goods Sold","Zelia Handwash Liquid",,"Accounts Receivable",1003.30,"",688395.20
,"Sales Receipt","30-10-2024","3725",,"Safa Groceries","-MULTIPLE-","Cost of Goods Sold","Zelia Handwash Liquid",,"Undeposited Funds",564.76,"",688959.96
,"Sales Receipt","30-10-2024","3726",,"Msafi Shop","-MULTIPLE-","Cost of Goods Sold","Zelia Handwash Liquid",,"Undeposited Funds",2823.80,"",691783.76
,"Sales Receipt","30-10-2024","3727",,"Ellas Store","-MULTIPLE-","Cost of Goods Sold","Zelia Handwash Liquid",,"Undeposited Funds",705.72,"",692489.48
,"Sales Receipt","31-10-2024","3192",,"Cash Sales","Zelia Strawberry Handwash Liquid 4x5L","Cost of Goods Sold","Zelia Handwash Liquid",,"Undeposited Funds",752.48,"",693241.96
,"Sales Receipt","31-10-2024","3196",,"Cash Sales","Zelia Strawberry Handwash Liquid 15x500ML","Cost of Goods Sold","Zelia Handwash Liquid",,"Undeposited Funds",93.68,"",693335.64
,"Sales Receipt","02-11-2024","3707",,"Cheaper Cheap","-MULTIPLE-","Cost of Goods Sold","Zelia Handwash Liquid",,"Undeposited Funds",1411.90,"",694747.54
,"Sales Receipt","04-11-2024","3197",,"Cash Sales","Zelia Strawberry Handwash Liquid 15x500ML","Cost of Goods Sold","Zelia Handwash Liquid",,"Undeposited Funds",46.84,"",694794.38
,"Sales Receipt","04-11-2024","3709",,"Brinso Foodstufs","-MULTIPLE-","Cost of Goods Sold","Zelia Handwash Liquid",,"Undeposited Funds",706.17,"",695500.55
,"Sales Receipt","05-11-2024","3713",,"Elwak Minimart","-MULTIPLE-","Cost of Goods Sold","Zelia Handwash Liquid",,"Undeposited Funds",706.61,"",696207.16
,"Sales Receipt","05-11-2024","3714",,"Marris Mini mart","-MULTIPLE-","Cost of Goods Sold","Zelia Handwash Liquid",,"Undeposited Funds",282.38,"",696489.54
,"Sales Receipt","05-11-2024","3712",,"Hidika Shop","-MULTIPLE-","Cost of Goods Sold","Zelia Handwash Liquid",,"Undeposited Funds",706.17,"",697195.71
,"Invoice","06-11-2024","MC06335",,"Guard Mart Supermarket Limited","-MULTIPLE-","Cost of Goods Sold","Zelia Handwash Liquid",,"Accounts Receivable",94.13,"",697289.84
,"Invoice","06-11-2024","MC06336",,"Ellas Store","-MULTIPLE-","Cost of Goods Sold","Zelia Handwash Liquid",,"Accounts Receivable",705.72,"",697995.56
,"Sales Receipt","06-11-2024","3402",,"Cash Sales","Zelia Apple Handwash Liquid 15X500ML","Cost of Goods Sold","Zelia Handwash Liquid",,"Undeposited Funds",94.57,"",698090.13
,"Sales Receipt","06-11-2024","3721",,"Towba foodstuffs","-MULTIPLE-","Cost of Goods Sold","Zelia Handwash Liquid",,"Undeposited Funds",1411.90,"",699502.03
,"Sales Receipt","06-11-2024","3719",,"Adam Boss","-MULTIPLE-","Cost of Goods Sold","Zelia Handwash Liquid",,"Undeposited Funds",706.17,"",700208.20
,"Sales Receipt","07-11-2024","3722",,"D-Madina Enterprise","-MULTIPLE-","Cost of Goods Sold","Zelia Handwash Liquid",,"Undeposited Funds",706.17,"",700914.37
,"Sales Receipt","08-11-2024","3458",,"Mama Sam Shop","-MULTIPLE-","Cost of Goods Sold","Zelia Handwash Liquid",,"Undeposited Funds",753.00,"",701667.37
,"Sales Receipt","11-11-2024","3420",,"Cash Sales","Zelia Strawberry Handwash Liquid 15x500ML","Cost of Goods Sold","Zelia Handwash Liquid",,"Undeposited Funds",140.52,"",701807.89
,"Sales Receipt","11-11-2024","3426",,"Golden Save","-MULTIPLE-","Cost of Goods Sold","Zelia Handwash Liquid",,"Undeposited Funds",3533.08,"",705340.97
,"Sales Receipt","11-11-2024","3429",,"Downtown Wholesalers","-MULTIPLE-","Cost of Goods Sold","Zelia Handwash Liquid",,"Undeposited Funds",1411.90,"",706752.87
,"Sales Receipt","11-11-2024","3430",,"Dalwo Wholesallers","-MULTIPLE-","Cost of Goods Sold","Zelia Handwash Liquid",,"Undeposited Funds",705.72,"",707458.59
,"Sales Receipt","12-11-2024","3431",,"Cash Sales","-MULTIPLE-","Cost of Goods Sold","Zelia Handwash Liquid",,"Undeposited Funds",8203.09,"",715661.68
,"Sales Receipt","12-11-2024","3436",,"Horn of Africa","-MULTIPLE-","Cost of Goods Sold","Zelia Handwash Liquid",,"Undeposited Funds",1129.52,"",716791.20
,"Sales Receipt","12-11-2024","3439",,"Maida Minimart","Zelia Apple Handwash Liquid 15X500ML","Cost of Goods Sold","Zelia Handwash Liquid",,"Undeposited Funds",283.72,"",717074.92
,"Invoice","13-11-2024","MC06355",,"KASAMAT INVESTMENTS LTD","-MULTIPLE-","Cost of Goods Sold","Zelia Handwash Liquid",,"Accounts Receivable",564.76,"",717639.68
,"Invoice","13-11-2024","MC06357",,"LUCKY MART SUPERMARKET LIMITED","-MULTIPLE-","Cost of Goods Sold","Zelia Handwash Liquid",,"Accounts Receivable",1411.90,"",719051.58
,"Invoice","13-11-2024","MC06359",,"PRICE CHOPPER STORES LIMITED","Zelia Apple Handwash Liquid 15X500ML  6Pieces@116","Cost of Goods Sold","Zelia Handwash Liquid",,"Accounts Receivable",283.72,"",719335.30
,"Sales Receipt","13-11-2024","3434",,"Cash Sales","Zelia Apple Handwash Liquid 4x5L","Cost of Goods Sold","Zelia Handwash Liquid",,"Undeposited Funds",517.35,"",719852.65
,"Sales Receipt","13-11-2024","3493",,"Mwambao Shop","-MULTIPLE-","Cost of Goods Sold","Zelia Handwash Liquid",,"Undeposited Funds",188.25,"",720040.90
,"Sales Receipt","13-11-2024","3441",,"Publix Supermarket","-MULTIPLE-","Cost of Goods Sold","Zelia Handwash Liquid",,"Undeposited Funds",706.17,"",720747.07
,"Sales Receipt","13-11-2024","3445",,"Gold mart Supermarket","Zelia Apple Handwash Liquid 15X500ML","Cost of Goods Sold","Zelia Handwash Liquid",,"Undeposited Funds",283.72,"",721030.79
,"Sales Receipt","14-11-2024","3728",,"Cash Sales","Zelia Apple Handwash Liquid 4x5L","Cost of Goods Sold","Zelia Handwash Liquid",,"Undeposited Funds",258.68,"",721289.47
,"Sales Receipt","14-11-2024","3461",,"Kopeyo Shop","-MULTIPLE-","Cost of Goods Sold","Zelia Handwash Liquid",,"Undeposited Funds",2823.79,"",724113.26
,"Invoice","15-11-2024","MC06367",,"ROAM MART","-MULTIPLE-","Cost of Goods Sold","Zelia Handwash Liquid",,"Accounts Receivable",1411.90,"",725525.16
,"Sales Receipt","15-11-2024","3448",,"Cash Sales","Zelia Strawberry Handwash Liquid 4x5L","Cost of Goods Sold","Zelia Handwash Liquid",,"Undeposited Funds",256.18,"",725781.34
,"Sales Receipt","15-11-2024","3730",,"Cash Sales","Zelia Strawberry Handwash Liquid 15x500ML","Cost of Goods Sold","Zelia Handwash Liquid",,"Undeposited Funds",46.84,"",725828.18
,"Invoice","18-11-2024","MC06372",,"Guard Mart Supermarket Limited","-MULTIPLE-","Cost of Goods Sold","Zelia Handwash Liquid",,"Accounts Receivable",1411.90,"",727240.08
,"Credit Note","18-11-2024","CN01073",,"Guard Mart Supermarket Limited","-MULTIPLE-","Cost of Goods Sold","Zelia Handwash Liquid",,"Accounts Receivable","",94.13,727145.95
,"Sales Receipt","18-11-2024","3450",,"Cash Sales","Zelia Strawberry Handwash Liquid 15x500ML","Cost of Goods Sold","Zelia Handwash Liquid",,"Undeposited Funds",93.68,"",727239.63
,"Sales Receipt","18-11-2024","3472",,"Cash Sales","Zelia Strawberry Handwash Liquid 4x5L","Cost of Goods Sold","Zelia Handwash Liquid",,"Undeposited Funds",256.18,"",727495.81
,"Sales Receipt","18-11-2024","3733",,"Cash Sales","Zelia Strawberry Handwash Liquid 20L","Cost of Goods Sold","Zelia Handwash Liquid",,"Undeposited Funds",803.96,"",728299.77
,"Sales Receipt","18-11-2024","3462",,"Nabcom Stores","-MULTIPLE-","Cost of Goods Sold","Zelia Handwash Liquid",,"Undeposited Funds",705.72,"",729005.49
,"Sales Receipt","18-11-2024","3464",,"Restoration Traders","-MULTIPLE-","Cost of Goods Sold","Zelia Handwash Liquid",,"Undeposited Funds",1411.90,"",730417.39
,"Sales Receipt","18-11-2024","3466",,"Faisel Wholesale","-MULTIPLE-","Cost of Goods Sold","Zelia Handwash Liquid",,"Undeposited Funds",1411.90,"",731829.29
,"Invoice","19-11-2024","MC06374",,"SUMM SUPERMARKET LIMITED","Zelia Strawberry Handwash Liquid 15x500ML  6Pcs @117","Cost of Goods Sold","Zelia Handwash Liquid",,"Accounts Receivable",281.04,"",732110.33
,"Invoice","19-11-2024","MC06378",,"ROYMATT SUPERMARKET LIMITED","-MULTIPLE-","Cost of Goods Sold","Zelia Handwash Liquid",,"Accounts Receivable",705.72,"",732816.05
,"Invoice","19-11-2024","MC06379",,"DALLAS SHOPRITE LTD","-MULTIPLE-","Cost of Goods Sold","Zelia Handwash Liquid",,"Accounts Receivable",706.17,"",733522.22
,"Sales Receipt","19-11-2024","3471",,"Kedulle Enterprises","-MULTIPLE-","Cost of Goods Sold","Zelia Handwash Liquid",,"Undeposited Funds",4235.69,"",737757.91
,"Sales Receipt","19-11-2024","3474",,"Milele Shop","-MULTIPLE-","Cost of Goods Sold","Zelia Handwash Liquid",,"Undeposited Funds",706.17,"",738464.08
,"Sales Receipt","20-11-2024","3477",,"Cash Sales","Zelia Strawberry Handwash Liquid 15x500ML","Cost of Goods Sold","Zelia Handwash Liquid",,"Undeposited Funds",46.84,"",738510.92
,"Sales Receipt","20-11-2024","3479",,"Dola Wholesalers","-MULTIPLE-","Cost of Goods Sold","Zelia Handwash Liquid",,"Undeposited Funds",1411.90,"",739922.82
,"Sales Receipt","21-11-2024","3482",,"Cash Sales","Zelia Strawberry Handwash Liquid 15x500ML","Cost of Goods Sold","Zelia Handwash Liquid",,"Undeposited Funds",46.84,"",739969.66
,"Sales Receipt","22-11-2024","3488",,"Cash Sales","Zelia Strawberry Handwash Liquid 15x500ML","Cost of Goods Sold","Zelia Handwash Liquid",,"Undeposited Funds",281.04,"",740250.70
,"Sales Receipt","22-11-2024","3499",,"Cash Sales","Zelia Strawberry Handwash Liquid 4x5L","Cost of Goods Sold","Zelia Handwash Liquid",,"Undeposited Funds",512.37,"",740763.07
,"Sales Receipt","22-11-2024","3494",,"Asfa Shop","Zelia Strawberry Handwash Liquid 15x500ML","Cost of Goods Sold","Zelia Handwash Liquid",,"Undeposited Funds",281.04,"",741044.11
,"Sales Receipt","25-11-2024","3762",,"Oyugis Discount","-MULTIPLE-","Cost of Goods Sold","Zelia Handwash Liquid",,"Undeposited Funds",2823.79,"",743867.90
,"Sales Receipt","25-11-2024","3763",,"Domie Shop","-MULTIPLE-","Cost of Goods Sold","Zelia Handwash Liquid",,"Undeposited Funds",753.00,"",744620.90
,"Invoice","26-11-2024","MC06412",,"Seasons lane Mart","-MULTIPLE-","Cost of Goods Sold","Zelia Handwash Liquid",,"Accounts Receivable",705.72,"",745326.62
,"Sales Receipt","26-11-2024","3740",,"Afrodrip JKIA","Zelia Apple Handwash Liquid 15X500ML","Cost of Goods Sold","Zelia Handwash Liquid",,"Undeposited Funds",47.29,"",745373.91
,"Sales Receipt","27-11-2024","3743",,"Mama Amina","-MULTIPLE-","Cost of Goods Sold","Zelia Handwash Liquid",,"Undeposited Funds",706.17,"",746080.08
,"Sales Receipt","27-11-2024","3764",,"Molly Shop","-MULTIPLE-","Cost of Goods Sold","Zelia Handwash Liquid",,"Undeposited Funds",376.51,"",746456.59
,"Sales Receipt","27-11-2024","3765",,"Duto Rumo Store","-MULTIPLE-","Cost of Goods Sold","Zelia Handwash Liquid",,"Undeposited Funds",705.72,"",747162.31
,"Sales Receipt","28-11-2024","3751",,"Cash Sales","Zelia Strawberry Handwash Liquid 4x5L","Cost of Goods Sold","Zelia Handwash Liquid",,"Undeposited Funds",256.18,"",747418.49
,"Sales Receipt","28-11-2024","3752",,"Cash Sales","Zelia Strawberry Handwash Liquid 15x500ML","Cost of Goods Sold","Zelia Handwash Liquid",,"Undeposited Funds",93.68,"",747512.17
,"Sales Receipt","29-11-2024","3754",,"Cash Sales","Zelia Strawberry Handwash Liquid 15x500ML","Cost of Goods Sold","Zelia Handwash Liquid",,"Undeposited Funds",46.84,"",747559.01
,"Sales Receipt","29-11-2024","3755",,"Cash Sales","Zelia Strawberry Handwash Liquid 15x500ML","Cost of Goods Sold","Zelia Handwash Liquid",,"Undeposited Funds",46.84,"",747605.85
,"Sales Receipt","29-11-2024","3756",,"Cash Sales","Zelia Strawberry Handwash Liquid 15x500ML","Cost of Goods Sold","Zelia Handwash Liquid",,"Undeposited Funds",46.84,"",747652.69
,"Sales Receipt","29-11-2024","3789",,"Ubwete Shop","-MULTIPLE-","Cost of Goods Sold","Zelia Handwash Liquid",,"Undeposited Funds",564.76,"",748217.45
,"Sales Receipt","30-11-2024","3760",,"Cash Sales","Zelia Apple Handwash Liquid 15X500ML","Cost of Goods Sold","Zelia Handwash Liquid",,"Undeposited Funds",189.15,"",748406.60
,"Sales Receipt","30-11-2024","AT203",,"Cash Sales","Zelia Strawberry Handwash Liquid 15x500ML","Cost of Goods Sold","Zelia Handwash Liquid",,"Undeposited Funds",702.61,"",749109.21
,"Sales Receipt","30-11-2024","3766",,"Muga Shop","-MULTIPLE-","Cost of Goods Sold","Zelia Handwash Liquid",,"Undeposited Funds",2823.80,"",751933.01
,"Sales Receipt","02-12-2024","3761",,"Cash Sales","Zelia Strawberry Handwash Liquid 4x5L","Cost of Goods Sold","Zelia Handwash Liquid",,"Undeposited Funds",256.18,"",752189.19
,"Sales Receipt","02-12-2024","3767",,"Cash Sales","Zelia Strawberry Handwash Liquid 15x500ML","Cost of Goods Sold","Zelia Handwash Liquid",,"Undeposited Funds",46.84,"",752236.03
,"Sales Receipt","02-12-2024","3775",,"Gacal Wholesale","-MULTIPLE-","Cost of Goods Sold","Zelia Handwash Liquid",,"Undeposited Funds",705.72,"",752941.75
,"Sales Receipt","03-12-2024","3782",,"Summer Outlets","-MULTIPLE-","Cost of Goods Sold","Zelia Handwash Liquid",,"Undeposited Funds",706.17,"",753647.92
,"Sales Receipt","03-12-2024","3783",,"Tender Store Limited","-MULTIPLE-","Cost of Goods Sold","Zelia Handwash Liquid",,"Undeposited Funds",2823.79,"",756471.71
,"Sales Receipt","04-12-2024","3784",,"Gure Yare Shop","-MULTIPLE-","Cost of Goods Sold","Zelia Handwash Liquid",,"Undeposited Funds",1411.90,"",757883.61
,"Sales Receipt","04-12-2024","3785",,"Towba Parkroad","-MULTIPLE-","Cost of Goods Sold","Zelia Handwash Liquid",,"Undeposited Funds",1411.90,"",759295.51
,"Sales Receipt","04-12-2024","3326",,"Mwananchi Store","-MULTIPLE-","Cost of Goods Sold","Zelia Handwash Liquid",,"Undeposited Funds",1411.90,"",760707.41
,"Sales Receipt","04-12-2024","3786",,"Warfa Wholesale","-MULTIPLE-","Cost of Goods Sold","Zelia Handwash Liquid",,"Undeposited Funds",2823.79,"",763531.20
,"Sales Receipt","04-12-2024","3791",,"Gold mart Supermarket","Zelia Strawberry Handwash Liquid 15x500ML","Cost of Goods Sold","Zelia Handwash Liquid",,"Undeposited Funds",281.04,"",763812.24
,"Invoice","05-12-2024","MC06447",,"NASRI MART LIMITED","Zelia Apple Handwash Liquid 15X500ML  6Pcs@118","Cost of Goods Sold","Zelia Handwash Liquid",,"Accounts Receivable",283.72,"",764095.96
,"Sales Receipt","05-12-2024","3793",,"BCB Shop","-MULTIPLE-","Cost of Goods Sold","Zelia Handwash Liquid",,"Undeposited Funds",564.76,"",764660.72
,"Sales Receipt","05-12-2024","3799",,"Hayan Wholesalers","-MULTIPLE-","Cost of Goods Sold","Zelia Handwash Liquid",,"Undeposited Funds",1411.90,"",766072.62
,"Sales Receipt","05-12-2024","3327",,"Macbellah Shop","-MULTIPLE-","Cost of Goods Sold","Zelia Handwash Liquid",,"Undeposited Funds",1411.90,"",767484.52
,"Sales Receipt","07-12-2024","3323",,"Mahitaji Store","-MULTIPLE-","Cost of Goods Sold","Zelia Handwash Liquid",,"Undeposited Funds",1411.90,"",768896.42
,"Sales Receipt","07-12-2024","3324",,"Queen of Cleaning","-MULTIPLE-","Cost of Goods Sold","Zelia Handwash Liquid",,"Undeposited Funds",941.27,"",769837.69
,"Sales Receipt","07-12-2024","3325",,"Blossom Shop","-MULTIPLE-","Cost of Goods Sold","Zelia Handwash Liquid",,"Undeposited Funds",2823.79,"",772661.48
,"Invoice","09-12-2024","MC06452",,"DISII TRADERS LTD","-MULTIPLE-","Cost of Goods Sold","Zelia Handwash Liquid",,"Accounts Receivable",1129.52,"",773791.00
,"Invoice","09-12-2024","MC06456",,"OFFSHORE GLOBAL LOGISTICS LIMITED","Zelia Strawberry Handwash Liquid 4x5L","Cost of Goods Sold","Zelia Handwash Liquid",,"Accounts Receivable",512.37,"",774303.37
,"Sales Receipt","09-12-2024","3310",,"Cash Sales","Zelia Strawberry Handwash Liquid 4x5L","Cost of Goods Sold","Zelia Handwash Liquid",,"Undeposited Funds",256.18,"",774559.55
,"Sales Receipt","09-12-2024","3317",,"Cash Sales","Zelia Strawberry Handwash Liquid 15x500ML","Cost of Goods Sold","Zelia Handwash Liquid",,"Undeposited Funds",46.84,"",774606.39
,"Sales Receipt","09-12-2024","3315",,"Shop 5","-MULTIPLE-","Cost of Goods Sold","Zelia Handwash Liquid",,"Undeposited Funds",706.17,"",775312.56
,"Sales Receipt","10-12-2024","3328",,"Horn of Africa","-MULTIPLE-","Cost of Goods Sold","Zelia Handwash Liquid",,"Undeposited Funds",705.72,"",776018.28
,"Sales Receipt","10-12-2024","3329",,"Soimo Mini mart","-MULTIPLE-","Cost of Goods Sold","Zelia Handwash Liquid",,"Undeposited Funds",282.38,"",776300.66
,"Sales Receipt","11-12-2024","3339",,"Fahal Wholesalers","-MULTIPLE-","Cost of Goods Sold","Zelia Handwash Liquid",,"Undeposited Funds",3526.40,"",779827.06
,"Sales Receipt","11-12-2024","3338",,"Freshfinds Mart","-MULTIPLE-","Cost of Goods Sold","Zelia Handwash Liquid",,"Undeposited Funds",706.17,"",780533.23
,"Sales Receipt","13-12-2024","3349",,"032 minimart","-MULTIPLE-","Cost of Goods Sold","Zelia Handwash Liquid",,"Undeposited Funds",705.72,"",781238.95
,"Sales Receipt","16-12-2024","3342",,"Cash Sales","Zelia Apple Handwash Liquid 15X500ML","Cost of Goods Sold","Zelia Handwash Liquid",,"Undeposited Funds",47.29,"",781286.24
,"Sales Receipt","16-12-2024","3345",,"Cash Sales","Zelia Strawberry Handwash Liquid 15x500ML","Cost of Goods Sold","Zelia Handwash Liquid",,"Undeposited Funds",46.84,"",781333.08
,"Sales Receipt","16-12-2024","3348",,"Cash Sales","Zelia Strawberry Handwash Liquid 4x5L","Cost of Goods Sold","Zelia Handwash Liquid",,"Undeposited Funds",256.18,"",781589.26
,"Sales Receipt","16-12-2024","3352",,"Rayyan Shop","-MULTIPLE-","Cost of Goods Sold","Zelia Handwash Liquid",,"Undeposited Funds",706.17,"",782295.43
,"Invoice","17-12-2024","MC06477",,"OFFSHORE GLOBAL LOGISTICS LIMITED","Zelia Strawberry Handwash Liquid 4x5L","Cost of Goods Sold","Zelia Handwash Liquid",,"Accounts Receivable",512.37,"",782807.80
,"Sales Receipt","17-12-2024","3354",,"Cash Sales","Zelia Strawberry Handwash Liquid 15x500ML","Cost of Goods Sold","Zelia Handwash Liquid",,"Undeposited Funds",93.68,"",782901.48
,"Sales Receipt","17-12-2024","3356",,"Restoration Traders","-MULTIPLE-","Cost of Goods Sold","Zelia Handwash Liquid",,"Undeposited Funds",2823.79,"",785725.27
,"Sales Receipt","18-12-2024","3358",,"Cash Sales","Zelia Strawberry Handwash Liquid 15x500ML","Cost of Goods Sold","Zelia Handwash Liquid",,"Undeposited Funds",46.84,"",785772.11
,"Sales Receipt","18-12-2024","3364",,"Gold mart Supermarket","-MULTIPLE-","Cost of Goods Sold","Zelia Handwash Liquid",,"Undeposited Funds",1129.52,"",786901.63
,"Sales Receipt","18-12-2024","3366",,"Libim Minimart","-MULTIPLE-","Cost of Goods Sold","Zelia Handwash Liquid",,"Undeposited Funds",2823.79,"",789725.42
"Total Zelia Handwash Liquid",,,,,,,,,,,801911.56,12186.14,789725.42
"Zelia Scouring Powder",,,,,,,,,,,,,""
,"Invoice","04-01-2024","MC05269",,"OFFSHORE GLOBAL LOGISTICS LIMITED","Zelia Scourer Lemon 500g","Cost of Goods Sold","Zelia Scouring Powder",,"Accounts Receivable",119.32,"",119.32
,"Sales Receipt","12-01-2024","1733",,"Cash Sales","Zelia Scourer Lemon 500g","Cost of Goods Sold","Zelia Scouring Powder",,"Undeposited Funds",59.66,"",178.98
,"Sales Receipt","15-01-2024","1729",,"Cash Sales","Zelia Scourer Lemon 500g","Cost of Goods Sold","Zelia Scouring Powder",,"Undeposited Funds",14.91,"",193.89
,"Sales Receipt","29-01-2024","1763",,"Cash Sales","Zelia Scourer Lemon 500g","Cost of Goods Sold","Zelia Scouring Powder",,"Undeposited Funds",14.91,"",208.80
,"Sales Receipt","08-02-2024","1816",,"Cash Sales","Zelia Scourer Lemon 500g","Cost of Goods Sold","Zelia Scouring Powder",,"Undeposited Funds",59.66,"",268.46
,"Invoice","12-02-2024","MC05396",,"OFFSHORE GLOBAL LOGISTICS LIMITED","Zelia Scourer Lemon 500g","Cost of Goods Sold","Zelia Scouring Powder",,"Accounts Receivable",149.15,"",417.61
,"Sales Receipt","27-02-2024","1878",,"Cash Sales","Zelia Scourer Lemon 500g","Cost of Goods Sold","Zelia Scouring Powder",,"Undeposited Funds",44.74,"",462.35
,"Sales Receipt","05-03-2024","2008",,"Cash Sales","Zelia Scourer Lemon 500g","Cost of Goods Sold","Zelia Scouring Powder",,"Undeposited Funds",14.91,"",477.26
,"Sales Receipt","05-03-2024","2009",,"Cash Sales","Zelia Scourer Lemon 500g","Cost of Goods Sold","Zelia Scouring Powder",,"Undeposited Funds",14.91,"",492.17
,"Sales Receipt","05-03-2024","2012",,"Cash Sales","Zelia Scourer Lemon 500g","Cost of Goods Sold","Zelia Scouring Powder",,"Undeposited Funds",14.91,"",507.08
,"Sales Receipt","06-03-2024","2018",,"Cash Sales","Zelia Scourer Lemon 500g","Cost of Goods Sold","Zelia Scouring Powder",,"Undeposited Funds",14.91,"",521.99
,"Invoice","07-03-2024","MC05477",,"OFFSHORE GLOBAL LOGISTICS LIMITED","Zelia Scourer Lemon 500g","Cost of Goods Sold","Zelia Scouring Powder",,"Accounts Receivable",59.66,"",581.65
,"Sales Receipt","07-03-2024","2030",,"Blue Bubble Homecare Products Ltd","Zelia Scourer Lemon 500g","Cost of Goods Sold","Zelia Scouring Powder",,"Undeposited Funds",29.83,"",611.48
,"Sales Receipt","07-03-2024","2032",,"Cash Sales","Zelia Scourer Lemon 500g","Cost of Goods Sold","Zelia Scouring Powder",,"Undeposited Funds",14.91,"",626.39
,"Sales Receipt","07-03-2024","2037",,"Cash Sales","Zelia Scourer Lemon 500g","Cost of Goods Sold","Zelia Scouring Powder",,"Undeposited Funds",14.91,"",641.30
,"Sales Receipt","08-03-2024","2045",,"Cash Sales","Zelia Scourer Lemon 500g","Cost of Goods Sold","Zelia Scouring Powder",,"Undeposited Funds",59.66,"",700.96
,"Sales Receipt","18-03-2024","2074",,"Cash Sales","Zelia Scourer Lemon 500g","Cost of Goods Sold","Zelia Scouring Powder",,"Undeposited Funds",59.66,"",760.62
,"Sales Receipt","28-03-2024","2127",,"Cash Sales","Zelia Scourer Lemon 500g","Cost of Goods Sold","Zelia Scouring Powder",,"Undeposited Funds",14.91,"",775.53
,"Sales Receipt","15-04-2024","2190",,"Cash Sales","Zelia Scourer Lemon 500g","Cost of Goods Sold","Zelia Scouring Powder",,"Undeposited Funds",29.83,"",805.36
,"Sales Receipt","18-04-2024","2223",,"Cash Sales","Zelia Scourer Lemon 500g","Cost of Goods Sold","Zelia Scouring Powder",,"Undeposited Funds",14.91,"",820.27
,"Sales Receipt","19-04-2024","2231",,"Cash Sales","Zelia Scourer Lemon 500g","Cost of Goods Sold","Zelia Scouring Powder",,"Undeposited Funds",29.83,"",850.10
,"Sales Receipt","29-04-2024","2271",,"Cash Sales","Zelia Scourer Lemon 500g","Cost of Goods Sold","Zelia Scouring Powder",,"Undeposited Funds",29.83,"",879.93
,"Sales Receipt","29-04-2024","2277",,"Cash Sales","Zelia Scourer Lemon 500g","Cost of Goods Sold","Zelia Scouring Powder",,"Undeposited Funds",178.98,"",1058.91
,"Invoice","30-04-2024","MC05652",,"OFFSHORE GLOBAL LOGISTICS LIMITED","Zelia Scourer Lemon 500g","Cost of Goods Sold","Zelia Scouring Powder",,"Accounts Receivable",89.49,"",1148.40
,"Sales Receipt","05-05-2024","2308",,"Cash Sales","Zelia Scourer Lemon 500g","Cost of Goods Sold","Zelia Scouring Powder",,"Undeposited Funds",14.91,"",1163.31
,"Sales Receipt","09-05-2024","2336",,"Donation","Zelia Scourer Lemon 500g","Cost of Goods Sold","Zelia Scouring Powder",,"Undeposited Funds",1073.85,"",2237.16
,"Sales Receipt","09-05-2024","2342",,"Cash Sales","Zelia Scourer Lemon 500g","Cost of Goods Sold","Zelia Scouring Powder",,"Undeposited Funds",357.95,"",2595.11
,"Sales Receipt","15-05-2024","1927",,"Cash Sales","Zelia Scourer Lemon 500g","Cost of Goods Sold","Zelia Scouring Powder",,"Undeposited Funds",14.91,"",2610.02
,"Invoice","30-05-2024","MC05776",,"OFFSHORE GLOBAL LOGISTICS LIMITED","Zelia Scourer Lemon 500g","Cost of Goods Sold","Zelia Scouring Powder",,"Accounts Receivable",119.32,"",2729.34
,"Sales Receipt","03-06-2024","2406",,"Downtown Wholesalers","Zelia Scourer Lemon 500g","Cost of Goods Sold","Zelia Scouring Powder",,"Undeposited Funds",357.95,"",3087.29
,"Sales Receipt","03-06-2024","2407",,"Sharma Shop","Zelia Scourer Lemon 500g","Cost of Goods Sold","Zelia Scouring Powder",,"Undeposited Funds",357.95,"",3445.24
,"Sales Receipt","03-06-2024","2408",,"Fatah Wholesaler","Zelia Scourer Lemon 500g","Cost of Goods Sold","Zelia Scouring Powder",,"Undeposited Funds",3579.51,"",7024.75
,"Sales Receipt","03-06-2024","2409",,"Faaz Minimart","Zelia Scourer Lemon 500g","Cost of Goods Sold","Zelia Scouring Powder",,"Undeposited Funds",357.95,"",7382.70
,"Sales Receipt","03-06-2024","2410",,"Hidika Shop","Zelia Scourer Lemon 500g","Cost of Goods Sold","Zelia Scouring Powder",,"Undeposited Funds",178.98,"",7561.68
,"Sales Receipt","03-06-2024","2411",,"Gure Yare Shop","Zelia Scourer Lemon 500g","Cost of Goods Sold","Zelia Scouring Powder",,"Undeposited Funds",1789.75,"",9351.43
,"Sales Receipt","03-06-2024","2412",,"Adurus Wholesallers","Zelia Scourer Lemon 500g","Cost of Goods Sold","Zelia Scouring Powder",,"Undeposited Funds",357.95,"",9709.38
,"Build Assembly","04-06-2024","10527",,,"24232","Cost of Goods Sold","Zelia Scouring Powder","X","-SPLIT-",1216.98,"",10926.36
,"Sales Receipt","04-06-2024","2413",,"Horn of Africa","Zelia Scourer Lemon 500g","Cost of Goods Sold","Zelia Scouring Powder",,"Undeposited Funds",215.49,"",11141.85
,"Sales Receipt","04-06-2024","2717",,"Jamilas Store","Zelia Scourer Lemon 500g","Cost of Goods Sold","Zelia Scouring Powder",,"Undeposited Funds",430.97,"",11572.82
,"Sales Receipt","04-06-2024","2414",,"Tawakal Wholesale","Zelia Scourer Lemon 500g","Cost of Goods Sold","Zelia Scouring Powder",,"Undeposited Funds",861.94,"",12434.76
,"Sales Receipt","04-06-2024","2415",,"Towba general stores","Zelia Scourer Lemon 500g","Cost of Goods Sold","Zelia Scouring Powder",,"Undeposited Funds",430.97,"",12865.73
,"Sales Receipt","05-06-2024","2417",,"D-Madina Enterprise","Zelia Scourer Lemon 500g","Cost of Goods Sold","Zelia Scouring Powder",,"Undeposited Funds",861.94,"",13727.67
,"Sales Receipt","05-06-2024","2419",,"Publix Supermarket","Zelia Scourer Lemon 500g","Cost of Goods Sold","Zelia Scouring Powder",,"Undeposited Funds",215.49,"",13943.16
,"Sales Receipt","05-06-2024","2420",,"Labook Enterprise","Zelia Scourer Lemon 500g","Cost of Goods Sold","Zelia Scouring Powder",,"Undeposited Funds",430.97,"",14374.13
,"Sales Receipt","06-06-2024","2429",,"Cash Sales","Zelia Scourer Lemon 500g","Cost of Goods Sold","Zelia Scouring Powder",,"Undeposited Funds",17.96,"",14392.09
,"Sales Receipt","06-06-2024","2425",,"Soimo Minimart","Zelia Scourer Lemon 500g","Cost of Goods Sold","Zelia Scouring Powder",,"Undeposited Funds",107.74,"",14499.83
,"Sales Receipt","06-06-2024","2718",,"Mama G Wholesale","Zelia Scourer Lemon 500g","Cost of Goods Sold","Zelia Scouring Powder",,"Undeposited Funds",430.97,"",14930.80
,"Sales Receipt","07-06-2024","1996",,"Cash Sales","Zelia Scourer Lemon 500g","Cost of Goods Sold","Zelia Scouring Powder",,"Undeposited Funds",107.74,"",15038.54
,"Sales Receipt","07-06-2024","2427",,"Garumo Wholesale","Zelia Scourer Lemon 500g","Cost of Goods Sold","Zelia Scouring Powder",,"Undeposited Funds",430.97,"",15469.51
,"Sales Receipt","10-06-2024","2433",,"Cash Sales","Zelia Scourer Lemon 500g","Cost of Goods Sold","Zelia Scouring Powder",,"Undeposited Funds",17.96,"",15487.47
,"Sales Receipt","10-06-2024","2436",,"Arqam minimart","Zelia Scourer Lemon 500g","Cost of Goods Sold","Zelia Scouring Powder",,"Undeposited Funds",430.97,"",15918.44
,"Sales Receipt","10-06-2024","2437",,"Al Mubarak Wholesalers","Zelia Scourer Lemon 500g","Cost of Goods Sold","Zelia Scouring Powder",,"Undeposited Funds",430.97,"",16349.41
,"Sales Receipt","10-06-2024","2438",,"Tayokom Wholesalers","Zelia Scourer Lemon 500g","Cost of Goods Sold","Zelia Scouring Powder",,"Undeposited Funds",2154.86,"",18504.27
,"Invoice","11-06-2024","MC05815",,"MADINA SUPERMARKET LIMITED","Zelia Scourer Lemon 500g","Cost of Goods Sold","Zelia Scouring Powder",,"Accounts Receivable",107.74,"",18612.01
,"Sales Receipt","11-06-2024","2439",,"Cash Sales","Zelia Scourer Lemon 500g","Cost of Goods Sold","Zelia Scouring Powder",,"Undeposited Funds",17.96,"",18629.97
,"Sales Receipt","11-06-2024","2448",,"Farmwell Enterprises","Zelia Scourer Lemon 500g","Cost of Goods Sold","Zelia Scouring Powder",,"Undeposited Funds",107.74,"",18737.71
,"Invoice","12-06-2024","MC05818",,"KIRINYAGA FLOUR MILLS LIMITED","Zelia Scourer Lemon 500g","Cost of Goods Sold","Zelia Scouring Powder",,"Accounts Receivable",71.83,"",18809.54
,"Sales Receipt","12-06-2024","2449",,"Cash Sales","Zelia Scourer Lemon 500g","Cost of Goods Sold","Zelia Scouring Powder",,"Undeposited Funds",17.96,"",18827.50
,"Sales Receipt","12-06-2024","2453",,"Cash Sales","Zelia Scourer Lemon 500g","Cost of Goods Sold","Zelia Scouring Powder",,"Undeposited Funds",377.10,"",19204.60
,"Sales Receipt","12-06-2024","2461",,"Cash Sales","Zelia Scourer Lemon 500g","Cost of Goods Sold","Zelia Scouring Powder",,"Undeposited Funds",17.96,"",19222.56
,"Sales Receipt","12-06-2024","2459",,"Baasmart Store","Zelia Scourer Lemon 500g","Cost of Goods Sold","Zelia Scouring Powder",,"Undeposited Funds",861.94,"",20084.50
,"Sales Receipt","12-06-2024","2457",,"Elwak Stores","Zelia Scourer Lemon 500g","Cost of Goods Sold","Zelia Scouring Powder",,"Undeposited Funds",430.97,"",20515.47
,"Sales Receipt","12-06-2024","2456",,"Tawakal","Zelia Scourer Lemon 500g","Cost of Goods Sold","Zelia Scouring Powder",,"Undeposited Funds",430.97,"",20946.44
,"Sales Receipt","12-06-2024","2455",,"Antic Wholesallers","Zelia Scourer Lemon 500g","Cost of Goods Sold","Zelia Scouring Powder",,"Undeposited Funds",2154.86,"",23101.30
,"Sales Receipt","12-06-2024","2465",,"Gacal Wholesale","Zelia Scourer Lemon 500g","Cost of Goods Sold","Zelia Scouring Powder",,"Undeposited Funds",430.97,"",23532.27
,"Sales Receipt","12-06-2024","2463",,"Raja Foodstuffs","Zelia Scourer Lemon 500g","Cost of Goods Sold","Zelia Scouring Powder",,"Undeposited Funds",430.97,"",23963.24
,"Sales Receipt","12-06-2024","2747",,"Smart Choice","Zelia Scourer Lemon 500g","Cost of Goods Sold","Zelia Scouring Powder",,"Undeposited Funds",215.49,"",24178.73
,"Sales Receipt","13-06-2024","2474",,"Fahma Qali","Zelia Scourer Lemon 500g","Cost of Goods Sold","Zelia Scouring Powder",,"Undeposited Funds",215.49,"",24394.22
,"Sales Receipt","14-06-2024","2709",,"mwaspart","Zelia Scourer Lemon 500g","Cost of Goods Sold","Zelia Scouring Powder",,"Undeposited Funds",107.74,"",24501.96
,"Sales Receipt","18-06-2024","2703",,"Cash Sales","Zelia Scourer Lemon 500g","Cost of Goods Sold","Zelia Scouring Powder",,"Undeposited Funds",107.74,"",24609.70
,"Sales Receipt","18-06-2024","2711",,"Cash Sales","Zelia Scourer Lemon 500g","Cost of Goods Sold","Zelia Scouring Powder",,"Undeposited Funds",35.91,"",24645.61
,"Sales Receipt","18-06-2024","2707",,"Beta Traders","Zelia Scourer Lemon 500g","Cost of Goods Sold","Zelia Scouring Powder",,"Undeposited Funds",215.49,"",24861.10
,"Sales Receipt","19-06-2024","2483",,"Cash Sales","Zelia Scourer Lemon 500g","Cost of Goods Sold","Zelia Scouring Powder",,"Undeposited Funds",17.96,"",24879.06
,"Sales Receipt","19-06-2024","2490",,"Bismillahi Shop","Zelia Scourer Lemon 500g","Cost of Goods Sold","Zelia Scouring Powder",,"Undeposited Funds",430.97,"",25310.03
,"Sales Receipt","20-06-2024","2494",,"Restoration Traders","Zelia Scourer Lemon 500g","Cost of Goods Sold","Zelia Scouring Powder",,"Undeposited Funds",1292.92,"",26602.95
,"Sales Receipt","20-06-2024","2498",,"Mamken Minimart","Zelia Scourer Lemon 500g","Cost of Goods Sold","Zelia Scouring Powder",,"Undeposited Funds",107.74,"",26710.69
,"Sales Receipt","21-06-2024","2721",,"Home Soko Minimart","Zelia Scourer Lemon 500g","Cost of Goods Sold","Zelia Scouring Powder",,"Undeposited Funds",104.66,"",26815.35
,"Sales Receipt","21-06-2024","2722",,"Kika Mart","Zelia Scourer Lemon 500g","Cost of Goods Sold","Zelia Scouring Powder",,"Undeposited Funds",104.66,"",26920.01
,"Sales Receipt","21-06-2024","2725",,"Marris Mini mart","Zelia Scourer Lemon 500g","Cost of Goods Sold","Zelia Scouring Powder",,"Undeposited Funds",104.66,"",27024.67
,"Invoice","24-06-2024","MC05851",,"SUMM SUPERMARKET LIMITED","Zelia Scourer Lemon 500g","Cost of Goods Sold","Zelia Scouring Powder",,"Accounts Receivable",104.66,"",27129.33
,"Sales Receipt","24-06-2024","2719",,"Cash Sales","Zelia Scourer Lemon 500g","Cost of Goods Sold","Zelia Scouring Powder",,"Undeposited Funds",17.44,"",27146.77
,"Sales Receipt","24-06-2024","2730",,"Neema Bei Nafuu","Zelia Scourer Lemon 500g","Cost of Goods Sold","Zelia Scouring Powder",,"Undeposited Funds",209.29,"",27356.06
,"Sales Receipt","24-06-2024","2729",,"Natala Shop","Zelia Scourer Lemon 500g","Cost of Goods Sold","Zelia Scouring Powder",,"Undeposited Funds",209.29,"",27565.35
,"Sales Receipt","24-06-2024","2728",,"Gidesh Supermarket","Zelia Scourer Lemon 500g","Cost of Goods Sold","Zelia Scouring Powder",,"Undeposited Funds",418.58,"",27983.93
,"Sales Receipt","24-06-2024","2750",,"Mabini store","Zelia Scourer Lemon 500g","Cost of Goods Sold","Zelia Scouring Powder",,"Undeposited Funds",104.64,"",28088.57
,"Sales Receipt","25-06-2024","2730",,"Bei Nafuu Shop","Zelia Scourer Lemon 500g","Cost of Goods Sold","Zelia Scouring Powder",,"Undeposited Funds",104.64,"",28193.21
,"Invoice","26-06-2024","MC05866",,"DISII TRADERS LTD","Zelia Scourer Lemon 500g","Cost of Goods Sold","Zelia Scouring Powder",,"Accounts Receivable",104.64,"",28297.85
,"Sales Receipt","26-06-2024","2732",,"Instanbul Shop","Zelia Scourer Lemon 500g","Cost of Goods Sold","Zelia Scouring Powder",,"Undeposited Funds",104.64,"",28402.49
,"Sales Receipt","28-06-2024","2737",,"Cash Sales","Zelia Scourer Lemon 500g","Cost of Goods Sold","Zelia Scouring Powder",,"Undeposited Funds",17.44,"",28419.93
,"Sales Receipt","28-06-2024","2743",,"Cash Sales","Zelia Scourer Lemon 500g","Cost of Goods Sold","Zelia Scouring Powder",,"Undeposited Funds",69.76,"",28489.69
,"Sales Receipt","28-06-2024","2744",,"Cash Sales","Zelia Scourer Lemon 500g","Cost of Goods Sold","Zelia Scouring Powder",,"Undeposited Funds",87.20,"",28576.89
,"Sales Receipt","29-06-2024","593",,"Danaba Wholesallers","Zelia Scourer Lemon 500g","Cost of Goods Sold","Zelia Scouring Powder",,"Undeposited Funds",418.58,"",28995.47
,"Sales Receipt","02-07-2024","2762",,"Maida Minimart","Zelia Scourer Lemon 500g","Cost of Goods Sold","Zelia Scouring Powder",,"Undeposited Funds",104.64,"",29100.11
,"Invoice","03-07-2024","MC05880",,"SECUTOR LIMITED","Zelia Scourer Lemon 500g","Cost of Goods Sold","Zelia Scouring Powder",,"Accounts Receivable",17.44,"",29117.55
,"Sales Receipt","03-07-2024","2761",,"Cash Sales","Zelia Scourer Lemon 500g","Cost of Goods Sold","Zelia Scouring Powder",,"Undeposited Funds",104.64,"",29222.19
,"Sales Receipt","03-07-2024","2773",,"Muleshe Wholesallers","Zelia Scourer Lemon 500g","Cost of Goods Sold","Zelia Scouring Powder",,"Undeposited Funds",418.58,"",29640.77
,"Sales Receipt","03-07-2024","2774",,"Warfa Wholesale","Zelia Scourer Lemon 500g","Cost of Goods Sold","Zelia Scouring Powder",,"Undeposited Funds",837.15,"",30477.92
,"Sales Receipt","03-07-2024","2768",,"Madini mart","Zelia Scourer Lemon 500g","Cost of Goods Sold","Zelia Scouring Powder",,"Undeposited Funds",104.64,"",30582.56
,"Sales Receipt","05-07-2024","2799",,"Milimani Store","Zelia Scourer Lemon 500g","Cost of Goods Sold","Zelia Scouring Powder",,"Undeposited Funds",104.64,"",30687.20
,"Sales Receipt","06-07-2024","2516",,"Baraka Cerials","Zelia Scourer Lemon 500g","Cost of Goods Sold","Zelia Scouring Powder",,"Undeposited Funds",104.64,"",30791.84
,"Sales Receipt","08-07-2024","2518",,"Freshtake wholesalers","Zelia Scourer Lemon 500g","Cost of Goods Sold","Zelia Scouring Powder",,"Undeposited Funds",418.58,"",31210.42
,"Sales Receipt","09-07-2024","2509",,"Cash Sales","Zelia Scourer Lemon 500g","Cost of Goods Sold","Zelia Scouring Powder",,"Undeposited Funds",17.44,"",31227.86
,"Sales Receipt","09-07-2024","2526",,"Cash Sales","Zelia Scourer Lemon 500g","Cost of Goods Sold","Zelia Scouring Powder",,"Undeposited Funds",17.44,"",31245.30
,"Sales Receipt","09-07-2024","2569",,"Al Hamdu shop","Zelia Scourer Lemon 500g","Cost of Goods Sold","Zelia Scouring Powder",,"Undeposited Funds",418.58,"",31663.88
,"Sales Receipt","09-07-2024","2522",,"Beraccah Syokimau","Zelia Scourer Lemon 500g","Cost of Goods Sold","Zelia Scouring Powder",,"Undeposited Funds",418.58,"",32082.46
,"Sales Receipt","10-07-2024","2532",,"Norhani Groceries","Zelia Scourer Lemon 500g","Cost of Goods Sold","Zelia Scouring Powder",,"Undeposited Funds",209.29,"",32291.75
,"Invoice","15-07-2024","MC05921",,"OFFSHORE GLOBAL LOGISTICS LIMITED","Zelia Scourer Lemon 500g","Cost of Goods Sold","Zelia Scouring Powder",,"Accounts Receivable",209.29,"",32501.04
,"Invoice","15-07-2024","MC05932",,"ROYMATT SUPERMARKET LIMITED","Zelia Scourer Lemon 500g","Cost of Goods Sold","Zelia Scouring Powder",,"Accounts Receivable",104.64,"",32605.68
,"Sales Receipt","15-07-2024","2543",,"Cash Sales","Zelia Scourer Lemon 500g","Cost of Goods Sold","Zelia Scouring Powder",,"Undeposited Funds",34.88,"",32640.56
,"Sales Receipt","15-07-2024","2546",,"Brinso Foodstufs","Zelia Scourer Lemon 500g","Cost of Goods Sold","Zelia Scouring Powder",,"Undeposited Funds",418.58,"",33059.14
,"Sales Receipt","16-07-2024","2557",,"Somo 1 Mowlem","Zelia Scourer Lemon 500g","Cost of Goods Sold","Zelia Scouring Powder",,"Undeposited Funds",104.64,"",33163.78
,"Sales Receipt","16-07-2024","2558",,"Somo Supermarket","Zelia Scourer Lemon 500g","Cost of Goods Sold","Zelia Scouring Powder",,"Undeposited Funds",104.64,"",33268.42
,"Invoice","17-07-2024","MC05938",,"DISII TRADERS LTD","Zelia Scourer Lemon 500g","Cost of Goods Sold","Zelia Scouring Powder",,"Accounts Receivable",209.29,"",33477.71
,"Sales Receipt","17-07-2024","2551",,"Cash Sales","Zelia Scourer Lemon 500g","Cost of Goods Sold","Zelia Scouring Powder",,"Undeposited Funds",104.64,"",33582.35
,"Sales Receipt","18-07-2024","2576",,"Mizpa Minimart","Zelia Scourer Lemon 500g","Cost of Goods Sold","Zelia Scouring Powder",,"Undeposited Funds",104.64,"",33686.99
,"Sales Receipt","22-07-2024","2570",,"Cash Sales","Zelia Scourer Lemon 500g","Cost of Goods Sold","Zelia Scouring Powder",,"Undeposited Funds",17.44,"",33704.43
,"Sales Receipt","23-07-2024","2591",,"Cash Sales","Zelia Scourer Lemon 500g","Cost of Goods Sold","Zelia Scouring Powder",,"Undeposited Funds",87.20,"",33791.63
,"Sales Receipt","23-07-2024","2581",,"Cash Sales","Zelia Scourer Lemon 500g","Cost of Goods Sold","Zelia Scouring Powder",,"Undeposited Funds",69.76,"",33861.39
,"Sales Receipt","23-07-2024","2584",,"Elwak Stores","Zelia Scourer Lemon 500g","Cost of Goods Sold","Zelia Scouring Powder",,"Undeposited Funds",418.58,"",34279.97
,"Sales Receipt","24-07-2024","2588",,"Cash Sales","Zelia Scourer Lemon 500g","Cost of Goods Sold","Zelia Scouring Powder",,"Undeposited Funds",69.76,"",34349.73
,"Sales Receipt","24-07-2024","2593",,"Cash Sales","Zelia Scourer Lemon 500g","Cost of Goods Sold","Zelia Scouring Powder",,"Undeposited Funds",697.63,"",35047.36
,"Sales Receipt","24-07-2024","2608",,"Capital Halal","Zelia Scourer Lemon 500g","Cost of Goods Sold","Zelia Scouring Powder",,"Undeposited Funds",104.64,"",35152.00
,"Sales Receipt","25-07-2024","2609",,"Zebra Minimart","Zelia Scourer Lemon 500g","Cost of Goods Sold","Zelia Scouring Powder",,"Undeposited Funds",139.53,"",35291.53
,"Invoice","26-07-2024","MC05976",,"SUMM SUPERMARKET LIMITED","Zelia Scourer Lemon 500g","Cost of Goods Sold","Zelia Scouring Powder",,"Accounts Receivable",104.64,"",35396.17
,"Invoice","29-07-2024","MC05983",,"Muhaya & Rukundo Holdings Ltd","0001.12.00 Zelia Scourer Lemon 24x500g","Cost of Goods Sold","Zelia Scouring Powder",,"Accounts Receivable",151983.00,"",187379.17
,"Sales Receipt","29-07-2024","2602",,"Cash Sales","Zelia Scourer Lemon 500g","Cost of Goods Sold","Zelia Scouring Powder",,"Undeposited Funds",34.02,"",187413.19
,"Build Assembly","29-07-2024","11035",,,,"Cost of Goods Sold","Zelia Scouring Powder","X","-SPLIT-","",35688.64,151724.55
,"Sales Receipt","29-07-2024","2922",,"Muhaya & Rukundo Holdings Ltd","Zelia Scourer Lemon 24x500g","Cost of Goods Sold","Zelia Scouring Powder",,"Undeposited Funds",151983.00,"",303707.55
,"Sales Receipt","30-07-2024","2619",,"Cash Sales","Zelia Scourer Lemon 500g","Cost of Goods Sold","Zelia Scouring Powder",,"Undeposited Funds",17.01,"",303724.56
,"Sales Receipt","30-07-2024","2620",,"Cash Sales","Zelia Scourer Lemon 500g","Cost of Goods Sold","Zelia Scouring Powder",,"Undeposited Funds",34.02,"",303758.58
,"Sales Receipt","30-07-2024","2623",,"Smart Choice","Zelia Scourer Lemon 500g","Cost of Goods Sold","Zelia Scouring Powder",,"Undeposited Funds",204.14,"",303962.72
,"Sales Receipt","31-07-2024","AT200",,"Cash Sales","Zelia Scourer Lemon 500g","Cost of Goods Sold","Zelia Scouring Powder",,"Undeposited Funds",408.28,"",304371.00
,"Sales Receipt","31-07-2024","2631",,"Cash Sales","Zelia Scourer Lemon 500g","Cost of Goods Sold","Zelia Scouring Powder",,"Undeposited Funds",408.28,"",304779.28
,"Sales Receipt","31-07-2024","2633",,"Sharazad Wholesalers","Zelia Scourer Lemon 500g","Cost of Goods Sold","Zelia Scouring Powder",,"Undeposited Funds",408.28,"",305187.56
,"Sales Receipt","01-08-2024","2641",,"Taqwa Shop","Zelia Scourer Lemon 500g","Cost of Goods Sold","Zelia Scouring Powder",,"Undeposited Funds",204.14,"",305391.70
,"Sales Receipt","01-08-2024","2637",,"Burhani Shop","Zelia Scourer Lemon 500g","Cost of Goods Sold","Zelia Scouring Powder",,"Undeposited Funds",204.14,"",305595.84
,"Sales Receipt","01-08-2024","2691",,"Ubwere Store","Zelia Scourer Lemon 500g","Cost of Goods Sold","Zelia Scouring Powder",,"Undeposited Funds",204.14,"",305799.98
,"Sales Receipt","01-08-2024","2664",,"Mkulima Supermarket","Zelia Scourer Lemon 500g","Cost of Goods Sold","Zelia Scouring Powder",,"Undeposited Funds",204.14,"",306004.12
,"Sales Receipt","01-08-2024","2918",,"Burhani Shop","Zelia Scourer Lemon 500g","Cost of Goods Sold","Zelia Scouring Powder",,"Undeposited Funds",2041.39,"",308045.51
,"Sales Receipt","02-08-2024","2644",,"Cash Sales","Zelia Scourer Lemon 500g","Cost of Goods Sold","Zelia Scouring Powder",,"Undeposited Funds",17.01,"",308062.52
,"Sales Receipt","02-08-2024","2645",,"Cash Sales","Zelia Scourer Lemon 500g","Cost of Goods Sold","Zelia Scouring Powder",,"Undeposited Funds",17.01,"",308079.53
,"Sales Receipt","02-08-2024","2649",,"Cash Sales","Zelia Scourer Lemon 500g","Cost of Goods Sold","Zelia Scouring Powder",,"Undeposited Funds",68.05,"",308147.58
,"Sales Receipt","02-08-2024","2650",,"Cash Sales","Zelia Scourer Lemon 500g","Cost of Goods Sold","Zelia Scouring Powder",,"Undeposited Funds",34.02,"",308181.60
,"Sales Receipt","03-08-2024","2670",,"Gacal Wholesale","Zelia Scourer Lemon 500g","Cost of Goods Sold","Zelia Scouring Powder",,"Undeposited Funds",408.28,"",308589.88
,"Sales Receipt","05-08-2024","2658",,"Cash Sales","Zelia Scourer Lemon 500g","Cost of Goods Sold","Zelia Scouring Powder",,"Undeposited Funds",34.02,"",308623.90
,"Sales Receipt","05-08-2024","2661",,"Kibibi Wasai Store","Zelia Scourer Lemon 500g","Cost of Goods Sold","Zelia Scouring Powder",,"Undeposited Funds",408.28,"",309032.18
,"Sales Receipt","05-08-2024","2671",,"Hidika Shop","Zelia Scourer Lemon 500g","Cost of Goods Sold","Zelia Scouring Powder",,"Undeposited Funds",204.14,"",309236.32
,"Sales Receipt","05-08-2024","2675",,"Adurus Wholesallers","Zelia Scourer Lemon 500g","Cost of Goods Sold","Zelia Scouring Powder",,"Undeposited Funds",408.28,"",309644.60
,"Sales Receipt","06-08-2024","2659",,"Cash Sales","Zelia Scourer Lemon 500g","Cost of Goods Sold","Zelia Scouring Powder",,"Undeposited Funds",68.05,"",309712.65
,"Sales Receipt","06-08-2024","2680",,"Juja Minimart","Zelia Scourer Lemon 500g","Cost of Goods Sold","Zelia Scouring Powder",,"Undeposited Funds",408.28,"",310120.93
,"Sales Receipt","07-08-2024","2809",,"Safa Mart Wholesalers","Zelia Scourer Lemon 500g","Cost of Goods Sold","Zelia Scouring Powder",,"Undeposited Funds",204.14,"",310325.07
,"Invoice","08-08-2024","MC06015",,"Burhani Private Mart Limited","Zelia Scourer Lemon 500g","Cost of Goods Sold","Zelia Scouring Powder",,"Accounts Receivable",204.14,"",310529.21
,"Invoice","08-08-2024","MC06016",,"DISII TRADERS LTD","Zelia Scourer Lemon 500g","Cost of Goods Sold","Zelia Scouring Powder",,"Accounts Receivable",204.14,"",310733.35
,"Invoice","08-08-2024","MC06018",,"OFFSHORE GLOBAL LOGISTICS LIMITED","Zelia Scourer Lemon 500g","Cost of Goods Sold","Zelia Scouring Powder",,"Accounts Receivable",102.07,"",310835.42
,"Sales Receipt","08-08-2024","2694",,"mwaspart","Zelia Scourer Lemon 500g","Cost of Goods Sold","Zelia Scouring Powder",,"Undeposited Funds",102.07,"",310937.49
,"Sales Receipt","12-08-2024","2816",,"Freshtake wholesalers","Zelia Scourer Lemon 500g","Cost of Goods Sold","Zelia Scouring Powder",,"Undeposited Funds",408.28,"",311345.77
,"Sales Receipt","13-08-2024","2820",,"Cash Sales","Zelia Scourer Lemon 500g","Cost of Goods Sold","Zelia Scouring Powder",,"Undeposited Funds",34.02,"",311379.79
,"Sales Receipt","13-08-2024","2819",,"Tawakal Shop","Zelia Scourer Lemon 500g","Cost of Goods Sold","Zelia Scouring Powder",,"Undeposited Funds",408.28,"",311788.07
,"Sales Receipt","14-08-2024","2823",,"Cash Sales","Zelia Scourer Lemon 500g","Cost of Goods Sold","Zelia Scouring Powder",,"Undeposited Funds",51.03,"",311839.10
,"Sales Receipt","14-08-2024","2834",,"Milimani Store","Zelia Scourer Lemon 500g","Cost of Goods Sold","Zelia Scouring Powder",,"Undeposited Funds",204.14,"",312043.24
,"Sales Receipt","14-08-2024","2842",,"Kibibi Wasai Store","Zelia Scourer Lemon 500g","Cost of Goods Sold","Zelia Scouring Powder",,"Undeposited Funds",408.28,"",312451.52
,"Sales Receipt","14-08-2024","2829",,"First Choice","Zelia Scourer Lemon 500g","Cost of Goods Sold","Zelia Scouring Powder",,"Undeposited Funds",408.28,"",312859.80
,"Sales Receipt","15-08-2024","2892",,"Makueni Store","Zelia Scourer Lemon 500g","Cost of Goods Sold","Zelia Scouring Powder",,"Undeposited Funds",17.01,"",312876.81
,"Sales Receipt","16-08-2024","2901",,"Cash Sales","Zelia Scourer Lemon 500g","Cost of Goods Sold","Zelia Scouring Powder",,"Undeposited Funds",17.01,"",312893.82
,"Sales Receipt","16-08-2024","2851",,"Tahila Enterprises","Zelia Scourer Lemon 500g","Cost of Goods Sold","Zelia Scouring Powder",,"Undeposited Funds",102.07,"",312995.89
,"Sales Receipt","19-08-2024","2839",,"Cash Sales","Zelia Scourer Lemon 500g","Cost of Goods Sold","Zelia Scouring Powder",,"Undeposited Funds",34.02,"",313029.91
,"Sales Receipt","19-08-2024","2835",,"Jombs Wholesale","Zelia Scourer Lemon 500g","Cost of Goods Sold","Zelia Scouring Powder",,"Undeposited Funds",51.03,"",313080.94
,"Sales Receipt","20-08-2024","2858",,"Home Soko Minimart","Zelia Scourer Lemon 500g","Cost of Goods Sold","Zelia Scouring Powder",,"Undeposited Funds",102.07,"",313183.01
,"Sales Receipt","20-08-2024","2869",,"Soft Landing","Zelia Scourer Lemon 500g","Cost of Goods Sold","Zelia Scouring Powder",,"Undeposited Funds",34.02,"",313217.03
,"Sales Receipt","20-08-2024","2859",,"Nzuri Supermarket","Zelia Scourer Lemon 500g","Cost of Goods Sold","Zelia Scouring Powder",,"Undeposited Funds",102.07,"",313319.10
,"Credit Note","21-08-2024","CN01064",,"Muhaya & Rukundo Holdings Ltd","0001.12.00 Zelia Scourer Lemon 24x500g","Cost of Goods Sold","Zelia Scouring Powder",,"Accounts Receivable","",151983.00,161336.10
,"Invoice","21-08-2024","MC06062",,"Muhaya & Rukundo Holdings Ltd","0001.12.00 Outer Zelia Scourer Lemon 500g","Cost of Goods Sold","Zelia Scouring Powder",,"Accounts Receivable",3933.71,"",165269.81
,"Sales Receipt","21-08-2024","2863",,"alhamdulilah shop","Zelia Scourer Lemon 500g","Cost of Goods Sold","Zelia Scouring Powder",,"Undeposited Funds",204.14,"",165473.95
,"Invoice","22-08-2024","MC06067",,"Cash Sales","Zelia Scourer Lemon 500g","Cost of Goods Sold","Zelia Scouring Powder",,"Accounts Receivable",34.02,"",165507.97
,"Credit Note","22-08-2024","CN01066",,"Cash Sales","Zelia Scourer Lemon 500g","Cost of Goods Sold","Zelia Scouring Powder",,"Accounts Receivable","",34.02,165473.95
,"Sales Receipt","22-08-2024","2868",,"Cash Sales","Zelia Scourer Lemon 500g","Cost of Goods Sold","Zelia Scouring Powder",,"Undeposited Funds",17.01,"",165490.96
,"Sales Receipt","23-08-2024","2877",,"Cash Sales","Zelia Scourer Lemon 500g","Cost of Goods Sold","Zelia Scouring Powder",,"Undeposited Funds",17.01,"",165507.97
,"Sales Receipt","23-08-2024","2881",,"Cash Sales","Zelia Scourer Lemon 500g","Cost of Goods Sold","Zelia Scouring Powder",,"Undeposited Funds",34.02,"",165541.99
,"Sales Receipt","24-08-2024","2887",,"Brightfood Nasra","Zelia Scourer Lemon 500g","Cost of Goods Sold","Zelia Scouring Powder",,"Undeposited Funds",102.07,"",165644.06
,"Invoice","26-08-2024","MC06082",,"SUMM SUPERMARKET LIMITED","Zelia Scourer Lemon 500g","Cost of Goods Sold","Zelia Scouring Powder",,"Accounts Receivable",102.07,"",165746.13
,"Sales Receipt","26-08-2024","2882",,"Cash Sales","Zelia Scourer Lemon 500g","Cost of Goods Sold","Zelia Scouring Powder",,"Undeposited Funds",34.02,"",165780.15
,"Sales Receipt","26-08-2024","2883",,"Cash Sales","Zelia Scourer Lemon 500g","Cost of Goods Sold","Zelia Scouring Powder",,"Undeposited Funds",34.02,"",165814.17
,"Sales Receipt","26-08-2024","2900",,"Al- Zake Shop","Zelia Scourer Lemon 500g","Cost of Goods Sold","Zelia Scouring Powder",,"Undeposited Funds",102.07,"",165916.24
,"Sales Receipt","02-09-2024","3225",,"Purity Shop","Zelia Scourer Lemon 24x500g Standard","Cost of Goods Sold","Zelia Scouring Powder",,"Undeposited Funds",48.71,"",165964.95
,"Sales Receipt","02-09-2024","2923",,"Blossom Beauty","Zelia Scourer Lemon 24x500g Standard","Cost of Goods Sold","Zelia Scouring Powder",,"Undeposited Funds",146.14,"",166111.09
,"Sales Receipt","02-09-2024","3001",,"Cash Sales","Zelia Scourer Lemon 24x500g Standard","Cost of Goods Sold","Zelia Scouring Powder",,"Undeposited Funds",24.36,"",166135.45
,"Sales Receipt","03-09-2024","2930",,"Horn of Africa","Zelia Scourer Lemon 24x500g Standard","Cost of Goods Sold","Zelia Scouring Powder",,"Undeposited Funds",292.28,"",166427.73
,"Sales Receipt","03-09-2024","2931",,"Jombs wholesalers","Zelia Scourer Lemon 24x500g Standard","Cost of Goods Sold","Zelia Scouring Powder",,"Undeposited Funds",146.14,"",166573.87
,"Sales Receipt","03-09-2024","2922",,"Cash Sales","Zelia Scourer Lemon 24x500g Standard","Cost of Goods Sold","Zelia Scouring Powder",,"Undeposited Funds",48.71,"",166622.58
,"Invoice","04-09-2024","MC06109",,"ROYMATT SUPERMARKET LIMITED","Zelia Scourer Lemon 500g","Cost of Goods Sold","Zelia Scouring Powder",,"Accounts Receivable",102.10,"",166724.68
,"Sales Receipt","04-09-2024","2937",,"Restoration Traders","Zelia Scourer Lemon 24x500g Standard","Cost of Goods Sold","Zelia Scouring Powder",,"Undeposited Funds",1169.10,"",167893.78
,"Sales Receipt","04-09-2024","3013",,"Ogena Matt","Zelia Scourer Lemon 24x500g Standard","Cost of Goods Sold","Zelia Scouring Powder",,"Undeposited Funds",121.78,"",168015.56
,"Sales Receipt","04-09-2024","3014",,"Gifted Hands","Zelia Scourer Lemon 24x500g Standard","Cost of Goods Sold","Zelia Scouring Powder",,"Undeposited Funds",97.43,"",168112.99
,"Sales Receipt","05-09-2024","2948",,"Jam Tower Shop","Zelia Scourer Lemon 24x500g Standard","Cost of Goods Sold","Zelia Scouring Powder",,"Undeposited Funds",292.28,"",168405.27
,"Sales Receipt","05-09-2024","2967",,"Freshtake wholesalers","Zelia Scourer Lemon 24x500g Standard","Cost of Goods Sold","Zelia Scouring Powder",,"Undeposited Funds",584.55,"",168989.82
,"Sales Receipt","05-09-2024","2952",,"Cash Sales","Zelia Scourer Lemon 24x500g Standard","Cost of Goods Sold","Zelia Scouring Powder",,"Undeposited Funds",73.07,"",169062.89
,"Sales Receipt","10-09-2024","3015",,"Cash Sales","Zelia Scourer Lemon 24x500g Standard","Cost of Goods Sold","Zelia Scouring Powder",,"Undeposited Funds",24.36,"",169087.25
,"Sales Receipt","11-09-2024","2994",,"Mutawakal Stores","Zelia Scourer Lemon 24x500g Standard","Cost of Goods Sold","Zelia Scouring Powder",,"Undeposited Funds",292.28,"",169379.53
,"Sales Receipt","11-09-2024","2999",,"Anab Shop","Zelia Scourer Lemon 24x500g Standard","Cost of Goods Sold","Zelia Scouring Powder",,"Undeposited Funds",146.14,"",169525.67
,"Sales Receipt","11-09-2024","3011",,"Warfa Wholesale","Zelia Scourer Lemon 24x500g Standard","Cost of Goods Sold","Zelia Scouring Powder",,"Undeposited Funds",2338.20,"",171863.87
,"Invoice","12-09-2024","MC06147",,"ZAIN SUPERMARKET LIMITED","Zelia Scourer Lemon 24x500g Standard","Cost of Goods Sold","Zelia Scouring Powder",,"Accounts Receivable",146.14,"",172010.01
,"Sales Receipt","12-09-2024","3021",,"Marwa Tower Shop","Zelia Scourer Lemon 24x500g Standard","Cost of Goods Sold","Zelia Scouring Powder",,"Undeposited Funds",584.55,"",172594.56
,"Sales Receipt","12-09-2024","2987",,"Cash Sales","Zelia Scourer Lemon 24x500g Standard","Cost of Goods Sold","Zelia Scouring Powder",,"Undeposited Funds",194.85,"",172789.41
,"Sales Receipt","12-09-2024","3019",,"Cash Sales","Zelia Scourer Lemon 24x500g Standard","Cost of Goods Sold","Zelia Scouring Powder",,"Undeposited Funds",24.36,"",172813.77
,"Sales Receipt","13-09-2024","3029",,"Omari Store","Zelia Scourer Lemon 24x500g Standard","Cost of Goods Sold","Zelia Scouring Powder",,"Undeposited Funds",121.78,"",172935.55
,"Sales Receipt","16-09-2024","3039",,"Cash Sales","Zelia Scourer Lemon 24x500g Standard","Cost of Goods Sold","Zelia Scouring Powder",,"Undeposited Funds",48.71,"",172984.26
,"Sales Receipt","16-09-2024","3047",,"Cash Sales","Zelia Scourer Lemon 24x500g Standard","Cost of Goods Sold","Zelia Scouring Powder",,"Undeposited Funds",48.71,"",173032.97
,"Sales Receipt","17-09-2024","3050",,"Cash Sales","Zelia Scourer Lemon 24x500g Standard","Cost of Goods Sold","Zelia Scouring Powder",,"Undeposited Funds",73.07,"",173106.04
,"Invoice","18-09-2024","MC06163",,"MKULIMA WANGIGE SUPERMARKET","Zelia Scourer Lemon 24x500g Standard","Cost of Goods Sold","Zelia Scouring Powder",,"Accounts Receivable",146.14,"",173252.18
,"Sales Receipt","18-09-2024","3057",,"Jimos Wholesalers","Zelia Scourer Lemon 24x500g Standard","Cost of Goods Sold","Zelia Scouring Powder",,"Undeposited Funds",146.14,"",173398.32
,"Sales Receipt","18-09-2024","3060",,"Faisel Wholesalers","Zelia Scourer Lemon 24x500g Standard","Cost of Goods Sold","Zelia Scouring Powder",,"Undeposited Funds",584.55,"",173982.87
,"Sales Receipt","18-09-2024","3061",,"Cash Sales","Zelia Scourer Lemon 24x500g Standard","Cost of Goods Sold","Zelia Scouring Powder",,"Undeposited Funds",170.50,"",174153.37
,"Invoice","20-09-2024","MC06179",,"OFFSHORE GLOBAL LOGISTICS LIMITED","Zelia Scourer Lemon 24x500g Standard","Cost of Goods Sold","Zelia Scouring Powder",,"Accounts Receivable",97.43,"",174250.80
,"Sales Receipt","20-09-2024","3094",,"Duto Rumo Store","Zelia Scourer Lemon 24x500g Standard","Cost of Goods Sold","Zelia Scouring Powder",,"Undeposited Funds",24.36,"",174275.16
,"Invoice","24-09-2024","MC06194",,"OGENA PRIME DISTRIBUTORS LIMITED","Zelia Scourer Lemon 24x500g Standard","Cost of Goods Sold","Zelia Scouring Powder",,"Accounts Receivable",121.78,"",174396.94
,"Credit Note","24-09-2024","CN01069",,"OGENA PRIME DISTRIBUTORS LIMITED","Zelia Scourer Lemon 24x500g Standard","Cost of Goods Sold","Zelia Scouring Powder",,"Accounts Receivable","",121.78,174275.16
,"Sales Receipt","24-09-2024","3090",,"Elliane Wholesalers","Zelia Scourer Lemon 24x500g Standard","Cost of Goods Sold","Zelia Scouring Powder",,"Undeposited Funds",146.14,"",174421.30
,"Invoice","26-09-2024","MC06205",,"OFFSHORE GLOBAL LOGISTICS LIMITED","Zelia Scourer Lemon 24x500g Standard","Cost of Goods Sold","Zelia Scouring Powder",,"Accounts Receivable",194.85,"",174616.15
,"Credit Note","27-09-2024","CN01070",,"ROYMATT SUPERMARKET LIMITED","Zelia Scourer Lemon 500g","Cost of Goods Sold","Zelia Scouring Powder",,"Accounts Receivable","",102.07,174514.08
,"Invoice","27-09-2024","MC06216",,"QUALITYMART SUPERMARKET LIMITED","Zelia Scourer Lemon 24x500g Standard","Cost of Goods Sold","Zelia Scouring Powder",,"Accounts Receivable",146.14,"",174660.22
,"Sales Receipt","27-09-2024","3215",,"Supaa Mart","Zelia Scourer Lemon 24x500g Standard","Cost of Goods Sold","Zelia Scouring Powder",,"Undeposited Funds",584.55,"",175244.77
,"Sales Receipt","27-09-2024","3213",,"DayBreak Shop","Zelia Scourer Lemon 24x500g Standard","Cost of Goods Sold","Zelia Scouring Powder",,"Undeposited Funds",73.07,"",175317.84
,"Sales Receipt","27-09-2024","3211",,"Cash Sales","Zelia Scourer Lemon 24x500g Standard","Cost of Goods Sold","Zelia Scouring Powder",,"Undeposited Funds",24.36,"",175342.20
,"Sales Receipt","27-09-2024","3216",,"Cash Sales","Zelia Scourer Lemon 24x500g Standard","Cost of Goods Sold","Zelia Scouring Powder",,"Undeposited Funds",48.71,"",175390.91
,"Sales Receipt","28-09-2024","3221",,"Bulsho Wholesalers","Zelia Scourer Lemon 24x500g Standard","Cost of Goods Sold","Zelia Scouring Powder",,"Undeposited Funds",146.14,"",175537.05
,"Sales Receipt","02-10-2024","3244",,"B-Shop","Zelia Scourer Lemon 24x500g Standard","Cost of Goods Sold","Zelia Scouring Powder",,"Undeposited Funds",584.55,"",176121.60
,"Sales Receipt","03-10-2024","3246",,"Fahan Foodstuff","Zelia Scourer Lemon 24x500g Standard","Cost of Goods Sold","Zelia Scouring Powder",,"Undeposited Funds",1169.10,"",177290.70
,"Sales Receipt","03-10-2024","3248",,"Elwak Stores","Zelia Scourer Lemon 24x500g Standard","Cost of Goods Sold","Zelia Scouring Powder",,"Undeposited Funds",584.55,"",177875.25
,"Sales Receipt","06-10-2024","3184",,"Precious Mart","Zelia Scourer Lemon 24x500g Standard","Cost of Goods Sold","Zelia Scouring Powder",,"Undeposited Funds",73.07,"",177948.32
,"Sales Receipt","06-10-2024","3422",,"Mikara Shop","Zelia Scourer Lemon 24x500g Standard","Cost of Goods Sold","Zelia Scouring Powder",,"Undeposited Funds",292.28,"",178240.60
,"Sales Receipt","06-10-2024","3423",,"Jikweri Minimart","-MULTIPLE-","Cost of Goods Sold","Zelia Scouring Powder",,"Undeposited Funds",1369.70,"",179610.30
,"Sales Receipt","09-10-2024","3276",,"Cash Sales","Zelia Scourer Lemon 24x500g Standard","Cost of Goods Sold","Zelia Scouring Powder",,"Undeposited Funds",24.36,"",179634.66
,"Sales Receipt","09-10-2024","3279",,"Cash Sales","Zelia Scourer Lemon 24x500g Standard","Cost of Goods Sold","Zelia Scouring Powder",,"Undeposited Funds",48.71,"",179683.37
,"Sales Receipt","09-10-2024","3287",,"Baba Ali Shop","Zelia Scourer Lemon 24x500g Standard","Cost of Goods Sold","Zelia Scouring Powder",,"Undeposited Funds",292.28,"",179975.65
,"Invoice","11-10-2024","MC06251",,"HOPEMART SELF SERVICES LTD","Zelia Scourer Lemon 24x500g Standard  6 Pieces @66.12","Cost of Goods Sold","Zelia Scouring Powder",,"Accounts Receivable",146.14,"",180121.79
,"Sales Receipt","11-10-2024","3291",,"Cash Sales","Zelia Scourer Lemon 24x500g Standard","Cost of Goods Sold","Zelia Scouring Powder",,"Undeposited Funds",48.71,"",180170.50
,"Sales Receipt","14-10-2024","3105",,"Faaz Mart","Zelia Scourer Lemon 24x500g Standard","Cost of Goods Sold","Zelia Scouring Powder",,"Undeposited Funds",584.55,"",180755.05
,"Sales Receipt","14-10-2024","3104",,"Adurus Wholesallers","Zelia Scourer Lemon 24x500g Standard","Cost of Goods Sold","Zelia Scouring Powder",,"Undeposited Funds",584.55,"",181339.60
,"Sales Receipt","15-10-2024","3187",,"Big Fish Minimart","Zelia Scourer Lemon 24x500g Standard","Cost of Goods Sold","Zelia Scouring Powder",,"Undeposited Funds",73.07,"",181412.67
,"Sales Receipt","16-10-2024","3112",,"Ruksan Shop","Zelia Scourer Lemon 24x500g Standard","Cost of Goods Sold","Zelia Scouring Powder",,"Undeposited Funds",584.55,"",181997.22
,"Sales Receipt","17-10-2024","3120",,"Cash Sales","Zelia Scourer Lemon 24x500g Standard","Cost of Goods Sold","Zelia Scouring Powder",,"Undeposited Funds",1169.10,"",183166.32
,"Sales Receipt","17-10-2024","3115",,"Corner Shop","Zelia Scourer Lemon 24x500g Standard","Cost of Goods Sold","Zelia Scouring Powder",,"Undeposited Funds",584.55,"",183750.87
,"Sales Receipt","17-10-2024","3117",,"Freshtake wholesalers","Zelia Scourer Lemon 24x500g Standard","Cost of Goods Sold","Zelia Scouring Powder",,"Undeposited Funds",584.55,"",184335.42
,"Sales Receipt","19-10-2024","3180",,"Witgad Shop","Zelia Scourer Lemon 24x500g Standard","Cost of Goods Sold","Zelia Scouring Powder",,"Undeposited Funds",146.14,"",184481.56
,"Sales Receipt","22-10-2024","3132",,"Hidika Shop","Zelia Scourer Lemon 24x500g Standard","Cost of Goods Sold","Zelia Scouring Powder",,"Undeposited Funds",292.28,"",184773.84
,"Sales Receipt","23-10-2024","3151",,"Cash Sales","Zelia Scourer Lemon 24x500g Standard","Cost of Goods Sold","Zelia Scouring Powder",,"Undeposited Funds",48.71,"",184822.55
,"Sales Receipt","23-10-2024","3139",,"Cash Sales","Zelia Scourer Lemon 24x500g Standard","Cost of Goods Sold","Zelia Scouring Powder",,"Undeposited Funds",73.07,"",184895.62
,"Sales Receipt","23-10-2024","3142",,"Cash Sales","Zelia Scourer Lemon 24x500g Standard","Cost of Goods Sold","Zelia Scouring Powder",,"Undeposited Funds",24.36,"",184919.98
,"Sales Receipt","24-10-2024","3149",,"Cash Sales","Zelia Scourer Lemon 24x500g Standard","Cost of Goods Sold","Zelia Scouring Powder",,"Undeposited Funds",24.36,"",184944.34
,"Sales Receipt","24-10-2024","3701",,"One Stop Minimart","Zelia Scourer Lemon 12x1Kg","Cost of Goods Sold","Zelia Scouring Powder",,"Undeposited Funds",1083.18,"",186027.52
,"Sales Receipt","25-10-2024","3159",,"Marris Mini mart","Zelia Scourer Lemon 24x500g Standard","Cost of Goods Sold","Zelia Scouring Powder",,"Undeposited Funds",73.07,"",186100.59
,"Sales Receipt","28-10-2024","3702",,"Adurus Wholesallers","Zelia Scourer Lemon 12x1Kg","Cost of Goods Sold","Zelia Scouring Powder",,"Undeposited Funds",1083.18,"",187183.77
,"Sales Receipt","28-10-2024","3703",,"Himilo General Store","-MULTIPLE-","Cost of Goods Sold","Zelia Scouring Powder",,"Undeposited Funds",1667.73,"",188851.50
,"Sales Receipt","29-10-2024","3704",,"Home Soko Minimart","Zelia Scourer Lemon 12x1Kg","Cost of Goods Sold","Zelia Scouring Powder",,"Undeposited Funds",270.80,"",189122.30
,"Sales Receipt","29-10-2024","3705",,"Elliane Wholesalers","Zelia Scourer Lemon 12x1Kg","Cost of Goods Sold","Zelia Scouring Powder",,"Undeposited Funds",270.80,"",189393.10
,"Invoice","30-10-2024","MC06322",,"OFFSHORE GLOBAL LOGISTICS LIMITED","Zelia Scourer Lemon 24x500g Standard","Cost of Goods Sold","Zelia Scouring Powder",,"Accounts Receivable",243.56,"",189636.66
,"Build Assembly","30-10-2024","11809",,,"24443","Cost of Goods Sold","Zelia Scouring Powder","X","-SPLIT-","",949.39,188687.27
,"Sales Receipt","02-11-2024","3707",,"Cheaper Cheap","-MULTIPLE-","Cost of Goods Sold","Zelia Scouring Powder",,"Undeposited Funds",1007.47,"",189694.74
,"Sales Receipt","04-11-2024","3430",,"Mabini Minimart","Zelia Scourer Lemon 24x500g Standard","Cost of Goods Sold","Zelia Scouring Powder",,"Undeposited Funds",292.28,"",189987.02
,"Sales Receipt","04-11-2024","3708",,"Gure Yare Shop","-MULTIPLE-","Cost of Goods Sold","Zelia Scouring Powder",,"Undeposited Funds",1592.02,"",191579.04
,"Sales Receipt","04-11-2024","3709",,"Brinso Foodstufs","Zelia Scourer Lemon 12x1Kg","Cost of Goods Sold","Zelia Scouring Powder",,"Undeposited Funds",845.83,"",192424.87
,"Sales Receipt","05-11-2024","3713",,"Elwak Minimart","Zelia Scourer Lemon 12x1Kg","Cost of Goods Sold","Zelia Scouring Powder",,"Undeposited Funds",845.83,"",193270.70
,"Sales Receipt","05-11-2024","3714",,"Marris Mini mart","Zelia Scourer Lemon 24x500g Standard","Cost of Goods Sold","Zelia Scouring Powder",,"Undeposited Funds",73.07,"",193343.77
,"Invoice","06-11-2024","MC06335",,"Guard Mart Supermarket Limited","Zelia Scourer Lemon 24x500g Standard  1pc @73.08","Cost of Goods Sold","Zelia Scouring Powder",,"Accounts Receivable",24.36,"",193368.13
,"Sales Receipt","06-11-2024","3721",,"Towba foodstuffs","Zelia Scourer Lemon 12x1Kg","Cost of Goods Sold","Zelia Scouring Powder",,"Undeposited Funds",845.83,"",194213.96
,"Sales Receipt","06-11-2024","3719",,"Adam Boss","Zelia Scourer Lemon 24x500g Standard","Cost of Goods Sold","Zelia Scouring Powder",,"Undeposited Funds",584.55,"",194798.51
,"Sales Receipt","07-11-2024","3407",,"Cash Sales","Zelia Scourer Lemon 24x500g Standard","Cost of Goods Sold","Zelia Scouring Powder",,"Undeposited Funds",24.36,"",194822.87
,"Sales Receipt","07-11-2024","3722",,"D-Madina Enterprise","-MULTIPLE-","Cost of Goods Sold","Zelia Scouring Powder",,"Undeposited Funds",2014.93,"",196837.80
,"Sales Receipt","07-11-2024","3457",,"Dylyn Enterprise","Zelia Scourer Lemon 24x500g Standard","Cost of Goods Sold","Zelia Scouring Powder",,"Undeposited Funds",121.78,"",196959.58
,"Sales Receipt","08-11-2024","3409",,"Cash Sales","Zelia Scourer Lemon 12x1Kg","Cost of Goods Sold","Zelia Scouring Powder",,"Undeposited Funds",70.49,"",197030.07
,"Sales Receipt","11-11-2024","3415",,"Cash Sales","Zelia Scourer Lemon 12x1Kg","Cost of Goods Sold","Zelia Scouring Powder",,"Undeposited Funds",70.49,"",197100.56
,"Sales Receipt","11-11-2024","3420",,"Cash Sales","Zelia Scourer Lemon 12x1Kg","Cost of Goods Sold","Zelia Scouring Powder",,"Undeposited Funds",105.73,"",197206.29
,"Sales Receipt","12-11-2024","3431",,"Cash Sales","-MULTIPLE-","Cost of Goods Sold","Zelia Scouring Powder",,"Undeposited Funds",2797.47,"",200003.76
,"Sales Receipt","12-11-2024","3436",,"Horn of Africa","-MULTIPLE-","Cost of Goods Sold","Zelia Scouring Powder",,"Undeposited Funds",715.20,"",200718.96
,"Sales Receipt","12-11-2024","3437",,"Jombs wholesalers","Zelia Scourer Lemon 24x500g Standard","Cost of Goods Sold","Zelia Scouring Powder",,"Undeposited Funds",146.14,"",200865.10
,"Sales Receipt","13-11-2024","3441",,"Publix Supermarket","Zelia Scourer Lemon 12x1Kg","Cost of Goods Sold","Zelia Scouring Powder",,"Undeposited Funds",211.46,"",201076.56
,"Sales Receipt","14-11-2024","3446",,"One Stop Minimart","Zelia Scourer Lemon 12x1Kg","Cost of Goods Sold","Zelia Scouring Powder",,"Undeposited Funds",845.83,"",201922.39
,"Invoice","18-11-2024","MC06372",,"Guard Mart Supermarket Limited","Zelia Scourer Lemon 24x500g Standard  24pc @73.08","Cost of Goods Sold","Zelia Scouring Powder",,"Accounts Receivable",584.55,"",202506.94
,"Credit Note","18-11-2024","CN01073",,"Guard Mart Supermarket Limited","Zelia Scourer Lemon 24x500g Standard  1pc @73.08","Cost of Goods Sold","Zelia Scouring Powder",,"Accounts Receivable","",24.36,202482.58
,"Sales Receipt","18-11-2024","3451",,"Cash Sales","Zelia Scourer Lemon 12x1Kg","Cost of Goods Sold","Zelia Scouring Powder",,"Undeposited Funds",35.24,"",202517.82
,"Sales Receipt","18-11-2024","3468",,"Cash Sales","-MULTIPLE-","Cost of Goods Sold","Zelia Scouring Powder",,"Undeposited Funds",72.01,"",202589.83
,"Sales Receipt","18-11-2024","3466",,"Faisel Wholesale","-MULTIPLE-","Cost of Goods Sold","Zelia Scouring Powder",,"Undeposited Funds",1007.47,"",203597.30
,"Invoice","19-11-2024","MC06374",,"SUMM SUPERMARKET LIMITED","Zelia Scourer Lemon 24x500g Standard  6Pcs@66","Cost of Goods Sold","Zelia Scouring Powder",,"Accounts Receivable",146.14,"",203743.44
,"Invoice","19-11-2024","MC06378",,"ROYMATT SUPERMARKET LIMITED","-MULTIPLE-","Cost of Goods Sold","Zelia Scouring Powder",,"Accounts Receivable",357.60,"",204101.04
,"Sales Receipt","20-11-2024","3481",,"Norhani Groceries","-MULTIPLE-","Cost of Goods Sold","Zelia Scouring Powder",,"Undeposited Funds",715.20,"",204816.24
,"Sales Receipt","20-11-2024","3480",,"Burhani Shop","Zelia Scourer Lemon 24x500g Standard","Cost of Goods Sold","Zelia Scouring Powder",,"Undeposited Funds",2922.75,"",207738.99
,"Sales Receipt","25-11-2024","3763",,"Domie Shop","Zelia Scourer Lemon 24x500g Standard","Cost of Goods Sold","Zelia Scouring Powder",,"Undeposited Funds",194.85,"",207933.84
,"Sales Receipt","27-11-2024","3739",,"Eugombe Enterprises","Zelia Scourer Lemon 24x500g Standard","Cost of Goods Sold","Zelia Scouring Powder",,"Undeposited Funds",584.55,"",208518.39
,"Sales Receipt","27-11-2024","3764",,"Molly Shop","Zelia Scourer Lemon 24x500g Standard","Cost of Goods Sold","Zelia Scouring Powder",,"Undeposited Funds",146.14,"",208664.53
,"Invoice","28-11-2024","MC06426",,"ZAIN SUPERMARKET LIMITED","Zelia Scourer Lemon 12x1Kg  6Pcs @116","Cost of Goods Sold","Zelia Scouring Powder",,"Accounts Receivable",211.46,"",208875.99
,"Sales Receipt","28-11-2024","3750",,"Cash Sales","Zelia Scourer Lemon 24x500g Standard","Cost of Goods Sold","Zelia Scouring Powder",,"Undeposited Funds",73.07,"",208949.06
,"Sales Receipt","29-11-2024","3755",,"Cash Sales","Zelia Scourer Lemon 12x1Kg","Cost of Goods Sold","Zelia Scouring Powder",,"Undeposited Funds",35.24,"",208984.30
,"Sales Receipt","30-11-2024","3760",,"Cash Sales","Zelia Scourer Lemon 12x1Kg","Cost of Goods Sold","Zelia Scouring Powder",,"Undeposited Funds",246.70,"",209231.00
,"Sales Receipt","30-11-2024","AT203",,"Cash Sales","-MULTIPLE-","Cost of Goods Sold","Zelia Scouring Powder",,"Undeposited Funds",1007.47,"",210238.47
,"Sales Receipt","30-11-2024","3766",,"Muga Shop","-MULTIPLE-","Cost of Goods Sold","Zelia Scouring Powder",,"Undeposited Funds",715.20,"",210953.67
,"Sales Receipt","02-12-2024","3767",,"Cash Sales","Zelia Scourer Lemon 24x500g Standard","Cost of Goods Sold","Zelia Scouring Powder",,"Undeposited Funds",24.36,"",210978.03
,"Sales Receipt","02-12-2024","3777",,"Cash Sales","Zelia Scourer Lemon 12x1Kg","Cost of Goods Sold","Zelia Scouring Powder",,"Undeposited Funds",35.24,"",211013.27
,"Sales Receipt","02-12-2024","3780",,"Cash Sales","Zelia Scourer Lemon 12x1Kg","Cost of Goods Sold","Zelia Scouring Powder",,"Undeposited Funds",35.24,"",211048.51
,"Sales Receipt","02-12-2024","3774",,"Downtown Wholesalers","Zelia Scourer Lemon 12x1Kg","Cost of Goods Sold","Zelia Scouring Powder",,"Undeposited Funds",845.83,"",211894.34
,"Sales Receipt","02-12-2024","3775",,"Gacal Wholesale","-MULTIPLE-","Cost of Goods Sold","Zelia Scouring Powder",,"Undeposited Funds",1007.47,"",212901.81
,"Sales Receipt","02-12-2024","3776",,"Elwak Stores","Zelia Scourer Lemon 24x500g Standard","Cost of Goods Sold","Zelia Scouring Powder",,"Undeposited Funds",584.55,"",213486.36
,"Sales Receipt","04-12-2024","3791",,"Gold mart Supermarket","Zelia Scourer Lemon 24x500g Standard","Cost of Goods Sold","Zelia Scouring Powder",,"Undeposited Funds",292.28,"",213778.64
,"Sales Receipt","05-12-2024","3800",,"Saacid Shop","Zelia Scourer Lemon 12x1Kg","Cost of Goods Sold","Zelia Scouring Powder",,"Undeposited Funds",845.83,"",214624.47
,"Invoice","09-12-2024","MC06452",,"DISII TRADERS LTD","Zelia Scourer Lemon 24x500g Standard  12Pcs@66","Cost of Goods Sold","Zelia Scouring Powder",,"Accounts Receivable",292.28,"",214916.75
,"Invoice","09-12-2024","MC06453",,"Maji Asili Limited","Zelia Scourer Lemon 24x500g Standard  12Pcs@66","Cost of Goods Sold","Zelia Scouring Powder",,"Accounts Receivable",292.28,"",215209.03
,"Invoice","09-12-2024","MC06456",,"OFFSHORE GLOBAL LOGISTICS LIMITED","Zelia Scourer Lemon 12x1Kg","Cost of Goods Sold","Zelia Scouring Powder",,"Accounts Receivable",140.97,"",215350.00
,"Sales Receipt","09-12-2024","3316",,"Cash Sales","Zelia Scourer Lemon 12x1Kg","Cost of Goods Sold","Zelia Scouring Powder",,"Undeposited Funds",140.97,"",215490.97
,"Sales Receipt","10-12-2024","3321",,"Cash Sales","Zelia Scourer Lemon 24x500g Standard","Cost of Goods Sold","Zelia Scouring Powder",,"Undeposited Funds",146.14,"",215637.11
,"Sales Receipt","10-12-2024","3329",,"Soimo Mini mart","-MULTIPLE-","Cost of Goods Sold","Zelia Scouring Powder",,"Undeposited Funds",357.60,"",215994.71
,"Sales Receipt","11-12-2024","3339",,"Fahal Wholesalers","Zelia Scourer Lemon 12x1Kg","Cost of Goods Sold","Zelia Scouring Powder",,"Undeposited Funds",422.92,"",216417.63
,"Sales Receipt","13-12-2024","3340",,"Cash Sales","Zelia Scourer Lemon 12x1Kg","Cost of Goods Sold","Zelia Scouring Powder",,"Undeposited Funds",35.24,"",216452.87
,"Sales Receipt","13-12-2024","3341",,"Cash Sales","Zelia Scourer Lemon 24x500g Standard","Cost of Goods Sold","Zelia Scouring Powder",,"Undeposited Funds",48.71,"",216501.58
,"Sales Receipt","14-12-2024","3351",,"Hidika Shop","-MULTIPLE-","Cost of Goods Sold","Zelia Scouring Powder",,"Undeposited Funds",1007.47,"",217509.05
,"Sales Receipt","14-12-2024","3378",,"Egesa Shop","Zelia Scourer Lemon 24x500g Standard","Cost of Goods Sold","Zelia Scouring Powder",,"Undeposited Funds",73.07,"",217582.12
,"Sales Receipt","16-12-2024","3345",,"Cash Sales","Zelia Scourer Lemon 12x1Kg","Cost of Goods Sold","Zelia Scouring Powder",,"Undeposited Funds",35.24,"",217617.36
,"Sales Receipt","16-12-2024","3348",,"Cash Sales","Zelia Scourer Lemon 24x500g Standard","Cost of Goods Sold","Zelia Scouring Powder",,"Undeposited Funds",146.14,"",217763.50
,"Sales Receipt","17-12-2024","3354",,"Cash Sales","Zelia Scourer Lemon 12x1Kg","Cost of Goods Sold","Zelia Scouring Powder",,"Undeposited Funds",70.49,"",217833.99
,"Sales Receipt","17-12-2024","3357",,"Safwan Wholesalers","Zelia Scourer Lemon 12x1Kg","Cost of Goods Sold","Zelia Scouring Powder",,"Undeposited Funds",2114.58,"",219948.57
"Total Zelia Scouring Powder",,,,,,,,,,,408851.83,188903.26,219948.57
"Zelia Dishwashing Paste",,,,,,,,,,,,,""
,"Sales Receipt","03-01-2024","1592",,"Cash Sales","Zelia Dishwashing Paste 400g","Cost of Goods Sold","Zelia Dishwashing Paste",,"Undeposited Funds",87.39,"",87.39
,"Sales Receipt","03-01-2024","1594",,"ROYAL SEALS SUPERMARKET","Zelia Dishwashing Paste 400g","Cost of Goods Sold","Zelia Dishwashing Paste",,"Undeposited Funds",524.36,"",611.75
,"Sales Receipt","03-01-2024","1595",,"Restoration Traders","Zelia Dishwashing Paste 400g","Cost of Goods Sold","Zelia Dishwashing Paste",,"Undeposited Funds",1048.72,"",1660.47
,"Sales Receipt","03-01-2024","1596",,"Cash Sales","Zelia Dishwashing Paste 400g","Cost of Goods Sold","Zelia Dishwashing Paste",,"Undeposited Funds",43.70,"",1704.17
,"Sales Receipt","03-01-2024","1599",,"Cash Sales","Zelia Dishwashing Paste 400g","Cost of Goods Sold","Zelia Dishwashing Paste",,"Undeposited Funds",87.39,"",1791.56
,"Sales Receipt","04-01-2024","1704",,"Cash Sales","Zelia Dishwashing Paste 400g","Cost of Goods Sold","Zelia Dishwashing Paste",,"Undeposited Funds",43.70,"",1835.26
,"Sales Receipt","04-01-2024","1706",,"Tawakal Wholesale Eastleigh","Zelia Dishwashing Paste 400g","Cost of Goods Sold","Zelia Dishwashing Paste",,"Undeposited Funds",3146.17,"",4981.43
,"Sales Receipt","04-01-2024","1710",,"Sahal General Stores","Zelia Dishwashing Paste 400g","Cost of Goods Sold","Zelia Dishwashing Paste",,"Undeposited Funds",1048.72,"",6030.15
,"Invoice","05-01-2024","MC05272",,"Mumsha Supamat","Zelia Dishwashing Paste 400g","Cost of Goods Sold","Zelia Dishwashing Paste",,"Accounts Receivable",262.18,"",6292.33
,"Sales Receipt","05-01-2024","1600",,"Cash Sales","Zelia Dishwashing Paste 400g","Cost of Goods Sold","Zelia Dishwashing Paste",,"Undeposited Funds",262.18,"",6554.51
,"Sales Receipt","05-01-2024","1711",,"Summer Outlets","Zelia Dishwashing Paste 400g","Cost of Goods Sold","Zelia Dishwashing Paste",,"Undeposited Funds",524.36,"",7078.87
,"Sales Receipt","08-01-2024","1715",,"Cash Sales","Zelia Dishwashing Paste 400g","Cost of Goods Sold","Zelia Dishwashing Paste",,"Undeposited Funds",349.57,"",7428.44
,"Sales Receipt","09-01-2024","1717",,"Cash Sales","Zelia Dishwashing Paste 400g","Cost of Goods Sold","Zelia Dishwashing Paste",,"Undeposited Funds",349.57,"",7778.01
,"Sales Receipt","09-01-2024","1720",,"Kwiksave supermarket","Zelia Dishwashing Paste 400g","Cost of Goods Sold","Zelia Dishwashing Paste",,"Undeposited Funds",1048.72,"",8826.73
,"Sales Receipt","10-01-2024","1718",,"Memos Supermarket","Zelia Dishwashing Paste 400g","Cost of Goods Sold","Zelia Dishwashing Paste",,"Undeposited Funds",524.36,"",9351.09
,"Sales Receipt","10-01-2024","1722",,"Cash Sales","Zelia Dishwashing Paste 400g","Cost of Goods Sold","Zelia Dishwashing Paste",,"Undeposited Funds",87.39,"",9438.48
,"Sales Receipt","11-01-2024","1723",,"Cash Sales","Zelia Dishwashing Paste 400g","Cost of Goods Sold","Zelia Dishwashing Paste",,"Undeposited Funds",174.79,"",9613.27
,"Sales Receipt","11-01-2024","1724",,"Mashallah Foodstuffs","Zelia Dishwashing Paste 400g","Cost of Goods Sold","Zelia Dishwashing Paste",,"Undeposited Funds",1048.72,"",10661.99
,"Invoice","12-01-2024","MC05298",,"MUHINDI MWEUSI SUPERMARKET LIMITED","Zelia Dishwashing Paste 400g","Cost of Goods Sold","Zelia Dishwashing Paste",,"Accounts Receivable",2097.45,"",12759.44
,"Invoice","12-01-2024","MC05299",,"MUHINDI MWEUSI SUPERMARKET LIMITED","Zelia Dishwashing Paste 400g","Cost of Goods Sold","Zelia Dishwashing Paste",,"Accounts Receivable",1048.72,"",13808.16
,"Invoice","12-01-2024","MC05300",,"MUHINDI MWEUSI SUPERMARKET LIMITED","Zelia Dishwashing Paste 400g","Cost of Goods Sold","Zelia Dishwashing Paste",,"Accounts Receivable",1048.72,"",14856.88
,"Invoice","12-01-2024","MC05301",,"MUHINDI MWEUSI SUPERMARKET LIMITED","Zelia Dishwashing Paste 400g","Cost of Goods Sold","Zelia Dishwashing Paste",,"Accounts Receivable",524.36,"",15381.24
,"Invoice","12-01-2024","MC05302",,"MUHINDI MWEUSI SUPERMARKET LIMITED","Zelia Dishwashing Paste 400g","Cost of Goods Sold","Zelia Dishwashing Paste",,"Accounts Receivable",524.36,"",15905.60
,"Invoice","12-01-2024","MC05306",,"Azaavi Collections Limited","Zelia Dishwashing Paste 400g","Cost of Goods Sold","Zelia Dishwashing Paste",,"Accounts Receivable",87.39,"",15992.99
,"Sales Receipt","12-01-2024","1725",,"Cash Sales","Zelia Dishwashing Paste 400g","Cost of Goods Sold","Zelia Dishwashing Paste",,"Undeposited Funds",1040.75,"",17033.74
,"Sales Receipt","12-01-2024","1733",,"Cash Sales","Zelia Dishwashing Paste 400g","Cost of Goods Sold","Zelia Dishwashing Paste",,"Undeposited Funds",130.09,"",17163.83
,"Invoice","15-01-2024","MC05308",,"MUHINDI MWEUSI SUPERMARKET LIMITED","Zelia Dishwashing Paste 400g","Cost of Goods Sold","Zelia Dishwashing Paste",,"Accounts Receivable",1040.75,"",18204.58
,"Invoice","15-01-2024","MC05309",,"MUHINDI MWEUSI SUPERMARKET LIMITED","Zelia Dishwashing Paste 400g","Cost of Goods Sold","Zelia Dishwashing Paste",,"Accounts Receivable",520.37,"",18724.95
,"Invoice","15-01-2024","MC05310",,"MUHINDI MWEUSI SUPERMARKET LIMITED","Zelia Dishwashing Paste 400g","Cost of Goods Sold","Zelia Dishwashing Paste",,"Accounts Receivable",520.37,"",19245.32
,"Invoice","15-01-2024","MC05311",,"Seasons lane Mart","Zelia Dishwashing Paste 400g","Cost of Goods Sold","Zelia Dishwashing Paste",,"Accounts Receivable",520.37,"",19765.69
,"Invoice","15-01-2024","MC05312",,"KASAMAT INVESTMENTS LTD","Zelia Dishwashing Paste 400g","Cost of Goods Sold","Zelia Dishwashing Paste",,"Accounts Receivable",260.19,"",20025.88
,"Invoice","15-01-2024","MC05315",,"MUHINDI MWEUSI SUPERMARKET LIMITED","Zelia Dishwashing Paste 400g","Cost of Goods Sold","Zelia Dishwashing Paste",,"Accounts Receivable",1040.75,"",21066.63
,"Sales Receipt","15-01-2024","1729",,"Cash Sales","Zelia Dishwashing Paste 400g","Cost of Goods Sold","Zelia Dishwashing Paste",,"Undeposited Funds",86.73,"",21153.36
,"Sales Receipt","15-01-2024","1730",,"tRIPPLE M","Zelia Dishwashing Paste 400g","Cost of Goods Sold","Zelia Dishwashing Paste",,"Undeposited Funds",260.19,"",21413.55
,"Sales Receipt","16-01-2024","1740",,"Cash Sales","Zelia Dishwashing Paste 400g","Cost of Goods Sold","Zelia Dishwashing Paste",,"Undeposited Funds",43.32,"",21456.87
,"Sales Receipt","17-01-2024","1735",,"B Shop","Zelia Dishwashing Paste 400g","Cost of Goods Sold","Zelia Dishwashing Paste",,"Undeposited Funds",1039.65,"",22496.52
,"Sales Receipt","17-01-2024","1737",,"Mumtaz Shop","Zelia Dishwashing Paste 400g","Cost of Goods Sold","Zelia Dishwashing Paste",,"Undeposited Funds",519.82,"",23016.34
,"Sales Receipt","17-01-2024","1748",,"Yasin Shop","Zelia Dishwashing Paste 400g","Cost of Goods Sold","Zelia Dishwashing Paste",,"Undeposited Funds",129.96,"",23146.30
,"Sales Receipt","18-01-2024","1738",,"Cash Sales","Zelia Dishwashing Paste 400g","Cost of Goods Sold","Zelia Dishwashing Paste",,"Undeposited Funds",173.27,"",23319.57
,"Sales Receipt","18-01-2024","1741",,"Newclear Minimart Fedha","Zelia Dishwashing Paste 400g","Cost of Goods Sold","Zelia Dishwashing Paste",,"Undeposited Funds",129.96,"",23449.53
,"Sales Receipt","19-01-2024","1739",,"Cash Sales","Zelia Dishwashing Paste 400g","Cost of Goods Sold","Zelia Dishwashing Paste",,"Undeposited Funds",43.32,"",23492.85
,"Sales Receipt","19-01-2024","1744",,"Cash Sales","Zelia Dishwashing Paste 400g","Cost of Goods Sold","Zelia Dishwashing Paste",,"Undeposited Funds",1039.65,"",24532.50
,"Sales Receipt","19-01-2024","1745",,"Cash Sales","Zelia Dishwashing Paste 400g","Cost of Goods Sold","Zelia Dishwashing Paste",,"Undeposited Funds",259.91,"",24792.41
,"Sales Receipt","21-01-2024","AT186",,"Cash Sales","Zelia Dishwashing Paste 400g","Cost of Goods Sold","Zelia Dishwashing Paste",,"Undeposited Funds",1039.65,"",25832.06
,"Invoice","23-01-2024","MC05343",,"MUHINDI MWEUSI SUPERMARKET LIMITED","Zelia Dishwashing Paste 400g","Cost of Goods Sold","Zelia Dishwashing Paste",,"Accounts Receivable",519.82,"",26351.88
,"Sales Receipt","23-01-2024","1750",,"Mumtaz Shop","Zelia Dishwashing Paste 400g","Cost of Goods Sold","Zelia Dishwashing Paste",,"Undeposited Funds",1039.65,"",27391.53
,"Sales Receipt","23-01-2024","1751",,"Cash Sales","Zelia Dishwashing Paste 400g","Cost of Goods Sold","Zelia Dishwashing Paste",,"Undeposited Funds",173.27,"",27564.80
,"Sales Receipt","23-01-2024","1752",,"Cash Sales","Zelia Dishwashing Paste 400g","Cost of Goods Sold","Zelia Dishwashing Paste",,"Undeposited Funds",86.64,"",27651.44
,"Invoice","24-01-2024","MC05346",,"Qways Supermarket","Zelia Dishwashing Paste 400g","Cost of Goods Sold","Zelia Dishwashing Paste",,"Accounts Receivable",519.82,"",28171.26
,"Invoice","24-01-2024","MC05347",,"MUHINDI MWEUSI SUPERMARKET LIMITED","Zelia Dishwashing Paste 400g","Cost of Goods Sold","Zelia Dishwashing Paste",,"Accounts Receivable",1039.65,"",29210.91
,"Invoice","24-01-2024","MC05348",,"MUHINDI MWEUSI SUPERMARKET LIMITED","Zelia Dishwashing Paste 400g","Cost of Goods Sold","Zelia Dishwashing Paste",,"Accounts Receivable",1039.65,"",30250.56
,"Sales Receipt","24-01-2024","1755",,"Alma Mart","Zelia Dishwashing Paste 400g","Cost of Goods Sold","Zelia Dishwashing Paste",,"Undeposited Funds",519.82,"",30770.38
,"Sales Receipt","24-01-2024","1756",,"Cash Sales","Zelia Dishwashing Paste 400g","Cost of Goods Sold","Zelia Dishwashing Paste",,"Undeposited Funds",129.96,"",30900.34
,"Sales Receipt","24-01-2024","1757",,"Cash Sales","Zelia Dishwashing Paste 400g","Cost of Goods Sold","Zelia Dishwashing Paste",,"Undeposited Funds",43.32,"",30943.66
,"Sales Receipt","29-01-2024","1762",,"Cash Sales","Zelia Dishwashing Paste 400g","Cost of Goods Sold","Zelia Dishwashing Paste",,"Undeposited Funds",259.91,"",31203.57
,"Sales Receipt","29-01-2024","1763",,"Cash Sales","Zelia Dishwashing Paste 400g","Cost of Goods Sold","Zelia Dishwashing Paste",,"Undeposited Funds",43.32,"",31246.89
,"Sales Receipt","29-01-2024","1764",,"Restoration Traders","Zelia Dishwashing Paste 400g","Cost of Goods Sold","Zelia Dishwashing Paste",,"Undeposited Funds",1039.65,"",32286.54
,"Sales Receipt","29-01-2024","1769",,"Cash Sales","Zelia Dishwashing Paste 400g","Cost of Goods Sold","Zelia Dishwashing Paste",,"Undeposited Funds",43.32,"",32329.86
,"Sales Receipt","30-01-2024","1766",,"Cash Sales","Zelia Dishwashing Paste 400g","Cost of Goods Sold","Zelia Dishwashing Paste",,"Undeposited Funds",173.27,"",32503.13
,"Sales Receipt","30-01-2024","1768",,"Cash Sales","Zelia Dishwashing Paste 400g","Cost of Goods Sold","Zelia Dishwashing Paste",,"Undeposited Funds",43.32,"",32546.45
,"Sales Receipt","30-01-2024","1771",,"Arqam Savanna","Zelia Dishwashing Paste 400g","Cost of Goods Sold","Zelia Dishwashing Paste",,"Undeposited Funds",1039.65,"",33586.10
,"Sales Receipt","30-01-2024","1772",,"Amina Shop","Zelia Dishwashing Paste 400g","Cost of Goods Sold","Zelia Dishwashing Paste",,"Undeposited Funds",519.82,"",34105.92
,"Sales Receipt","31-01-2024","1773",,"Cash Sales","Zelia Dishwashing Paste 400g","Cost of Goods Sold","Zelia Dishwashing Paste",,"Undeposited Funds",86.64,"",34192.56
,"Sales Receipt","31-01-2024","1774",,"Cash Sales","Zelia Dishwashing Paste 400g","Cost of Goods Sold","Zelia Dishwashing Paste",,"Undeposited Funds",43.32,"",34235.88
,"Sales Receipt","31-01-2024","1778",,"Cash Sales","Zelia Dishwashing Paste 400g","Cost of Goods Sold","Zelia Dishwashing Paste",,"Undeposited Funds",129.96,"",34365.84
,"Invoice","01-02-2024","MC05373",,"THE M-PESA ACADEMY","Zelia Dishwashing Paste 400g","Cost of Goods Sold","Zelia Dishwashing Paste",,"Accounts Receivable",4158.58,"",38524.42
,"Sales Receipt","01-02-2024","1779",,"Cash Sales","Zelia Dishwashing Paste 400g","Cost of Goods Sold","Zelia Dishwashing Paste",,"Undeposited Funds",1299.56,"",39823.98
,"Sales Receipt","01-02-2024","1780",,"Cash Sales","Zelia Dishwashing Paste 400g","Cost of Goods Sold","Zelia Dishwashing Paste",,"Undeposited Funds",259.91,"",40083.89
,"Sales Receipt","01-02-2024","1789",,"Cash Sales","Zelia Dishwashing Paste 400g","Cost of Goods Sold","Zelia Dishwashing Paste",,"Undeposited Funds",1039.65,"",41123.54
,"Invoice","02-02-2024","MC05378",,"MZOORI STORE LIMITED","Zelia Dishwashing Paste 400g","Cost of Goods Sold","Zelia Dishwashing Paste",,"Accounts Receivable",519.82,"",41643.36
,"Sales Receipt","02-02-2024","1782",,"Cash Sales","Zelia Dishwashing Paste 400g","Cost of Goods Sold","Zelia Dishwashing Paste",,"Undeposited Funds",43.32,"",41686.68
,"Sales Receipt","02-02-2024","1783",,"Cheche Minimart","Zelia Dishwashing Paste 400g","Cost of Goods Sold","Zelia Dishwashing Paste",,"Undeposited Funds",259.91,"",41946.59
,"Sales Receipt","02-02-2024","1784",,"Kandara minimart","Zelia Dishwashing Paste 400g","Cost of Goods Sold","Zelia Dishwashing Paste",,"Undeposited Funds",259.91,"",42206.50
,"Sales Receipt","05-02-2024","1787",,"Cash Sales","Zelia Dishwashing Paste 400g","Cost of Goods Sold","Zelia Dishwashing Paste",,"Undeposited Funds",43.32,"",42249.82
,"Sales Receipt","05-02-2024","1788",,"Cash Sales","Zelia Dishwashing Paste 400g","Cost of Goods Sold","Zelia Dishwashing Paste",,"Undeposited Funds",43.32,"",42293.14
,"Sales Receipt","05-02-2024","1794",,"Cash Sales","Zelia Dishwashing Paste 400g","Cost of Goods Sold","Zelia Dishwashing Paste",,"Undeposited Funds",173.27,"",42466.41
,"Sales Receipt","06-02-2024","1800",,"Mama Amina","Zelia Dishwashing Paste 400g","Cost of Goods Sold","Zelia Dishwashing Paste",,"Undeposited Funds",1039.65,"",43506.06
,"Sales Receipt","06-02-2024","1805",,"Tawakal Wholesale Eastleigh","Zelia Dishwashing Paste 400g","Cost of Goods Sold","Zelia Dishwashing Paste",,"Undeposited Funds",2079.29,"",45585.35
,"Sales Receipt","06-02-2024","1807",,"Perfect Enterprise","Zelia Dishwashing Paste 400g","Cost of Goods Sold","Zelia Dishwashing Paste",,"Undeposited Funds",519.82,"",46105.17
,"Sales Receipt","06-02-2024","1808",,"Cash Sales","Zelia Dishwashing Paste 400g","Cost of Goods Sold","Zelia Dishwashing Paste",,"Undeposited Funds",43.32,"",46148.49
,"Sales Receipt","07-02-2024","1810",,"Cash Sales","Zelia Dishwashing Paste 400g","Cost of Goods Sold","Zelia Dishwashing Paste",,"Undeposited Funds",86.64,"",46235.13
,"Sales Receipt","07-02-2024","1812",,"Cash Sales","Zelia Dishwashing Paste 400g","Cost of Goods Sold","Zelia Dishwashing Paste",,"Undeposited Funds",1039.65,"",47274.78
,"Sales Receipt","08-02-2024","1814",,"Cash Sales","Zelia Dishwashing Paste 400g","Cost of Goods Sold","Zelia Dishwashing Paste",,"Undeposited Funds",43.32,"",47318.10
,"Sales Receipt","08-02-2024","1815",,"Cash Sales","Zelia Dishwashing Paste 400g","Cost of Goods Sold","Zelia Dishwashing Paste",,"Undeposited Funds",43.32,"",47361.42
,"Sales Receipt","09-02-2024","1818",,"Cash Sales","Zelia Dishwashing Paste 400g","Cost of Goods Sold","Zelia Dishwashing Paste",,"Undeposited Funds",86.64,"",47448.06
,"Sales Receipt","10-02-2024","1821",,"Alma Mart","Zelia Dishwashing Paste 400g","Cost of Goods Sold","Zelia Dishwashing Paste",,"Undeposited Funds",259.91,"",47707.97
,"Invoice","12-02-2024","MC05395",,"THE M-PESA ACADEMY","Zelia Dishwashing Paste 400g","Cost of Goods Sold","Zelia Dishwashing Paste",,"Accounts Receivable",4158.58,"",51866.55
,"Credit Note","12-02-2024","CN01056",,"THE M-PESA ACADEMY","Zelia Dishwashing Paste 400g","Cost of Goods Sold","Zelia Dishwashing Paste",,"Accounts Receivable","",4158.58,47707.97
,"Invoice","12-02-2024","MC05400",,"KASAMAT INVESTMENTS LTD","Zelia Dishwashing Paste 400g","Cost of Goods Sold","Zelia Dishwashing Paste",,"Accounts Receivable",259.91,"",47967.88
,"Sales Receipt","13-02-2024","1832",,"Cash Sales","Zelia Dishwashing Paste 400g","Cost of Goods Sold","Zelia Dishwashing Paste",,"Undeposited Funds",86.64,"",48054.52
,"Sales Receipt","13-02-2024","1833",,"Cash Sales","Zelia Dishwashing Paste 400g","Cost of Goods Sold","Zelia Dishwashing Paste",,"Undeposited Funds",43.32,"",48097.84
,"Invoice","14-02-2024","MC05405",,"MUHINDI MWEUSI SUPERMARKET LIMITED","Zelia Dishwashing Paste 400g","Cost of Goods Sold","Zelia Dishwashing Paste",,"Accounts Receivable",519.82,"",48617.66
,"Invoice","14-02-2024","MC05407",,"Qways Supermarket","Zelia Dishwashing Paste 400g","Cost of Goods Sold","Zelia Dishwashing Paste",,"Accounts Receivable",519.82,"",49137.48
,"Sales Receipt","14-02-2024","1836",,"Cheaper Cheap","Zelia Dishwashing Paste 400g","Cost of Goods Sold","Zelia Dishwashing Paste",,"Undeposited Funds",1039.65,"",50177.13
,"Sales Receipt","15-02-2024","1841",,"Al Naim store","Zelia Dishwashing Paste 400g","Cost of Goods Sold","Zelia Dishwashing Paste",,"Undeposited Funds",1039.65,"",51216.78
,"Sales Receipt","15-02-2024","1843",,"DHAGAXFUR WHOLESALE","Zelia Dishwashing Paste 400g","Cost of Goods Sold","Zelia Dishwashing Paste",,"Undeposited Funds",1039.65,"",52256.43
,"Sales Receipt","15-02-2024","1844",,"Salman Shop","Zelia Dishwashing Paste 400g","Cost of Goods Sold","Zelia Dishwashing Paste",,"Undeposited Funds",1039.65,"",53296.08
,"Sales Receipt","16-02-2024","1845",,"Cash Sales","Zelia Dishwashing Paste 400g","Cost of Goods Sold","Zelia Dishwashing Paste",,"Undeposited Funds",86.64,"",53382.72
,"Sales Receipt","16-02-2024","1847",,"Gidesh Supermarket","Zelia Dishwashing Paste 400g","Cost of Goods Sold","Zelia Dishwashing Paste",,"Undeposited Funds",259.91,"",53642.63
,"Sales Receipt","16-02-2024","1852",,"Nuclear Supermarket","Zelia Dishwashing Paste 400g","Cost of Goods Sold","Zelia Dishwashing Paste",,"Undeposited Funds",259.91,"",53902.54
,"Sales Receipt","17-02-2024","1851",,"MumsCereal and General Stores","Zelia Dishwashing Paste 400g","Cost of Goods Sold","Zelia Dishwashing Paste",,"Undeposited Funds",129.96,"",54032.50
,"Sales Receipt","20-02-2024","1857",,"RAZAQ AIRWAYS","Zelia Dishwashing Paste 400g","Cost of Goods Sold","Zelia Dishwashing Paste",,"Undeposited Funds",1039.65,"",55072.15
,"Invoice","21-02-2024","MC05422",,"THE M-PESA ACADEMY","Zelia Dishwashing Paste 400g","Cost of Goods Sold","Zelia Dishwashing Paste",,"Accounts Receivable",2079.29,"",57151.44
,"Sales Receipt","21-02-2024","1855",,"Cash Sales","Zelia Dishwashing Paste 400g","Cost of Goods Sold","Zelia Dishwashing Paste",,"Undeposited Funds",43.32,"",57194.76
,"Sales Receipt","21-02-2024","1859",,"Cash Sales","Zelia Dishwashing Paste 400g","Cost of Goods Sold","Zelia Dishwashing Paste",,"Undeposited Funds",86.64,"",57281.40
,"Sales Receipt","21-02-2024","1860",,"Cash Sales","Zelia Dishwashing Paste 400g","Cost of Goods Sold","Zelia Dishwashing Paste",,"Undeposited Funds",129.96,"",57411.36
,"Invoice","22-02-2024","MC05434",,"NASRI MART LIMITED","Zelia Dishwashing Paste 400g","Cost of Goods Sold","Zelia Dishwashing Paste",,"Accounts Receivable",216.59,"",57627.95
,"Sales Receipt","22-02-2024","1865",,"Cash Sales","Zelia Dishwashing Paste 400g","Cost of Goods Sold","Zelia Dishwashing Paste",,"Undeposited Funds",43.32,"",57671.27
,"Sales Receipt","22-02-2024","1867",,"Corner Shop","Zelia Dishwashing Paste 400g","Cost of Goods Sold","Zelia Dishwashing Paste",,"Undeposited Funds",1039.65,"",58710.92
,"Invoice","23-02-2024","MC05443",,"DAILY CHAMPIONS MINI SUPERMARKET LIMITED","Zelia Dishwashing Paste 400g","Cost of Goods Sold","Zelia Dishwashing Paste",,"Accounts Receivable",519.82,"",59230.74
,"Sales Receipt","23-02-2024","1870",,"Home Cell Minimart","Zelia Dishwashing Paste 400g","Cost of Goods Sold","Zelia Dishwashing Paste",,"Undeposited Funds",259.91,"",59490.65
,"Invoice","26-02-2024","MC05444",,"The Joymai Blessed Stores Limited","Zelia Dishwashing Paste 400g","Cost of Goods Sold","Zelia Dishwashing Paste",,"Accounts Receivable",259.91,"",59750.56
,"Invoice","26-02-2024","MC05445",,"Mumsha Supamat","Zelia Dishwashing Paste 400g","Cost of Goods Sold","Zelia Dishwashing Paste",,"Accounts Receivable",519.82,"",60270.38
,"Sales Receipt","26-02-2024","1872",,"Jombs wholesalers","Zelia Dishwashing Paste 400g","Cost of Goods Sold","Zelia Dishwashing Paste",,"Undeposited Funds",173.27,"",60443.65
,"Sales Receipt","26-02-2024","1873",,"mamkon minimart","Zelia Dishwashing Paste 400g","Cost of Goods Sold","Zelia Dishwashing Paste",,"Undeposited Funds",86.64,"",60530.29
,"Sales Receipt","26-02-2024","1874",,"Cash Sales","Zelia Dishwashing Paste 400g","Cost of Goods Sold","Zelia Dishwashing Paste",,"Undeposited Funds",129.96,"",60660.25
,"Sales Receipt","26-02-2024","1877",,"Cash Sales","Zelia Dishwashing Paste 400g","Cost of Goods Sold","Zelia Dishwashing Paste",,"Undeposited Funds",43.32,"",60703.57
,"Sales Receipt","27-02-2024","1878",,"Cash Sales","Zelia Dishwashing Paste 400g","Cost of Goods Sold","Zelia Dishwashing Paste",,"Undeposited Funds",259.91,"",60963.48
,"Sales Receipt","28-02-2024","1806",,"Beraccah Wholesallers","Zelia Dishwashing Paste 400g","Cost of Goods Sold","Zelia Dishwashing Paste",,"Undeposited Funds",259.91,"",61223.39
,"Sales Receipt","28-02-2024","1884",,"Amir shop","Zelia Dishwashing Paste 400g","Cost of Goods Sold","Zelia Dishwashing Paste",,"Undeposited Funds",519.82,"",61743.21
,"Sales Receipt","28-02-2024","1885",,"Amulqura Shop","Zelia Dishwashing Paste 400g","Cost of Goods Sold","Zelia Dishwashing Paste",,"Undeposited Funds",519.82,"",62263.03
,"Sales Receipt","28-02-2024","1887",,"Adno shop","Zelia Dishwashing Paste 400g","Cost of Goods Sold","Zelia Dishwashing Paste",,"Undeposited Funds",519.82,"",62782.85
,"Sales Receipt","29-02-2024","1889",,"Cash Sales","Zelia Dishwashing Paste 400g","Cost of Goods Sold","Zelia Dishwashing Paste",,"Undeposited Funds",43.32,"",62826.17
,"Sales Receipt","29-02-2024","1890",,"Cash Sales","Zelia Dishwashing Paste 400g","Cost of Goods Sold","Zelia Dishwashing Paste",,"Undeposited Funds",1516.15,"",64342.32
,"Sales Receipt","04-03-2024","1894",,"Cash Sales","Zelia Dishwashing Paste 400g","Cost of Goods Sold","Zelia Dishwashing Paste",,"Undeposited Funds",43.32,"",64385.64
,"Sales Receipt","04-03-2024","1896",,"Cash Sales","Zelia Dishwashing Paste 400g","Cost of Goods Sold","Zelia Dishwashing Paste",,"Undeposited Funds",86.64,"",64472.28
,"Sales Receipt","04-03-2024","2003",,"Cash Sales","Zelia Dishwashing Paste 400g","Cost of Goods Sold","Zelia Dishwashing Paste",,"Undeposited Funds",129.96,"",64602.24
,"Sales Receipt","04-03-2024","2004",,"Cash Sales","Zelia Dishwashing Paste 400g","Cost of Goods Sold","Zelia Dishwashing Paste",,"Undeposited Funds",173.27,"",64775.51
,"Invoice","05-03-2024","MC05469",,"MUHINDI MWEUSI SUPERMARKET LIMITED","Zelia Dishwashing Paste 400g","Cost of Goods Sold","Zelia Dishwashing Paste",,"Accounts Receivable",1039.65,"",65815.16
,"Invoice","05-03-2024","MC05470",,"MUHINDI MWEUSI SUPERMARKET LIMITED","Zelia Dishwashing Paste 400g","Cost of Goods Sold","Zelia Dishwashing Paste",,"Accounts Receivable",1039.65,"",66854.81
,"Sales Receipt","05-03-2024","2008",,"Cash Sales","Zelia Dishwashing Paste 400g","Cost of Goods Sold","Zelia Dishwashing Paste",,"Undeposited Funds",43.32,"",66898.13
,"Sales Receipt","05-03-2024","2012",,"Cash Sales","Zelia Dishwashing Paste 400g","Cost of Goods Sold","Zelia Dishwashing Paste",,"Undeposited Funds",43.32,"",66941.45
,"Sales Receipt","06-03-2024","2021",,"Farhan Wholesellers","Zelia Dishwashing Paste 400g","Cost of Goods Sold","Zelia Dishwashing Paste",,"Undeposited Funds",1039.65,"",67981.10
,"Sales Receipt","06-03-2024","2023",,"Kenafa Wholesalers","Zelia Dishwashing Paste 400g","Cost of Goods Sold","Zelia Dishwashing Paste",,"Undeposited Funds",519.82,"",68500.92
,"Sales Receipt","06-03-2024","2025",,"Wadajir Wholesallers","Zelia Dishwashing Paste 400g","Cost of Goods Sold","Zelia Dishwashing Paste",,"Undeposited Funds",10656.37,"",79157.29
,"Sales Receipt","06-03-2024","2027",,"Khalifa Shop","Zelia Dishwashing Paste 400g","Cost of Goods Sold","Zelia Dishwashing Paste",,"Undeposited Funds",519.82,"",79677.11
,"Sales Receipt","06-03-2024","2035",,"Cash Sales","Zelia Dishwashing Paste 400g","Cost of Goods Sold","Zelia Dishwashing Paste",,"Undeposited Funds",173.27,"",79850.38
,"Sales Receipt","07-03-2024","2028",,"Cash Sales","Zelia Dishwashing Paste 400g","Cost of Goods Sold","Zelia Dishwashing Paste",,"Undeposited Funds",1039.65,"",80890.03
,"Sales Receipt","07-03-2024","2029",,"Cash Sales","Zelia Dishwashing Paste 400g","Cost of Goods Sold","Zelia Dishwashing Paste",,"Undeposited Funds",43.32,"",80933.35
,"Sales Receipt","07-03-2024","2031",,"Cash Sales","Zelia Dishwashing Paste 400g","Cost of Goods Sold","Zelia Dishwashing Paste",,"Undeposited Funds",259.91,"",81193.26
,"Sales Receipt","07-03-2024","2032",,"Cash Sales","Zelia Dishwashing Paste 400g","Cost of Goods Sold","Zelia Dishwashing Paste",,"Undeposited Funds",173.27,"",81366.53
,"Sales Receipt","07-03-2024","2037",,"Cash Sales","Zelia Dishwashing Paste 400g","Cost of Goods Sold","Zelia Dishwashing Paste",,"Undeposited Funds",43.32,"",81409.85
,"Sales Receipt","08-03-2024","2044",,"Cash Sales","Zelia Dishwashing Paste 400g","Cost of Goods Sold","Zelia Dishwashing Paste",,"Undeposited Funds",86.64,"",81496.49
,"Sales Receipt","09-03-2024","2051",,"Ebenezer  Minimart","Zelia Dishwashing Paste 400g","Cost of Goods Sold","Zelia Dishwashing Paste",,"Undeposited Funds",259.91,"",81756.40
,"Invoice","11-03-2024","MC05484",,"MUHINDI MWEUSI SUPERMARKET LIMITED","Zelia Dishwashing Paste 400g","Cost of Goods Sold","Zelia Dishwashing Paste",,"Accounts Receivable",1039.65,"",82796.05
,"Sales Receipt","11-03-2024","2055",,"Beta Traders","Zelia Dishwashing Paste 400g","Cost of Goods Sold","Zelia Dishwashing Paste",,"Undeposited Funds",259.91,"",83055.96
,"Sales Receipt","11-03-2024","2056",,"Nasib Wholesallers","Zelia Dishwashing Paste 400g","Cost of Goods Sold","Zelia Dishwashing Paste",,"Undeposited Funds",1039.65,"",84095.61
,"Invoice","12-03-2024","MC05492",,"DALLAS SHOPRITE LTD","Zelia Dishwashing Paste 400g","Cost of Goods Sold","Zelia Dishwashing Paste",,"Accounts Receivable",259.91,"",84355.52
,"Sales Receipt","13-03-2024","2059",,"Cash Sales","Zelia Dishwashing Paste 400g","Cost of Goods Sold","Zelia Dishwashing Paste",,"Undeposited Funds",43.32,"",84398.84
,"Sales Receipt","13-03-2024","2060",,"Cash Sales","Zelia Dishwashing Paste 400g","Cost of Goods Sold","Zelia Dishwashing Paste",,"Undeposited Funds",43.32,"",84442.16
,"Sales Receipt","13-03-2024","2062",,"Mama Shukri","Zelia Dishwashing Paste 400g","Cost of Goods Sold","Zelia Dishwashing Paste",,"Undeposited Funds",519.82,"",84961.98
,"Sales Receipt","14-03-2024","2063",,"Cash Sales","Zelia Dishwashing Paste 400g","Cost of Goods Sold","Zelia Dishwashing Paste",,"Undeposited Funds",43.32,"",85005.30
,"Sales Receipt","14-03-2024","2066",,"Soimo Minimart","Zelia Dishwashing Paste 400g","Cost of Goods Sold","Zelia Dishwashing Paste",,"Undeposited Funds",519.82,"",85525.12
,"Sales Receipt","15-03-2024","2069",,"Cash Sales","Zelia Dishwashing Paste 400g","Cost of Goods Sold","Zelia Dishwashing Paste",,"Undeposited Funds",216.59,"",85741.71
,"Sales Receipt","15-03-2024","2070",,"Cash Sales","Zelia Dishwashing Paste 400g","Cost of Goods Sold","Zelia Dishwashing Paste",,"Undeposited Funds",173.27,"",85914.98
,"Sales Receipt","18-03-2024","2071",,"Simester General Stores","Zelia Dishwashing Paste 400g","Cost of Goods Sold","Zelia Dishwashing Paste",,"Undeposited Funds",216.59,"",86131.57
,"Sales Receipt","18-03-2024","2072",,"Cash Sales","Zelia Dishwashing Paste 400g","Cost of Goods Sold","Zelia Dishwashing Paste",,"Undeposited Funds",259.91,"",86391.48
,"Sales Receipt","18-03-2024","2074",,"Cash Sales","Zelia Dishwashing Paste 400g","Cost of Goods Sold","Zelia Dishwashing Paste",,"Undeposited Funds",129.96,"",86521.44
,"Sales Receipt","18-03-2024","2075",,"Cash Sales","Zelia Dishwashing Paste 400g","Cost of Goods Sold","Zelia Dishwashing Paste",,"Undeposited Funds",43.32,"",86564.76
,"Invoice","19-03-2024","MC05499",,"EASEBYYTTE SUPERMARKET LIMITED","Zelia Dishwashing Paste 400g","Cost of Goods Sold","Zelia Dishwashing Paste",,"Accounts Receivable",519.82,"",87084.58
,"Invoice","19-03-2024","MC05501",,"MUHINDI MWEUSI SUPERMARKET LIMITED","Zelia Dishwashing Paste 400g","Cost of Goods Sold","Zelia Dishwashing Paste",,"Accounts Receivable",1039.65,"",88124.23
,"Invoice","19-03-2024","MC05502",,"Tupo Mart Limited","Zelia Dishwashing Paste 400g","Cost of Goods Sold","Zelia Dishwashing Paste",,"Accounts Receivable",259.91,"",88384.14
,"Invoice","19-03-2024","MC05503",,"LUCKY MART SUPERMARKET LIMITED","Zelia Dishwashing Paste 400g","Cost of Goods Sold","Zelia Dishwashing Paste",,"Accounts Receivable",259.91,"",88644.05
,"Invoice","20-03-2024","MC05507",,"DAILY CHAMPIONS MINI SUPERMARKET LIMITED","Zelia Dishwashing Paste 400g","Cost of Goods Sold","Zelia Dishwashing Paste",,"Accounts Receivable",259.91,"",88903.96
,"Sales Receipt","20-03-2024","2085",,"Cash Sales","Zelia Dishwashing Paste 400g","Cost of Goods Sold","Zelia Dishwashing Paste",,"Undeposited Funds",43.32,"",88947.28
,"Sales Receipt","20-03-2024","2087",,"Pambazuka Mart (K) Limited","Zelia Dishwashing Paste 400g","Cost of Goods Sold","Zelia Dishwashing Paste",,"Undeposited Funds",1039.65,"",89986.93
,"Sales Receipt","20-03-2024","2089",,"Restoration Traders","Zelia Dishwashing Paste 400g","Cost of Goods Sold","Zelia Dishwashing Paste",,"Undeposited Funds",1039.65,"",91026.58
,"Sales Receipt","21-03-2024","2091",,"Mama Amina","Zelia Dishwashing Paste 400g","Cost of Goods Sold","Zelia Dishwashing Paste",,"Undeposited Funds",1039.65,"",92066.23
,"Sales Receipt","21-03-2024","2092",,"Norham Groceries","Zelia Dishwashing Paste 400g","Cost of Goods Sold","Zelia Dishwashing Paste",,"Undeposited Funds",259.91,"",92326.14
,"Sales Receipt","21-03-2024","2101",,"Raymart Minimart","Zelia Dishwashing Paste 400g","Cost of Goods Sold","Zelia Dishwashing Paste",,"Undeposited Funds",259.91,"",92586.05
,"Sales Receipt","21-03-2024","2102",,"Umushan Shop","Zelia Dishwashing Paste 400g","Cost of Goods Sold","Zelia Dishwashing Paste",,"Undeposited Funds",519.82,"",93105.87
,"Sales Receipt","21-03-2024","2103",,"Ilyes Gas and Water ltd","Zelia Dishwashing Paste 400g","Cost of Goods Sold","Zelia Dishwashing Paste",,"Undeposited Funds",519.82,"",93625.69
,"Sales Receipt","21-03-2024","2104",,"Nuclear Supermarket","Zelia Dishwashing Paste 400g","Cost of Goods Sold","Zelia Dishwashing Paste",,"Undeposited Funds",519.82,"",94145.51
,"Sales Receipt","25-03-2024","2094",,"Instanbul Shop","Zelia Dishwashing Paste 400g","Cost of Goods Sold","Zelia Dishwashing Paste",,"Undeposited Funds",519.82,"",94665.33
,"Invoice","27-03-2024","MC05542",,"BLUEMART SUPERMARKET LIMITED","Zelia Dishwashing Paste 400g","Cost of Goods Sold","Zelia Dishwashing Paste",,"Accounts Receivable",259.91,"",94925.24
,"Sales Receipt","27-03-2024","2110",,"Toyokom Wholesallers","Zelia Dishwashing Paste 400g","Cost of Goods Sold","Zelia Dishwashing Paste",,"Undeposited Funds",1039.65,"",95964.89
,"Sales Receipt","27-03-2024","2116",,"Cash Sales","Zelia Dishwashing Paste 400g","Cost of Goods Sold","Zelia Dishwashing Paste",,"Undeposited Funds",43.32,"",96008.21
,"Sales Receipt","28-03-2024","2118",,"Cash Sales","Zelia Dishwashing Paste 400g","Cost of Goods Sold","Zelia Dishwashing Paste",,"Undeposited Funds",173.27,"",96181.48
,"Sales Receipt","28-03-2024","2119",,"Moonlight Wholesallers","Zelia Dishwashing Paste 400g","Cost of Goods Sold","Zelia Dishwashing Paste",,"Undeposited Funds",1039.65,"",97221.13
,"Sales Receipt","28-03-2024","2120",,"Warfa Wholesallers","Zelia Dishwashing Paste 400g","Cost of Goods Sold","Zelia Dishwashing Paste",,"Undeposited Funds",2079.29,"",99300.42
,"Sales Receipt","28-03-2024","2127",,"Cash Sales","Zelia Dishwashing Paste 400g","Cost of Goods Sold","Zelia Dishwashing Paste",,"Undeposited Funds",43.32,"",99343.74
,"Sales Receipt","28-03-2024","2129",,"Cash Sales","Zelia Dishwashing Paste 400g","Cost of Goods Sold","Zelia Dishwashing Paste",,"Undeposited Funds",216.59,"",99560.33
,"Sales Receipt","02-04-2024","2131",,"Q-mart Minimart","Zelia Dishwashing Paste 400g","Cost of Goods Sold","Zelia Dishwashing Paste",,"Undeposited Funds",259.91,"",99820.24
,"Sales Receipt","02-04-2024","2133",,"Cash Sales","Zelia Dishwashing Paste 400g","Cost of Goods Sold","Zelia Dishwashing Paste",,"Undeposited Funds",303.23,"",100123.47
,"Sales Receipt","02-04-2024","2134",,"Cash Sales","Zelia Dishwashing Paste 400g","Cost of Goods Sold","Zelia Dishwashing Paste",,"Undeposited Funds",86.64,"",100210.11
,"Sales Receipt","03-04-2024","2135",,"Walalaha Wholesale","Zelia Dishwashing Paste 400g","Cost of Goods Sold","Zelia Dishwashing Paste",,"Undeposited Funds",1041.91,"",101252.02
,"Sales Receipt","03-04-2024","2139",,"Tawakal Wholesale Eastleigh","Zelia Dishwashing Paste 400g","Cost of Goods Sold","Zelia Dishwashing Paste",,"Undeposited Funds",2083.81,"",103335.83
,"Sales Receipt","03-04-2024","2140",,"Dacaad Wholesalers","Zelia Dishwashing Paste 400g","Cost of Goods Sold","Zelia Dishwashing Paste",,"Undeposited Funds",1041.91,"",104377.74
,"Sales Receipt","03-04-2024","2148",,"Cash Sales","Zelia Dishwashing Paste 400g","Cost of Goods Sold","Zelia Dishwashing Paste",,"Undeposited Funds",520.95,"",104898.69
,"Invoice","04-04-2024","MC05564",,"Azaavi Collections Limited","Zelia Dishwashing Paste 400g","Cost of Goods Sold","Zelia Dishwashing Paste",,"Accounts Receivable",43.41,"",104942.10
,"Sales Receipt","04-04-2024","2143",,"Jubilee Candy  Shop","Zelia Dishwashing Paste 400g","Cost of Goods Sold","Zelia Dishwashing Paste",,"Undeposited Funds",217.06,"",105159.16
,"Sales Receipt","04-04-2024","2150",,"Strawberry Minimart","Zelia Dishwashing Paste 400g","Cost of Goods Sold","Zelia Dishwashing Paste",,"Undeposited Funds",520.95,"",105680.11
,"Sales Receipt","04-04-2024","2151",,"Sahal General Stores","Zelia Dishwashing Paste 400g","Cost of Goods Sold","Zelia Dishwashing Paste",,"Undeposited Funds",1041.91,"",106722.02
,"Sales Receipt","04-04-2024","2153",,"Budget Store","Zelia Dishwashing Paste 400g","Cost of Goods Sold","Zelia Dishwashing Paste",,"Undeposited Funds",260.48,"",106982.50
,"Sales Receipt","05-04-2024","2156",,"D -Madina Enterprise","Zelia Dishwashing Paste 400g","Cost of Goods Sold","Zelia Dishwashing Paste",,"Undeposited Funds",1041.91,"",108024.41
,"Sales Receipt","05-04-2024","2157",,"Cash Sales","Zelia Dishwashing Paste 400g","Cost of Goods Sold","Zelia Dishwashing Paste",,"Undeposited Funds",86.83,"",108111.24
,"Sales Receipt","05-04-2024","2158",,"Cash Sales","Zelia Dishwashing Paste 400g","Cost of Goods Sold","Zelia Dishwashing Paste",,"Undeposited Funds",43.41,"",108154.65
,"Sales Receipt","05-04-2024","2160",,"Cash Sales","Zelia Dishwashing Paste 400g","Cost of Goods Sold","Zelia Dishwashing Paste",,"Undeposited Funds",173.65,"",108328.30
,"Sales Receipt","05-04-2024","2161",,"Cash Sales","Zelia Dishwashing Paste 400g","Cost of Goods Sold","Zelia Dishwashing Paste",,"Undeposited Funds",43.41,"",108371.71
,"Sales Receipt","05-04-2024","AT 193",,"JUDY USENGE","Zelia Dishwashing Paste 400g","Cost of Goods Sold","Zelia Dishwashing Paste",,"Undeposited Funds",6251.44,"",114623.15
,"Invoice","05-04-2024","MC05577",,"MUHINDI MWEUSI SUPERMARKET LIMITED","Zelia Dishwashing Paste 400g","Cost of Goods Sold","Zelia Dishwashing Paste",,"Accounts Receivable",520.95,"",115144.10
,"Invoice","05-04-2024","MC05578",,"MUHINDI MWEUSI SUPERMARKET LIMITED","Zelia Dishwashing Paste 400g","Cost of Goods Sold","Zelia Dishwashing Paste",,"Accounts Receivable",520.95,"",115665.05
,"Sales Receipt","08-04-2024","2162",,"Alma Stores","Zelia Dishwashing Paste 400g","Cost of Goods Sold","Zelia Dishwashing Paste",,"Undeposited Funds",521.88,"",116186.93
,"Sales Receipt","08-04-2024","2163",,"Deeps General Shop","Zelia Dishwashing Paste 400g","Cost of Goods Sold","Zelia Dishwashing Paste",,"Undeposited Funds",43.49,"",116230.42
,"Sales Receipt","08-04-2024","2164",,"Kangundo Briolly Bookshop","Zelia Dishwashing Paste 400g","Cost of Goods Sold","Zelia Dishwashing Paste",,"Undeposited Funds",43.49,"",116273.91
,"Sales Receipt","08-04-2024","2166",,"Cash Sales","Zelia Dishwashing Paste 400g","Cost of Goods Sold","Zelia Dishwashing Paste",,"Undeposited Funds",130.47,"",116404.38
,"Sales Receipt","08-04-2024","2167",,"Cash Sales","Zelia Dishwashing Paste 400g","Cost of Goods Sold","Zelia Dishwashing Paste",,"Undeposited Funds",217.45,"",116621.83
,"Sales Receipt","08-04-2024","2170",,"Antic Wholesallers","Zelia Dishwashing Paste 400g","Cost of Goods Sold","Zelia Dishwashing Paste",,"Undeposited Funds",4175.02,"",120796.85
,"Sales Receipt","08-04-2024","2171",,"Raage mart","Zelia Dishwashing Paste 400g","Cost of Goods Sold","Zelia Dishwashing Paste",,"Undeposited Funds",5218.77,"",126015.62
,"Sales Receipt","09-04-2024","2172",,"Cash Sales","Zelia Dishwashing Paste 400g","Cost of Goods Sold","Zelia Dishwashing Paste",,"Undeposited Funds",43.53,"",126059.15
,"Sales Receipt","12-04-2024","2175",,"Tekonstruct LTD","Zelia Dishwashing Paste 400g","Cost of Goods Sold","Zelia Dishwashing Paste",,"Undeposited Funds",87.05,"",126146.20
,"Sales Receipt","12-04-2024","2177",,"Cash Sales","Zelia Dishwashing Paste 400g","Cost of Goods Sold","Zelia Dishwashing Paste",,"Undeposited Funds",87.05,"",126233.25
,"Sales Receipt","12-04-2024","2179",,"Cash Sales","Zelia Dishwashing Paste 400g","Cost of Goods Sold","Zelia Dishwashing Paste",,"Undeposited Funds",43.53,"",126276.78
,"Sales Receipt","12-04-2024","2180",,"Elwak Stores Ltd","Zelia Dishwashing Paste 400g","Cost of Goods Sold","Zelia Dishwashing Paste",,"Undeposited Funds",1044.63,"",127321.41
,"Sales Receipt","12-04-2024","2182",,"Cheaper Cheap","Zelia Dishwashing Paste 400g","Cost of Goods Sold","Zelia Dishwashing Paste",,"Undeposited Funds",1044.63,"",128366.04
,"Sales Receipt","12-04-2024","2184",,"First Choice Shop","Zelia Dishwashing Paste 400g","Cost of Goods Sold","Zelia Dishwashing Paste",,"Undeposited Funds",522.32,"",128888.36
,"Sales Receipt","12-04-2024","2185",,"Mamken Minimart","Zelia Dishwashing Paste 400g","Cost of Goods Sold","Zelia Dishwashing Paste",,"Undeposited Funds",261.16,"",129149.52
,"Sales Receipt","12-04-2024","2186",,"Kandara minimart","Zelia Dishwashing Paste 400g","Cost of Goods Sold","Zelia Dishwashing Paste",,"Undeposited Funds",261.16,"",129410.68
,"Sales Receipt","12-04-2024","2187",,"Kikamart Minimart","Zelia Dishwashing Paste 400g","Cost of Goods Sold","Zelia Dishwashing Paste",,"Undeposited Funds",261.16,"",129671.84
,"Sales Receipt","12-04-2024","2211",,"Cash Sales","Zelia Dishwashing Paste 400g","Cost of Goods Sold","Zelia Dishwashing Paste",,"Undeposited Funds",348.21,"",130020.05
,"Sales Receipt","12-04-2024","2246",,"Skype Traders","Zelia Dishwashing Paste 400g","Cost of Goods Sold","Zelia Dishwashing Paste",,"Undeposited Funds",2089.26,"",132109.31
,"Sales Receipt","15-04-2024","2188",,"Delta Mart","Zelia Dishwashing Paste 400g","Cost of Goods Sold","Zelia Dishwashing Paste",,"Undeposited Funds",261.16,"",132370.47
,"Sales Receipt","15-04-2024","2193",,"Diaspora Diaries","Zelia Dishwashing Paste 400g","Cost of Goods Sold","Zelia Dishwashing Paste",,"Undeposited Funds",130.58,"",132501.05
,"Sales Receipt","15-04-2024","2194",,"Marwan Shop","Zelia Dishwashing Paste 400g","Cost of Goods Sold","Zelia Dishwashing Paste",,"Undeposited Funds",522.32,"",133023.37
,"Sales Receipt","15-04-2024","2196",,"Ebenezer  Minimart","Zelia Dishwashing Paste 400g","Cost of Goods Sold","Zelia Dishwashing Paste",,"Undeposited Funds",261.16,"",133284.53
,"Sales Receipt","15-04-2024","2197",,"Lekima Royal Merchants","Zelia Dishwashing Paste 400g","Cost of Goods Sold","Zelia Dishwashing Paste",,"Undeposited Funds",261.16,"",133545.69
,"Sales Receipt","16-04-2024","2212",,"Cash Sales","Zelia Dishwashing Paste 400g","Cost of Goods Sold","Zelia Dishwashing Paste",,"Undeposited Funds",43.76,"",133589.45
,"Sales Receipt","17-04-2024","2215",,"Best Ratino Stores","Zelia Dishwashing Paste 400g","Cost of Goods Sold","Zelia Dishwashing Paste",,"Undeposited Funds",2100.61,"",135690.06
,"Sales Receipt","17-04-2024","2218",,"Maida Minimart","Zelia Dishwashing Paste 400g","Cost of Goods Sold","Zelia Dishwashing Paste",,"Undeposited Funds",262.58,"",135952.64
,"Sales Receipt","17-04-2024","2219",,"Memos Supermarket","Zelia Dishwashing Paste 400g","Cost of Goods Sold","Zelia Dishwashing Paste",,"Undeposited Funds",525.15,"",136477.79
,"Sales Receipt","18-04-2024","2220",,"Towba General Store","Zelia Dishwashing Paste 400g","Cost of Goods Sold","Zelia Dishwashing Paste",,"Undeposited Funds",2100.61,"",138578.40
,"Sales Receipt","18-04-2024","2221",,"Baraka Shop","Zelia Dishwashing Paste 400g","Cost of Goods Sold","Zelia Dishwashing Paste",,"Undeposited Funds",525.15,"",139103.55
,"Sales Receipt","18-04-2024","2222",,"Amin Wholesalers","Zelia Dishwashing Paste 400g","Cost of Goods Sold","Zelia Dishwashing Paste",,"Undeposited Funds",1050.31,"",140153.86
,"Sales Receipt","18-04-2024","2225",,"Cash Sales","Zelia Dishwashing Paste 400g","Cost of Goods Sold","Zelia Dishwashing Paste",,"Undeposited Funds",43.76,"",140197.62
,"Sales Receipt","18-04-2024","2226",,"Zambia Shopping Centre","Zelia Dishwashing Paste 400g","Cost of Goods Sold","Zelia Dishwashing Paste",,"Undeposited Funds",262.58,"",140460.20
,"Sales Receipt","18-04-2024","2227",,"El Magina Store","Zelia Dishwashing Paste 400g","Cost of Goods Sold","Zelia Dishwashing Paste",,"Undeposited Funds",262.58,"",140722.78
,"Sales Receipt","18-04-2024","2228",,"Gods Favour","Zelia Dishwashing Paste 400g","Cost of Goods Sold","Zelia Dishwashing Paste",,"Undeposited Funds",525.15,"",141247.93
,"Sales Receipt","18-04-2024","2230",,"Ngomei Shop","Zelia Dishwashing Paste 400g","Cost of Goods Sold","Zelia Dishwashing Paste",,"Undeposited Funds",525.15,"",141773.08
,"Invoice","19-04-2024","MC05610",,"DISII TRADERS LTD","Zelia Dishwashing Paste 400g","Cost of Goods Sold","Zelia Dishwashing Paste",,"Accounts Receivable",525.15,"",142298.23
,"Invoice","19-04-2024","MC05613",,"HAPPY VIEW SUPERMARKET LIMITED","Zelia Dishwashing Paste 400g","Cost of Goods Sold","Zelia Dishwashing Paste",,"Accounts Receivable",262.58,"",142560.81
,"Invoice","19-04-2024","MC05614",,"MUHINDI MWEUSI SUPERMARKET LIMITED","Zelia Dishwashing Paste 400g","Cost of Goods Sold","Zelia Dishwashing Paste",,"Accounts Receivable",1050.31,"",143611.12
,"Invoice","19-04-2024","MC05615",,"BIN GINAAB HOUSEHOLD","Zelia Dishwashing Paste 400g","Cost of Goods Sold","Zelia Dishwashing Paste",,"Accounts Receivable",525.15,"",144136.27
,"Sales Receipt","19-04-2024","2231",,"Cash Sales","Zelia Dishwashing Paste 400g","Cost of Goods Sold","Zelia Dishwashing Paste",,"Undeposited Funds",218.81,"",144355.08
,"Sales Receipt","19-04-2024","2237",,"Garumo Wholesallers","Zelia Dishwashing Paste 400g","Cost of Goods Sold","Zelia Dishwashing Paste",,"Undeposited Funds",525.15,"",144880.23
,"Sales Receipt","20-04-2024","2243",,"Horn of Africa","Zelia Dishwashing Paste 400g","Cost of Goods Sold","Zelia Dishwashing Paste",,"Undeposited Funds",525.15,"",145405.38
,"Invoice","22-04-2024","MC05622",,"KASAMAT INVESTMENTS LTD","Zelia Dishwashing Paste 400g","Cost of Goods Sold","Zelia Dishwashing Paste",,"Accounts Receivable",262.58,"",145667.96
,"Invoice","22-04-2024","MC05623",,"MUHINDI MWEUSI SUPERMARKET LIMITED","Zelia Dishwashing Paste 400g","Cost of Goods Sold","Zelia Dishwashing Paste",,"Accounts Receivable",1050.31,"",146718.27
,"Sales Receipt","22-04-2024","2241",,"Cash Sales","Zelia Dishwashing Paste 400g","Cost of Goods Sold","Zelia Dishwashing Paste",,"Undeposited Funds",43.76,"",146762.03
,"Sales Receipt","22-04-2024","2244",,"MWASPART AIRWAYS","Zelia Dishwashing Paste 400g","Cost of Goods Sold","Zelia Dishwashing Paste",,"Undeposited Funds",262.58,"",147024.61
,"Sales Receipt","23-04-2024","2251",,"Cash Sales","Zelia Dishwashing Paste 400g","Cost of Goods Sold","Zelia Dishwashing Paste",,"Undeposited Funds",43.76,"",147068.37
,"Sales Receipt","23-04-2024","2254",,"Cash Sales","Zelia Dishwashing Paste 400g","Cost of Goods Sold","Zelia Dishwashing Paste",,"Undeposited Funds",1050.31,"",148118.68
,"Invoice","24-04-2024","MC05631",,"PRICE CHOPPER STORES LIMITED","Zelia Dishwashing Paste 400g","Cost of Goods Sold","Zelia Dishwashing Paste",,"Accounts Receivable",525.15,"",148643.83
,"Invoice","24-04-2024","MC05636",,"Maji Asili Limited","Zelia Dishwashing Paste 400g","Cost of Goods Sold","Zelia Dishwashing Paste",,"Accounts Receivable",3150.92,"",151794.75
,"Sales Receipt","24-04-2024","2255",,"Cash Sales","Zelia Dishwashing Paste 400g","Cost of Goods Sold","Zelia Dishwashing Paste",,"Undeposited Funds",43.79,"",151838.54
,"Sales Receipt","24-04-2024","2256",,"Kimathi Store","Zelia Dishwashing Paste 400g","Cost of Goods Sold","Zelia Dishwashing Paste",,"Undeposited Funds",43.79,"",151882.33
,"Sales Receipt","24-04-2024","2257",,"Cash Sales","Zelia Dishwashing Paste 400g","Cost of Goods Sold","Zelia Dishwashing Paste",,"Undeposited Funds",43.79,"",151926.12
,"Sales Receipt","24-04-2024","2259",,"Muleshe Wholesallers","Zelia Dishwashing Paste 400g","Cost of Goods Sold","Zelia Dishwashing Paste",,"Undeposited Funds",2101.92,"",154028.04
,"Sales Receipt","25-04-2024","2261",,"Teyamo Enterprises","Zelia Dishwashing Paste 400g","Cost of Goods Sold","Zelia Dishwashing Paste",,"Undeposited Funds",131.39,"",154159.43
,"Sales Receipt","25-04-2024","2263",,"Cash Sales","Zelia Dishwashing Paste 400g","Cost of Goods Sold","Zelia Dishwashing Paste",,"Undeposited Funds",43.80,"",154203.23
,"Sales Receipt","25-04-2024","2265",,"Strawberry Minimart","Zelia Dishwashing Paste 400g","Cost of Goods Sold","Zelia Dishwashing Paste",,"Undeposited Funds",525.55,"",154728.78
,"Sales Receipt","25-04-2024","2266",,"Goldmart Supermarket","Zelia Dishwashing Paste 400g","Cost of Goods Sold","Zelia Dishwashing Paste",,"Undeposited Funds",525.55,"",155254.33
,"Sales Receipt","29-04-2024","2271",,"Cash Sales","Zelia Dishwashing Paste 400g","Cost of Goods Sold","Zelia Dishwashing Paste",,"Undeposited Funds",87.59,"",155341.92
,"Sales Receipt","29-04-2024","2272",,"Mabruk","Zelia Dishwashing Paste 400g","Cost of Goods Sold","Zelia Dishwashing Paste",,"Undeposited Funds",262.77,"",155604.69
,"Sales Receipt","29-04-2024","2273",,"Blessed Shop","Zelia Dishwashing Paste 400g","Cost of Goods Sold","Zelia Dishwashing Paste",,"Undeposited Funds",87.59,"",155692.28
,"Sales Receipt","29-04-2024","2275",,"Cash Sales","Zelia Dishwashing Paste 400g","Cost of Goods Sold","Zelia Dishwashing Paste",,"Undeposited Funds",87.59,"",155779.87
,"Invoice","29-04-2024","MC05650",,"MUHINDI MWEUSI SUPERMARKET LIMITED","Zelia Dishwashing Paste 400g","Cost of Goods Sold","Zelia Dishwashing Paste",,"Accounts Receivable",1051.10,"",156830.97
,"Sales Receipt","29-04-2024","2277",,"Cash Sales","Zelia Dishwashing Paste 400g","Cost of Goods Sold","Zelia Dishwashing Paste",,"Undeposited Funds",875.92,"",157706.89
,"Sales Receipt","29-04-2024","2278",,"Hidika Shop","Zelia Dishwashing Paste 400g","Cost of Goods Sold","Zelia Dishwashing Paste",,"Undeposited Funds",525.55,"",158232.44
,"Sales Receipt","29-04-2024","2279",,"Cash Sales","Zelia Dishwashing Paste 400g","Cost of Goods Sold","Zelia Dishwashing Paste",,"Undeposited Funds",175.18,"",158407.62
,"Sales Receipt","30-04-2024","2281",,"Cash Sales","Zelia Dishwashing Paste 400g","Cost of Goods Sold","Zelia Dishwashing Paste",,"Undeposited Funds",175.18,"",158582.80
,"Sales Receipt","30-04-2024","2286",,"Homecare Enterprise","Zelia Dishwashing Paste 400g","Cost of Goods Sold","Zelia Dishwashing Paste",,"Undeposited Funds",262.85,"",158845.65
,"Sales Receipt","30-04-2024","2288",,"Simester General Stores","Zelia Dishwashing Paste 400g","Cost of Goods Sold","Zelia Dishwashing Paste",,"Undeposited Funds",262.85,"",159108.50
,"Sales Receipt","02-05-2024","2289",,"Al Naim store","Zelia Dishwashing Paste 400g","Cost of Goods Sold","Zelia Dishwashing Paste",,"Undeposited Funds",2102.78,"",161211.28
,"Sales Receipt","02-05-2024","2291",,"Mama Hamdi","Zelia Dishwashing Paste 400g","Cost of Goods Sold","Zelia Dishwashing Paste",,"Undeposited Funds",1051.39,"",162262.67
,"Sales Receipt","02-05-2024","2292",,"Jamilas Store","Zelia Dishwashing Paste 400g","Cost of Goods Sold","Zelia Dishwashing Paste",,"Undeposited Funds",525.70,"",162788.37
,"Sales Receipt","03-05-2024","2300",,"Cash Sales","Zelia Dishwashing Paste 400g","Cost of Goods Sold","Zelia Dishwashing Paste",,"Undeposited Funds",87.62,"",162875.99
,"Sales Receipt","03-05-2024","2301",,"Cash Sales","Zelia Dishwashing Paste 400g","Cost of Goods Sold","Zelia Dishwashing Paste",,"Undeposited Funds",43.81,"",162919.80
,"Sales Receipt","03-05-2024","2303",,"Cash Sales","Zelia Dishwashing Paste 400g","Cost of Goods Sold","Zelia Dishwashing Paste",,"Undeposited Funds",43.81,"",162963.61
,"Sales Receipt","03-05-2024","2306",,"Cash Sales","Zelia Dishwashing Paste 400g","Cost of Goods Sold","Zelia Dishwashing Paste",,"Undeposited Funds",43.81,"",163007.42
,"Sales Receipt","05-05-2024","2308",,"Cash Sales","Zelia Dishwashing Paste 400g","Cost of Goods Sold","Zelia Dishwashing Paste",,"Undeposited Funds",131.42,"",163138.84
,"Sales Receipt","06-05-2024","2307",,"Cash Sales","Zelia Dishwashing Paste 400g","Cost of Goods Sold","Zelia Dishwashing Paste",,"Undeposited Funds",87.64,"",163226.48
,"Sales Receipt","06-05-2024","2309",,"Jackys Shop","Zelia Dishwashing Paste 400g","Cost of Goods Sold","Zelia Dishwashing Paste",,"Undeposited Funds",43.82,"",163270.30
,"Sales Receipt","06-05-2024","2310",,"Razia Wholesalers","Zelia Dishwashing Paste 400g","Cost of Goods Sold","Zelia Dishwashing Paste",,"Undeposited Funds",219.10,"",163489.40
,"Sales Receipt","06-05-2024","2313",,"Hidika Shop","Zelia Dishwashing Paste 400g","Cost of Goods Sold","Zelia Dishwashing Paste",,"Undeposited Funds",525.85,"",164015.25
,"Sales Receipt","08-05-2024","2317",,"Pambazuka Mart (K) Limited","Zelia Dishwashing Paste 400g","Cost of Goods Sold","Zelia Dishwashing Paste",,"Undeposited Funds",525.85,"",164541.10
,"Sales Receipt","08-05-2024","2318",,"Adurus Wholesallers","Zelia Dishwashing Paste 400g","Cost of Goods Sold","Zelia Dishwashing Paste",,"Undeposited Funds",1051.70,"",165592.80
,"Sales Receipt","08-05-2024","2320",,"Johns Shop","Zelia Dishwashing Paste 400g","Cost of Goods Sold","Zelia Dishwashing Paste",,"Undeposited Funds",525.85,"",166118.65
,"Sales Receipt","08-05-2024","2321",,"Cash Sales","Zelia Dishwashing Paste 400g","Cost of Goods Sold","Zelia Dishwashing Paste",,"Undeposited Funds",87.64,"",166206.29
,"Sales Receipt","08-05-2024","2323",,"Cash Sales","Zelia Dishwashing Paste 400g","Cost of Goods Sold","Zelia Dishwashing Paste",,"Undeposited Funds",175.28,"",166381.57
,"Sales Receipt","08-05-2024","2325",,"Mama Amina","Zelia Dishwashing Paste 400g","Cost of Goods Sold","Zelia Dishwashing Paste",,"Undeposited Funds",1051.70,"",167433.27
,"Sales Receipt","08-05-2024","2327",,"Shahrazaad Wholesalers","Zelia Dishwashing Paste 400g","Cost of Goods Sold","Zelia Dishwashing Paste",,"Undeposited Funds",1051.70,"",168484.97
,"Sales Receipt","08-05-2024","2328",,"safa general store","Zelia Dishwashing Paste 400g","Cost of Goods Sold","Zelia Dishwashing Paste",,"Undeposited Funds",1051.70,"",169536.67
,"Sales Receipt","08-05-2024","2329",,"Al Baraka Shop","Zelia Dishwashing Paste 400g","Cost of Goods Sold","Zelia Dishwashing Paste",,"Undeposited Funds",525.85,"",170062.52
,"Sales Receipt","08-05-2024","2330",,"Neema Bei Nafuu Shop","Zelia Dishwashing Paste 400g","Cost of Goods Sold","Zelia Dishwashing Paste",,"Undeposited Funds",525.85,"",170588.37
,"Sales Receipt","08-05-2024","2331",,"Amir shop","Zelia Dishwashing Paste 400g","Cost of Goods Sold","Zelia Dishwashing Paste",,"Undeposited Funds",1051.70,"",171640.07
,"Sales Receipt","09-05-2024","2332",,"Gitonga Store","Zelia Dishwashing Paste 400g","Cost of Goods Sold","Zelia Dishwashing Paste",,"Undeposited Funds",2629.26,"",174269.33
,"Sales Receipt","09-05-2024","2336",,"Donation","Zelia Dishwashing Paste 400g","Cost of Goods Sold","Zelia Dishwashing Paste",,"Undeposited Funds",2103.40,"",176372.73
,"Sales Receipt","09-05-2024","2339",,"Cash Sales","Zelia Dishwashing Paste 400g","Cost of Goods Sold","Zelia Dishwashing Paste",,"Undeposited Funds",131.46,"",176504.19
,"Sales Receipt","09-05-2024","2341",,"Cash Sales","Zelia Dishwashing Paste 400g","Cost of Goods Sold","Zelia Dishwashing Paste",,"Undeposited Funds",87.64,"",176591.83
,"Sales Receipt","09-05-2024","2342",,"Cash Sales","Zelia Dishwashing Paste 400g","Cost of Goods Sold","Zelia Dishwashing Paste",,"Undeposited Funds",1051.70,"",177643.53
,"Sales Receipt","10-05-2024","1919",,"Cash Sales","Zelia Dishwashing Paste 400g","Cost of Goods Sold","Zelia Dishwashing Paste",,"Undeposited Funds",43.82,"",177687.35
,"Sales Receipt","13-05-2024","2345",,"Katani Foodstore","Zelia Dishwashing Paste 400g","Cost of Goods Sold","Zelia Dishwashing Paste",,"Undeposited Funds",262.93,"",177950.28
,"Sales Receipt","13-05-2024","2348",,"Gargar Foodstuffs","Zelia Dishwashing Paste 400g","Cost of Goods Sold","Zelia Dishwashing Paste",,"Undeposited Funds",1051.70,"",179001.98
,"Sales Receipt","13-05-2024","2350",,"Aymat Wholesalers","Zelia Dishwashing Paste 400g","Cost of Goods Sold","Zelia Dishwashing Paste",,"Undeposited Funds",525.85,"",179527.83
,"Sales Receipt","13-05-2024","2356",,"The Hub Minimart","Zelia Dishwashing Paste 400g","Cost of Goods Sold","Zelia Dishwashing Paste",,"Undeposited Funds",262.93,"",179790.76
,"Sales Receipt","13-05-2024","1921",,"Cash Sales","Zelia Dishwashing Paste 400g","Cost of Goods Sold","Zelia Dishwashing Paste",,"Undeposited Funds",175.28,"",179966.04
,"Sales Receipt","14-05-2024","2355",,"Beraccah Wholesallers","Zelia Dishwashing Paste 400g","Cost of Goods Sold","Zelia Dishwashing Paste",,"Undeposited Funds",525.85,"",180491.89
,"Invoice","15-05-2024","MC05701",,"MUHINDI MWEUSI SUPERMARKET LIMITED","Zelia Dishwashing Paste 400g","Cost of Goods Sold","Zelia Dishwashing Paste",,"Accounts Receivable",1051.70,"",181543.59
,"Invoice","15-05-2024","MC05703",,"MUHINDI MWEUSI SUPERMARKET LIMITED","Zelia Dishwashing Paste 400g","Cost of Goods Sold","Zelia Dishwashing Paste",,"Accounts Receivable",1051.70,"",182595.29
,"Sales Receipt","15-05-2024","1928",,"Cash Sales","Zelia Dishwashing Paste 400g","Cost of Goods Sold","Zelia Dishwashing Paste",,"Undeposited Funds",43.82,"",182639.11
,"Sales Receipt","16-05-2024","2365",,"Salma Shop","Zelia Dishwashing Paste 400g","Cost of Goods Sold","Zelia Dishwashing Paste",,"Undeposited Funds",1051.70,"",183690.81
,"Sales Receipt","16-05-2024","2366",,"Tusma Wholesale Eastleigh","Zelia Dishwashing Paste 400g","Cost of Goods Sold","Zelia Dishwashing Paste",,"Undeposited Funds",1051.70,"",184742.51
,"Sales Receipt","16-05-2024","1930",,"Cash Sales","Zelia Dishwashing Paste 400g","Cost of Goods Sold","Zelia Dishwashing Paste",,"Undeposited Funds",175.28,"",184917.79
,"Invoice","17-05-2024","MC05713",,"DISII TRADERS LTD","Zelia Dishwashing Paste 400g","Cost of Goods Sold","Zelia Dishwashing Paste",,"Accounts Receivable",525.85,"",185443.64
,"Sales Receipt","17-05-2024","2372",,"Danaba Wholesalers","Zelia Dishwashing Paste 400g","Cost of Goods Sold","Zelia Dishwashing Paste",,"Undeposited Funds",1051.70,"",186495.34
,"Sales Receipt","17-05-2024","1933",,"Cash Sales","Zelia Dishwashing Paste 400g","Cost of Goods Sold","Zelia Dishwashing Paste",,"Undeposited Funds",43.82,"",186539.16
,"Sales Receipt","17-05-2024","1935",,"Cash Sales","Zelia Dishwashing Paste 400g","Cost of Goods Sold","Zelia Dishwashing Paste",,"Undeposited Funds",175.28,"",186714.44
,"Sales Receipt","20-05-2024","1938",,"Gitonga Store","Zelia Dishwashing Paste 400g","Cost of Goods Sold","Zelia Dishwashing Paste",,"Undeposited Funds",3155.11,"",189869.55
,"Sales Receipt","21-05-2024","1943",,"Smart Choice","Zelia Dishwashing Paste 400g","Cost of Goods Sold","Zelia Dishwashing Paste",,"Undeposited Funds",525.85,"",190395.40
,"Sales Receipt","21-05-2024","1946",,"Moyale Shop","Zelia Dishwashing Paste 400g","Cost of Goods Sold","Zelia Dishwashing Paste",,"Undeposited Funds",525.85,"",190921.25
,"Sales Receipt","21-05-2024","1947",,"Minara Shop","Zelia Dishwashing Paste 400g","Cost of Goods Sold","Zelia Dishwashing Paste",,"Undeposited Funds",1051.70,"",191972.95
,"Sales Receipt","21-05-2024","1949",,"Cash Sales","Zelia Dishwashing Paste 400g","Cost of Goods Sold","Zelia Dishwashing Paste",,"Undeposited Funds",43.82,"",192016.77
,"Sales Receipt","21-05-2024","1951",,"Gidesh Supermarket","Zelia Dishwashing Paste 400g","Cost of Goods Sold","Zelia Dishwashing Paste",,"Undeposited Funds",525.85,"",192542.62
,"Sales Receipt","22-05-2024","2375",,"Visina Ltd","Zelia Dishwashing Paste 400g","Cost of Goods Sold","Zelia Dishwashing Paste",,"Undeposited Funds",1051.70,"",193594.32
,"Sales Receipt","22-05-2024","2376",,"Towfiqq Shop","Zelia Dishwashing Paste 400g","Cost of Goods Sold","Zelia Dishwashing Paste",,"Undeposited Funds",262.93,"",193857.25
,"Sales Receipt","23-05-2024","1953",,"Cash Sales","Zelia Dishwashing Paste 400g","Cost of Goods Sold","Zelia Dishwashing Paste",,"Undeposited Funds",87.64,"",193944.89
,"Sales Receipt","23-05-2024","1954",,"Cash Sales","Zelia Dishwashing Paste 400g","Cost of Goods Sold","Zelia Dishwashing Paste",,"Undeposited Funds",43.82,"",193988.71
,"Sales Receipt","23-05-2024","1957",,"Cash Sales","Zelia Dishwashing Paste 400g","Cost of Goods Sold","Zelia Dishwashing Paste",,"Undeposited Funds",175.28,"",194163.99
,"Sales Receipt","23-05-2024","1961",,"Ilyas Retail Shop","Zelia Dishwashing Paste 400g","Cost of Goods Sold","Zelia Dishwashing Paste",,"Undeposited Funds",525.85,"",194689.84
,"Sales Receipt","23-05-2024","1965",,"Marris Minimart","Zelia Dishwashing Paste 400g","Cost of Goods Sold","Zelia Dishwashing Paste",,"Undeposited Funds",262.93,"",194952.77
,"Sales Receipt","23-05-2024","1967",,"Mina Wholesalers","Zelia Dishwashing Paste 400g","Cost of Goods Sold","Zelia Dishwashing Paste",,"Undeposited Funds",525.85,"",195478.62
,"Sales Receipt","23-05-2024","1968",,"Moonlight Wholesallers","Zelia Dishwashing Paste 400g","Cost of Goods Sold","Zelia Dishwashing Paste",,"Undeposited Funds",5258.51,"",200737.13
,"Sales Receipt","23-05-2024","1969",,"Bahati Super Star Limited","Zelia Dishwashing Paste 400g","Cost of Goods Sold","Zelia Dishwashing Paste",,"Undeposited Funds",3155.11,"",203892.24
,"Invoice","24-05-2024","MC05739",,"MUHINDI MWEUSI SUPERMARKET LIMITED","Zelia Dishwashing Paste 400g","Cost of Goods Sold","Zelia Dishwashing Paste",,"Accounts Receivable",1051.70,"",204943.94
,"Invoice","24-05-2024","MC05746",,"MUHINDI MWEUSI SUPERMARKET LIMITED","Zelia Dishwashing Paste 400g","Cost of Goods Sold","Zelia Dishwashing Paste",,"Accounts Receivable",525.85,"",205469.79
,"Invoice","24-05-2024","MC05748",,"MUHINDI MWEUSI SUPERMARKET LIMITED","Zelia Dishwashing Paste 400g","Cost of Goods Sold","Zelia Dishwashing Paste",,"Accounts Receivable",1051.70,"",206521.49
,"Invoice","24-05-2024","MC05749",,"Ck Upscales Limited","Zelia Dishwashing Paste 400g","Cost of Goods Sold","Zelia Dishwashing Paste",,"Accounts Receivable",2103.40,"",208624.89
,"Invoice","24-05-2024","MC05750",,"MUHINDI MWEUSI SUPERMARKET LIMITED","Zelia Dishwashing Paste 400g","Cost of Goods Sold","Zelia Dishwashing Paste",,"Accounts Receivable",1051.70,"",209676.59
,"Sales Receipt","24-05-2024","2380",,"Cash Sales","Zelia Dishwashing Paste 400g","Cost of Goods Sold","Zelia Dishwashing Paste",,"Undeposited Funds",438.21,"",210114.80
,"Invoice","28-05-2024","MC05761",,"MUHINDI MWEUSI SUPERMARKET LIMITED","Zelia Dishwashing Paste 400g","Cost of Goods Sold","Zelia Dishwashing Paste",,"Accounts Receivable",525.85,"",210640.65
,"Invoice","28-05-2024","MC05762",,"MUHINDI MWEUSI SUPERMARKET LIMITED","Zelia Dishwashing Paste 400g","Cost of Goods Sold","Zelia Dishwashing Paste",,"Accounts Receivable",1051.70,"",211692.35
,"Invoice","28-05-2024","MC05764",,"DALLAS SHOPRITE LTD","Zelia Dishwashing Paste 400g","Cost of Goods Sold","Zelia Dishwashing Paste",,"Accounts Receivable",262.93,"",211955.28
,"Invoice","28-05-2024","MC05765",,"TAWALA SUPERMARKET LIMITED","Zelia Dishwashing Paste 400g","Cost of Goods Sold","Zelia Dishwashing Paste",,"Accounts Receivable",525.85,"",212481.13
,"Sales Receipt","28-05-2024","2389",,"Restoration Traders","Zelia Dishwashing Paste 400g","Cost of Goods Sold","Zelia Dishwashing Paste",,"Undeposited Funds",1051.70,"",213532.83
,"Sales Receipt","29-05-2024","2390",,"Cash Sales","Zelia Dishwashing Paste 400g","Cost of Goods Sold","Zelia Dishwashing Paste",,"Undeposited Funds",175.28,"",213708.11
,"Sales Receipt","29-05-2024","2391",,"Cash Sales","Zelia Dishwashing Paste 400g","Cost of Goods Sold","Zelia Dishwashing Paste",,"Undeposited Funds",175.28,"",213883.39
,"Sales Receipt","29-05-2024","1971",,"Freshfinds Wholesale","Zelia Dishwashing Paste 400g","Cost of Goods Sold","Zelia Dishwashing Paste",,"Undeposited Funds",262.93,"",214146.32
,"Sales Receipt","30-05-2024","2394",,"Gure Yare Shop Nasra","Zelia Dishwashing Paste 400g","Cost of Goods Sold","Zelia Dishwashing Paste",,"Undeposited Funds",5258.51,"",219404.83
,"Sales Receipt","31-05-2024","2369",,"Golden Store","Zelia Dishwashing Paste 400g","Cost of Goods Sold","Zelia Dishwashing Paste",,"Undeposited Funds",1051.70,"",220456.53
,"Sales Receipt","31-05-2024","1937",,"Island Gift Shop","Zelia Dishwashing Paste 400g","Cost of Goods Sold","Zelia Dishwashing Paste",,"Undeposited Funds",175.28,"",220631.81
,"Sales Receipt","31-05-2024","1975",,"Cash Sales","Zelia Dishwashing Paste 400g","Cost of Goods Sold","Zelia Dishwashing Paste",,"Undeposited Funds",175.28,"",220807.09
,"Sales Receipt","31-05-2024","1977",,"Cash Sales","Zelia Dishwashing Paste 400g","Cost of Goods Sold","Zelia Dishwashing Paste",,"Undeposited Funds",175.28,"",220982.37
,"Sales Receipt","03-06-2024","2396",,"Cash Sales","Zelia Dishwashing Paste 400g","Cost of Goods Sold","Zelia Dishwashing Paste",,"Undeposited Funds",87.64,"",221070.01
,"Sales Receipt","03-06-2024","2398",,"Cash Sales","Zelia Dishwashing Paste 400g","Cost of Goods Sold","Zelia Dishwashing Paste",,"Undeposited Funds",43.82,"",221113.83
,"Sales Receipt","03-06-2024","2399",,"Cash Sales","Zelia Dishwashing Paste 400g","Cost of Goods Sold","Zelia Dishwashing Paste",,"Undeposited Funds",43.82,"",221157.65
,"Sales Receipt","03-06-2024","1975",,"Cash Sales","Zelia Dishwashing Paste 400g","Cost of Goods Sold","Zelia Dishwashing Paste",,"Undeposited Funds",175.28,"",221332.93
,"Sales Receipt","03-06-2024","1977",,"Cash Sales","Zelia Dishwashing Paste 400g","Cost of Goods Sold","Zelia Dishwashing Paste",,"Undeposited Funds",175.28,"",221508.21
,"Sales Receipt","04-06-2024","2413",,"Horn of Africa","Zelia Dishwashing Paste 400g","Cost of Goods Sold","Zelia Dishwashing Paste",,"Undeposited Funds",525.85,"",222034.06
,"Sales Receipt","04-06-2024","1986",,"Kiembeni Grocery","Zelia Dishwashing Paste 400g","Cost of Goods Sold","Zelia Dishwashing Paste",,"Undeposited Funds",1051.70,"",223085.76
,"Sales Receipt","04-06-2024","2742",,"Arwa Wholesale","Zelia Dishwashing Paste 400g","Cost of Goods Sold","Zelia Dishwashing Paste",,"Undeposited Funds",525.85,"",223611.61
,"Sales Receipt","04-06-2024","2741",,"Sasa Wholesalers","Zelia Dishwashing Paste 400g","Cost of Goods Sold","Zelia Dishwashing Paste",,"Undeposited Funds",1051.70,"",224663.31
,"Sales Receipt","05-06-2024","2416",,"Amir shop","Zelia Dishwashing Paste 400g","Cost of Goods Sold","Zelia Dishwashing Paste",,"Undeposited Funds",525.85,"",225189.16
,"Sales Receipt","05-06-2024","2417",,"D-Madina Enterprise","Zelia Dishwashing Paste 400g","Cost of Goods Sold","Zelia Dishwashing Paste",,"Undeposited Funds",1051.70,"",226240.86
,"Sales Receipt","05-06-2024","2419",,"Publix Supermarket","Zelia Dishwashing Paste 400g","Cost of Goods Sold","Zelia Dishwashing Paste",,"Undeposited Funds",525.85,"",226766.71
,"Invoice","06-06-2024","MC05790",,"Karia Supermarkets Limited","Zelia Dishwashing Paste 400g","Cost of Goods Sold","Zelia Dishwashing Paste",,"Accounts Receivable",1051.70,"",227818.41
,"Sales Receipt","06-06-2024","2429",,"Cash Sales","Zelia Dishwashing Paste 400g","Cost of Goods Sold","Zelia Dishwashing Paste",,"Undeposited Funds",43.82,"",227862.23
,"Sales Receipt","06-06-2024","1991",,"Cash Sales","Zelia Dishwashing Paste 400g","Cost of Goods Sold","Zelia Dishwashing Paste",,"Undeposited Funds",1051.70,"",228913.93
,"Sales Receipt","06-06-2024","2425",,"Soimo Minimart","Zelia Dishwashing Paste 400g","Cost of Goods Sold","Zelia Dishwashing Paste",,"Undeposited Funds",525.85,"",229439.78
,"Sales Receipt","06-06-2024","2423",,"Ekai moke wholesale","Zelia Dishwashing Paste 400g","Cost of Goods Sold","Zelia Dishwashing Paste",,"Undeposited Funds",525.85,"",229965.63
,"Sales Receipt","06-06-2024","2421",,"Feng Sheng Supermarket","Zelia Dishwashing Paste 400g","Cost of Goods Sold","Zelia Dishwashing Paste",,"Undeposited Funds",1051.70,"",231017.33
,"Sales Receipt","07-06-2024","1992",,"Cash Sales","Zelia Dishwashing Paste 400g","Cost of Goods Sold","Zelia Dishwashing Paste",,"Undeposited Funds",131.46,"",231148.79
,"Sales Receipt","07-06-2024","2428",,"Nabcom Stores","Zelia Dishwashing Paste 400g","Cost of Goods Sold","Zelia Dishwashing Paste",,"Undeposited Funds",525.85,"",231674.64
,"Sales Receipt","10-06-2024","2434",,"Cash Sales","Zelia Dishwashing Paste 400g","Cost of Goods Sold","Zelia Dishwashing Paste",,"Undeposited Funds",87.96,"",231762.60
,"Invoice","11-06-2024","MC05815",,"MADINA SUPERMARKET LIMITED","Zelia Dishwashing Paste 400g","Cost of Goods Sold","Zelia Dishwashing Paste",,"Accounts Receivable",263.88,"",232026.48
,"Sales Receipt","11-06-2024","2439",,"Cash Sales","Zelia Dishwashing Paste 400g","Cost of Goods Sold","Zelia Dishwashing Paste",,"Undeposited Funds",44.00,"",232070.48
,"Sales Receipt","11-06-2024","2440",,"Cash Sales","Zelia Dishwashing Paste 400g","Cost of Goods Sold","Zelia Dishwashing Paste",,"Undeposited Funds",87.99,"",232158.47
,"Sales Receipt","11-06-2024","2446",,"Cash Sales","Zelia Dishwashing Paste 400g","Cost of Goods Sold","Zelia Dishwashing Paste",,"Undeposited Funds",175.98,"",232334.45
,"Sales Receipt","11-06-2024","2715",,"Asfa Shop","Zelia Dishwashing Paste 400g","Cost of Goods Sold","Zelia Dishwashing Paste",,"Undeposited Funds",527.94,"",232862.39
,"Sales Receipt","11-06-2024","2448",,"Farmwell Enterprises","Zelia Dishwashing Paste 400g","Cost of Goods Sold","Zelia Dishwashing Paste",,"Undeposited Funds",131.99,"",232994.38
,"Sales Receipt","12-06-2024","2449",,"Cash Sales","Zelia Dishwashing Paste 400g","Cost of Goods Sold","Zelia Dishwashing Paste",,"Undeposited Funds",44.02,"",233038.40
,"Sales Receipt","12-06-2024","2451",,"Cash Sales","Zelia Dishwashing Paste 400g","Cost of Goods Sold","Zelia Dishwashing Paste",,"Undeposited Funds",88.05,"",233126.45
,"Sales Receipt","12-06-2024","2452",,"Cash Sales","Zelia Dishwashing Paste 400g","Cost of Goods Sold","Zelia Dishwashing Paste",,"Undeposited Funds",88.05,"",233214.50
,"Sales Receipt","12-06-2024","2453",,"Cash Sales","Zelia Dishwashing Paste 400g","Cost of Goods Sold","Zelia Dishwashing Paste",,"Undeposited Funds",2201.20,"",235415.70
,"Sales Receipt","12-06-2024","2461",,"Cash Sales","Zelia Dishwashing Paste 400g","Cost of Goods Sold","Zelia Dishwashing Paste",,"Undeposited Funds",88.05,"",235503.75
,"Sales Receipt","12-06-2024","2458",,"Sahal Wholesale","Zelia Dishwashing Paste 400g","Cost of Goods Sold","Zelia Dishwashing Paste",,"Undeposited Funds",1056.58,"",236560.33
,"Sales Receipt","12-06-2024","2463",,"Raja Foodstuffs","Zelia Dishwashing Paste 400g","Cost of Goods Sold","Zelia Dishwashing Paste",,"Undeposited Funds",2113.16,"",238673.49
,"Invoice","13-06-2024","MC05820",,"ZAIN SUPERMARKET LIMITED","Zelia Dishwashing Paste 400g","Cost of Goods Sold","Zelia Dishwashing Paste",,"Accounts Receivable",264.14,"",238937.63
,"Sales Receipt","13-06-2024","2464",,"Cash Sales","Zelia Dishwashing Paste 400g","Cost of Goods Sold","Zelia Dishwashing Paste",,"Undeposited Funds",44.05,"",238981.68
,"Sales Receipt","13-06-2024","2471",,"Cash Sales","Zelia Dishwashing Paste 400g","Cost of Goods Sold","Zelia Dishwashing Paste",,"Undeposited Funds",88.09,"",239069.77
,"Sales Receipt","13-06-2024","2474",,"Fahma Qali","Zelia Dishwashing Paste 400g","Cost of Goods Sold","Zelia Dishwashing Paste",,"Undeposited Funds",528.56,"",239598.33
,"Sales Receipt","14-06-2024","2475",,"Cash Sales","Zelia Dishwashing Paste 400g","Cost of Goods Sold","Zelia Dishwashing Paste",,"Undeposited Funds",264.36,"",239862.69
,"Sales Receipt","14-06-2024","2714",,"Damuda Mart","Zelia Dishwashing Paste 400g","Cost of Goods Sold","Zelia Dishwashing Paste",,"Undeposited Funds",1057.43,"",240920.12
,"Sales Receipt","14-06-2024","2710",,"tRIPPLE M","Zelia Dishwashing Paste 400g","Cost of Goods Sold","Zelia Dishwashing Paste",,"Undeposited Funds",176.24,"",241096.36
,"Sales Receipt","14-06-2024","2709",,"mwaspart","Zelia Dishwashing Paste 400g","Cost of Goods Sold","Zelia Dishwashing Paste",,"Undeposited Funds",264.36,"",241360.72
,"Invoice","18-06-2024","MC05828",,"MUHINDI MWEUSI SUPERMARKET LIMITED","Zelia Dishwashing Paste 400g","Cost of Goods Sold","Zelia Dishwashing Paste",,"Accounts Receivable",528.72,"",241889.44
,"Invoice","18-06-2024","MC05829",,"MUHINDI MWEUSI SUPERMARKET LIMITED","Zelia Dishwashing Paste 400g","Cost of Goods Sold","Zelia Dishwashing Paste",,"Accounts Receivable",528.72,"",242418.16
,"Invoice","18-06-2024","MC05830",,"MUHINDI MWEUSI SUPERMARKET LIMITED","Zelia Dishwashing Paste 400g","Cost of Goods Sold","Zelia Dishwashing Paste",,"Accounts Receivable",1057.43,"",243475.59
,"Invoice","18-06-2024","MC05831",,"MUHINDI MWEUSI SUPERMARKET LIMITED","Zelia Dishwashing Paste 400g","Cost of Goods Sold","Zelia Dishwashing Paste",,"Accounts Receivable",528.72,"",244004.31
,"Invoice","18-06-2024","MC05832",,"MUHINDI MWEUSI SUPERMARKET LIMITED","Zelia Dishwashing Paste 400g","Cost of Goods Sold","Zelia Dishwashing Paste",,"Accounts Receivable",1057.43,"",245061.74
,"Sales Receipt","18-06-2024","2703",,"Cash Sales","Zelia Dishwashing Paste 400g","Cost of Goods Sold","Zelia Dishwashing Paste",,"Undeposited Funds",176.24,"",245237.98
,"Sales Receipt","18-06-2024","2701",,"Cash Sales","Zelia Dishwashing Paste 400g","Cost of Goods Sold","Zelia Dishwashing Paste",,"Undeposited Funds",528.72,"",245766.70
,"Sales Receipt","18-06-2024","2711",,"Cash Sales","Zelia Dishwashing Paste 400g","Cost of Goods Sold","Zelia Dishwashing Paste",,"Undeposited Funds",44.06,"",245810.76
,"Sales Receipt","18-06-2024","2708",,"Downtown Wholesalers","Zelia Dishwashing Paste 400g","Cost of Goods Sold","Zelia Dishwashing Paste",,"Undeposited Funds",1057.43,"",246868.19
,"Sales Receipt","18-06-2024","2500",,"Al Hamdu shop","Zelia Dishwashing Paste 400g","Cost of Goods Sold","Zelia Dishwashing Paste",,"Undeposited Funds",264.36,"",247132.55
,"Sales Receipt","18-06-2024","2707",,"Beta Traders","Zelia Dishwashing Paste 400g","Cost of Goods Sold","Zelia Dishwashing Paste",,"Undeposited Funds",1057.43,"",248189.98
,"Sales Receipt","18-06-2024","2706",,"Hidika Shop","Zelia Dishwashing Paste 400g","Cost of Goods Sold","Zelia Dishwashing Paste",,"Undeposited Funds",528.72,"",248718.70
,"Sales Receipt","18-06-2024","2748",,"Mabini store","Zelia Dishwashing Paste 400g","Cost of Goods Sold","Zelia Dishwashing Paste",,"Undeposited Funds",264.36,"",248983.06
,"Sales Receipt","19-06-2024","2484",,"Cash Sales","Zelia Dishwashing Paste 400g","Cost of Goods Sold","Zelia Dishwashing Paste",,"Undeposited Funds",176.24,"",249159.30
,"Sales Receipt","19-06-2024","2491",,"D-Madina Enterprise","Zelia Dishwashing Paste 400g","Cost of Goods Sold","Zelia Dishwashing Paste",,"Undeposited Funds",1057.43,"",250216.73
,"Invoice","20-06-2024","MC05842",,"HOPEMART SELF SERVICES LTD","Zelia Dishwashing Paste 400g","Cost of Goods Sold","Zelia Dishwashing Paste",,"Accounts Receivable",220.30,"",250437.03
,"Invoice","20-06-2024","MC05843",,"MUHINDI MWEUSI SUPERMARKET LIMITED","Zelia Dishwashing Paste 400g","Cost of Goods Sold","Zelia Dishwashing Paste",,"Accounts Receivable",1057.43,"",251494.46
,"Sales Receipt","20-06-2024","2493",,"Cash Sales","Zelia Dishwashing Paste 400g","Cost of Goods Sold","Zelia Dishwashing Paste",,"Undeposited Funds",44.06,"",251538.52
,"Sales Receipt","20-06-2024","AT197",,"Cash Sales","Zelia Dishwashing Paste 400g","Cost of Goods Sold","Zelia Dishwashing Paste",,"Undeposited Funds",528.72,"",252067.24
,"Sales Receipt","20-06-2024","2498",,"Mamken Minimart","Zelia Dishwashing Paste 400g","Cost of Goods Sold","Zelia Dishwashing Paste",,"Undeposited Funds",264.36,"",252331.60
,"Sales Receipt","21-06-2024","2716",,"Cash Sales","Zelia Dishwashing Paste 400g","Cost of Goods Sold","Zelia Dishwashing Paste",,"Undeposited Funds",176.24,"",252507.84
,"Sales Receipt","21-06-2024","2721",,"Home Soko Minimart","Zelia Dishwashing Paste 400g","Cost of Goods Sold","Zelia Dishwashing Paste",,"Undeposited Funds",528.72,"",253036.56
,"Sales Receipt","21-06-2024","2722",,"Kika Mart","Zelia Dishwashing Paste 400g","Cost of Goods Sold","Zelia Dishwashing Paste",,"Undeposited Funds",264.36,"",253300.92
,"Sales Receipt","23-06-2024","2907",,"Cash Sales","Zelia Dishwashing Paste 400g","Cost of Goods Sold","Zelia Dishwashing Paste",,"Undeposited Funds",176.24,"",253477.16
,"Sales Receipt","24-06-2024","2729",,"Natala Shop","Zelia Dishwashing Paste 400g","Cost of Goods Sold","Zelia Dishwashing Paste",,"Undeposited Funds",528.72,"",254005.88
,"Invoice","26-06-2024","MC05862",,"LUCKY MART SUPERMARKET LIMITED","Zelia Dishwashing Paste 400g","Cost of Goods Sold","Zelia Dishwashing Paste",,"Accounts Receivable",264.36,"",254270.24
,"Sales Receipt","26-06-2024","2732",,"Instanbul Shop","Zelia Dishwashing Paste 400g","Cost of Goods Sold","Zelia Dishwashing Paste",,"Undeposited Funds",528.72,"",254798.96
,"Sales Receipt","26-06-2024","2733",,"Mumtaz Shop","Zelia Dishwashing Paste 400g","Cost of Goods Sold","Zelia Dishwashing Paste",,"Undeposited Funds",1057.43,"",255856.39
,"Sales Receipt","26-06-2024","2734",,"Wadajir Wholesalers","Zelia Dishwashing Paste 400g","Cost of Goods Sold","Zelia Dishwashing Paste",,"Undeposited Funds",10574.33,"",266430.72
,"Sales Receipt","28-06-2024","2737",,"Cash Sales","Zelia Dishwashing Paste 400g","Cost of Goods Sold","Zelia Dishwashing Paste",,"Undeposited Funds",44.06,"",266474.78
,"Sales Receipt","28-06-2024","2738",,"Cash Sales","Zelia Dishwashing Paste 400g","Cost of Goods Sold","Zelia Dishwashing Paste",,"Undeposited Funds",176.24,"",266651.02
,"Sales Receipt","28-06-2024","2743",,"Cash Sales","Zelia Dishwashing Paste 400g","Cost of Goods Sold","Zelia Dishwashing Paste",,"Undeposited Funds",176.24,"",266827.26
,"Sales Receipt","28-06-2024","AT199",,"Cash Sales","Zelia Dishwashing Paste 400g","Cost of Goods Sold","Zelia Dishwashing Paste",,"Undeposited Funds",1057.43,"",267884.69
,"Sales Receipt","01-07-2024","2749",,"Mama Amina","Zelia Dishwashing Paste 400g","Cost of Goods Sold","Zelia Dishwashing Paste",,"Undeposited Funds",1057.43,"",268942.12
,"Sales Receipt","01-07-2024","2750",,"Adurus Wholesallers","Zelia Dishwashing Paste 400g","Cost of Goods Sold","Zelia Dishwashing Paste",,"Undeposited Funds",2114.87,"",271056.99
,"Sales Receipt","01-07-2024","2752",,"Elwak Stores","Zelia Dishwashing Paste 400g","Cost of Goods Sold","Zelia Dishwashing Paste",,"Undeposited Funds",1057.43,"",272114.42
,"Sales Receipt","01-07-2024","2753",,"Sharma Shop","Zelia Dishwashing Paste 400g","Cost of Goods Sold","Zelia Dishwashing Paste",,"Undeposited Funds",1057.43,"",273171.85
,"Sales Receipt","01-07-2024","2553",,"Soko Store","Zelia Dishwashing Paste 400g","Cost of Goods Sold","Zelia Dishwashing Paste",,"Undeposited Funds",264.36,"",273436.21
,"Sales Receipt","02-07-2024","2755",,"Cash Sales","Zelia Dishwashing Paste 400g","Cost of Goods Sold","Zelia Dishwashing Paste",,"Undeposited Funds",88.12,"",273524.33
,"Sales Receipt","02-07-2024","2759",,"Cash Sales","Zelia Dishwashing Paste 400g","Cost of Goods Sold","Zelia Dishwashing Paste",,"Undeposited Funds",176.24,"",273700.57
,"Sales Receipt","02-07-2024","2760",,"Cash Sales","Zelia Dishwashing Paste 400g","Cost of Goods Sold","Zelia Dishwashing Paste",,"Undeposited Funds",88.12,"",273788.69
,"Invoice","03-07-2024","MC05880",,"SECUTOR LIMITED","Zelia Dishwashing Paste 400g","Cost of Goods Sold","Zelia Dishwashing Paste",,"Accounts Receivable",44.06,"",273832.75
,"Sales Receipt","03-07-2024","2761",,"Cash Sales","Zelia Dishwashing Paste 400g","Cost of Goods Sold","Zelia Dishwashing Paste",,"Undeposited Funds",264.36,"",274097.11
,"Sales Receipt","03-07-2024","2767",,"Cash Sales","Zelia Dishwashing Paste 400g","Cost of Goods Sold","Zelia Dishwashing Paste",,"Undeposited Funds",88.12,"",274185.23
,"Sales Receipt","03-07-2024","2779",,"Cash Sales","Zelia Dishwashing Paste 400g","Cost of Goods Sold","Zelia Dishwashing Paste",,"Undeposited Funds",176.24,"",274361.47
,"Sales Receipt","03-07-2024","2772",,"Ahlam Shop","Zelia Dishwashing Paste 400g","Cost of Goods Sold","Zelia Dishwashing Paste",,"Undeposited Funds",1057.43,"",275418.90
,"Sales Receipt","03-07-2024","2775",,"Tawakal","Zelia Dishwashing Paste 400g","Cost of Goods Sold","Zelia Dishwashing Paste",,"Undeposited Funds",3172.30,"",278591.20
,"Sales Receipt","03-07-2024","2776",,"Aaraka Shop","Zelia Dishwashing Paste 400g","Cost of Goods Sold","Zelia Dishwashing Paste",,"Undeposited Funds",528.72,"",279119.92
,"Sales Receipt","03-07-2024","2783",,"Cheaper Cheap","Zelia Dishwashing Paste 400g","Cost of Goods Sold","Zelia Dishwashing Paste",,"Undeposited Funds",1057.43,"",280177.35
,"Sales Receipt","03-07-2024","2796",,"Madina  Mombasa Supamat","Zelia Dishwashing Paste 400g","Cost of Goods Sold","Zelia Dishwashing Paste",,"Undeposited Funds",1057.43,"",281234.78
,"Sales Receipt","03-07-2024","2766",,"Anns Shop","Zelia Dishwashing Paste 400g","Cost of Goods Sold","Zelia Dishwashing Paste",,"Undeposited Funds",264.36,"",281499.14
,"Sales Receipt","03-07-2024","2770",,"Tayamo Wholesalers","Zelia Dishwashing Paste 400g","Cost of Goods Sold","Zelia Dishwashing Paste",,"Undeposited Funds",44.06,"",281543.20
,"Invoice","04-07-2024","MC05884",,"PRICE CHOPPER STORES LIMITED","Zelia Dishwashing Paste 400g","Cost of Goods Sold","Zelia Dishwashing Paste",,"Accounts Receivable",528.72,"",282071.92
,"Invoice","04-07-2024","MC05885",,"The Joymai Blessed Stores Limited","Zelia Dishwashing Paste 400g","Cost of Goods Sold","Zelia Dishwashing Paste",,"Accounts Receivable",528.72,"",282600.64
,"Sales Receipt","04-07-2024","2789",,"Cash Sales","Zelia Dishwashing Paste 400g","Cost of Goods Sold","Zelia Dishwashing Paste",,"Undeposited Funds",44.06,"",282644.70
,"Sales Receipt","05-07-2024","2791",,"Cash Sales","Zelia Dishwashing Paste 500g","Cost of Goods Sold","Zelia Dishwashing Paste",,"Undeposited Funds",55.07,"",282699.77
,"Sales Receipt","05-07-2024","2797",,"Afro Drip LTD","Zelia Dishwashing Paste 400g","Cost of Goods Sold","Zelia Dishwashing Paste",,"Undeposited Funds",44.06,"",282743.83
,"Sales Receipt","05-07-2024","2798",,"Two Boys Shop","Zelia Dishwashing Paste 400g","Cost of Goods Sold","Zelia Dishwashing Paste",,"Undeposited Funds",264.36,"",283008.19
,"Sales Receipt","05-07-2024","2799",,"Milimani Store","Zelia Dishwashing Paste 400g","Cost of Goods Sold","Zelia Dishwashing Paste",,"Undeposited Funds",264.36,"",283272.55
,"Sales Receipt","05-07-2024","2800",,"Arqam minimart","Zelia Dishwashing Paste 400g","Cost of Goods Sold","Zelia Dishwashing Paste",,"Undeposited Funds",1057.43,"",284329.98
,"Sales Receipt","05-07-2024","2513",,"Homecare Enterprise","Zelia Dishwashing Paste 400g","Cost of Goods Sold","Zelia Dishwashing Paste",,"Undeposited Funds",528.72,"",284858.70
,"Sales Receipt","06-07-2024","2515",,"Horn of Africa","Zelia Dishwashing Paste 400g","Cost of Goods Sold","Zelia Dishwashing Paste",,"Undeposited Funds",1057.43,"",285916.13
,"Sales Receipt","06-07-2024","2516",,"Baraka Cerials","Zelia Dishwashing Paste 400g","Cost of Goods Sold","Zelia Dishwashing Paste",,"Undeposited Funds",264.36,"",286180.49
,"Sales Receipt","08-07-2024","2527",,"Afro Drip LTD","Zelia Dishwashing Paste 400g","Cost of Goods Sold","Zelia Dishwashing Paste",,"Undeposited Funds",88.12,"",286268.61
,"Sales Receipt","08-07-2024","2517",,"Hidika Shop","Zelia Dishwashing Paste 400g","Cost of Goods Sold","Zelia Dishwashing Paste",,"Undeposited Funds",1057.43,"",287326.04
,"Sales Receipt","09-07-2024","2509",,"Cash Sales","Zelia Dishwashing Paste 400g","Cost of Goods Sold","Zelia Dishwashing Paste",,"Undeposited Funds",44.06,"",287370.10
,"Sales Receipt","09-07-2024","2512",,"Cash Sales","Zelia Dishwashing Paste 400g","Cost of Goods Sold","Zelia Dishwashing Paste",,"Undeposited Funds",176.24,"",287546.34
,"Sales Receipt","09-07-2024","2525",,"Cash Sales","Zelia Dishwashing Paste 400g","Cost of Goods Sold","Zelia Dishwashing Paste",,"Undeposited Funds",528.72,"",288075.06
,"Sales Receipt","09-07-2024","2526",,"Cash Sales","Zelia Dishwashing Paste 400g","Cost of Goods Sold","Zelia Dishwashing Paste",,"Undeposited Funds",44.06,"",288119.12
,"Sales Receipt","09-07-2024","2524",,"Towba general stores Parkroad","Zelia Dishwashing Paste 400g","Cost of Goods Sold","Zelia Dishwashing Paste",,"Undeposited Funds",1057.43,"",289176.55
,"Sales Receipt","10-07-2024","2556",,"Ekai moke wholesale","Zelia Dishwashing Paste 400g","Cost of Goods Sold","Zelia Dishwashing Paste",,"Undeposited Funds",1057.43,"",290233.98
,"Sales Receipt","10-07-2024","2532",,"Norhani Groceries","Zelia Dishwashing Paste 400g","Cost of Goods Sold","Zelia Dishwashing Paste",,"Undeposited Funds",528.72,"",290762.70
,"Sales Receipt","10-07-2024","2533",,"Mega Shop","Zelia Dishwashing Paste 400g","Cost of Goods Sold","Zelia Dishwashing Paste",,"Undeposited Funds",1057.43,"",291820.13
,"Sales Receipt","10-07-2024","2534",,"Dhagaxtuur","Zelia Dishwashing Paste 400g","Cost of Goods Sold","Zelia Dishwashing Paste",,"Undeposited Funds",2114.87,"",293935.00
,"Sales Receipt","12-07-2024","2537",,"Cash Sales","Zelia Dishwashing Paste 400g","Cost of Goods Sold","Zelia Dishwashing Paste",,"Undeposited Funds",528.72,"",294463.72
,"Sales Receipt","12-07-2024","2538",,"Cash Sales","Zelia Dishwashing Paste 400g","Cost of Goods Sold","Zelia Dishwashing Paste",,"Undeposited Funds",176.24,"",294639.96
,"Sales Receipt","12-07-2024","2539",,"Cash Sales","Zelia Dishwashing Paste 400g","Cost of Goods Sold","Zelia Dishwashing Paste",,"Undeposited Funds",176.24,"",294816.20
,"Sales Receipt","13-07-2024","2654",,"Damim Mart","Zelia Dishwashing Paste 400g","Cost of Goods Sold","Zelia Dishwashing Paste",,"Undeposited Funds",1321.79,"",296137.99
,"Invoice","15-07-2024","MC05921",,"OFFSHORE GLOBAL LOGISTICS LIMITED","Zelia Dishwashing Paste 400g","Cost of Goods Sold","Zelia Dishwashing Paste",,"Accounts Receivable",88.12,"",296226.11
,"Invoice","15-07-2024","MC05924",,"Azaavi Collections Limited","Zelia Dishwashing Paste 400g","Cost of Goods Sold","Zelia Dishwashing Paste",,"Accounts Receivable",44.06,"",296270.17
,"Invoice","15-07-2024","MC05931",,"KASAMAT INVESTMENTS LTD","Zelia Dishwashing Paste 400g","Cost of Goods Sold","Zelia Dishwashing Paste",,"Accounts Receivable",264.36,"",296534.53
,"Invoice","15-07-2024","MC05932",,"ROYMATT SUPERMARKET LIMITED","Zelia Dishwashing Paste 400g","Cost of Goods Sold","Zelia Dishwashing Paste",,"Accounts Receivable",264.36,"",296798.89
,"Sales Receipt","15-07-2024","2543",,"Cash Sales","Zelia Dishwashing Paste 400g","Cost of Goods Sold","Zelia Dishwashing Paste",,"Undeposited Funds",44.06,"",296842.95
,"Sales Receipt","15-07-2024","2546",,"Brinso Foodstufs","Zelia Dishwashing Paste 400g","Cost of Goods Sold","Zelia Dishwashing Paste",,"Undeposited Funds",1057.43,"",297900.38
,"Sales Receipt","15-07-2024","2545",,"Taam Wholesalers","Zelia Dishwashing Paste 400g","Cost of Goods Sold","Zelia Dishwashing Paste",,"Undeposited Funds",5287.16,"",303187.54
,"Sales Receipt","16-07-2024","2557",,"Somo 1 Mowlem","Zelia Dishwashing Paste 400g","Cost of Goods Sold","Zelia Dishwashing Paste",,"Undeposited Funds",528.72,"",303716.26
,"Sales Receipt","16-07-2024","2558",,"Somo Supermarket","Zelia Dishwashing Paste 400g","Cost of Goods Sold","Zelia Dishwashing Paste",,"Undeposited Funds",528.72,"",304244.98
,"Invoice","17-07-2024","MC05941",,"Ck Upscales Limited","Zelia Dishwashing Paste 400g","Cost of Goods Sold","Zelia Dishwashing Paste",,"Accounts Receivable",1057.43,"",305302.41
,"Invoice","17-07-2024","MC05939",,"DISII TRADERS LTD","Zelia Dishwashing Paste 400g","Cost of Goods Sold","Zelia Dishwashing Paste",,"Accounts Receivable",1057.43,"",306359.84
,"Sales Receipt","17-07-2024","2552",,"Cash Sales","Zelia Dishwashing Paste 400g","Cost of Goods Sold","Zelia Dishwashing Paste",,"Undeposited Funds",176.24,"",306536.08
,"Sales Receipt","17-07-2024","2562",,"Fresh Finds Mart","Zelia Dishwashing Paste 400g","Cost of Goods Sold","Zelia Dishwashing Paste",,"Undeposited Funds",528.72,"",307064.80
,"Sales Receipt","17-07-2024","2560",,"Beraccah Syokimau","Zelia Dishwashing Paste 400g","Cost of Goods Sold","Zelia Dishwashing Paste",,"Undeposited Funds",528.72,"",307593.52
,"Sales Receipt","18-07-2024","2564",,"Cash Sales","Zelia Dishwashing Paste 400g","Cost of Goods Sold","Zelia Dishwashing Paste",,"Undeposited Funds",88.12,"",307681.64
,"Sales Receipt","18-07-2024","2566",,"Cash Sales","Zelia Dishwashing Paste 400g","Cost of Goods Sold","Zelia Dishwashing Paste",,"Undeposited Funds",176.24,"",307857.88
,"Sales Receipt","18-07-2024","2576",,"Mizpa Minimart","Zelia Dishwashing Paste 400g","Cost of Goods Sold","Zelia Dishwashing Paste",,"Undeposited Funds",264.36,"",308122.24
,"Sales Receipt","19-07-2024","2567",,"Cash Sales","Zelia Dishwashing Paste 400g","Cost of Goods Sold","Zelia Dishwashing Paste",,"Undeposited Funds",44.06,"",308166.30
,"Sales Receipt","19-07-2024","2568",,"Cash Sales","Zelia Dishwashing Paste 400g","Cost of Goods Sold","Zelia Dishwashing Paste",,"Undeposited Funds",176.24,"",308342.54
,"Sales Receipt","19-07-2024","2605",,"Restoration Traders","Zelia Dishwashing Paste 400g","Cost of Goods Sold","Zelia Dishwashing Paste",,"Undeposited Funds",2114.87,"",310457.41
,"Sales Receipt","20-07-2024","2577",,"Rosemary Store","Zelia Dishwashing Paste 400g","Cost of Goods Sold","Zelia Dishwashing Paste",,"Undeposited Funds",440.60,"",310898.01
,"Sales Receipt","20-07-2024","2579",,"Kilimanjaro Store","Zelia Dishwashing Paste 400g","Cost of Goods Sold","Zelia Dishwashing Paste",,"Undeposited Funds",1057.43,"",311955.44
,"Sales Receipt","22-07-2024","2573",,"Cash Sales","Zelia Dishwashing Paste 400g","Cost of Goods Sold","Zelia Dishwashing Paste",,"Undeposited Funds",44.06,"",311999.50
,"Sales Receipt","22-07-2024","2575",,"Cash Sales","Zelia Dishwashing Paste 400g","Cost of Goods Sold","Zelia Dishwashing Paste",,"Undeposited Funds",1057.43,"",313056.93
,"Sales Receipt","22-07-2024","2570",,"Cash Sales","Zelia Dishwashing Paste 400g","Cost of Goods Sold","Zelia Dishwashing Paste",,"Undeposited Funds",44.06,"",313100.99
,"Sales Receipt","22-07-2024","2606",,"Skype Traders","Zelia Dishwashing Paste 400g","Cost of Goods Sold","Zelia Dishwashing Paste",,"Undeposited Funds",2114.87,"",315215.86
,"Sales Receipt","23-07-2024","2582",,"Cash Sales","Zelia Dishwashing Paste 400g","Cost of Goods Sold","Zelia Dishwashing Paste",,"Undeposited Funds",176.24,"",315392.10
,"Sales Receipt","23-07-2024","2586",,"Cash Sales","Zelia Dishwashing Paste 400g","Cost of Goods Sold","Zelia Dishwashing Paste",,"Undeposited Funds",44.06,"",315436.16
,"Sales Receipt","23-07-2024","2581",,"Cash Sales","Zelia Dishwashing Paste 400g","Cost of Goods Sold","Zelia Dishwashing Paste",,"Undeposited Funds",176.24,"",315612.40
,"Sales Receipt","24-07-2024","2588",,"Cash Sales","Zelia Dishwashing Paste 400g","Cost of Goods Sold","Zelia Dishwashing Paste",,"Undeposited Funds",264.36,"",315876.76
,"Sales Receipt","24-07-2024","2589",,"Cash Sales","Zelia Dishwashing Paste 400g","Cost of Goods Sold","Zelia Dishwashing Paste",,"Undeposited Funds",88.12,"",315964.88
,"Sales Receipt","24-07-2024","2593",,"Cash Sales","Zelia Dishwashing Paste 400g","Cost of Goods Sold","Zelia Dishwashing Paste",,"Undeposited Funds",1762.39,"",317727.27
,"Sales Receipt","24-07-2024","2598",,"Zonal Minimart","Zelia Dishwashing Paste 400g","Cost of Goods Sold","Zelia Dishwashing Paste",,"Undeposited Funds",528.72,"",318255.99
,"Sales Receipt","24-07-2024","2608",,"Capital Halal","Zelia Dishwashing Paste 400g","Cost of Goods Sold","Zelia Dishwashing Paste",,"Undeposited Funds",264.36,"",318520.35
,"Sales Receipt","24-07-2024","2599",,"Goldmart Supermarket","Zelia Dishwashing Paste 400g","Cost of Goods Sold","Zelia Dishwashing Paste",,"Undeposited Funds",528.72,"",319049.07
,"Sales Receipt","25-07-2024","2609",,"Zebra Minimart","Zelia Dishwashing Paste 400g","Cost of Goods Sold","Zelia Dishwashing Paste",,"Undeposited Funds",352.48,"",319401.55
,"Sales Receipt","26-07-2024","2595",,"Cash Sales","Zelia Dishwashing Paste 400g","Cost of Goods Sold","Zelia Dishwashing Paste",,"Undeposited Funds",176.24,"",319577.79
,"Sales Receipt","27-07-2024","2601",,"Cash Sales","Zelia Dishwashing Paste 400g","Cost of Goods Sold","Zelia Dishwashing Paste",,"Undeposited Funds",88.12,"",319665.91
,"Sales Receipt","27-07-2024","2653",,"Danaba Wholesallers","Zelia Dishwashing Paste 400g","Cost of Goods Sold","Zelia Dishwashing Paste",,"Undeposited Funds",1057.43,"",320723.34
,"Sales Receipt","27-07-2024","2652",,"Mash-B Wholesale","Zelia Dishwashing Paste 400g","Cost of Goods Sold","Zelia Dishwashing Paste",,"Undeposited Funds",528.72,"",321252.06
,"Sales Receipt","27-07-2024","2655",,"Towfique Shop","Zelia Dishwashing Paste 400g","Cost of Goods Sold","Zelia Dishwashing Paste",,"Undeposited Funds",528.72,"",321780.78
,"Invoice","29-07-2024","MC05983",,"Muhaya & Rukundo Holdings Ltd","0001.12.00 Zelia Dishwashing Paste 24X400g","Cost of Goods Sold","Zelia Dishwashing Paste",,"Accounts Receivable",2100.78,"",323881.56
,"Sales Receipt","29-07-2024","2602",,"Cash Sales","Zelia Dishwashing Paste 400g","Cost of Goods Sold","Zelia Dishwashing Paste",,"Undeposited Funds",88.12,"",323969.68
,"Sales Receipt","29-07-2024","2603",,"Cash Sales","Zelia Dishwashing Paste 400g","Cost of Goods Sold","Zelia Dishwashing Paste",,"Undeposited Funds",44.06,"",324013.74
,"Sales Receipt","29-07-2024","2617",,"Mama G shop","Zelia Dishwashing Paste 400g","Cost of Goods Sold","Zelia Dishwashing Paste",,"Undeposited Funds",1057.43,"",325071.17
,"Build Assembly","29-07-2024","11036",,,,"Cost of Goods Sold","Zelia Dishwashing Paste","X","-SPLIT-",81.31,"",325152.48
,"Sales Receipt","29-07-2024","2922",,"Muhaya & Rukundo Holdings Ltd","Zelia Dishwashing Paste 24X400g","Cost of Goods Sold","Zelia Dishwashing Paste",,"Undeposited Funds",2100.78,"",327253.26
,"Invoice","30-07-2024","MC05985",,"LUCKY MART SUPERMARKET LIMITED","Zelia Dishwashing Paste 400g","Cost of Goods Sold","Zelia Dishwashing Paste",,"Accounts Receivable",264.36,"",327517.62
,"Sales Receipt","30-07-2024","2620",,"Cash Sales","Zelia Dishwashing Paste 400g","Cost of Goods Sold","Zelia Dishwashing Paste",,"Undeposited Funds",44.06,"",327561.68
,"Sales Receipt","30-07-2024","2629",,"Cash Sales","Zelia Dishwashing Paste 400g","Cost of Goods Sold","Zelia Dishwashing Paste",,"Undeposited Funds",44.06,"",327605.74
,"Sales Receipt","30-07-2024","2621",,"Moyale Shop","Zelia Dishwashing Paste 400g","Cost of Goods Sold","Zelia Dishwashing Paste",,"Undeposited Funds",1057.43,"",328663.17
,"Sales Receipt","30-07-2024","2623",,"Smart Choice","Zelia Dishwashing Paste 400g","Cost of Goods Sold","Zelia Dishwashing Paste",,"Undeposited Funds",528.72,"",329191.89
,"Sales Receipt","30-07-2024","2627",,"Elliane Wholesalers","Zelia Dishwashing Paste 400g","Cost of Goods Sold","Zelia Dishwashing Paste",,"Undeposited Funds",264.36,"",329456.25
,"Sales Receipt","30-07-2024","2689",,"Mt Kenya  mart","Zelia Dishwashing Paste 400g","Cost of Goods Sold","Zelia Dishwashing Paste",,"Undeposited Funds",528.72,"",329984.97
,"Sales Receipt","31-07-2024","2632",,"Al Naim Stores","Zelia Dishwashing Paste 400g","Cost of Goods Sold","Zelia Dishwashing Paste",,"Undeposited Funds",1057.43,"",331042.40
,"Sales Receipt","01-08-2024","2637",,"Burhani Shop","Zelia Dishwashing Paste 400g","Cost of Goods Sold","Zelia Dishwashing Paste",,"Undeposited Funds",528.72,"",331571.12
,"Sales Receipt","01-08-2024","2691",,"Ubwere Store","-MULTIPLE-","Cost of Goods Sold","Zelia Dishwashing Paste",,"Undeposited Funds",1514.88,"",333086.00
,"Sales Receipt","01-08-2024","2664",,"Mkulima Supermarket","Zelia Dishwashing Paste 400g","Cost of Goods Sold","Zelia Dishwashing Paste",,"Undeposited Funds",528.72,"",333614.72
,"Sales Receipt","02-08-2024","2644",,"Cash Sales","Zelia Dishwashing Paste 500g","Cost of Goods Sold","Zelia Dishwashing Paste",,"Undeposited Funds",55.07,"",333669.79
,"Sales Receipt","02-08-2024","2645",,"Cash Sales","Zelia Dishwashing Paste 800g","Cost of Goods Sold","Zelia Dishwashing Paste",,"Undeposited Funds",82.18,"",333751.97
,"Sales Receipt","02-08-2024","2648",,"Cash Sales","Zelia Dishwashing Paste 400g","Cost of Goods Sold","Zelia Dishwashing Paste",,"Undeposited Funds",176.24,"",333928.21
,"Sales Receipt","02-08-2024","2649",,"Cash Sales","Zelia Dishwashing Paste 400g","Cost of Goods Sold","Zelia Dishwashing Paste",,"Undeposited Funds",88.12,"",334016.33
,"Sales Receipt","02-08-2024","2650",,"Cash Sales","Zelia Dishwashing Paste 400g","Cost of Goods Sold","Zelia Dishwashing Paste",,"Undeposited Funds",176.24,"",334192.57
,"Sales Receipt","02-08-2024","2667",,"Safa Mart Wholesalers","Zelia Dishwashing Paste 400g","Cost of Goods Sold","Zelia Dishwashing Paste",,"Undeposited Funds",1057.43,"",335250.00
,"Sales Receipt","03-08-2024","2668",,"Freshtake wholesalers","Zelia Dishwashing Paste 400g","Cost of Goods Sold","Zelia Dishwashing Paste",,"Undeposited Funds",528.72,"",335778.72
,"Build Assembly","05-08-2024","11046",,,,"Cost of Goods Sold","Zelia Dishwashing Paste","X","-SPLIT-","",28.90,335749.82
,"Sales Receipt","05-08-2024","2673",,"Gure Yare Shop","-MULTIPLE-","Cost of Goods Sold","Zelia Dishwashing Paste",,"Undeposited Funds",4033.83,"",339783.65
,"Sales Receipt","05-08-2024","2675",,"Adurus Wholesallers","Zelia Dishwashing Paste 400g","Cost of Goods Sold","Zelia Dishwashing Paste",,"Undeposited Funds",1057.43,"",340841.08
,"Invoice","06-08-2024","MC06004",,"HAPPY VIEW SUPERMARKET LIMITED","Zelia Dishwashing Paste 400g","Cost of Goods Sold","Zelia Dishwashing Paste",,"Accounts Receivable",264.36,"",341105.44
,"Sales Receipt","06-08-2024","2659",,"Cash Sales","Zelia Dishwashing Paste 400g","Cost of Goods Sold","Zelia Dishwashing Paste",,"Undeposited Funds",176.24,"",341281.68
,"Sales Receipt","06-08-2024","2663",,"Cash Sales","Zelia Dishwashing Paste 400g","Cost of Goods Sold","Zelia Dishwashing Paste",,"Undeposited Funds",176.24,"",341457.92
,"Sales Receipt","06-08-2024","2676",,"Warfa Wholesale","Zelia Dishwashing Paste 800g","Cost of Goods Sold","Zelia Dishwashing Paste",,"Undeposited Funds",1918.96,"",343376.88
,"Sales Receipt","06-08-2024","2678",,"Farhan Wholesallers","-MULTIPLE-","Cost of Goods Sold","Zelia Dishwashing Paste",,"Undeposited Funds",2976.39,"",346353.27
,"Sales Receipt","06-08-2024","2665",,"Kenafa Wholesalers","Zelia Dishwashing Paste 400g","Cost of Goods Sold","Zelia Dishwashing Paste",,"Undeposited Funds",1057.43,"",347410.70
,"Sales Receipt","06-08-2024","2680",,"Juja Minimart","-MULTIPLE-","Cost of Goods Sold","Zelia Dishwashing Paste",,"Undeposited Funds",2976.39,"",350387.09
,"Sales Receipt","06-08-2024","2681",,"Adam Boss","Zelia Dishwashing Paste 800g","Cost of Goods Sold","Zelia Dishwashing Paste",,"Undeposited Funds",1918.96,"",352306.05
,"Invoice","07-08-2024","MC06006",,"NASRI MART LIMITED","Zelia Dishwashing Paste 400g","Cost of Goods Sold","Zelia Dishwashing Paste",,"Accounts Receivable",264.36,"",352570.41
,"Sales Receipt","07-08-2024","2686",,"Soimo Minimart","Zelia Dishwashing Paste 400g","Cost of Goods Sold","Zelia Dishwashing Paste",,"Undeposited Funds",528.72,"",353099.13
,"Invoice","08-08-2024","MC06015",,"Burhani Private Mart Limited","Zelia Dishwashing Paste 400g","Cost of Goods Sold","Zelia Dishwashing Paste",,"Accounts Receivable",528.72,"",353627.85
,"Invoice","08-08-2024","MC06016",,"DISII TRADERS LTD","Zelia Dishwashing Paste 400g","Cost of Goods Sold","Zelia Dishwashing Paste",,"Accounts Receivable",528.72,"",354156.57
,"Invoice","08-08-2024","MC06018",,"OFFSHORE GLOBAL LOGISTICS LIMITED","Zelia Dishwashing Paste 400g","Cost of Goods Sold","Zelia Dishwashing Paste",,"Accounts Receivable",132.18,"",354288.75
,"Sales Receipt","08-08-2024","2672",,"Cash Sales","Zelia Dishwashing Paste 400g","Cost of Goods Sold","Zelia Dishwashing Paste",,"Undeposited Funds",176.24,"",354464.99
,"Sales Receipt","09-08-2024","2692",,"Cash Sales","Zelia Dishwashing Paste 400g","Cost of Goods Sold","Zelia Dishwashing Paste",,"Undeposited Funds",176.24,"",354641.23
,"Sales Receipt","09-08-2024","2695",,"Cash Sales","Zelia Dishwashing Paste 400g","Cost of Goods Sold","Zelia Dishwashing Paste",,"Undeposited Funds",88.12,"",354729.35
,"Invoice","12-08-2024","MC06031",,"KAVYA SUPERMARKET LIMITED","Zelia Dishwashing Paste 400g","Cost of Goods Sold","Zelia Dishwashing Paste",,"Accounts Receivable",1057.43,"",355786.78
,"Sales Receipt","12-08-2024","2810",,"Cash Sales","Zelia Dishwashing Paste 400g","Cost of Goods Sold","Zelia Dishwashing Paste",,"Undeposited Funds",176.24,"",355963.02
,"Sales Receipt","12-08-2024","2813",,"Mamken Minimart","Zelia Dishwashing Paste 400g","Cost of Goods Sold","Zelia Dishwashing Paste",,"Undeposited Funds",264.36,"",356227.38
,"Sales Receipt","12-08-2024","2815",,"Kibibi Wasai Store","Zelia Dishwashing Paste 400g","Cost of Goods Sold","Zelia Dishwashing Paste",,"Undeposited Funds",264.36,"",356491.74
,"Sales Receipt","12-08-2024","2818",,"Rumi Wholesalers","Zelia Dishwashing Paste 400g","Cost of Goods Sold","Zelia Dishwashing Paste",,"Undeposited Funds",2114.87,"",358606.61
,"Sales Receipt","13-08-2024","2848",,"Discount Traders","Zelia Dishwashing Paste 400g","Cost of Goods Sold","Zelia Dishwashing Paste",,"Undeposited Funds",1057.43,"",359664.04
,"Sales Receipt","13-08-2024","2819",,"Tawakal Shop","Zelia Dishwashing Paste 400g","Cost of Goods Sold","Zelia Dishwashing Paste",,"Undeposited Funds",1057.43,"",360721.47
,"Sales Receipt","14-08-2024","2833",,"Mama Hamdi","Zelia Dishwashing Paste 400g","Cost of Goods Sold","Zelia Dishwashing Paste",,"Undeposited Funds",1057.43,"",361778.90
,"Sales Receipt","14-08-2024","2831",,"Jamilas Store","Zelia Dishwashing Paste 400g","Cost of Goods Sold","Zelia Dishwashing Paste",,"Undeposited Funds",1057.43,"",362836.33
,"Sales Receipt","14-08-2024","2830",,"Hussein Soko Store","Zelia Dishwashing Paste 400g","Cost of Goods Sold","Zelia Dishwashing Paste",,"Undeposited Funds",264.36,"",363100.69
,"Sales Receipt","14-08-2024","2829",,"First Choice","Zelia Dishwashing Paste 400g","Cost of Goods Sold","Zelia Dishwashing Paste",,"Undeposited Funds",1057.43,"",364158.12
,"Sales Receipt","15-08-2024","2824",,"Cash Sales","Zelia Dishwashing Paste 800g","Cost of Goods Sold","Zelia Dishwashing Paste",,"Undeposited Funds",239.87,"",364397.99
,"Sales Receipt","15-08-2024","2825",,"Cash Sales","Zelia Dishwashing Paste 400g","Cost of Goods Sold","Zelia Dishwashing Paste",,"Undeposited Funds",176.24,"",364574.23
,"Sales Receipt","15-08-2024","2826",,"Cash Sales","Zelia Dishwashing Paste 400g","Cost of Goods Sold","Zelia Dishwashing Paste",,"Undeposited Funds",528.72,"",365102.95
,"Sales Receipt","15-08-2024","2828",,"Nabcom Wholesalers","Zelia Dishwashing Paste 400g","Cost of Goods Sold","Zelia Dishwashing Paste",,"Undeposited Funds",528.72,"",365631.67
,"Sales Receipt","15-08-2024","2892",,"Makueni Store","Zelia Dishwashing Paste 400g","Cost of Goods Sold","Zelia Dishwashing Paste",,"Undeposited Funds",44.06,"",365675.73
,"Sales Receipt","15-08-2024","2846",,"Hogol Wholesale","-MULTIPLE-","Cost of Goods Sold","Zelia Dishwashing Paste",,"Undeposited Funds",7969.70,"",373645.43
,"Sales Receipt","15-08-2024","2845",,"Rajah Foodstuffs","Zelia Dishwashing Paste 800g","Cost of Goods Sold","Zelia Dishwashing Paste",,"Undeposited Funds",1918.96,"",375564.39
,"Sales Receipt","15-08-2024","2844",,"Tusma Wholesale","-MULTIPLE-","Cost of Goods Sold","Zelia Dishwashing Paste",,"Undeposited Funds",2016.91,"",377581.30
,"Sales Receipt","16-08-2024","2850",,"Hawkers Paradise","Zelia Dishwashing Paste 400g","Cost of Goods Sold","Zelia Dishwashing Paste",,"Undeposited Funds",264.36,"",377845.66
,"Sales Receipt","16-08-2024","2851",,"Tahila Enterprises","Zelia Dishwashing Paste 400g","Cost of Goods Sold","Zelia Dishwashing Paste",,"Undeposited Funds",264.36,"",378110.02
,"Sales Receipt","16-08-2024","2852",,"032 Mart","-MULTIPLE-","Cost of Goods Sold","Zelia Dishwashing Paste",,"Undeposited Funds",372.05,"",378482.07
,"Invoice","19-08-2024","MC06050",,"Azaavi Collections Limited","Zelia Dishwashing Paste 400g","Cost of Goods Sold","Zelia Dishwashing Paste",,"Accounts Receivable",44.06,"",378526.13
,"Sales Receipt","19-08-2024","2838",,"Cash Sales","Zelia Dishwashing Paste 400g","Cost of Goods Sold","Zelia Dishwashing Paste",,"Undeposited Funds",132.18,"",378658.31
,"Sales Receipt","19-08-2024","2839",,"Cash Sales","Zelia Dishwashing Paste 400g","Cost of Goods Sold","Zelia Dishwashing Paste",,"Undeposited Funds",88.12,"",378746.43
,"Sales Receipt","19-08-2024","2840",,"Cash Sales","Zelia Dishwashing Paste 400g","Cost of Goods Sold","Zelia Dishwashing Paste",,"Undeposited Funds",44.06,"",378790.49
,"Sales Receipt","19-08-2024","2841",,"Cash Sales","Zelia Dishwashing Paste 400g","Cost of Goods Sold","Zelia Dishwashing Paste",,"Undeposited Funds",44.06,"",378834.55
,"Sales Receipt","20-08-2024","2858",,"Home Soko Minimart","Zelia Dishwashing Paste 400g","Cost of Goods Sold","Zelia Dishwashing Paste",,"Undeposited Funds",528.72,"",379363.27
,"Sales Receipt","20-08-2024","2859",,"Nzuri Supermarket","Zelia Dishwashing Paste 400g","Cost of Goods Sold","Zelia Dishwashing Paste",,"Undeposited Funds",264.36,"",379627.63
,"Credit Note","21-08-2024","CN01064",,"Muhaya & Rukundo Holdings Ltd","0001.12.00 Zelia Dishwashing Paste 24X400g","Cost of Goods Sold","Zelia Dishwashing Paste",,"Accounts Receivable","",2100.78,377526.85
,"Invoice","21-08-2024","MC06061",,"Muhaya & Rukundo Holdings Ltd","-MULTIPLE-","Cost of Goods Sold","Zelia Dishwashing Paste",,"Accounts Receivable",123422.82,"",500949.67
,"Invoice","21-08-2024","MC06062",,"Muhaya & Rukundo Holdings Ltd","0001.12.00 Outer Zelia Paste 12x800g/24x400g","Cost of Goods Sold","Zelia Dishwashing Paste",,"Accounts Receivable",336.12,"",501285.79
,"Sales Receipt","21-08-2024","2853",,"Cash Sales","Zelia Dishwashing Paste 400g","Cost of Goods Sold","Zelia Dishwashing Paste",,"Undeposited Funds",176.24,"",501462.03
,"Sales Receipt","21-08-2024","2861",,"Al Towba Shop","Zelia Dishwashing Paste 800g","Cost of Goods Sold","Zelia Dishwashing Paste",,"Undeposited Funds",959.48,"",502421.51
,"Sales Receipt","21-08-2024","2862",,"Salma Shop","Zelia Dishwashing Paste 400g","Cost of Goods Sold","Zelia Dishwashing Paste",,"Undeposited Funds",1057.43,"",503478.94
,"Build Assembly","21-08-2024","11296",,,,"Cost of Goods Sold","Zelia Dishwashing Paste","X","-SPLIT-","",3193.42,500285.52
,"Build Assembly","21-08-2024","11298",,,,"Cost of Goods Sold","Zelia Dishwashing Paste","X","-SPLIT-","",622.75,499662.77
,"Invoice","22-08-2024","MC06066",,"Cash Sales","Zelia Dishwashing Paste 800g","Cost of Goods Sold","Zelia Dishwashing Paste",,"Accounts Receivable",79.96,"",499742.73
,"Invoice","22-08-2024","MC06067",,"Cash Sales","Zelia Dishwashing Paste 800g","Cost of Goods Sold","Zelia Dishwashing Paste",,"Accounts Receivable",79.96,"",499822.69
,"Credit Note","22-08-2024","CN01065",,"Cash Sales","Zelia Dishwashing Paste 800g","Cost of Goods Sold","Zelia Dishwashing Paste",,"Accounts Receivable","",79.96,499742.73
,"Credit Note","22-08-2024","CN01066",,"Cash Sales","Zelia Dishwashing Paste 800g","Cost of Goods Sold","Zelia Dishwashing Paste",,"Accounts Receivable","",79.96,499662.77
,"Invoice","22-08-2024","MC06070",,"LUCKY MART SUPERMARKET LIMITED","Zelia Dishwashing Paste 400g","Cost of Goods Sold","Zelia Dishwashing Paste",,"Accounts Receivable",264.36,"",499927.13
,"Sales Receipt","22-08-2024","2867",,"Sultan Iman Shop","Zelia Dishwashing Paste 400g","Cost of Goods Sold","Zelia Dishwashing Paste",,"Undeposited Funds",1057.43,"",500984.56
,"Sales Receipt","22-08-2024","2875",,"Maida Minimart","Zelia Dishwashing Paste 400g","Cost of Goods Sold","Zelia Dishwashing Paste",,"Undeposited Funds",264.36,"",501248.92
,"Sales Receipt","22-08-2024","2897",,"Hayan Wholesalers","-MULTIPLE-","Cost of Goods Sold","Zelia Dishwashing Paste",,"Undeposited Funds",2016.91,"",503265.83
,"Sales Receipt","22-08-2024","1135",,"Ebenezer Minimart","Zelia Dishwashing Paste 400g","Cost of Goods Sold","Zelia Dishwashing Paste",,"Undeposited Funds",264.36,"",503530.19
,"Sales Receipt","22-08-2024","1206",,"Tangents Minimart","Zelia Dishwashing Paste 400g","Cost of Goods Sold","Zelia Dishwashing Paste",,"Undeposited Funds",132.18,"",503662.37
,"Sales Receipt","23-08-2024","2872",,"Cash Sales","Zelia Dishwashing Paste 400g","Cost of Goods Sold","Zelia Dishwashing Paste",,"Undeposited Funds",176.24,"",503838.61
,"Sales Receipt","23-08-2024","2877",,"Cash Sales","Zelia Dishwashing Paste 800g","Cost of Goods Sold","Zelia Dishwashing Paste",,"Undeposited Funds",79.96,"",503918.57
,"Sales Receipt","23-08-2024","2880",,"Cash Sales","Zelia Dishwashing Paste 800g","Cost of Goods Sold","Zelia Dishwashing Paste",,"Undeposited Funds",79.96,"",503998.53
,"Sales Receipt","23-08-2024","2881",,"Cash Sales","Zelia Dishwashing Paste 800g","Cost of Goods Sold","Zelia Dishwashing Paste",,"Undeposited Funds",79.96,"",504078.49
,"Sales Receipt","23-08-2024","2874",,"Amir shop","Zelia Dishwashing Paste 400g","Cost of Goods Sold","Zelia Dishwashing Paste",,"Undeposited Funds",1057.43,"",505135.92
,"Sales Receipt","24-08-2024","2887",,"Brightfood Nasra","Zelia Dishwashing Paste 400g","Cost of Goods Sold","Zelia Dishwashing Paste",,"Undeposited Funds",264.36,"",505400.28
,"Sales Receipt","26-08-2024","2882",,"Cash Sales","Zelia Dishwashing Paste 800g","Cost of Goods Sold","Zelia Dishwashing Paste",,"Undeposited Funds",79.96,"",505480.24
,"Sales Receipt","26-08-2024","2883",,"Cash Sales","Zelia Dishwashing Paste 400g","Cost of Goods Sold","Zelia Dishwashing Paste",,"Undeposited Funds",132.18,"",505612.42
,"Sales Receipt","26-08-2024","2886",,"Cash Sales","Zelia Dishwashing Paste 800g","Cost of Goods Sold","Zelia Dishwashing Paste",,"Undeposited Funds",159.91,"",505772.33
,"Sales Receipt","27-08-2024","2895",,"Cash Sales","Zelia Dishwashing Paste 800g","Cost of Goods Sold","Zelia Dishwashing Paste",,"Undeposited Funds",79.01,"",505851.34
,"Sales Receipt","28-08-2024","2913",,"Gods Favour","Zelia Dishwashing Paste 400g","Cost of Goods Sold","Zelia Dishwashing Paste",,"Undeposited Funds",528.72,"",506380.06
,"Sales Receipt","29-08-2024","AT201",,"Cash Sales","-MULTIPLE-","Cost of Goods Sold","Zelia Dishwashing Paste",,"Undeposited Funds",1474.04,"",507854.10
,"Sales Receipt","29-08-2024","965",,"Mombasa Velvet","Zelia Dishwashing Paste 400g","Cost of Goods Sold","Zelia Dishwashing Paste",,"Undeposited Funds",264.36,"",508118.46
,"Sales Receipt","31-08-2024","1151",,"Hussein Soko Store","Zelia Dishwashing Paste 400g","Cost of Goods Sold","Zelia Dishwashing Paste",,"Undeposited Funds",264.36,"",508382.82
,"Sales Receipt","02-09-2024","3225",,"Purity Shop","Zelia Dishwashing Paste 24X400g","Cost of Goods Sold","Zelia Dishwashing Paste",,"Undeposited Funds",175.07,"",508557.89
,"Sales Receipt","02-09-2024","2923",,"Blossom Beauty","Zelia Dishwashing Paste 24X400g","Cost of Goods Sold","Zelia Dishwashing Paste",,"Undeposited Funds",262.60,"",508820.49
,"Sales Receipt","02-09-2024","2924",,"Rio Deli Wholesalers","-MULTIPLE-","Cost of Goods Sold","Zelia Dishwashing Paste",,"Undeposited Funds",2074.62,"",510895.11
,"Sales Receipt","02-09-2024","3008",,"Cash Sales","-MULTIPLE-","Cost of Goods Sold","Zelia Dishwashing Paste",,"Undeposited Funds",172.88,"",511067.99
,"Sales Receipt","02-09-2024","3010",,"Cash Sales","-MULTIPLE-","Cost of Goods Sold","Zelia Dishwashing Paste",,"Undeposited Funds",302.01,"",511370.00
,"Sales Receipt","02-09-2024","2920",,"Cash Sales","Zelia Dishwashing Paste 24X400g","Cost of Goods Sold","Zelia Dishwashing Paste",,"Undeposited Funds",350.13,"",511720.13
,"Sales Receipt","03-09-2024","2936",,"Jumaira Wholesale","-MULTIPLE-","Cost of Goods Sold","Zelia Dishwashing Paste",,"Undeposited Funds",4149.24,"",515869.37
,"Sales Receipt","03-09-2024","2927",,"Cash Sales","Zelia Dishwashing Paste 12X800g","Cost of Goods Sold","Zelia Dishwashing Paste",,"Undeposited Funds",85.35,"",515954.72
,"Sales Receipt","03-09-2024","2922",,"Cash Sales","Zelia Dishwashing Paste 24X400g","Cost of Goods Sold","Zelia Dishwashing Paste",,"Undeposited Funds",43.77,"",515998.49
,"Invoice","04-09-2024","MC06107",,"Tupo Mart Limited","Zelia Dishwashing Paste 400g New","Cost of Goods Sold","Zelia Dishwashing Paste",,"Accounts Receivable",244.77,"",516243.26
,"Invoice","04-09-2024","MC06108",,"PRICE CHOPPER STORES LIMITED","Zelia Dishwashing Paste 400g New","Cost of Goods Sold","Zelia Dishwashing Paste",,"Accounts Receivable",244.77,"",516488.03
,"Invoice","04-09-2024","MC06109",,"ROYMATT SUPERMARKET LIMITED","Zelia Dishwashing Paste 400g New","Cost of Goods Sold","Zelia Dishwashing Paste",,"Accounts Receivable",285.57,"",516773.60
,"Sales Receipt","04-09-2024","2940",,"Kenafa Wholesalers","Zelia Dishwashing Paste 24X400g","Cost of Goods Sold","Zelia Dishwashing Paste",,"Undeposited Funds",1050.39,"",517823.99
,"Sales Receipt","04-09-2024","2941",,"BCB Shop","Zelia Dishwashing Paste 12X800g","Cost of Goods Sold","Zelia Dishwashing Paste",,"Undeposited Funds",1024.23,"",518848.22
,"Sales Receipt","04-09-2024","2942",,"SK Groceries","Zelia Dishwashing Paste 24X400g","Cost of Goods Sold","Zelia Dishwashing Paste",,"Undeposited Funds",1050.39,"",519898.61
,"Sales Receipt","04-09-2024","2932",,"Cash Sales","Zelia Dishwashing Paste 12X800g","Cost of Goods Sold","Zelia Dishwashing Paste",,"Undeposited Funds",85.35,"",519983.96
,"Sales Receipt","04-09-2024","2933",,"Cash Sales","Zelia Dishwashing Paste 12X800g","Cost of Goods Sold","Zelia Dishwashing Paste",,"Undeposited Funds",85.35,"",520069.31
,"Invoice","05-09-2024","MC06120",,"ROYMATT SUPERMARKET LIMITED","Zelia Dishwashing Paste 400g New","Cost of Goods Sold","Zelia Dishwashing Paste",,"Accounts Receivable",203.97,"",520273.28
,"Sales Receipt","05-09-2024","2946",,"Ilyas Wholesale","Zelia Dishwashing Paste 24X400g","Cost of Goods Sold","Zelia Dishwashing Paste",,"Undeposited Funds",1050.39,"",521323.67
,"Sales Receipt","05-09-2024","2948",,"Jam Tower Shop","-MULTIPLE-","Cost of Goods Sold","Zelia Dishwashing Paste",,"Undeposited Funds",1549.43,"",522873.10
,"Sales Receipt","05-09-2024","2967",,"Freshtake wholesalers","Zelia Dishwashing Paste 12X800g","Cost of Goods Sold","Zelia Dishwashing Paste",,"Undeposited Funds",512.12,"",523385.22
,"Sales Receipt","05-09-2024","2944",,"Cash Sales","-MULTIPLE-","Cost of Goods Sold","Zelia Dishwashing Paste",,"Undeposited Funds",172.88,"",523558.10
,"Sales Receipt","05-09-2024","2950",,"Cash Sales","Zelia Dishwashing Paste 24X400g","Cost of Goods Sold","Zelia Dishwashing Paste",,"Undeposited Funds",175.07,"",523733.17
,"Sales Receipt","05-09-2024","2951",,"Cash Sales","Zelia Dishwashing Paste 24X400g","Cost of Goods Sold","Zelia Dishwashing Paste",,"Undeposited Funds",43.77,"",523776.94
,"Sales Receipt","05-09-2024","2953",,"Cash Sales","Zelia Dishwashing Paste 24X400g","Cost of Goods Sold","Zelia Dishwashing Paste",,"Undeposited Funds",131.30,"",523908.24
,"Sales Receipt","05-09-2024","2955",,"Cash Sales","Zelia Dishwashing Paste 12X800g","Cost of Goods Sold","Zelia Dishwashing Paste",,"Undeposited Funds",170.71,"",524078.95
,"Sales Receipt","05-09-2024","2952",,"Cash Sales","Zelia Dishwashing Paste 24X400g","Cost of Goods Sold","Zelia Dishwashing Paste",,"Undeposited Funds",131.30,"",524210.25
,"Sales Receipt","06-09-2024","2963",,"Nabcom Stores","Zelia Dishwashing Paste 12X800g","Cost of Goods Sold","Zelia Dishwashing Paste",,"Undeposited Funds",1024.23,"",525234.48
,"Sales Receipt","06-09-2024","2957",,"Cash Sales","Zelia Dishwashing Paste 12X800g","Cost of Goods Sold","Zelia Dishwashing Paste",,"Undeposited Funds",85.35,"",525319.83
,"Sales Receipt","06-09-2024","2958",,"Cash Sales","Zelia Dishwashing Paste 12X800g","Cost of Goods Sold","Zelia Dishwashing Paste",,"Undeposited Funds",85.35,"",525405.18
,"Sales Receipt","08-09-2024","3227",,"Visina Stores","Zelia Dishwashing Paste 24X400g","Cost of Goods Sold","Zelia Dishwashing Paste",,"Undeposited Funds",6127.28,"",531532.46
,"Sales Receipt","09-09-2024","2968",,"Hidika Shop","Zelia Dishwashing Paste 24X400g","Cost of Goods Sold","Zelia Dishwashing Paste",,"Undeposited Funds",525.20,"",532057.66
,"Sales Receipt","09-09-2024","2960",,"Mizpa Minimart","Zelia Dishwashing Paste 12X800g","Cost of Goods Sold","Zelia Dishwashing Paste",,"Undeposited Funds",85.35,"",532143.01
,"Sales Receipt","09-09-2024","2986",,"Pambazuka Mart (K) Limited","-MULTIPLE-","Cost of Goods Sold","Zelia Dishwashing Paste",,"Undeposited Funds",1549.43,"",533692.44
,"Sales Receipt","10-09-2024","2984",,"Al manaan","-MULTIPLE-","Cost of Goods Sold","Zelia Dishwashing Paste",,"Undeposited Funds",3098.85,"",536791.29
,"Sales Receipt","10-09-2024","2991",,"Nuclear Supermarket","Zelia Dishwashing Paste 24X400g","Cost of Goods Sold","Zelia Dishwashing Paste",,"Undeposited Funds",262.60,"",537053.89
,"Sales Receipt","10-09-2024","2973",,"Cash Sales","Zelia Dishwashing Paste 12X800g","Cost of Goods Sold","Zelia Dishwashing Paste",,"Undeposited Funds",85.35,"",537139.24
,"Sales Receipt","10-09-2024","2975",,"Cash Sales","Zelia Dishwashing Paste 24X400g","Cost of Goods Sold","Zelia Dishwashing Paste",,"Undeposited Funds",175.07,"",537314.31
,"Sales Receipt","10-09-2024","3015",,"Cash Sales","Zelia Dishwashing Paste 12X800g","Cost of Goods Sold","Zelia Dishwashing Paste",,"Undeposited Funds",85.35,"",537399.66
,"Sales Receipt","10-09-2024","2976",,"Cash Sales","Zelia Dishwashing Paste 24X400g","Cost of Goods Sold","Zelia Dishwashing Paste",,"Undeposited Funds",87.53,"",537487.19
,"Sales Receipt","10-09-2024","3237",,"Cash Sales","Zelia Dishwashing Paste 24X400g","Cost of Goods Sold","Zelia Dishwashing Paste",,"Undeposited Funds",43.77,"",537530.96
,"Sales Receipt","11-09-2024","2994",,"Mutawakal Stores","-MULTIPLE-","Cost of Goods Sold","Zelia Dishwashing Paste",,"Undeposited Funds",1549.43,"",539080.39
,"Sales Receipt","11-09-2024","2995",,"Strawberry Minimart","Zelia Dishwashing Paste 12X800g","Cost of Goods Sold","Zelia Dishwashing Paste",,"Undeposited Funds",1024.23,"",540104.62
,"Sales Receipt","11-09-2024","2996",,"Freshfinds Mart","Zelia Dishwashing Paste 24X400g","Cost of Goods Sold","Zelia Dishwashing Paste",,"Undeposited Funds",1050.39,"",541155.01
,"Sales Receipt","11-09-2024","3011",,"Warfa Wholesale","Zelia Dishwashing Paste 12X800g","Cost of Goods Sold","Zelia Dishwashing Paste",,"Undeposited Funds",3072.69,"",544227.70
,"Sales Receipt","11-09-2024","3017",,"Alham Wholesalers","Zelia Dishwashing Paste 24X400g","Cost of Goods Sold","Zelia Dishwashing Paste",,"Undeposited Funds",1050.39,"",545278.09
,"Sales Receipt","11-09-2024","3018",,"Tawakal Wholesale","Zelia Dishwashing Paste 12X800g","Cost of Goods Sold","Zelia Dishwashing Paste",,"Undeposited Funds",2048.46,"",547326.55
,"Invoice","12-09-2024","MC06143",,"Karia Supermarkets Limited","Zelia Dishwashing Paste 24X400g","Cost of Goods Sold","Zelia Dishwashing Paste",,"Accounts Receivable",525.20,"",547851.75
,"Invoice","12-09-2024","MC06144",,"DALLAS SHOPRITE LTD","Zelia Dishwashing Paste 24X400g","Cost of Goods Sold","Zelia Dishwashing Paste",,"Accounts Receivable",525.20,"",548376.95
,"Invoice","12-09-2024","MC06147",,"ZAIN SUPERMARKET LIMITED","Zelia Dishwashing Paste 24X400g","Cost of Goods Sold","Zelia Dishwashing Paste",,"Accounts Receivable",262.60,"",548639.55
,"Invoice","12-09-2024","MC06149",,"Azaavi Collections Limited","Zelia Dishwashing Paste 12X800g","Cost of Goods Sold","Zelia Dishwashing Paste",,"Accounts Receivable",170.71,"",548810.26
,"Sales Receipt","12-09-2024","3055",,"Mubarak Shop","-MULTIPLE-","Cost of Goods Sold","Zelia Dishwashing Paste",,"Undeposited Funds",1549.43,"",550359.69
,"Sales Receipt","12-09-2024","2988",,"Kumlliye Shop","-MULTIPLE-","Cost of Goods Sold","Zelia Dishwashing Paste",,"Undeposited Funds",10373.10,"",560732.79
,"Sales Receipt","12-09-2024","1845",,"Daniel Shop","Zelia Dishwashing Paste 24X400g","Cost of Goods Sold","Zelia Dishwashing Paste",,"Undeposited Funds",87.53,"",560820.32
,"Sales Receipt","12-09-2024","2987",,"Cash Sales","-MULTIPLE-","Cost of Goods Sold","Zelia Dishwashing Paste",,"Undeposited Funds",302.01,"",561122.33
,"Sales Receipt","12-09-2024","3019",,"Cash Sales","Zelia Dishwashing Paste 12X800g","Cost of Goods Sold","Zelia Dishwashing Paste",,"Undeposited Funds",85.35,"",561207.68
,"Sales Receipt","12-09-2024","3023",,"Cash Sales","Zelia Dishwashing Paste 24X400g","Cost of Goods Sold","Zelia Dishwashing Paste",,"Undeposited Funds",262.60,"",561470.28
,"Sales Receipt","13-09-2024","3035",,"Horn of Africa","Zelia Dishwashing Paste 24X400g","Cost of Goods Sold","Zelia Dishwashing Paste",,"Undeposited Funds",1050.39,"",562520.67
,"Sales Receipt","13-09-2024","3032",,"Cash Sales","Zelia Dishwashing Paste 12X800g","Cost of Goods Sold","Zelia Dishwashing Paste",,"Undeposited Funds",85.35,"",562606.02
,"Sales Receipt","14-09-2024","3042",,"mwaspart","Zelia Dishwashing Paste 24X400g","Cost of Goods Sold","Zelia Dishwashing Paste",,"Undeposited Funds",525.20,"",563131.22
,"Sales Receipt","14-09-2024","3043",,"Gladys Wholesalers","Zelia Dishwashing Paste 24X400g","Cost of Goods Sold","Zelia Dishwashing Paste",,"Undeposited Funds",262.60,"",563393.82
,"Sales Receipt","16-09-2024","3046",,"Rumi Wholesalers","Zelia Dishwashing Paste 12X800g","Cost of Goods Sold","Zelia Dishwashing Paste",,"Undeposited Funds",5121.15,"",568514.97
,"Sales Receipt","16-09-2024","3037",,"Cash Sales","Zelia Dishwashing Paste 24X400g","Cost of Goods Sold","Zelia Dishwashing Paste",,"Undeposited Funds",43.77,"",568558.74
,"Sales Receipt","17-09-2024","3050",,"Cash Sales","Zelia Dishwashing Paste 24X400g","Cost of Goods Sold","Zelia Dishwashing Paste",,"Undeposited Funds",218.83,"",568777.57
,"Invoice","18-09-2024","MC06163",,"MKULIMA WANGIGE SUPERMARKET","-MULTIPLE-","Cost of Goods Sold","Zelia Dishwashing Paste",,"Accounts Receivable",1023.47,"",569801.04
,"Invoice","18-09-2024","MC06164",,"MKULIMA WANGIGE SUPERMARKET","Zelia Dishwashing Paste 24X400g","Cost of Goods Sold","Zelia Dishwashing Paste",,"Accounts Receivable",262.60,"",570063.64
,"Invoice","18-09-2024","MC06165",,"MKULIMA MUCHATHA","Zelia Dishwashing Paste 24X400g","Cost of Goods Sold","Zelia Dishwashing Paste",,"Accounts Receivable",262.60,"",570326.24
,"Sales Receipt","18-09-2024","3057",,"Jimos Wholesalers","Zelia Dishwashing Paste 24X400g","Cost of Goods Sold","Zelia Dishwashing Paste",,"Undeposited Funds",262.60,"",570588.84
,"Sales Receipt","18-09-2024","3059",,"Farhan Shop","-MULTIPLE-","Cost of Goods Sold","Zelia Dishwashing Paste",,"Undeposited Funds",1521.75,"",572110.59
,"Sales Receipt","18-09-2024","3062",,"Mama Amina","Zelia Dishwashing Paste 24X400g","Cost of Goods Sold","Zelia Dishwashing Paste",,"Undeposited Funds",1050.39,"",573160.98
,"Sales Receipt","18-09-2024","3052",,"Cash Sales","Zelia Dishwashing Paste 12X800g","Cost of Goods Sold","Zelia Dishwashing Paste",,"Undeposited Funds",166.09,"",573327.07
,"Sales Receipt","18-09-2024","3056",,"Cash Sales","Zelia Dishwashing Paste 12X800g","Cost of Goods Sold","Zelia Dishwashing Paste",,"Undeposited Funds",83.04,"",573410.11
,"Sales Receipt","19-09-2024","3063",,"Gold mart","-MULTIPLE-","Cost of Goods Sold","Zelia Dishwashing Paste",,"Undeposited Funds",1020.36,"",574430.47
,"Sales Receipt","20-09-2024","3094",,"Duto Rumo Store","Zelia Dishwashing Paste 24X400g","Cost of Goods Sold","Zelia Dishwashing Paste",,"Undeposited Funds",87.53,"",574518.00
,"Sales Receipt","21-09-2024","2917",,"Jubilee Candy Shop","-MULTIPLE-","Cost of Goods Sold","Zelia Dishwashing Paste",,"Undeposited Funds",340.13,"",574858.13
,"Sales Receipt","23-09-2024","3084",,"Dollar Sign Traders","-MULTIPLE-","Cost of Goods Sold","Zelia Dishwashing Paste",,"Undeposited Funds",3031.04,"",577889.17
,"Sales Receipt","23-09-2024","3086",,"Brinso Foodstufs","-MULTIPLE-","Cost of Goods Sold","Zelia Dishwashing Paste",,"Undeposited Funds",3031.04,"",580920.21
,"Sales Receipt","23-09-2024","3071",,"Cash Sales","Zelia Dishwashing Paste 12X800g","Cost of Goods Sold","Zelia Dishwashing Paste",,"Undeposited Funds",82.52,"",581002.73
,"Sales Receipt","23-09-2024","3073",,"Cash Sales","Zelia Dishwashing Paste 12X800g","Cost of Goods Sold","Zelia Dishwashing Paste",,"Undeposited Funds",82.52,"",581085.25
,"Sales Receipt","24-09-2024","3090",,"Elliane Wholesalers","Zelia Dishwashing Paste 24X400g","Cost of Goods Sold","Zelia Dishwashing Paste",,"Undeposited Funds",256.15,"",581341.40
,"Sales Receipt","24-09-2024","3234",,"Gifted Hands","Zelia Dishwashing Paste 24X400g","Cost of Goods Sold","Zelia Dishwashing Paste",,"Undeposited Funds",85.38,"",581426.78
,"Sales Receipt","24-09-2024","3081",,"Kibibi Wasai Store","-MULTIPLE-","Cost of Goods Sold","Zelia Dishwashing Paste",,"Undeposited Funds",2014.90,"",583441.68
,"Sales Receipt","24-09-2024","3078",,"Cash Sales","Zelia Dishwashing Paste 12X800g","Cost of Goods Sold","Zelia Dishwashing Paste",,"Undeposited Funds",82.52,"",583524.20
,"Sales Receipt","24-09-2024","3079",,"Cash Sales","Zelia Dishwashing Paste 12X800g","Cost of Goods Sold","Zelia Dishwashing Paste",,"Undeposited Funds",330.10,"",583854.30
,"Sales Receipt","24-09-2024","3080",,"Cash Sales","Zelia Dishwashing Paste 12X800g","Cost of Goods Sold","Zelia Dishwashing Paste",,"Undeposited Funds",82.52,"",583936.82
,"Sales Receipt","24-09-2024","3089",,"Cash Sales","Zelia Dishwashing Paste 12X800g","Cost of Goods Sold","Zelia Dishwashing Paste",,"Undeposited Funds",82.52,"",584019.34
,"Sales Receipt","24-09-2024","3091",,"Cash Sales","Zelia Dishwashing Paste 12X800g","Cost of Goods Sold","Zelia Dishwashing Paste",,"Undeposited Funds",82.52,"",584101.86
,"Sales Receipt","25-09-2024","3097",,"Sunar Wholesalers","Zelia Dishwashing Paste 12X800g","Cost of Goods Sold","Zelia Dishwashing Paste",,"Undeposited Funds",4925.37,"",589027.23
,"Sales Receipt","25-09-2024","3098",,"D-Madina Enterprise","Zelia Dishwashing Paste 24X400g","Cost of Goods Sold","Zelia Dishwashing Paste",,"Undeposited Funds",1024.58,"",590051.81
,"Sales Receipt","25-09-2024","3095",,"Cash Sales","Zelia Dishwashing Paste 12X800g","Cost of Goods Sold","Zelia Dishwashing Paste",,"Undeposited Funds",82.09,"",590133.90
,"Sales Receipt","25-09-2024","3202",,"Cash Sales","Zelia Dishwashing Paste 24X400g","Cost of Goods Sold","Zelia Dishwashing Paste",,"Undeposited Funds",42.69,"",590176.59
,"Sales Receipt","26-09-2024","3206",,"Cash Sales","-MULTIPLE-","Cost of Goods Sold","Zelia Dishwashing Paste",,"Undeposited Funds",291.72,"",590468.31
,"Sales Receipt","26-09-2024","3208",,"Cash Sales","Zelia Dishwashing Paste 24X400g","Cost of Goods Sold","Zelia Dishwashing Paste",,"Undeposited Funds",170.06,"",590638.37
,"Sales Receipt","26-09-2024","3209",,"Cash Sales","Zelia Dishwashing Paste 12X800g","Cost of Goods Sold","Zelia Dishwashing Paste",,"Undeposited Funds",82.09,"",590720.46
,"Credit Note","27-09-2024","CN01070",,"ROYMATT SUPERMARKET LIMITED","Zelia Dishwashing Paste 400g New","Cost of Goods Sold","Zelia Dishwashing Paste",,"Accounts Receivable","",285.57,590434.89
,"Credit Note","27-09-2024","CN01071",,"ROYMATT SUPERMARKET LIMITED","Zelia Dishwashing Paste 400g New","Cost of Goods Sold","Zelia Dishwashing Paste",,"Accounts Receivable","",203.98,590230.91
,"Invoice","27-09-2024","MC06216",,"QUALITYMART SUPERMARKET LIMITED","Zelia Dishwashing Paste 24X400g","Cost of Goods Sold","Zelia Dishwashing Paste",,"Accounts Receivable",510.17,"",590741.08
,"Invoice","27-09-2024","MC06217",,"Mumsha Supamat","Zelia Dishwashing Paste 24X400g","Cost of Goods Sold","Zelia Dishwashing Paste",,"Accounts Receivable",255.09,"",590996.17
,"Sales Receipt","27-09-2024","3215",,"Supaa Mart","-MULTIPLE-","Cost of Goods Sold","Zelia Dishwashing Paste",,"Undeposited Funds",746.68,"",591742.85
,"Sales Receipt","27-09-2024","3211",,"Cash Sales","Zelia Dishwashing Paste 24X400g","Cost of Goods Sold","Zelia Dishwashing Paste",,"Undeposited Funds",1062.87,"",592805.72
,"Sales Receipt","27-09-2024","3216",,"Cash Sales","Zelia Dishwashing Paste 12X800g","Cost of Goods Sold","Zelia Dishwashing Paste",,"Undeposited Funds",327.72,"",593133.44
,"Sales Receipt","30-09-2024","3223",,"Brightfood Nasra","Zelia Dishwashing Paste 24X400g","Cost of Goods Sold","Zelia Dishwashing Paste",,"Undeposited Funds",510.17,"",593643.61
,"Sales Receipt","01-10-2024","3220",,"Cash Sales","Zelia Dishwashing Paste 24X400g","Cost of Goods Sold","Zelia Dishwashing Paste",,"Undeposited Funds",85.03,"",593728.64
,"Sales Receipt","02-10-2024","3225",,"Cash Sales","-MULTIPLE-","Cost of Goods Sold","Zelia Dishwashing Paste",,"Undeposited Funds",89.92,"",593818.56
,"Sales Receipt","02-10-2024","3225",,"Cash Sales","-MULTIPLE-","Cost of Goods Sold","Zelia Dishwashing Paste",,"Undeposited Funds",166.89,"",593985.45
,"Sales Receipt","02-10-2024","3228",,"Cash Sales","Zelia Dishwashing Paste 24X400g","Cost of Goods Sold","Zelia Dishwashing Paste",,"Undeposited Funds",42.48,"",594027.93
,"Sales Receipt","02-10-2024","3229",,"Towba general stores Parkroad","Zelia Dishwashing Paste 12X800g","Cost of Goods Sold","Zelia Dishwashing Paste",,"Undeposited Funds",1966.37,"",595994.30
,"Sales Receipt","02-10-2024","3235",,"Dhaxatuur Wholesalers","Zelia Dishwashing Paste 24X400g","Cost of Goods Sold","Zelia Dishwashing Paste",,"Undeposited Funds",2039.05,"",598033.35
,"Sales Receipt","02-10-2024","3236",,"Bahati Super Stores","Zelia Dishwashing Paste 12X800g","Cost of Goods Sold","Zelia Dishwashing Paste",,"Undeposited Funds",4915.91,"",602949.26
,"Sales Receipt","03-10-2024","3240",,"Cash Sales","Zelia Dishwashing Paste 24X400g","Cost of Goods Sold","Zelia Dishwashing Paste",,"Undeposited Funds",42.48,"",602991.74
,"Sales Receipt","03-10-2024","3243",,"Cash Sales","Zelia Dishwashing Paste 12X800g","Cost of Goods Sold","Zelia Dishwashing Paste",,"Undeposited Funds",81.93,"",603073.67
,"Sales Receipt","03-10-2024","3249",,"Cash Sales","Zelia Dishwashing Paste 12X800g","Cost of Goods Sold","Zelia Dishwashing Paste",,"Undeposited Funds",81.93,"",603155.60
,"Sales Receipt","03-10-2024","3245",,"Freshtake wholesalers","-MULTIPLE-","Cost of Goods Sold","Zelia Dishwashing Paste",,"Undeposited Funds",2985.90,"",606141.50
,"Sales Receipt","03-10-2024","3246",,"Fahan Foodstuff","Zelia Dishwashing Paste 12X800g","Cost of Goods Sold","Zelia Dishwashing Paste",,"Undeposited Funds",4915.91,"",611057.41
,"Sales Receipt","03-10-2024","3248",,"Elwak Stores","Zelia Dishwashing Paste 24X400g","Cost of Goods Sold","Zelia Dishwashing Paste",,"Undeposited Funds",1019.53,"",612076.94
,"Sales Receipt","03-10-2024","3233",,"Mabruk Wholesalers","Zelia Dishwashing Paste 24X400g","Cost of Goods Sold","Zelia Dishwashing Paste",,"Undeposited Funds",509.76,"",612586.70
,"Sales Receipt","05-10-2024","3420",,"Danaba Wholesallers","-MULTIPLE-","Cost of Goods Sold","Zelia Dishwashing Paste",,"Undeposited Funds",2476.12,"",615062.82
,"Sales Receipt","06-10-2024","3421",,"Raage mart","Zelia Dishwashing Paste 12X800g","Cost of Goods Sold","Zelia Dishwashing Paste",,"Undeposited Funds",1966.37,"",617029.19
,"Sales Receipt","06-10-2024","3184",,"Precious Mart","Zelia Dishwashing Paste 24X400g","Cost of Goods Sold","Zelia Dishwashing Paste",,"Undeposited Funds",127.44,"",617156.63
,"Sales Receipt","06-10-2024","3422",,"Mikara Shop","Zelia Dishwashing Paste 12X800g","Cost of Goods Sold","Zelia Dishwashing Paste",,"Undeposited Funds",163.87,"",617320.50
,"Sales Receipt","06-10-2024","3423",,"Jikweri Minimart","-MULTIPLE-","Cost of Goods Sold","Zelia Dishwashing Paste",,"Undeposited Funds",500.68,"",617821.18
,"Sales Receipt","07-10-2024","3254",,"Cash Sales","Zelia Dishwashing Paste 12X800g","Cost of Goods Sold","Zelia Dishwashing Paste",,"Undeposited Funds",81.93,"",617903.11
,"Sales Receipt","07-10-2024","3260",,"Sharma Shop","Zelia Dishwashing Paste 24X400g","Cost of Goods Sold","Zelia Dishwashing Paste",,"Undeposited Funds",1019.53,"",618922.64
,"Sales Receipt","07-10-2024","3288",,"Adurus Wholesallers","-MULTIPLE-","Cost of Goods Sold","Zelia Dishwashing Paste",,"Undeposited Funds",2002.71,"",620925.35
,"Sales Receipt","07-10-2024","3258",,"Fatah Wholesalers","Zelia Dishwashing Paste 12X800g","Cost of Goods Sold","Zelia Dishwashing Paste",,"Undeposited Funds",4915.91,"",625841.26
,"Sales Receipt","08-10-2024","3261",,"Cash Sales","Zelia Dishwashing Paste 12X800g","Cost of Goods Sold","Zelia Dishwashing Paste",,"Undeposited Funds",163.87,"",626005.13
,"Sales Receipt","08-10-2024","3264",,"Cash Sales","Zelia Dishwashing Paste 24X400g","Cost of Goods Sold","Zelia Dishwashing Paste",,"Undeposited Funds",169.92,"",626175.05
,"Sales Receipt","08-10-2024","3266",,"Cash Sales","Zelia Dishwashing Paste 12X800g","Cost of Goods Sold","Zelia Dishwashing Paste",,"Undeposited Funds",81.93,"",626256.98
,"Sales Receipt","08-10-2024","3268",,"Cash Sales","Zelia Dishwashing Paste 24X400g","Cost of Goods Sold","Zelia Dishwashing Paste",,"Undeposited Funds",42.48,"",626299.46
,"Sales Receipt","08-10-2024","3269",,"Cash Sales","Zelia Dishwashing Paste 24X400g","Cost of Goods Sold","Zelia Dishwashing Paste",,"Undeposited Funds",42.48,"",626341.94
,"Sales Receipt","09-10-2024","3275",,"Cash Sales","Zelia Dishwashing Paste 12X800g","Cost of Goods Sold","Zelia Dishwashing Paste",,"Undeposited Funds",245.80,"",626587.74
,"Sales Receipt","09-10-2024","3276",,"Cash Sales","Zelia Dishwashing Paste 24X400g","Cost of Goods Sold","Zelia Dishwashing Paste",,"Undeposited Funds",42.48,"",626630.22
,"Sales Receipt","09-10-2024","3279",,"Cash Sales","Zelia Dishwashing Paste 12X800g","Cost of Goods Sold","Zelia Dishwashing Paste",,"Undeposited Funds",81.93,"",626712.15
,"Sales Receipt","09-10-2024","3282",,"Cash Sales","Zelia Dishwashing Paste 12X800g","Cost of Goods Sold","Zelia Dishwashing Paste",,"Undeposited Funds",81.93,"",626794.08
,"Sales Receipt","09-10-2024","3283",,"Cash Sales","Zelia Dishwashing Paste 12X800g","Cost of Goods Sold","Zelia Dishwashing Paste",,"Undeposited Funds",81.93,"",626876.01
,"Sales Receipt","09-10-2024","3285",,"Strawberry Minimart","-MULTIPLE-","Cost of Goods Sold","Zelia Dishwashing Paste",,"Undeposited Funds",1492.94,"",628368.95
,"Sales Receipt","09-10-2024","3284",,"Mina Wholesalers","-MULTIPLE-","Cost of Goods Sold","Zelia Dishwashing Paste",,"Undeposited Funds",2002.71,"",630371.66
,"Invoice","11-10-2024","MC06251",,"HOPEMART SELF SERVICES LTD","-MULTIPLE-","Cost of Goods Sold","Zelia Dishwashing Paste",,"Accounts Receivable",1001.35,"",631373.01
,"Sales Receipt","11-10-2024","3289",,"Cash Sales","Zelia Dishwashing Paste 24X400g","Cost of Goods Sold","Zelia Dishwashing Paste",,"Undeposited Funds",84.96,"",631457.97
,"Sales Receipt","11-10-2024","3291",,"Cash Sales","Zelia Dishwashing Paste 24X400g","Cost of Goods Sold","Zelia Dishwashing Paste",,"Undeposited Funds",169.92,"",631627.89
,"Sales Receipt","11-10-2024","3292",,"Cash Sales","Zelia Dishwashing Paste 12X800g","Cost of Goods Sold","Zelia Dishwashing Paste",,"Undeposited Funds",163.87,"",631791.76
,"Sales Receipt","11-10-2024","3296",,"Restoration Traders","Zelia Dishwashing Paste 24X400g","Cost of Goods Sold","Zelia Dishwashing Paste",,"Undeposited Funds",1019.53,"",632811.29
,"Sales Receipt","12-10-2024","3295",,"Alma Wholesale","-MULTIPLE-","Cost of Goods Sold","Zelia Dishwashing Paste",,"Undeposited Funds",837.48,"",633648.77
,"Sales Receipt","15-10-2024","3107",,"Cash Sales","Zelia Dishwashing Paste 24X400g","Cost of Goods Sold","Zelia Dishwashing Paste",,"Undeposited Funds",84.96,"",633733.73
,"Sales Receipt","15-10-2024","3187",,"Big Fish Minimart","Zelia Dishwashing Paste 12X800g","Cost of Goods Sold","Zelia Dishwashing Paste",,"Undeposited Funds",245.80,"",633979.53
,"Sales Receipt","16-10-2024","3109",,"Cash Sales","Zelia Dishwashing Paste 12X800g","Cost of Goods Sold","Zelia Dishwashing Paste",,"Undeposited Funds",163.87,"",634143.40
,"Sales Receipt","16-10-2024","3110",,"Cash Sales","Zelia Dishwashing Paste 24X400g","Cost of Goods Sold","Zelia Dishwashing Paste",,"Undeposited Funds",127.44,"",634270.84
,"Invoice","17-10-2024","MC06269",,"MUHINDI MWEUSI SUPERMARKET LIMITED","Zelia Dishwashing Paste 24X400g  12 Pieces @129.92","Cost of Goods Sold","Zelia Dishwashing Paste",,"Accounts Receivable",509.76,"",634780.60
,"Sales Receipt","17-10-2024","3116",,"Cash Sales","Zelia Dishwashing Paste 12X800g","Cost of Goods Sold","Zelia Dishwashing Paste",,"Undeposited Funds",81.93,"",634862.53
,"Sales Receipt","17-10-2024","3115",,"Corner Shop","Zelia Dishwashing Paste 24X400g","Cost of Goods Sold","Zelia Dishwashing Paste",,"Undeposited Funds",1019.53,"",635882.06
,"Sales Receipt","17-10-2024","3117",,"Freshtake wholesalers","Zelia Dishwashing Paste 24X400g","Cost of Goods Sold","Zelia Dishwashing Paste",,"Undeposited Funds",509.76,"",636391.82
,"Sales Receipt","18-10-2024","3122",,"Cash Sales","-MULTIPLE-","Cost of Goods Sold","Zelia Dishwashing Paste",,"Undeposited Funds",248.83,"",636640.65
,"Sales Receipt","18-10-2024","3126",,"Cash Sales","Zelia Dishwashing Paste 24X400g","Cost of Goods Sold","Zelia Dishwashing Paste",,"Undeposited Funds",42.48,"",636683.13
,"Sales Receipt","18-10-2024","3127",,"Cash Sales","-MULTIPLE-","Cost of Goods Sold","Zelia Dishwashing Paste",,"Undeposited Funds",166.89,"",636850.02
,"Sales Receipt","18-10-2024","3128",,"Cash Sales","Zelia Dishwashing Paste 12X800g","Cost of Goods Sold","Zelia Dishwashing Paste",,"Undeposited Funds",163.87,"",637013.89
,"Sales Receipt","19-10-2024","3180",,"Witgad Shop","Zelia Dishwashing Paste 24X400g","Cost of Goods Sold","Zelia Dishwashing Paste",,"Undeposited Funds",169.92,"",637183.81
,"Sales Receipt","22-10-2024","3130",,"Cash Sales","Zelia Dishwashing Paste 24X400g","Cost of Goods Sold","Zelia Dishwashing Paste",,"Undeposited Funds",42.62,"",637226.43
,"Sales Receipt","22-10-2024","3131",,"Cash Sales","Zelia Dishwashing Paste 24X400g","Cost of Goods Sold","Zelia Dishwashing Paste",,"Undeposited Funds",85.22,"",637311.65
,"Sales Receipt","22-10-2024","3133",,"tRIPPLE M","Zelia Dishwashing Paste 24X400g","Cost of Goods Sold","Zelia Dishwashing Paste",,"Undeposited Funds",255.68,"",637567.33
,"Sales Receipt","23-10-2024","3138",,"Cash Sales","Zelia Dishwashing Paste 24X400g","Cost of Goods Sold","Zelia Dishwashing Paste",,"Undeposited Funds",85.22,"",637652.55
,"Sales Receipt","23-10-2024","3139",,"Cash Sales","Zelia Dishwashing Paste 24X400g","Cost of Goods Sold","Zelia Dishwashing Paste",,"Undeposited Funds",42.62,"",637695.17
,"Sales Receipt","23-10-2024","3142",,"Cash Sales","Zelia Dishwashing Paste 24X400g","Cost of Goods Sold","Zelia Dishwashing Paste",,"Undeposited Funds",42.62,"",637737.79
,"Sales Receipt","23-10-2024","3144",,"Cash Sales","Zelia Dishwashing Paste 24X400g","Cost of Goods Sold","Zelia Dishwashing Paste",,"Undeposited Funds",85.22,"",637823.01
,"Sales Receipt","23-10-2024","3141",,"Kibibi Wasai Store","-MULTIPLE-","Cost of Goods Sold","Zelia Dishwashing Paste",,"Undeposited Funds",6017.73,"",643840.74
,"Sales Receipt","24-10-2024","3147",,"Cash Sales","Zelia Dishwashing Paste 24X400g","Cost of Goods Sold","Zelia Dishwashing Paste",,"Undeposited Funds",170.46,"",644011.20
,"Sales Receipt","24-10-2024","3148",,"Cash Sales","Zelia Dishwashing Paste 12X800g","Cost of Goods Sold","Zelia Dishwashing Paste",,"Undeposited Funds",81.93,"",644093.13
,"Sales Receipt","24-10-2024","3154",,"Horn of Africa","Zelia Dishwashing Paste 24X400g","Cost of Goods Sold","Zelia Dishwashing Paste",,"Undeposited Funds",511.36,"",644604.49
,"Sales Receipt","24-10-2024","3701",,"One Stop Minimart","-MULTIPLE-","Cost of Goods Sold","Zelia Dishwashing Paste",,"Undeposited Funds",2005.91,"",646610.40
,"Invoice","25-10-2024","MC06300",,"HAPPY VIEW SUPERMARKET LIMITED","Zelia Dishwashing Paste 24X400g  6Pcs @130","Cost of Goods Sold","Zelia Dishwashing Paste",,"Accounts Receivable",255.68,"",646866.08
,"Sales Receipt","25-10-2024","3156",,"Cash Sales","Zelia Dishwashing Paste 12X800g","Cost of Goods Sold","Zelia Dishwashing Paste",,"Undeposited Funds",81.93,"",646948.01
,"Sales Receipt","25-10-2024","3160",,"Hussein Soko Store","Zelia Dishwashing Paste 24X400g","Cost of Goods Sold","Zelia Dishwashing Paste",,"Undeposited Funds",426.14,"",647374.15
,"Sales Receipt","26-10-2024","3193",,"032 minimart","Zelia Dishwashing Paste 24X400g","Cost of Goods Sold","Zelia Dishwashing Paste",,"Undeposited Funds",255.68,"",647629.83
,"Invoice","28-10-2024","MC06308",,"MUHINDI MWEUSI SUPERMARKET LIMITED","Zelia Dishwashing Paste 24X400g","Cost of Goods Sold","Zelia Dishwashing Paste",,"Accounts Receivable",1022.73,"",648652.56
,"Invoice","28-10-2024","MC06310",,"MUHINDI MWEUSI SUPERMARKET LIMITED","Zelia Dishwashing Paste 24X400g","Cost of Goods Sold","Zelia Dishwashing Paste",,"Accounts Receivable",1022.73,"",649675.29
,"Invoice","28-10-2024","MC06311",,"MUHINDI MWEUSI SUPERMARKET LIMITED","Zelia Dishwashing Paste 24X400g","Cost of Goods Sold","Zelia Dishwashing Paste",,"Accounts Receivable",1022.73,"",650698.02
,"Invoice","28-10-2024","MC06312",,"MUHINDI MWEUSI SUPERMARKET LIMITED","Zelia Dishwashing Paste 24X400g","Cost of Goods Sold","Zelia Dishwashing Paste",,"Accounts Receivable",1022.73,"",651720.75
,"Invoice","28-10-2024","MC06313",,"MUHINDI MWEUSI SUPERMARKET LIMITED","Zelia Dishwashing Paste 24X400g","Cost of Goods Sold","Zelia Dishwashing Paste",,"Accounts Receivable",1022.73,"",652743.48
,"Sales Receipt","28-10-2024","3164",,"Cash Sales","Zelia Dishwashing Paste 24X400g","Cost of Goods Sold","Zelia Dishwashing Paste",,"Undeposited Funds",1022.73,"",653766.21
,"Sales Receipt","28-10-2024","3173",,"Nasra Super stores","-MULTIPLE-","Cost of Goods Sold","Zelia Dishwashing Paste",,"Undeposited Funds",747.27,"",654513.48
,"Credit Note","29-10-2024","CN01072",,"Karia Supermarkets Limited","Zelia Dishwashing Paste 24X400g  7pcs @ 130","Cost of Goods Sold","Zelia Dishwashing Paste",,"Accounts Receivable","",298.30,654215.18
,"Sales Receipt","29-10-2024","3167",,"Cash Sales","Zelia Dishwashing Paste 24X400g","Cost of Goods Sold","Zelia Dishwashing Paste",,"Undeposited Funds",42.62,"",654257.80
,"Sales Receipt","29-10-2024","3168",,"Cash Sales","Zelia Dishwashing Paste 24X400g","Cost of Goods Sold","Zelia Dishwashing Paste",,"Undeposited Funds",42.62,"",654300.42
,"Sales Receipt","29-10-2024","3704",,"Home Soko Minimart","-MULTIPLE-","Cost of Goods Sold","Zelia Dishwashing Paste",,"Undeposited Funds",1002.95,"",655303.37
,"Sales Receipt","29-10-2024","3705",,"Elliane Wholesalers","Zelia Dishwashing Paste 24X400g","Cost of Goods Sold","Zelia Dishwashing Paste",,"Undeposited Funds",511.36,"",655814.73
,"Sales Receipt","30-10-2024","3171",,"Cash Sales","Zelia Dishwashing Paste 12X800g","Cost of Goods Sold","Zelia Dishwashing Paste",,"Undeposited Funds",245.80,"",656060.53
,"Sales Receipt","30-10-2024","3190",,"Hidika Shop","Zelia Dishwashing Paste 24X400g","Cost of Goods Sold","Zelia Dishwashing Paste",,"Undeposited Funds",1022.73,"",657083.26
,"Sales Receipt","30-10-2024","3189",,"Bahati Super Stores","Zelia Dishwashing Paste 12X800g","Cost of Goods Sold","Zelia Dishwashing Paste",,"Undeposited Funds",4915.91,"",661999.17
,"Sales Receipt","30-10-2024","3725",,"Safa Groceries","-MULTIPLE-","Cost of Goods Sold","Zelia Dishwashing Paste",,"Undeposited Funds",1494.54,"",663493.71
,"Sales Receipt","31-10-2024","3194",,"Cash Sales","Zelia Dishwashing Paste 12X800g","Cost of Goods Sold","Zelia Dishwashing Paste",,"Undeposited Funds",327.72,"",663821.43
,"Sales Receipt","02-11-2024","3706",,"Warfa Wholesale","-MULTIPLE-","Cost of Goods Sold","Zelia Dishwashing Paste",,"Undeposited Funds",4995.00,"",668816.43
,"Sales Receipt","04-11-2024","3430",,"Mabini Minimart","Zelia Dishwashing Paste 24X400g","Cost of Goods Sold","Zelia Dishwashing Paste",,"Undeposited Funds",255.68,"",669072.11
,"Sales Receipt","04-11-2024","3708",,"Gure Yare Shop","-MULTIPLE-","Cost of Goods Sold","Zelia Dishwashing Paste",,"Undeposited Funds",4993.55,"",674065.66
,"Sales Receipt","05-11-2024","3198",,"Cash Sales","Zelia Dishwashing Paste 24X400g","Cost of Goods Sold","Zelia Dishwashing Paste",,"Undeposited Funds",127.57,"",674193.23
,"Invoice","06-11-2024","MC06333",,"MUHINDI MWEUSI SUPERMARKET LIMITED","Zelia Dishwashing Paste 24X400g  24Pcs @130","Cost of Goods Sold","Zelia Dishwashing Paste",,"Accounts Receivable",1020.59,"",675213.82
,"Invoice","06-11-2024","MC06334",,"MUHINDI MWEUSI SUPERMARKET LIMITED","Zelia Dishwashing Paste 24X400g  12Pcs @130","Cost of Goods Sold","Zelia Dishwashing Paste",,"Accounts Receivable",510.29,"",675724.11
,"Invoice","06-11-2024","MC06335",,"Guard Mart Supermarket Limited","-MULTIPLE-","Cost of Goods Sold","Zelia Dishwashing Paste",,"Accounts Receivable",124.39,"",675848.50
,"Sales Receipt","06-11-2024","3199",,"Cash Sales","Zelia Dishwashing Paste 24X400g","Cost of Goods Sold","Zelia Dishwashing Paste",,"Undeposited Funds",255.15,"",676103.65
,"Sales Receipt","06-11-2024","3200",,"Cash Sales","Zelia Dishwashing Paste 12X800g","Cost of Goods Sold","Zelia Dishwashing Paste",,"Undeposited Funds",81.86,"",676185.51
,"Sales Receipt","06-11-2024","3402",,"Cash Sales","Zelia Dishwashing Paste 12X800g","Cost of Goods Sold","Zelia Dishwashing Paste",,"Undeposited Funds",81.86,"",676267.37
,"Sales Receipt","06-11-2024","3403",,"Cash Sales","Zelia Dishwashing Paste 24X400g","Cost of Goods Sold","Zelia Dishwashing Paste",,"Undeposited Funds",42.53,"",676309.90
,"Sales Receipt","06-11-2024","3404",,"Cash Sales","Zelia Dishwashing Paste 24X400g","Cost of Goods Sold","Zelia Dishwashing Paste",,"Undeposited Funds",42.53,"",676352.43
,"Sales Receipt","06-11-2024","3715",,"Mama Amina","Zelia Dishwashing Paste 24X400g","Cost of Goods Sold","Zelia Dishwashing Paste",,"Undeposited Funds",1020.59,"",677373.02
,"Sales Receipt","06-11-2024","3717",,"BCB Shop","Zelia Dishwashing Paste 12X800g","Cost of Goods Sold","Zelia Dishwashing Paste",,"Undeposited Funds",982.40,"",678355.42
,"Sales Receipt","06-11-2024","3720",,"Amir shop","Zelia Dishwashing Paste 24X400g","Cost of Goods Sold","Zelia Dishwashing Paste",,"Undeposited Funds",1020.59,"",679376.01
,"Sales Receipt","07-11-2024","3407",,"Cash Sales","Zelia Dishwashing Paste 24X400g","Cost of Goods Sold","Zelia Dishwashing Paste",,"Undeposited Funds",42.53,"",679418.54
,"Sales Receipt","07-11-2024","2688",,"Sahra Shop","Zelia Dishwashing Paste 24X400g","Cost of Goods Sold","Zelia Dishwashing Paste",,"Undeposited Funds",1020.59,"",680439.13
,"Sales Receipt","07-11-2024","3457",,"Dylyn Enterprise","Zelia Dishwashing Paste 24X400g","Cost of Goods Sold","Zelia Dishwashing Paste",,"Undeposited Funds",170.10,"",680609.23
,"Sales Receipt","08-11-2024","3411",,"Cash Sales","Zelia Dishwashing Paste 24X400g","Cost of Goods Sold","Zelia Dishwashing Paste",,"Undeposited Funds",42.53,"",680651.76
,"Sales Receipt","08-11-2024","3412",,"Cash Sales","Zelia Dishwashing Paste 12X800g","Cost of Goods Sold","Zelia Dishwashing Paste",,"Undeposited Funds",81.86,"",680733.62
,"Sales Receipt","08-11-2024","3413",,"Cash Sales","-MULTIPLE-","Cost of Goods Sold","Zelia Dishwashing Paste",,"Undeposited Funds",166.91,"",680900.53
,"Sales Receipt","09-11-2024","3308",,"Rosemary Shop","Zelia Dishwashing Paste 24X400g","Cost of Goods Sold","Zelia Dishwashing Paste",,"Undeposited Funds",382.72,"",681283.25
,"Sales Receipt","11-11-2024","3420",,"Cash Sales","Zelia Dishwashing Paste 12X800g","Cost of Goods Sold","Zelia Dishwashing Paste",,"Undeposited Funds",81.86,"",681365.11
,"Sales Receipt","11-11-2024","3456",,"RichMind Property","Zelia Dishwashing Paste 24X400g","Cost of Goods Sold","Zelia Dishwashing Paste",,"Undeposited Funds",85.05,"",681450.16
,"Sales Receipt","11-11-2024","3425",,"Dekh Wholesalers","-MULTIPLE-","Cost of Goods Sold","Zelia Dishwashing Paste",,"Undeposited Funds",1492.69,"",682942.85
,"Sales Receipt","11-11-2024","3428",,"Arqam minimart","-MULTIPLE-","Cost of Goods Sold","Zelia Dishwashing Paste",,"Undeposited Funds",2002.99,"",684945.84
,"Sales Receipt","12-11-2024","3431",,"Cash Sales","-MULTIPLE-","Cost of Goods Sold","Zelia Dishwashing Paste",,"Undeposited Funds",6470.44,"",691416.28
,"Sales Receipt","12-11-2024","3436",,"Horn of Africa","Zelia Dishwashing Paste 24X400g","Cost of Goods Sold","Zelia Dishwashing Paste",,"Undeposited Funds",510.29,"",691926.57
,"Sales Receipt","12-11-2024","3437",,"Jombs wholesalers","Zelia Dishwashing Paste 24X400g","Cost of Goods Sold","Zelia Dishwashing Paste",,"Undeposited Funds",255.15,"",692181.72
,"Sales Receipt","12-11-2024","3439",,"Maida Minimart","Zelia Dishwashing Paste 24X400g","Cost of Goods Sold","Zelia Dishwashing Paste",,"Undeposited Funds",255.15,"",692436.87
,"Invoice","13-11-2024","MC06359",,"PRICE CHOPPER STORES LIMITED","Zelia Dishwashing Paste 24X400g  12Pieces@130","Cost of Goods Sold","Zelia Dishwashing Paste",,"Accounts Receivable",510.29,"",692947.16
,"Sales Receipt","13-11-2024","3493",,"Mwambao Shop","Zelia Dishwashing Paste 24X400g","Cost of Goods Sold","Zelia Dishwashing Paste",,"Undeposited Funds",170.10,"",693117.26
,"Sales Receipt","13-11-2024","3443",,"Sunar Wholesalers","Zelia Dishwashing Paste 12X800g","Cost of Goods Sold","Zelia Dishwashing Paste",,"Undeposited Funds",4912.00,"",698029.26
,"Sales Receipt","14-11-2024","3447",,"Amir Wholesalers","Zelia Dishwashing Paste 24X400g","Cost of Goods Sold","Zelia Dishwashing Paste",,"Undeposited Funds",510.29,"",698539.55
,"Sales Receipt","14-11-2024","3446",,"One Stop Minimart","-MULTIPLE-","Cost of Goods Sold","Zelia Dishwashing Paste",,"Undeposited Funds",6991.36,"",705530.91
,"Invoice","15-11-2024","MC06366",,"MUHINDI MWEUSI SUPERMARKET LIMITED","Zelia Dishwashing Paste 24X400g  12Pcs @130","Cost of Goods Sold","Zelia Dishwashing Paste",,"Accounts Receivable",510.29,"",706041.20
,"Sales Receipt","15-11-2024","3730",,"Cash Sales","Zelia Dishwashing Paste 24X400g","Cost of Goods Sold","Zelia Dishwashing Paste",,"Undeposited Funds",170.10,"",706211.30
,"Sales Receipt","15-11-2024","3731",,"Cash Sales","Zelia Dishwashing Paste 24X400g","Cost of Goods Sold","Zelia Dishwashing Paste",,"Undeposited Funds",42.53,"",706253.83
,"Invoice","18-11-2024","MC06372",,"Guard Mart Supermarket Limited","-MULTIPLE-","Cost of Goods Sold","Zelia Dishwashing Paste",,"Accounts Receivable",2002.99,"",708256.82
,"Credit Note","18-11-2024","CN01073",,"Guard Mart Supermarket Limited","-MULTIPLE-","Cost of Goods Sold","Zelia Dishwashing Paste",,"Accounts Receivable","",124.39,708132.43
,"Sales Receipt","18-11-2024","3450",,"Cash Sales","Zelia Dishwashing Paste 24X400g","Cost of Goods Sold","Zelia Dishwashing Paste",,"Undeposited Funds",42.53,"",708174.96
,"Sales Receipt","18-11-2024","3468",,"Cash Sales","-MULTIPLE-","Cost of Goods Sold","Zelia Dishwashing Paste",,"Undeposited Funds",291.31,"",708466.27
,"Sales Receipt","18-11-2024","3470",,"Cash Sales","Zelia Dishwashing Paste 24X400g","Cost of Goods Sold","Zelia Dishwashing Paste",,"Undeposited Funds",42.53,"",708508.80
,"Sales Receipt","18-11-2024","3473",,"Cash Sales","Zelia Dishwashing Paste 24X400g","Cost of Goods Sold","Zelia Dishwashing Paste",,"Undeposited Funds",42.53,"",708551.33
,"Sales Receipt","18-11-2024","3462",,"Nabcom Stores","-MULTIPLE-","Cost of Goods Sold","Zelia Dishwashing Paste",,"Undeposited Funds",1492.69,"",710044.02
,"Invoice","19-11-2024","MC06376",,"MUHINDI MWEUSI SUPERMARKET LIMITED","Zelia Dishwashing Paste 24X400g  24Pcs @130","Cost of Goods Sold","Zelia Dishwashing Paste",,"Accounts Receivable",1020.59,"",711064.61
,"Invoice","19-11-2024","MC06378",,"ROYMATT SUPERMARKET LIMITED","Zelia Dishwashing Paste 24X400g  12Pcs@130","Cost of Goods Sold","Zelia Dishwashing Paste",,"Accounts Receivable",510.29,"",711574.90
,"Sales Receipt","20-11-2024","3477",,"Cash Sales","Zelia Dishwashing Paste 24X400g","Cost of Goods Sold","Zelia Dishwashing Paste",,"Undeposited Funds",42.53,"",711617.43
,"Sales Receipt","20-11-2024","3497",,"032 minimart","Zelia Dishwashing Paste 24X400g","Cost of Goods Sold","Zelia Dishwashing Paste",,"Undeposited Funds",255.15,"",711872.58
,"Sales Receipt","20-11-2024","3481",,"Norhani Groceries","Zelia Dishwashing Paste 24X400g","Cost of Goods Sold","Zelia Dishwashing Paste",,"Undeposited Funds",510.29,"",712382.87
,"Sales Receipt","20-11-2024","3480",,"Burhani Shop","Zelia Dishwashing Paste 12X800g","Cost of Goods Sold","Zelia Dishwashing Paste",,"Undeposited Funds",1964.80,"",714347.67
,"Sales Receipt","22-11-2024","3486",,"Cash Sales","Zelia Dishwashing Paste 12X800g","Cost of Goods Sold","Zelia Dishwashing Paste",,"Undeposited Funds",81.86,"",714429.53
,"Sales Receipt","22-11-2024","3488",,"Cash Sales","Zelia Dishwashing Paste 24X400g","Cost of Goods Sold","Zelia Dishwashing Paste",,"Undeposited Funds",255.15,"",714684.68
,"Sales Receipt","22-11-2024","3499",,"Cash Sales","Zelia Dishwashing Paste 24X400g","Cost of Goods Sold","Zelia Dishwashing Paste",,"Undeposited Funds",255.15,"",714939.83
,"Sales Receipt","22-11-2024","3734",,"Cash Sales","Zelia Dishwashing Paste 24X400g","Cost of Goods Sold","Zelia Dishwashing Paste",,"Undeposited Funds",42.53,"",714982.36
,"Invoice","26-11-2024","MC06416",,"MUHINDI MWEUSI SUPERMARKET LIMITED","Zelia Dishwashing Paste 24X400g  12Pcs @130","Cost of Goods Sold","Zelia Dishwashing Paste",,"Accounts Receivable",510.29,"",715492.65
,"Sales Receipt","26-11-2024","3736",,"Cash Sales","Zelia Dishwashing Paste 24X400g","Cost of Goods Sold","Zelia Dishwashing Paste",,"Undeposited Funds",42.53,"",715535.18
,"Sales Receipt","26-11-2024","3738",,"Garumo Wholesale","-MULTIPLE-","Cost of Goods Sold","Zelia Dishwashing Paste",,"Undeposited Funds",2002.99,"",717538.17
,"Sales Receipt","27-11-2024","3739",,"Eugombe Enterprises","Zelia Dishwashing Paste 24X400g","Cost of Goods Sold","Zelia Dishwashing Paste",,"Undeposited Funds",1020.59,"",718558.76
,"Sales Receipt","27-11-2024","3745",,"Al- Malik Wholesalers","Zelia Dishwashing Paste 12X800g","Cost of Goods Sold","Zelia Dishwashing Paste",,"Undeposited Funds",982.40,"",719541.16
,"Sales Receipt","27-11-2024","3746",,"Tusma Wholesale","Zelia Dishwashing Paste 12X800g","Cost of Goods Sold","Zelia Dishwashing Paste",,"Undeposited Funds",1964.80,"",721505.96
,"Sales Receipt","27-11-2024","3747",,"Bahati Super Stores","Zelia Dishwashing Paste 12X800g","Cost of Goods Sold","Zelia Dishwashing Paste",,"Undeposited Funds",9823.99,"",731329.95
,"Sales Receipt","27-11-2024","3748",,"Dhaxatuur Wholesalers","Zelia Dishwashing Paste 12X800g","Cost of Goods Sold","Zelia Dishwashing Paste",,"Undeposited Funds",1964.80,"",733294.75
,"Sales Receipt","27-11-2024","3764",,"Molly Shop","Zelia Dishwashing Paste 24X400g","Cost of Goods Sold","Zelia Dishwashing Paste",,"Undeposited Funds",255.15,"",733549.90
,"Invoice","28-11-2024","MC06426",,"ZAIN SUPERMARKET LIMITED","-MULTIPLE-","Cost of Goods Sold","Zelia Dishwashing Paste",,"Accounts Receivable",746.35,"",734296.25
,"Sales Receipt","28-11-2024","3750",,"Cash Sales","Zelia Dishwashing Paste 24X400g","Cost of Goods Sold","Zelia Dishwashing Paste",,"Undeposited Funds",170.10,"",734466.35
,"Sales Receipt","29-11-2024","3754",,"Cash Sales","Zelia Dishwashing Paste 24X400g","Cost of Goods Sold","Zelia Dishwashing Paste",,"Undeposited Funds",42.53,"",734508.88
,"Sales Receipt","29-11-2024","3756",,"Cash Sales","Zelia Dishwashing Paste 24X400g","Cost of Goods Sold","Zelia Dishwashing Paste",,"Undeposited Funds",85.05,"",734593.93
,"Sales Receipt","29-11-2024","3789",,"Ubwete Shop","Zelia Dishwashing Paste 24X400g","Cost of Goods Sold","Zelia Dishwashing Paste",,"Undeposited Funds",255.15,"",734849.08
,"Sales Receipt","30-11-2024","AT203",,"Cash Sales","-MULTIPLE-","Cost of Goods Sold","Zelia Dishwashing Paste",,"Undeposited Funds",1492.69,"",736341.77
,"Sales Receipt","30-11-2024","3766",,"Muga Shop","-MULTIPLE-","Cost of Goods Sold","Zelia Dishwashing Paste",,"Undeposited Funds",2513.28,"",738855.05
,"Sales Receipt","02-12-2024","3761",,"Cash Sales","Zelia Dishwashing Paste 24X400g","Cost of Goods Sold","Zelia Dishwashing Paste",,"Undeposited Funds",42.53,"",738897.58
,"Sales Receipt","02-12-2024","3777",,"Cash Sales","Zelia Dishwashing Paste 12X800g","Cost of Goods Sold","Zelia Dishwashing Paste",,"Undeposited Funds",81.86,"",738979.44
,"Sales Receipt","02-12-2024","3780",,"Cash Sales","Zelia Dishwashing Paste 12X800g","Cost of Goods Sold","Zelia Dishwashing Paste",,"Undeposited Funds",81.86,"",739061.30
,"Sales Receipt","02-12-2024","3776",,"Elwak Stores","-MULTIPLE-","Cost of Goods Sold","Zelia Dishwashing Paste",,"Undeposited Funds",2002.99,"",741064.29
,"Sales Receipt","04-12-2024","3785",,"Towba Parkroad","-MULTIPLE-","Cost of Goods Sold","Zelia Dishwashing Paste",,"Undeposited Funds",2985.39,"",744049.68
,"Sales Receipt","04-12-2024","3787",,"Top Quality Shop","-MULTIPLE-","Cost of Goods Sold","Zelia Dishwashing Paste",,"Undeposited Funds",2475.09,"",746524.77
,"Sales Receipt","04-12-2024","3791",,"Gold mart Supermarket","Zelia Dishwashing Paste 12X800g","Cost of Goods Sold","Zelia Dishwashing Paste",,"Undeposited Funds",491.20,"",747015.97
,"Sales Receipt","05-12-2024","3309",,"Freshfinds Mart","Zelia Dishwashing Paste 24X400g","Cost of Goods Sold","Zelia Dishwashing Paste",,"Undeposited Funds",255.15,"",747271.12
,"Sales Receipt","05-12-2024","3793",,"BCB Shop","Zelia Dishwashing Paste 12X800g","Cost of Goods Sold","Zelia Dishwashing Paste",,"Undeposited Funds",982.40,"",748253.52
,"Sales Receipt","05-12-2024","3794",,"Tawakal Eastleigh","Zelia Dishwashing Paste 24X400g","Cost of Goods Sold","Zelia Dishwashing Paste",,"Undeposited Funds",1020.59,"",749274.11
,"Sales Receipt","05-12-2024","3799",,"Hayan Wholesalers","Zelia Dishwashing Paste 12X800g","Cost of Goods Sold","Zelia Dishwashing Paste",,"Undeposited Funds",982.40,"",750256.51
,"Invoice","09-12-2024","MC06452",,"DISII TRADERS LTD","Zelia Dishwashing Paste 24X400g  24Pcs@129","Cost of Goods Sold","Zelia Dishwashing Paste",,"Accounts Receivable",1020.59,"",751277.10
,"Invoice","09-12-2024","MC06453",,"Maji Asili Limited","Zelia Dishwashing Paste 24X400g  24Pcs@129","Cost of Goods Sold","Zelia Dishwashing Paste",,"Accounts Receivable",1020.59,"",752297.69
,"Sales Receipt","09-12-2024","3311",,"Cash Sales","Zelia Dishwashing Paste 12X800g","Cost of Goods Sold","Zelia Dishwashing Paste",,"Undeposited Funds",81.86,"",752379.55
,"Sales Receipt","09-12-2024","3312",,"Cash Sales","-MULTIPLE-","Cost of Goods Sold","Zelia Dishwashing Paste",,"Undeposited Funds",251.96,"",752631.51
,"Sales Receipt","09-12-2024","3314",,"Cash Sales","-MULTIPLE-","Cost of Goods Sold","Zelia Dishwashing Paste",,"Undeposited Funds",124.39,"",752755.90
,"Sales Receipt","09-12-2024","3316",,"Cash Sales","Zelia Dishwashing Paste 12X800g","Cost of Goods Sold","Zelia Dishwashing Paste",,"Undeposited Funds",327.46,"",753083.36
,"Sales Receipt","09-12-2024","3317",,"Cash Sales","Zelia Dishwashing Paste 12X800g","Cost of Goods Sold","Zelia Dishwashing Paste",,"Undeposited Funds",163.74,"",753247.10
,"Sales Receipt","09-12-2024","3318",,"Cash Sales","Zelia Dishwashing Paste 12X800g","Cost of Goods Sold","Zelia Dishwashing Paste",,"Undeposited Funds",163.74,"",753410.84
,"Sales Receipt","09-12-2024","3320",,"Cash Sales","Zelia Dishwashing Paste 12X800g","Cost of Goods Sold","Zelia Dishwashing Paste",,"Undeposited Funds",81.86,"",753492.70
,"Sales Receipt","09-12-2024","3315",,"Shop 5","Zelia Dishwashing Paste 24X400g","Cost of Goods Sold","Zelia Dishwashing Paste",,"Undeposited Funds",1020.59,"",754513.29
,"Sales Receipt","10-12-2024","3328",,"Horn of Africa","Zelia Dishwashing Paste 24X400g","Cost of Goods Sold","Zelia Dishwashing Paste",,"Undeposited Funds",1020.59,"",755533.88
,"Sales Receipt","10-12-2024","3329",,"Soimo Mini mart","Zelia Dishwashing Paste 24X400g","Cost of Goods Sold","Zelia Dishwashing Paste",,"Undeposited Funds",510.29,"",756044.17
,"Sales Receipt","10-12-2024","3330",,"Iqra Shop","Zelia Dishwashing Paste 24X400g","Cost of Goods Sold","Zelia Dishwashing Paste",,"Undeposited Funds",1020.59,"",757064.76
,"Sales Receipt","10-12-2024","3347",,"Beta Traders","Zelia Dishwashing Paste 24X400g","Cost of Goods Sold","Zelia Dishwashing Paste",,"Undeposited Funds",1020.59,"",758085.35
,"Sales Receipt","10-12-2024","3332",,"Amir Wholesalers","Zelia Dishwashing Paste 24X400g","Cost of Goods Sold","Zelia Dishwashing Paste",,"Undeposited Funds",510.29,"",758595.64
,"Sales Receipt","11-12-2024","3333",,"Cash Sales","Zelia Dishwashing Paste 12X800g","Cost of Goods Sold","Zelia Dishwashing Paste",,"Undeposited Funds",81.86,"",758677.50
,"Sales Receipt","11-12-2024","3336",,"Cash Sales","Zelia Dishwashing Paste 12X800g","Cost of Goods Sold","Zelia Dishwashing Paste",,"Undeposited Funds",163.74,"",758841.24
,"Sales Receipt","11-12-2024","3339",,"Fahal Wholesalers","Zelia Dishwashing Paste 12X800g","Cost of Goods Sold","Zelia Dishwashing Paste",,"Undeposited Funds",4912.00,"",763753.24
,"Sales Receipt","13-12-2024","3350",,"Daru-Rahma","Zelia Dishwashing Paste 12X800g","Cost of Goods Sold","Zelia Dishwashing Paste",,"Undeposited Funds",982.40,"",764735.64
,"Sales Receipt","14-12-2024","3378",,"Egesa Shop","-MULTIPLE-","Cost of Goods Sold","Zelia Dishwashing Paste",,"Undeposited Funds",166.91,"",764902.55
,"Sales Receipt","16-12-2024","3345",,"Cash Sales","Zelia Dishwashing Paste 12X800g","Cost of Goods Sold","Zelia Dishwashing Paste",,"Undeposited Funds",162.92,"",765065.47
,"Sales Receipt","16-12-2024","3346",,"Cash Sales","Zelia Dishwashing Paste 12X800g","Cost of Goods Sold","Zelia Dishwashing Paste",,"Undeposited Funds",325.83,"",765391.30
,"Sales Receipt","16-12-2024","3348",,"Cash Sales","Zelia Dishwashing Paste 12X800g","Cost of Goods Sold","Zelia Dishwashing Paste",,"Undeposited Funds",325.83,"",765717.13
,"Sales Receipt","16-12-2024","3352",,"Rayyan Shop","Zelia Dishwashing Paste 24X400g","Cost of Goods Sold","Zelia Dishwashing Paste",,"Undeposited Funds",1020.59,"",766737.72
,"Invoice","17-12-2024","MC06475",,"MUHINDI MWEUSI SUPERMARKET LIMITED","Zelia Dishwashing Paste 24X400g  12Pcs @130","Cost of Goods Sold","Zelia Dishwashing Paste",,"Accounts Receivable",1020.59,"",767758.31
,"Invoice","17-12-2024","MC06476",,"MUHINDI MWEUSI SUPERMARKET LIMITED","Zelia Dishwashing Paste 24X400g  12Pcs @130","Cost of Goods Sold","Zelia Dishwashing Paste",,"Accounts Receivable",510.29,"",768268.60
,"Sales Receipt","17-12-2024","3354",,"Cash Sales","Zelia Dishwashing Paste 12X800g","Cost of Goods Sold","Zelia Dishwashing Paste",,"Undeposited Funds",81.31,"",768349.91
,"Sales Receipt","18-12-2024","3359",,"Cash Sales","Zelia Dishwashing Paste 24X400g","Cost of Goods Sold","Zelia Dishwashing Paste",,"Undeposited Funds",85.05,"",768434.96
,"Sales Receipt","18-12-2024","3360",,"Cash Sales","-MULTIPLE-","Cost of Goods Sold","Zelia Dishwashing Paste",,"Undeposited Funds",417.78,"",768852.74
,"Sales Receipt","18-12-2024","3363",,"Cash Sales","Zelia Dishwashing Paste 24X400g","Cost of Goods Sold","Zelia Dishwashing Paste",,"Undeposited Funds",425.25,"",769277.99
,"Sales Receipt","18-12-2024","3369",,"Al-naim Store","Zelia Dishwashing Paste 24X400g","Cost of Goods Sold","Zelia Dishwashing Paste",,"Undeposited Funds",1020.59,"",770298.58
,"Sales Receipt","18-12-2024","3370",,"Adam Boss","Zelia Dishwashing Paste 12X800g","Cost of Goods Sold","Zelia Dishwashing Paste",,"Undeposited Funds",975.78,"",771274.36
,"Sales Receipt","18-12-2024","3371",,"Freshfinds Mart","Zelia Dishwashing Paste 12X800g","Cost of Goods Sold","Zelia Dishwashing Paste",,"Undeposited Funds",975.78,"",772250.14
,"Sales Receipt","19-12-2024","3373",,"Cash Sales","Zelia Dishwashing Paste 24X400g","Cost of Goods Sold","Zelia Dishwashing Paste",,"Undeposited Funds",255.15,"",772505.29
,"Credit Note","20-12-2024","CN01076",,"Karia Supermarkets Limited","Zelia Dishwashing Paste 24X400g  5pcs @ 130","Cost of Goods Sold","Zelia Dishwashing Paste",,"Accounts Receivable","",212.62,772292.67
"Total Zelia Dishwashing Paste",,,,,,,,,,,783681.88,11389.21,772292.67
"Total Zelia",,,,,,,,,,,3614578.68,252183.44,3362395.24
"Sixin",,,,,,,,,,,,,""
,"Invoice","12-01-2024","MC05305",,"Unilever Kenya Ltd:Sixin","Sixin Sulphate Blend ZA Processing Fee","Cost of Goods Sold","Sixin",,"Accounts Receivable",0.00,"",0.00
,"Invoice","04-03-2024","MC05462",,"Unilever Kenya Ltd:Sixin","Sixin Sulphate Blend ZA Processing Fee","Cost of Goods Sold","Sixin",,"Accounts Receivable",0.00,"",0.00
,"Invoice","23-03-2024","MC05526",,"Unilever Kenya Ltd:Sixin","Sixin Sulphate Blend ZA Processing Fee","Cost of Goods Sold","Sixin",,"Accounts Receivable",0.00,"",0.00
,"Invoice","04-04-2024","MC05567",,"Unilever Kenya Ltd:Sixin","Sixin Sulphate Blend ZA Processing Fee","Cost of Goods Sold","Sixin",,"Accounts Receivable",0.00,"",0.00
,"Invoice","15-05-2024","MC05705",,"Unilever Kenya Ltd:Sixin","Sixin Sulphate Blend ZA Processing Fee","Cost of Goods Sold","Sixin",,"Accounts Receivable",0.00,"",0.00
,"Invoice","30-05-2024","MC05773",,"Unilever Kenya Ltd:Sixin","Sixin Sulphate Blend ZA Processing Fee","Cost of Goods Sold","Sixin",,"Accounts Receivable",0.00,"",0.00
,"Invoice","07-06-2024","MC05796",,"Unilever Kenya Ltd:Sixin","Sixin Sulphate Blend ZA Processing Fee","Cost of Goods Sold","Sixin",,"Accounts Receivable",0.00,"",0.00
,"Invoice","24-06-2024","MC05853",,"Unilever Kenya Ltd:Sixin","Sixin Sulphate Blend ZA Processing Fee","Cost of Goods Sold","Sixin",,"Accounts Receivable",0.00,"",0.00
,"Invoice","04-07-2024","MC05883",,"Unilever Kenya Ltd:Sixin","Sixin Sulphate Blend ZA Processing Fee","Cost of Goods Sold","Sixin",,"Accounts Receivable",0.00,"",0.00
,"Invoice","15-08-2024","MC06038",,"Unilever Kenya Ltd:Sixin","Sixin Sulphate Blend ZA Processing Fee","Cost of Goods Sold","Sixin",,"Accounts Receivable",0.00,"",0.00
,"Invoice","04-09-2024","MC06111",,"Unilever Kenya Ltd:Sixin","Sixin Sulphate Blend ZA Processing Fee","Cost of Goods Sold","Sixin",,"Accounts Receivable",0.00,"",0.00
,"Invoice","25-09-2024","MC06198",,"Unilever Kenya Ltd:Sixin","Sixin Sulphate Blend ZA Processing Fee","Cost of Goods Sold","Sixin",,"Accounts Receivable",0.00,"",0.00
,"Invoice","08-11-2024","MC06349",,"Unilever Kenya Ltd:Sixin","Sixin Sulphate Blend ZA Processing Fee","Cost of Goods Sold","Sixin",,"Accounts Receivable",0.00,"",0.00
,"Invoice","21-11-2024","MC06393",,"Unilever Kenya Ltd:Sixin","Sixin Sulphate Blend ZA Processing Fee","Cost of Goods Sold","Sixin",,"Accounts Receivable",0.00,"",0.00
,"Invoice","04-12-2024","MC06442",,"Unilever Kenya Ltd:Sixin","Sixin Sulphate Blend ZA Processing Fee","Cost of Goods Sold","Sixin",,"Accounts Receivable",0.00,"",0.00
,"Invoice","17-12-2024","MC06482",,"Unilever Kenya Ltd:Sixin","Sixin Sulphate Blend ZA Processing Fee","Cost of Goods Sold","Sixin",,"Accounts Receivable",0.00,"",0.00
,"Invoice","23-12-2024","MC06501",,"Unilever Kenya Ltd","Sixin Sulphate Blend ZA Processing Fee","Cost of Goods Sold","Sixin",,"Accounts Receivable",0.00,"",0.00
"Total Sixin",,,,,,,,,,,0.00,0.00,0.00
"Direct Cost",,,,,,,,,,,,,""
"Equipment Expense",,,,,,,,,,,,,""
,"Bill","21-02-2024","0040226660000063778",,"Dovecote Company Limited","400 litres generator fuel","Cost of Goods Sold","Equipment Expense",,"Accounts Payable",67379.31,"",67379.31
,"Bill","22-07-2024","0040226660000084546",,"Dovecote Company Limited","400 litres generator fuel","Cost of Goods Sold","Equipment Expense",,"Accounts Payable",59172.41,"",126551.72
,"Bill","11-09-2024","0040226660000091667",,"Dovecote Company Limited","400 litres generator fuel","Cost of Goods Sold","Equipment Expense",,"Accounts Payable",59172.41,"",185724.13
,"Bill","22-11-2024","0040226660000100780",,"Dovecote Company Limited","300 litres generator fuel","Cost of Goods Sold","Equipment Expense",,"Accounts Payable",43448.28,"",229172.41
,"Bill","18-12-2024","0040226660000104047",,"Dovecote Company Limited","400 litres generator fuel","Cost of Goods Sold","Equipment Expense",,"Accounts Payable",56896.55,"",286068.96
"Total Equipment Expense",,,,,,,,,,,286068.96,0.00,286068.96
"Safety, Health, Envir & Quality",,,,,,,,,,,,,""
"Lab Services",,,,,,,,,,,,,""
,"Bill","15-10-2024","0110165140000003780",,"Analabs Limited","Naivas scourer analysis","Cost of Goods Sold","Lab Services",,"Accounts Payable",6900.00,"",6900.00
,"Bill","18-10-2024","0110165140000003783",,"Analabs Limited","Apo scourer analysis","Cost of Goods Sold","Lab Services",,"Accounts Payable",6900.00,"",13800.00
,"Bill","24-10-2024","0190429050000011089",,"Polucon Services Kenya Limited","Process water analysis","Cost of Goods Sold","Lab Services",,"Accounts Payable",7500.00,"",21300.00
"Total Lab Services",,,,,,,,,,,21300.00,0.00,21300.00
"System Audit Fees",,,,,,,,,,,,,""
,"Bill","30-10-2024","0091673680000000028",,"Royal Plant Inspetors","Lifting equipment inspection fee","Cost of Goods Sold","System Audit Fees",,"Accounts Payable",25000.00,"",25000.00
"Total System Audit Fees",,,,,,,,,,,25000.00,0.00,25000.00
"Lab Consumables",,,,,,,,,,,,,""
,"Cheque","07-05-2024","P2006",,,"market sample Vim Lemon 500g","Cost of Goods Sold","Lab Consumables",,"MPESA Account",100.00,"",100.00
,"Bill","14-08-2024","9677",,"FA General Store","Soy Wax","Cost of Goods Sold","Lab Consumables",,"Accounts Payable",1700.00,"",1800.00
"Total Lab Consumables",,,,,,,,,,,1800.00,0.00,1800.00
"Pest Control",,,,,,,,,,,,,""
,"Bill","07-03-2024","0020115310000157729",,"Rentokil Initial Kenya Limited","Pest net","Cost of Goods Sold","Pest Control",,"Accounts Payable",9236.53,"",9236.53
,"Bill","18-06-2024","0020115310000193185",,"Rentokil Initial Kenya Limited","Pest net","Cost of Goods Sold","Pest Control",,"Accounts Payable",10160.18,"",19396.71
,"Bill","13-09-2024","0020115310000223390",,"Rentokil Initial Kenya Limited","Pest net","Cost of Goods Sold","Pest Control",,"Accounts Payable",10160.18,"",29556.89
,"Bill","05-12-2024","0020115310000248951",,"Rentokil Initial Kenya Limited","Pest net","Cost of Goods Sold","Pest Control",,"Accounts Payable",10160.18,"",39717.07
"Total Pest Control",,,,,,,,,,,39717.07,0.00,39717.07
"Calibration Services",,,,,,,,,,,,,""
,"Bill","08-02-2024","0040915390000000500",,"Simax Engeneering Ltd","Fire system servicing","Cost of Goods Sold","Calibration Services",,"Accounts Payable",8500.00,"",8500.00
,"Bill","13-08-2024","KRACU0100042848/320",,"Simax Engeneering Ltd","Fire Extinguisher service, fire hose reel system & Fire alarm inspection service","Cost of Goods Sold","Calibration Services",,"Accounts Payable",10000.00,"",18500.00
,"Bill","21-11-2024","0171512370000001121",,"Quality Assurance Systems Limited","-MULTIPLE-","Cost of Goods Sold","Calibration Services",,"Accounts Payable",10200.00,"",28700.00
"Total Calibration Services",,,,,,,,,,,28700.00,0.00,28700.00
"Hygiene Services",,,,,,,,,,,,,""
,"Bill","05-01-2024","50719047",,"Rentokil Initial Kenya Limited","Signature Pedal Bin White 14L","Cost of Goods Sold","Hygiene Services",,"Accounts Payable",1251.38,"",1251.38
,"Bill","05-02-2024","0020115310000149347",,"Rentokil Initial Kenya Limited","Signature Pedal Bin White 14L","Cost of Goods Sold","Hygiene Services",,"Accounts Payable",1251.38,"",2502.76
,"Bill","13-02-2024","0020115310000151893",,"Rentokil Initial Kenya Limited","Jumbo Tissues","Cost of Goods Sold","Hygiene Services",,"Accounts Payable",5000.00,"",7502.76
,"Bill","07-03-2024","0020115310000160342",,"Rentokil Initial Kenya Limited","Signature Pedal Bin White 14L","Cost of Goods Sold","Hygiene Services",,"Accounts Payable",1251.38,"",8754.14
,"Bill","27-03-2024","0020115310000166294",,"Rentokil Initial Kenya Limited","Jumbo Tissues","Cost of Goods Sold","Hygiene Services",,"Accounts Payable",5000.00,"",13754.14
,"Bill","08-04-2024","0020115310000170965",,"Rentokil Initial Kenya Limited","Signature Pedal Bin White 14L","Cost of Goods Sold","Hygiene Services",,"Accounts Payable",1251.38,"",15005.52
,"Bill","22-04-2024","0040421360000013956",,"Blue Bubble Homecare Products Limited","Blue bubble toilet balls 200g*12pcs","Cost of Goods Sold","Hygiene Services",,"Accounts Payable",1396.55,"",16402.07
,"Bill","13-05-2024","0020115310000181951",,"Rentokil Initial Kenya Limited","Signature Pedal Bin White 14L","Cost of Goods Sold","Hygiene Services",,"Accounts Payable",1251.38,"",17653.45
,"Bill","24-05-2024","0020115310000185394",,"Rentokil Initial Kenya Limited","Jumbo Tissues","Cost of Goods Sold","Hygiene Services",,"Accounts Payable",5000.00,"",22653.45
,"Bill","11-06-2024","0020115310000191559",,"Rentokil Initial Kenya Limited","Signature Pedal Bin White 14L","Cost of Goods Sold","Hygiene Services",,"Accounts Payable",1251.38,"",23904.83
,"Bill","11-07-2024","0020115310000201487",,"Rentokil Initial Kenya Limited","Signature Pedal Bin White 14L","Cost of Goods Sold","Hygiene Services",,"Accounts Payable",1251.38,"",25156.21
,"Bill","22-07-2024","0020115310000204708",,"Rentokil Initial Kenya Limited","Jumbo Tissues","Cost of Goods Sold","Hygiene Services",,"Accounts Payable",5000.00,"",30156.21
,"Bill","09-08-2024","0020115310000210764",,"Rentokil Initial Kenya Limited","Signature Pedal Bin White 14L","Cost of Goods Sold","Hygiene Services",,"Accounts Payable",1251.38,"",31407.59
,"Bill","26-08-2024","0020115310000216376",,"Rentokil Initial Kenya Limited","Jumbo Tissues","Cost of Goods Sold","Hygiene Services",,"Accounts Payable",5000.00,"",36407.59
,"Bill","09-09-2024","0020115310000221698",,"Rentokil Initial Kenya Limited","Signature Pedal Bin White 14L","Cost of Goods Sold","Hygiene Services",,"Accounts Payable",1251.38,"",37658.97
,"Bill","30-09-2024","0020115310000227481",,"Rentokil Initial Kenya Limited","Jumbo Tissues","Cost of Goods Sold","Hygiene Services",,"Accounts Payable",5000.00,"",42658.97
,"Bill","09-10-2024","0020115310000232171",,"Rentokil Initial Kenya Limited","Signature Pedal Bin White 14L","Cost of Goods Sold","Hygiene Services",,"Accounts Payable",1251.38,"",43910.35
,"Bill","08-11-2024","0020115310000241933",,"Rentokil Initial Kenya Limited","Signature Pedal Bin White 14L","Cost of Goods Sold","Hygiene Services",,"Accounts Payable",1251.38,"",45161.73
,"Bill","18-11-2024","0020115310000244710",,"Rentokil Initial Kenya Limited","Jumbo Tissues","Cost of Goods Sold","Hygiene Services",,"Accounts Payable",5000.00,"",50161.73
,"Bill","07-12-2024","0020115310000251698",,"Rentokil Initial Kenya Limited","Signature Pedal Bin White 14L","Cost of Goods Sold","Hygiene Services",,"Accounts Payable",1251.38,"",51413.11
"Total Hygiene Services",,,,,,,,,,,51413.11,0.00,51413.11
"Medical Expenses",,,,,,,,,,,,,""
,"Cheque","22-01-2024","P1803",,,"Brian medical bill","Cost of Goods Sold","Medical Expenses",,"MPESA Account",3050.00,"",3050.00
,"Cheque","22-01-2024","P1805",,,"Brian medical bill","Cost of Goods Sold","Medical Expenses",,"MPESA Account",224.00,"",3274.00
,"Cheque","09-02-2024","502902",,,"Brian medical bill","Cost of Goods Sold","Medical Expenses",,"MPESA Account",5950.00,"",9224.00
,"Cheque","12-02-2024","P1837",,,"Brian medical bill","Cost of Goods Sold","Medical Expenses",,"MPESA Account",3500.00,"",12724.00
,"Cheque","13-02-2024","P1840",,,"Brian medical bill","Cost of Goods Sold","Medical Expenses",,"MPESA Account",700.00,"",13424.00
,"Cheque","14-02-2024","P1844",,,"Brian medical bill","Cost of Goods Sold","Medical Expenses",,"MPESA Account",200.00,"",13624.00
,"Cheque","14-02-2024","P1845",,,"Brian medical bill","Cost of Goods Sold","Medical Expenses",,"MPESA Account",2012.00,"",15636.00
,"Cheque","14-02-2024","P1848",,,"Brian medical bill","Cost of Goods Sold","Medical Expenses",,"MPESA Account",500.00,"",16136.00
,"Cheque","23-02-2024","P1865",,,"Brian medical bill","Cost of Goods Sold","Medical Expenses",,"MPESA Account",1150.00,"",17286.00
,"Cheque","28-02-2024","1730",,"Accra Pharmacy","Brian medical bill","Cost of Goods Sold","Medical Expenses",,"MPESA Account",2100.00,"",19386.00
,"Bill","04-03-2024","CS02752287",,"Temple Stores Pharmaceuticals","First aid kit restock","Cost of Goods Sold","Medical Expenses",,"Accounts Payable",5130.00,"",24516.00
,"Cheque","14-03-2024","014",,"Getcare Pharmacy","Brian medical bill","Cost of Goods Sold","Medical Expenses",,"MPESA Account",2500.00,"",27016.00
,"Cheque","22-03-2024","P1909",,,"Brian medical bill","Cost of Goods Sold","Medical Expenses",,"MPESA Account",1150.00,"",28166.00
,"Cheque","13-08-2024","SHD1WG6U5R",,"Victory Clinic","Denis injury first aid","Cost of Goods Sold","Medical Expenses",,"MPESA Account",2500.00,"",30666.00
,"Cheque","28-08-2024","090",,"Gallant Pharmcare","Vincent treatment","Cost of Goods Sold","Medical Expenses",,"MPESA Account",700.00,"",31366.00
,"Cheque","16-09-2024",,,,"Malenge eye first aid","Cost of Goods Sold","Medical Expenses",,"MPESA Account",250.00,"",31616.00
,"Bill","04-11-2024","KRACU0200038091/7786",,"Molars Dental Practice Limited","Medical expense","Cost of Goods Sold","Medical Expenses",,"Accounts Payable",40000.00,"",71616.00
"Total Medical Expenses",,,,,,,,,,,71616.00,0.00,71616.00
"Total Safety, Health, Envir & Quality",,,,,,,,,,,239546.18,0.00,239546.18
"Consumables",,,,,,,,,,,,,""
,"Cheque","13-01-2024","3025",,"Revelation General Hardware","Window Stay","Cost of Goods Sold","Consumables",,"Cash Account",600.00,"",600.00
,"Bill","12-06-2024","0040093830000004744",,"Quantum Lubricants (E.A) Limited","Motorol Hyflow68 hydraulic oil","Cost of Goods Sold","Consumables",,"Accounts Payable",105827.80,"",106427.80
"Total Consumables",,,,,,,,,,,106427.80,0.00,106427.80
"Direct Wages",,,,,,,,,,,,,""
,"General Journal","31-01-2024","22400",,,"Jan 2024 Wages","Cost of Goods Sold","Direct Wages",,"-SPLIT-",139166.42,"",139166.42
,"General Journal","29-02-2024","22655",,,"Feb 2024 Wages","Cost of Goods Sold","Direct Wages",,"-SPLIT-",121660.84,"",260827.26
,"Cheque","29-03-2024","P1925",,,"Casuals cash","Cost of Goods Sold","Direct Wages",,"MPESA Account",21429.00,"",282256.26
,"General Journal","31-03-2024","23191",,,"Mar 2024 Wages","Cost of Goods Sold","Direct Wages",,"-SPLIT-",130374.54,"",412630.80
,"General Journal","30-04-2024","23493",,,"Apr 2024 Wages","Cost of Goods Sold","Direct Wages",,"-SPLIT-",86791.81,"",499422.61
,"Cheque","01-05-2024","P1995",,,"Casuals cash","Cost of Goods Sold","Direct Wages",,"MPESA Account",56504.00,"",555926.61
,"General Journal","31-05-2024","23776",,,"May 2024 Wages","Cost of Goods Sold","Direct Wages",,"-SPLIT-",112201.99,"",668128.60
,"Cheque","31-05-2024","P2072",,,"Casuals cash","Cost of Goods Sold","Direct Wages",,"MPESA Account",112861.00,"",780989.60
,"Cheque","28-06-2024","P2120",,,"Casuals cash","Cost of Goods Sold","Direct Wages",,"MPESA Account",101108.00,"",882097.60
,"General Journal","30-06-2024","24429",,,"Jun 2024 Wages","Cost of Goods Sold","Direct Wages",,"-SPLIT-",93346.15,"",975443.75
,"Cheque","31-07-2024","P2183",,,"Casuals cash","Cost of Goods Sold","Direct Wages",,"MPESA Account",75091.00,"",1050534.75
,"General Journal","31-07-2024","24605",,,"Jul 2024 Wages","Cost of Goods Sold","Direct Wages",,"-SPLIT-",128416.21,"",1178950.96
,"Cheque","30-08-2024","P2249",,,"Casuals cash","Cost of Goods Sold","Direct Wages",,"MPESA Account",83155.00,"",1262105.96
,"General Journal","31-08-2024","24994",,,"Aug 2024 Wages","Cost of Goods Sold","Direct Wages",,"-SPLIT-",110060.86,"",1372166.82
,"General Journal","30-09-2024","25436",,,"Sep 2024 Wages","Cost of Goods Sold","Direct Wages",,"-SPLIT-",102120.77,"",1474287.59
,"Cheque","01-10-2024","P2317",,,"Casuals cash","Cost of Goods Sold","Direct Wages",,"MPESA Account",97787.00,"",1572074.59
,"General Journal","31-10-2024","26031",,,"Oct 2024 Wages","Cost of Goods Sold","Direct Wages",,"-SPLIT-",91788.91,"",1663863.50
,"Cheque","01-11-2024","P2370",,,"Casuals cash","Cost of Goods Sold","Direct Wages",,"MPESA Account",84965.00,"",1748828.50
,"General Journal","30-11-2024","26558",,,"Nov 2024 Wages","Cost of Goods Sold","Direct Wages",,"-SPLIT-",113112.18,"",1861940.68
,"Cheque","01-12-2024","P2438",,,"Casuals cash","Cost of Goods Sold","Direct Wages",,"MPESA Account",133668.00,"",1995608.68
,"Cheque","25-12-2024","P2504",,,"Casuals cash","Cost of Goods Sold","Direct Wages",,"MPESA Account",175074.00,"",2170682.68
,"General Journal","31-12-2024","26563",,,"Dec 2024 Wages","Cost of Goods Sold","Direct Wages",,"-SPLIT-",82946.08,"",2253628.76
"Total Direct Wages",,,,,,,,,,,2253628.76,0.00,2253628.76
"Handling Cost",,,,,,,,,,,,,""
"Forklift",,,,,,,,,,,,,""
"Forklift Fuel and Oil",,,,,,,,,,,,,""
,"Bill","04-01-2024","116997",,"Chemigas Ltd","20Kgs LPG Gas","Cost of Goods Sold","Forklift Fuel and Oil",,"Accounts Payable",3600.00,"",3600.00
,"Bill","10-01-2024","117139",,"Chemigas Ltd","20Kgs LPG Gas","Cost of Goods Sold","Forklift Fuel and Oil",,"Accounts Payable",3600.00,"",7200.00
,"Bill","12-01-2024","117211",,"Chemigas Ltd","20Kgs LPG Gas","Cost of Goods Sold","Forklift Fuel and Oil",,"Accounts Payable",3600.00,"",10800.00
,"Bill","18-01-2024","117342",,"Chemigas Ltd","20Kgs LPG Gas","Cost of Goods Sold","Forklift Fuel and Oil",,"Accounts Payable",3600.00,"",14400.00
,"Bill","22-01-2024","117441",,"Chemigas Ltd","20Kgs LPG Gas","Cost of Goods Sold","Forklift Fuel and Oil",,"Accounts Payable",7200.00,"",21600.00
,"Bill","26-01-2024","117616",,"Chemigas Ltd","20Kgs LPG Gas","Cost of Goods Sold","Forklift Fuel and Oil",,"Accounts Payable",3600.00,"",25200.00
,"Bill","31-01-2024","117721",,"Chemigas Ltd","20Kgs LPG Gas","Cost of Goods Sold","Forklift Fuel and Oil",,"Accounts Payable",3600.00,"",28800.00
,"Cheque","31-01-2024","P1818",,,"20Kgs LPG Gas","Cost of Goods Sold","Forklift Fuel and Oil",,"MPESA Account",2400.00,"",31200.00
,"Bill","02-02-2024","117799",,"Chemigas Ltd","20Kgs LPG Gas","Cost of Goods Sold","Forklift Fuel and Oil",,"Accounts Payable",3600.00,"",34800.00
,"Bill","06-02-2024","117932",,"Chemigas Ltd","20Kgs LPG Gas","Cost of Goods Sold","Forklift Fuel and Oil",,"Accounts Payable",3600.00,"",38400.00
,"Bill","12-02-2024","118084",,"Chemigas Ltd","20Kgs LPG Gas","Cost of Goods Sold","Forklift Fuel and Oil",,"Accounts Payable",7200.00,"",45600.00
,"Bill","15-02-2024","118244",,"Chemigas Ltd","20Kgs LPG Gas","Cost of Goods Sold","Forklift Fuel and Oil",,"Accounts Payable",3600.00,"",49200.00
,"Bill","20-02-2024","118365",,"Chemigas Ltd","20Kgs LPG Gas","Cost of Goods Sold","Forklift Fuel and Oil",,"Accounts Payable",3600.00,"",52800.00
,"Bill","21-02-2024","118398",,"Chemigas Ltd","20Kgs LPG Gas","Cost of Goods Sold","Forklift Fuel and Oil",,"Accounts Payable",3600.00,"",56400.00
,"Bill","26-02-2024","118533",,"Chemigas Ltd","20Kgs LPG Gas","Cost of Goods Sold","Forklift Fuel and Oil",,"Accounts Payable",3600.00,"",60000.00
,"Bill","28-02-2024","118659",,"Chemigas Ltd","20Kgs LPG Gas","Cost of Goods Sold","Forklift Fuel and Oil",,"Accounts Payable",3600.00,"",63600.00
,"Bill","29-02-2024","118701",,"Chemigas Ltd","20Kgs LPG Gas","Cost of Goods Sold","Forklift Fuel and Oil",,"Accounts Payable",3600.00,"",67200.00
,"Bill","06-03-2024","0040092630000023746",,"Chemigas Ltd","20Kgs LPG Gas","Cost of Goods Sold","Forklift Fuel and Oil",,"Accounts Payable",3600.00,"",70800.00
,"Bill","08-03-2024","0040092630000023851",,"Chemigas Ltd","20Kgs LPG Gas","Cost of Goods Sold","Forklift Fuel and Oil",,"Accounts Payable",3600.00,"",74400.00
,"Bill","13-03-2024","0040092630000024047",,"Chemigas Ltd","20Kgs LPG Gas","Cost of Goods Sold","Forklift Fuel and Oil",,"Accounts Payable",3600.00,"",78000.00
,"Bill","15-03-2024","0040092630000024193",,"Chemigas Ltd","20Kgs LPG Gas","Cost of Goods Sold","Forklift Fuel and Oil",,"Accounts Payable",3600.00,"",81600.00
,"Bill","21-03-2024","0040092630000024490",,"Chemigas Ltd","20Kgs LPG Gas","Cost of Goods Sold","Forklift Fuel and Oil",,"Accounts Payable",3600.00,"",85200.00
,"Bill","23-03-2024","0040092630000024571",,"Chemigas Ltd","20Kgs LPG Gas","Cost of Goods Sold","Forklift Fuel and Oil",,"Accounts Payable",3600.00,"",88800.00
,"Bill","25-03-2024","0040092630000024619",,"Chemigas Ltd","20Kgs LPG Gas","Cost of Goods Sold","Forklift Fuel and Oil",,"Accounts Payable",3600.00,"",92400.00
,"Bill","27-03-2024","0040092630000024736",,"Chemigas Ltd","20Kgs LPG Gas","Cost of Goods Sold","Forklift Fuel and Oil",,"Accounts Payable",3600.00,"",96000.00
,"Bill","28-03-2024","0040092630000024795",,"Chemigas Ltd","20Kgs LPG Gas","Cost of Goods Sold","Forklift Fuel and Oil",,"Accounts Payable",3600.00,"",99600.00
,"Bill","03-04-2024","0040092630000024970",,"Chemigas Ltd","20Kgs LPG Gas","Cost of Goods Sold","Forklift Fuel and Oil",,"Accounts Payable",3600.00,"",103200.00
,"Bill","05-04-2024","0040092630000025112",,"Chemigas Ltd","20Kgs LPG Gas","Cost of Goods Sold","Forklift Fuel and Oil",,"Accounts Payable",3600.00,"",106800.00
,"Bill","11-04-2024","0040092630000025322",,"Chemigas Ltd","20Kgs LPG Gas","Cost of Goods Sold","Forklift Fuel and Oil",,"Accounts Payable",3600.00,"",110400.00
,"Bill","15-04-2024","0040092630000025443",,"Chemigas Ltd","20Kgs LPG Gas","Cost of Goods Sold","Forklift Fuel and Oil",,"Accounts Payable",3600.00,"",114000.00
,"Bill","18-04-2024","0040226660000072093",,"Dovecote Company Limited","Forklift Fuel","Cost of Goods Sold","Forklift Fuel and Oil",,"Accounts Payable",2586.21,"",116586.21
,"Bill","18-04-2024","0040092630000025600",,"Chemigas Ltd","20Kgs LPG Gas","Cost of Goods Sold","Forklift Fuel and Oil",,"Accounts Payable",3600.00,"",120186.21
,"Bill","22-04-2024","0040092630000025743",,"Chemigas Ltd","20Kgs LPG Gas","Cost of Goods Sold","Forklift Fuel and Oil",,"Accounts Payable",3600.00,"",123786.21
,"Bill","25-04-2024","0040092630000025942",,"Chemigas Ltd","20Kgs LPG Gas","Cost of Goods Sold","Forklift Fuel and Oil",,"Accounts Payable",3600.00,"",127386.21
,"Bill","29-04-2024","0040226660000073817",,"Dovecote Company Limited","Forklift Fuel","Cost of Goods Sold","Forklift Fuel and Oil",,"Accounts Payable",2586.21,"",129972.42
,"Bill","30-04-2024","0040092630000026134",,"Chemigas Ltd","20Kgs LPG Gas","Cost of Goods Sold","Forklift Fuel and Oil",,"Accounts Payable",3600.00,"",133572.42
,"Bill","06-05-2024","0040092630000026313",,"Chemigas Ltd","20Kgs LPG Gas","Cost of Goods Sold","Forklift Fuel and Oil",,"Accounts Payable",7200.00,"",140772.42
,"Bill","13-05-2024","0040092630000026574",,"Chemigas Ltd","20Kgs LPG Gas","Cost of Goods Sold","Forklift Fuel and Oil",,"Accounts Payable",3600.00,"",144372.42
,"Bill","15-05-2024","0040092630000026679",,"Chemigas Ltd","20Kgs LPG Gas","Cost of Goods Sold","Forklift Fuel and Oil",,"Accounts Payable",3600.00,"",147972.42
,"Bill","20-05-2024","0040092630000026887",,"Chemigas Ltd","20Kgs LPG Gas","Cost of Goods Sold","Forklift Fuel and Oil",,"Accounts Payable",3600.00,"",151572.42
,"Bill","23-05-2024","0040092630000027055",,"Chemigas Ltd","20Kgs LPG Gas","Cost of Goods Sold","Forklift Fuel and Oil",,"Accounts Payable",7200.00,"",158772.42
,"Bill","28-05-2024","0040092630000027320",,"Chemigas Ltd","20Kgs LPG Gas","Cost of Goods Sold","Forklift Fuel and Oil",,"Accounts Payable",3600.00,"",162372.42
,"Bill","30-05-2024","0040092630000027456",,"Chemigas Ltd","20Kgs LPG Gas","Cost of Goods Sold","Forklift Fuel and Oil",,"Accounts Payable",3600.00,"",165972.42
,"Bill","04-06-2024","0040092630000027614",,"Chemigas Ltd","20Kgs LPG Gas","Cost of Goods Sold","Forklift Fuel and Oil",,"Accounts Payable",3600.00,"",169572.42
,"Bill","06-06-2024","0040092630000027740",,"Chemigas Ltd","20Kgs LPG Gas","Cost of Goods Sold","Forklift Fuel and Oil",,"Accounts Payable",3600.00,"",173172.42
,"Bill","10-06-2024","0040092630000027873",,"Chemigas Ltd","20Kgs LPG Gas","Cost of Goods Sold","Forklift Fuel and Oil",,"Accounts Payable",3600.00,"",176772.42
,"Bill","13-06-2024","0040092630000028049",,"Chemigas Ltd","20Kgs LPG Gas","Cost of Goods Sold","Forklift Fuel and Oil",,"Accounts Payable",7200.00,"",183972.42
,"Bill","19-06-2024","0040092630000028265",,"Chemigas Ltd","20Kgs LPG Gas","Cost of Goods Sold","Forklift Fuel and Oil",,"Accounts Payable",3600.00,"",187572.42
,"Bill","21-06-2024","0040092630000028375",,"Chemigas Ltd","20Kgs LPG Gas","Cost of Goods Sold","Forklift Fuel and Oil",,"Accounts Payable",3600.00,"",191172.42
,"Bill","24-06-2024","0040092630000028498",,"Chemigas Ltd","20Kgs LPG Gas","Cost of Goods Sold","Forklift Fuel and Oil",,"Accounts Payable",3600.00,"",194772.42
,"Bill","27-06-2024","0040092630000029643",,"Chemigas Ltd","20Kgs LPG Gas","Cost of Goods Sold","Forklift Fuel and Oil",,"Accounts Payable",3600.00,"",198372.42
,"Bill","02-07-2024","0040092630000028851",,"Chemigas Ltd","20Kgs LPG Gas","Cost of Goods Sold","Forklift Fuel and Oil",,"Accounts Payable",3600.00,"",201972.42
,"Bill","02-07-2024","0040092630000028846",,"Chemigas Ltd","20Kgs LPG Gas","Cost of Goods Sold","Forklift Fuel and Oil",,"Accounts Payable",3600.00,"",205572.42
,"Bill","05-07-2024","0040092630000029032",,"Chemigas Ltd","20Kgs LPG Gas","Cost of Goods Sold","Forklift Fuel and Oil",,"Accounts Payable",3600.00,"",209172.42
,"Bill","09-07-2024","0040092630000029169",,"Chemigas Ltd","20Kgs LPG Gas","Cost of Goods Sold","Forklift Fuel and Oil",,"Accounts Payable",3600.00,"",212772.42
,"Bill","12-07-2024","0040092630000029356",,"Chemigas Ltd","20Kgs LPG Gas","Cost of Goods Sold","Forklift Fuel and Oil",,"Accounts Payable",3600.00,"",216372.42
,"Bill","15-07-2024","0040092630000029464",,"Chemigas Ltd","20Kgs LPG Gas","Cost of Goods Sold","Forklift Fuel and Oil",,"Accounts Payable",3600.00,"",219972.42
,"Bill","17-07-2024","0040092630000029568",,"Chemigas Ltd","20Kgs LPG Gas","Cost of Goods Sold","Forklift Fuel and Oil",,"Accounts Payable",3600.00,"",223572.42
,"Bill","19-07-2024","0040092630000029645",,"Chemigas Ltd","20Kgs LPG Gas","Cost of Goods Sold","Forklift Fuel and Oil",,"Accounts Payable",3600.00,"",227172.42
,"Bill","23-07-2024","0040226660000084705",,"Dovecote Company Limited","Forklift Fuel","Cost of Goods Sold","Forklift Fuel and Oil",,"Accounts Payable",813.79,"",227986.21
,"Bill","24-07-2024","0040226660000084944",,"Dovecote Company Limited","Forklift Fuel","Cost of Goods Sold","Forklift Fuel and Oil",,"Accounts Payable",6896.55,"",234882.76
,"Bill","24-07-2024","0040092630000029869",,"Chemigas Ltd","20Kgs LPG Gas","Cost of Goods Sold","Forklift Fuel and Oil",,"Accounts Payable",3600.00,"",238482.76
,"Bill","26-07-2024","0040092630000030035",,"Chemigas Ltd","20Kgs LPG Gas","Cost of Goods Sold","Forklift Fuel and Oil",,"Accounts Payable",3600.00,"",242082.76
,"Bill","29-07-2024","0040092630000030075",,"Chemigas Ltd","20Kgs LPG Gas","Cost of Goods Sold","Forklift Fuel and Oil",,"Accounts Payable",3600.00,"",245682.76
,"Bill","01-08-2024","0040092630000030265",,"Chemigas Ltd","20Kgs LPG Gas","Cost of Goods Sold","Forklift Fuel and Oil",,"Accounts Payable",3600.00,"",249282.76
,"Bill","05-08-2024","0040092630000030458",,"Chemigas Ltd","20Kgs LPG Gas","Cost of Goods Sold","Forklift Fuel and Oil",,"Accounts Payable",3600.00,"",252882.76
,"Bill","09-08-2024","0040092630000030623",,"Chemigas Ltd","20Kgs LPG Gas","Cost of Goods Sold","Forklift Fuel and Oil",,"Accounts Payable",3600.00,"",256482.76
,"Bill","13-08-2024","0040092630000030846",,"Chemigas Ltd","20Kgs LPG Gas","Cost of Goods Sold","Forklift Fuel and Oil",,"Accounts Payable",3600.00,"",260082.76
,"Bill","16-08-2024","0040092630000030974",,"Chemigas Ltd","20Kgs LPG Gas","Cost of Goods Sold","Forklift Fuel and Oil",,"Accounts Payable",7200.00,"",267282.76
,"Bill","20-08-2024","0040092630000031154",,"Chemigas Ltd","20Kgs LPG Gas","Cost of Goods Sold","Forklift Fuel and Oil",,"Accounts Payable",3600.00,"",270882.76
,"Bill","23-08-2024","0040092630000031343",,"Chemigas Ltd","20Kgs LPG Gas","Cost of Goods Sold","Forklift Fuel and Oil",,"Accounts Payable",3600.00,"",274482.76
,"Bill","27-08-2024","0040092630000031467",,"Chemigas Ltd","20Kgs LPG Gas","Cost of Goods Sold","Forklift Fuel and Oil",,"Accounts Payable",3600.00,"",278082.76
,"Bill","28-08-2024","0040092630000031563",,"Chemigas Ltd","20Kgs LPG Gas","Cost of Goods Sold","Forklift Fuel and Oil",,"Accounts Payable",3600.00,"",281682.76
,"Bill","30-08-2024","0040092630000031649",,"Chemigas Ltd","20Kgs LPG Gas","Cost of Goods Sold","Forklift Fuel and Oil",,"Accounts Payable",3600.00,"",285282.76
,"Bill","03-09-2024","0040092630000031851",,"Chemigas Ltd","20Kgs LPG Gas","Cost of Goods Sold","Forklift Fuel and Oil",,"Accounts Payable",3600.00,"",288882.76
,"Bill","04-09-2024","0040092630000031894",,"Chemigas Ltd","20Kgs LPG Gas","Cost of Goods Sold","Forklift Fuel and Oil",,"Accounts Payable",3600.00,"",292482.76
,"Bill","06-09-2024","0040092630000032012",,"Chemigas Ltd","20Kgs LPG Gas","Cost of Goods Sold","Forklift Fuel and Oil",,"Accounts Payable",3600.00,"",296082.76
,"Bill","10-09-2024","0040092630000032177",,"Chemigas Ltd","20Kgs LPG Gas","Cost of Goods Sold","Forklift Fuel and Oil",,"Accounts Payable",3600.00,"",299682.76
,"Bill","13-09-2024","0040092630000032356",,"Chemigas Ltd","20Kgs LPG Gas","Cost of Goods Sold","Forklift Fuel and Oil",,"Accounts Payable",3600.00,"",303282.76
,"Bill","18-09-2024","0040092630000032598",,"Chemigas Ltd","20Kgs LPG Gas","Cost of Goods Sold","Forklift Fuel and Oil",,"Accounts Payable",3600.00,"",306882.76
,"Bill","20-09-2024","0040092630000032784",,"Chemigas Ltd","20Kgs LPG Gas","Cost of Goods Sold","Forklift Fuel and Oil",,"Accounts Payable",3600.00,"",310482.76
,"Bill","23-09-2024","0040092630000032900",,"Chemigas Ltd","20Kgs LPG Gas","Cost of Goods Sold","Forklift Fuel and Oil",,"Accounts Payable",3600.00,"",314082.76
,"Bill","24-09-2024",,,"Chemigas Ltd","20Kgs LPG Gas","Cost of Goods Sold","Forklift Fuel and Oil",,"Accounts Payable",3600.00,"",317682.76
,"Bill","27-09-2024","0040092630000033193",,"Chemigas Ltd","20Kgs LPG Gas","Cost of Goods Sold","Forklift Fuel and Oil",,"Accounts Payable",3600.00,"",321282.76
,"Bill","02-10-2024","0040226660000094441",,"Dovecote Company Limited","Forklift Fuel","Cost of Goods Sold","Forklift Fuel and Oil",,"Accounts Payable",325.86,"",321608.62
,"Bill","02-10-2024","0040226660000094442",,"Dovecote Company Limited","Forklift Fuel","Cost of Goods Sold","Forklift Fuel and Oil",,"Accounts Payable",9114.66,"",330723.28
,"Bill","02-10-2024","0040092630000033379",,"Chemigas Ltd","20Kgs LPG Gas","Cost of Goods Sold","Forklift Fuel and Oil",,"Accounts Payable",7200.00,"",337923.28
,"Bill","08-10-2024","1238393",,"Chemigas Ltd","20Kgs LPG Gas","Cost of Goods Sold","Forklift Fuel and Oil",,"Accounts Payable",3600.00,"",341523.28
,"Bill","14-10-2024","0040092630000033845",,"Chemigas Ltd","20Kgs LPG Gas","Cost of Goods Sold","Forklift Fuel and Oil",,"Accounts Payable",3600.00,"",345123.28
,"Bill","17-10-2024","0040092630000034021",,"Chemigas Ltd","20Kgs LPG Gas","Cost of Goods Sold","Forklift Fuel and Oil",,"Accounts Payable",3600.00,"",348723.28
,"Bill","22-10-2024","0040092630000034154",,"Chemigas Ltd","20Kgs LPG Gas","Cost of Goods Sold","Forklift Fuel and Oil",,"Accounts Payable",3600.00,"",352323.28
,"Bill","24-10-2024","0040092630000034305",,"Chemigas Ltd","20Kgs LPG Gas","Cost of Goods Sold","Forklift Fuel and Oil",,"Accounts Payable",3600.00,"",355923.28
,"Bill","28-10-2024","0040092630000034459",,"Chemigas Ltd","20Kgs LPG Gas","Cost of Goods Sold","Forklift Fuel and Oil",,"Accounts Payable",7200.00,"",363123.28
,"Bill","05-11-2024","0040092630000034797",,"Chemigas Ltd","20Kgs LPG Gas","Cost of Goods Sold","Forklift Fuel and Oil",,"Accounts Payable",3600.00,"",366723.28
,"Bill","08-11-2024","1239257",,"Chemigas Ltd","20Kgs LPG Gas","Cost of Goods Sold","Forklift Fuel and Oil",,"Accounts Payable",3600.00,"",370323.28
,"Bill","13-11-2024","0040092630000035165",,"Chemigas Ltd","20Kgs LPG Gas","Cost of Goods Sold","Forklift Fuel and Oil",,"Accounts Payable",3600.00,"",373923.28
,"Bill","15-11-2024","0040092630000035295",,"Chemigas Ltd","20Kgs LPG Gas","Cost of Goods Sold","Forklift Fuel and Oil",,"Accounts Payable",3600.00,"",377523.28
,"Bill","19-11-2024","0040092630000035432",,"Chemigas Ltd","20Kgs LPG Gas","Cost of Goods Sold","Forklift Fuel and Oil",,"Accounts Payable",7200.00,"",384723.28
,"Bill","21-11-2024","0040092630000035601",,"Chemigas Ltd","20Kgs LPG Gas","Cost of Goods Sold","Forklift Fuel and Oil",,"Accounts Payable",3600.00,"",388323.28
,"Bill","25-11-2024","0040092630000035709",,"Chemigas Ltd","20Kgs LPG Gas","Cost of Goods Sold","Forklift Fuel and Oil",,"Accounts Payable",3600.00,"",391923.28
,"Bill","29-11-2024","0040092630000035966",,"Chemigas Ltd","20Kgs LPG Gas","Cost of Goods Sold","Forklift Fuel and Oil",,"Accounts Payable",7200.00,"",399123.28
,"Bill","04-12-2024","0040092630000036213",,"Chemigas Ltd","20Kgs LPG Gas","Cost of Goods Sold","Forklift Fuel and Oil",,"Accounts Payable",3600.00,"",402723.28
,"Bill","11-12-2024","0040092630000036522",,"Chemigas Ltd","20Kgs LPG Gas","Cost of Goods Sold","Forklift Fuel and Oil",,"Accounts Payable",3600.00,"",406323.28
,"Bill","13-12-2024","0040092630000036605",,"Chemigas Ltd","20Kgs LPG Gas","Cost of Goods Sold","Forklift Fuel and Oil",,"Accounts Payable",3600.00,"",409923.28
,"Bill","16-12-2024","0040092630000036690",,"Chemigas Ltd","20Kgs LPG Gas","Cost of Goods Sold","Forklift Fuel and Oil",,"Accounts Payable",3600.00,"",413523.28
,"Bill","18-12-2024","0040092630000036814",,"Chemigas Ltd","20Kgs LPG Gas","Cost of Goods Sold","Forklift Fuel and Oil",,"Accounts Payable",3600.00,"",417123.28
,"Bill","20-12-2024","0040092630000036949",,"Chemigas Ltd","20Kgs LPG Gas","Cost of Goods Sold","Forklift Fuel and Oil",,"Accounts Payable",7200.00,"",424323.28
,"Bill","23-12-2024","0040092630000037074",,"Chemigas Ltd","20Kgs LPG Gas","Cost of Goods Sold","Forklift Fuel and Oil",,"Accounts Payable",3600.00,"",427923.28
,"Cheque","24-12-2024","P2502",,,"20Kgs LPG Gas","Cost of Goods Sold","Forklift Fuel and Oil",,"MPESA Account",3200.00,"",431123.28
"Total Forklift Fuel and Oil",,,,,,,,,,,431123.28,0.00,431123.28
"Total Forklift",,,,,,,,,,,431123.28,0.00,431123.28
"Loading",,,,,,,,,,,,,""
,"Cheque","04-01-2024","P1773",,,"Erick, Brian & Macharia export truck loading","Cost of Goods Sold","Loading",,"MPESA Account",2600.00,"",2600.00
,"Cheque","15-01-2024","P1790",,,"Douglas, Samson, & Erick export truck loading","Cost of Goods Sold","Loading",,"MPESA Account",600.00,"",3200.00
,"Cheque","26-01-2024","P1810",,,"Denis, Edwin & Siddy export truck loading","Cost of Goods Sold","Loading",,"MPESA Account",600.00,"",3800.00
,"Cheque","12-02-2024","P1835",,,"Douglas, Samson, & Erick export truck loading","Cost of Goods Sold","Loading",,"MPESA Account",1200.00,"",5000.00
,"Cheque","16-02-2024","P1853",,,"Douglas, Erick & Siddy export truck loading","Cost of Goods Sold","Loading",,"MPESA Account",600.00,"",5600.00
,"Cheque","16-02-2024","P1854",,,"Douglas, Erick, Samson & Fredrick export truck loading","Cost of Goods Sold","Loading",,"MPESA Account",800.00,"",6400.00
,"Cheque","21-02-2024","P1859",,,"Erick & Muthama export truck loading","Cost of Goods Sold","Loading",,"MPESA Account",600.00,"",7000.00
,"Cheque","22-02-2024","P1864",,,"Douglas, Erick & Peter export truck loading","Cost of Goods Sold","Loading",,"MPESA Account",600.00,"",7600.00
,"Cheque","04-03-2024","P1877",,,"Douglas, Erick & Samson export truck loading","Cost of Goods Sold","Loading",,"MPESA Account",1800.00,"",9400.00
,"Cheque","21-03-2024","P1906",,,"Douglas, Erick & Samson export truck loading","Cost of Goods Sold","Loading",,"MPESA Account",600.00,"",10000.00
,"Cheque","22-03-2024","P1910",,,"Evans, Edwin & David export truck loading","Cost of Goods Sold","Loading",,"MPESA Account",600.00,"",10600.00
,"Cheque","25-03-2024","P1916",,,"Evans, Edwin, Erick, and David export truck loading","Cost of Goods Sold","Loading",,"MPESA Account",1200.00,"",11800.00
,"Cheque","02-04-2024","P1939",,,"Douglas, Erick, and Samson export truck loading","Cost of Goods Sold","Loading",,"MPESA Account",600.00,"",12400.00
,"Cheque","22-05-2024","P2046",,,"Douglas, Erick, and Peter export truck loading","Cost of Goods Sold","Loading",,"MPESA Account",600.00,"",13000.00
,"Cheque","27-05-2024","P2058",,,"Erick, Evans, Douglas and Peter export truck loading","Cost of Goods Sold","Loading",,"MPESA Account",900.00,"",13900.00
,"Cheque","27-05-2024","P2059",,,"Denis, Samson, Kelvin and David export truck loading","Cost of Goods Sold","Loading",,"MPESA Account",800.00,"",14700.00
,"Cheque","29-05-2024","P2066",,,"David, Samson and Sylvester export truck loading","Cost of Goods Sold","Loading",,"MPESA Account",600.00,"",15300.00
,"Cheque","29-05-2024","P2067",,,"David, Douglas, Evans, and Peter export truck loading","Cost of Goods Sold","Loading",,"MPESA Account",800.00,"",16100.00
,"Cheque","10-06-2024","P2093",,,"Erick and Peter export truck loading","Cost of Goods Sold","Loading",,"MPESA Account",600.00,"",16700.00
,"Cheque","13-06-2024","P2103",,,"Douglas, Erick, and Peter export truck loading","Cost of Goods Sold","Loading",,"MPESA Account",600.00,"",17300.00
,"Cheque","20-06-2024","P2108",,,"Douglas, Erick, and Peter export truck loading","Cost of Goods Sold","Loading",,"MPESA Account",600.00,"",17900.00
,"Cheque","24-06-2024","P2114",,,"Denis, Benson, Kelvin and David export truck loading","Cost of Goods Sold","Loading",,"MPESA Account",1050.00,"",18950.00
,"Cheque","03-07-2024","P2125",,,"Erick and Peter export truck loading","Cost of Goods Sold","Loading",,"MPESA Account",1200.00,"",20150.00
,"Cheque","05-07-2024","P2140",,,"David, Fredrick, and Douglas export truck loading","Cost of Goods Sold","Loading",,"MPESA Account",600.00,"",20750.00
,"Cheque","29-07-2024","P2180",,,"Douglas, Peter, and Peter export truck loading","Cost of Goods Sold","Loading",,"MPESA Account",600.00,"",21350.00
,"Cheque","31-07-2024","P2184",,,"David, Evans, and Peter export truck loading","Cost of Goods Sold","Loading",,"MPESA Account",1800.00,"",23150.00
,"Cheque","19-08-2024","P2222",,,"Jeremiah, Peter, and Erick export truck loading","Cost of Goods Sold","Loading",,"MPESA Account",600.00,"",23750.00
,"Cheque","20-08-2024","P2227",,,"Douglas, Peter, and Erick export truck loading","Cost of Goods Sold","Loading",,"MPESA Account",600.00,"",24350.00
,"Cheque","23-08-2024","P2234",,,"Douglas, David, and Erick export truck loading","Cost of Goods Sold","Loading",,"MPESA Account",600.00,"",24950.00
,"Cheque","28-08-2024","P2245",,,"Denis, Wesley, and Kelvin export truck loading","Cost of Goods Sold","Loading",,"MPESA Account",600.00,"",25550.00
,"Cheque","29-08-2024","P2246",,,"Peter, David, and Erick export truck loading","Cost of Goods Sold","Loading",,"MPESA Account",600.00,"",26150.00
,"Cheque","05-09-2024","P2270",,,"Peter and Erick export truck loading","Cost of Goods Sold","Loading",,"MPESA Account",600.00,"",26750.00
,"Cheque","06-09-2024","P2271",,,"Denis, Edwin, and Erick export truck loading","Cost of Goods Sold","Loading",,"MPESA Account",600.00,"",27350.00
,"Cheque","09-09-2024","P2278",,,"Douglas, Peter, and Erick export truck loading","Cost of Goods Sold","Loading",,"MPESA Account",600.00,"",27950.00
,"Cheque","17-09-2024","P2294",,,"Kelvin and Erick export truck loading","Cost of Goods Sold","Loading",,"MPESA Account",400.00,"",28350.00
,"Cheque","23-09-2024","P2307",,,"Douglas, Peter, and Erick export truck loading","Cost of Goods Sold","Loading",,"MPESA Account",600.00,"",28950.00
,"Cheque","11-10-2024","P2340",,,"Douglas, Peter, and Brian export truck loading","Cost of Goods Sold","Loading",,"MPESA Account",600.00,"",29550.00
,"Cheque","18-10-2024","P2349",,,"Jeremiah, Peter, and Brian export truck loading","Cost of Goods Sold","Loading",,"MPESA Account",600.00,"",30150.00
,"Cheque","22-10-2024","P2354",,,"Fredrick and David export truck loading","Cost of Goods Sold","Loading",,"MPESA Account",600.00,"",30750.00
,"Cheque","05-11-2024","P2387",,,"David, Peter, and Brian export truck loading","Cost of Goods Sold","Loading",,"MPESA Account",600.00,"",31350.00
,"Cheque","08-11-2024","P2393",,,"Fredrick, Peter, and Brian export truck loading","Cost of Goods Sold","Loading",,"MPESA Account",600.00,"",31950.00
,"Cheque","15-11-2024","P2410",,,"Denis, Peter, and Brian export truck loading","Cost of Goods Sold","Loading",,"MPESA Account",900.00,"",32850.00
,"Cheque","19-11-2024","P2417",,,"Denis, Vincent, and Sylvester export truck loading","Cost of Goods Sold","Loading",,"MPESA Account",600.00,"",33450.00
,"Cheque","19-11-2024","P2418",,,"Denis, Evans, and Douglas export truck loading","Cost of Goods Sold","Loading",,"MPESA Account",600.00,"",34050.00
,"Cheque","26-11-2024","P2428",,,"Vincent, Brian, and Peter export truck loading","Cost of Goods Sold","Loading",,"MPESA Account",600.00,"",34650.00
,"Cheque","19-12-2024","P2488",,,"Vincent and Peter export truck loading","Cost of Goods Sold","Loading",,"MPESA Account",400.00,"",35050.00
,"Cheque","20-12-2024","P2491",,,"Denis, Benjamin, and Douglas export truck loading","Cost of Goods Sold","Loading",,"MPESA Account",1200.00,"",36250.00
,"Cheque","23-12-2024","P2499",,,"Denis, Kelvin, and Vincent export truck loading","Cost of Goods Sold","Loading",,"MPESA Account",600.00,"",36850.00
"Total Loading",,,,,,,,,,,36850.00,0.00,36850.00
"Transport",,,,,,,,,,,,,""
,"Cheque","05-01-2024","2820",,"Stanley N. Karani General Transpoters","Transport charges for 1 load of Emit from McDave to UKL","Cost of Goods Sold","Transport",,"Cash Account",15000.00,"",15000.00
,"Bill","11-01-2024","OGLINV240021",,"Offshore Global Logistics Ltd","storage and deliveries to customers","Cost of Goods Sold","Transport",,"Accounts Payable",7872.08,"",22872.08
,"Cheque","05-02-2024","2821",,"Stanley N. Karani General Transpoters","Transport charges for 1 load of Emit from McDave to UKL","Cost of Goods Sold","Transport",,"Cash Account",15000.00,"",37872.08
,"Bill","12-02-2024","0190175400000001076",,"Offshore Global Logistics Ltd","storage and deliveries to customers","Cost of Goods Sold","Transport",,"Accounts Payable",21391.96,"",59264.04
,"Cheque","04-03-2024","2822",,"Stanley N. Karani General Transpoters","Transport charges for 1 load of Emit from McDave to UKL","Cost of Goods Sold","Transport",,"Cash Account",15000.00,"",74264.04
,"Bill","12-03-2024","0190175400000001162",,"Offshore Global Logistics Ltd","storage and deliveries to customers","Cost of Goods Sold","Transport",,"Accounts Payable",15607.47,"",89871.51
,"Cheque","05-04-2024","2823",,"Stanley N. Karani General Transpoters","Transport charges for 2 loads of Emit from McDave to UKL","Cost of Goods Sold","Transport",,"MPESA Account",37500.00,"",127371.51
,"Cheque","05-04-2024","P1946",,,"FG Transportation to Usenge","Cost of Goods Sold","Transport",,"MPESA Account",13000.00,"",140371.51
,"Bill","16-04-2024","0190175400000001253",,"Offshore Global Logistics Ltd","storage and deliveries to customers","Cost of Goods Sold","Transport",,"Accounts Payable",14886.72,"",155258.23
,"Bill","20-04-2024","2824",,"Stanley N. Karani General Transpoters","Transport charges for 1 load of Emit from McDave to UKL","Cost of Goods Sold","Transport",,"Accounts Payable",15000.00,"",170258.23
,"Bill","06-05-2024","0041398770000079108",,"2NK SACCO CS LTD","FG Transportation","Cost of Goods Sold","Transport",,"Accounts Payable",258.62,"",170516.85
,"Bill","09-05-2024","0190175400000001326",,"Offshore Global Logistics Ltd","storage and deliveries to customers","Cost of Goods Sold","Transport",,"Accounts Payable",19780.45,"",190297.30
,"Bill","15-05-2024","2825",,"Stanley N. Karani General Transpoters","Transport charges for 1 load of Emit from McDave to UKL","Cost of Goods Sold","Transport",,"Accounts Payable",18000.00,"",208297.30
,"Bill","30-05-2024","2826",,"Stanley N. Karani General Transpoters","Transport charges for 1 load of Emit from McDave to UKL","Cost of Goods Sold","Transport",,"Accounts Payable",15000.00,"",223297.30
,"Bill","07-06-2024","2827",,"Stanley N. Karani General Transpoters","Transport charges for 1 load of Emit from McDave to UKL","Cost of Goods Sold","Transport",,"Accounts Payable",15000.00,"",238297.30
,"Bill","22-06-2024","0190175400000001455",,"Offshore Global Logistics Ltd","storage and deliveries to customers","Cost of Goods Sold","Transport",,"Accounts Payable",29869.58,"",268166.88
,"Bill","25-06-2024","2828",,"Stanley N. Karani General Transpoters","Transport charges for 1 load of Emit from McDave to UKL","Cost of Goods Sold","Transport",,"Accounts Payable",18000.00,"",286166.88
,"Bill","05-07-2024","2829",,"Stanley N. Karani General Transpoters","Transport charges for 1 load of Emit from McDave to UKL","Cost of Goods Sold","Transport",,"Accounts Payable",18000.00,"",304166.88
,"Bill","15-07-2024","0190175400000001534",,"Offshore Global Logistics Ltd","storage and deliveries to customers","Cost of Goods Sold","Transport",,"Accounts Payable",30016.31,"",334183.19
,"Bill","18-07-2024","2830",,"Stanley N. Karani General Transpoters","Transport charges for 1 load of Emit from McDave to UKL","Cost of Goods Sold","Transport",,"Accounts Payable",20000.00,"",354183.19
,"Bill","02-08-2024","2831",,"Stanley N. Karani General Transpoters","Transport charges for 1 load of Emit from McDave to UKL","Cost of Goods Sold","Transport",,"Accounts Payable",15000.00,"",369183.19
,"Bill","09-08-2024","0190175400000001635",,"Offshore Global Logistics Ltd","storage and deliveries to customers","Cost of Goods Sold","Transport",,"Accounts Payable",31150.05,"",400333.24
,"Bill","23-08-2024","2832",,"Stanley N. Karani General Transpoters","Transport charges for 1 load of Emit from McDave to UKL","Cost of Goods Sold","Transport",,"Accounts Payable",16500.00,"",416833.24
,"Bill","04-09-2024","2833",,"Stanley N. Karani General Transpoters","Transport charges for 1 load of Emit from McDave to UKL","Cost of Goods Sold","Transport",,"Accounts Payable",15000.00,"",431833.24
,"Bill","10-09-2024","0190175400000001731",,"Offshore Global Logistics Ltd","storage and deliveries to customers","Cost of Goods Sold","Transport",,"Accounts Payable",35308.29,"",467141.53
,"Bill","19-09-2024","2834",,"Stanley N. Karani General Transpoters","Transport charges for 1 load of Emit from McDave to UKL","Cost of Goods Sold","Transport",,"Accounts Payable",18000.00,"",485141.53
,"Cheque","19-09-2024","433",,"Nene Truck Transport","FG Transportation","Cost of Goods Sold","Transport",,"MPESA Account",9000.00,"",494141.53
,"Cheque","20-09-2024","437",,"Nene Truck Transport","FG Transportation","Cost of Goods Sold","Transport",,"MPESA Account",9000.00,"",503141.53
,"Bill","25-09-2024","2835",,"Stanley N. Karani General Transpoters","Transport charges for 1 load of Emit from McDave to UKL","Cost of Goods Sold","Transport",,"Accounts Payable",15000.00,"",518141.53
,"Bill","09-10-2024","0190175400000001839",,"Offshore Global Logistics Ltd","storage and deliveries to customers","Cost of Goods Sold","Transport",,"Accounts Payable",33746.46,"",551887.99
,"Bill","08-11-2024","2836",,"Stanley N. Karani General Transpoters","Transport charges for 1 load of Emit from McDave to UKL","Cost of Goods Sold","Transport",,"Accounts Payable",18000.00,"",569887.99
,"Bill","12-11-2024","0190175400000001933",,"Offshore Global Logistics Ltd","storage and deliveries to customers","Cost of Goods Sold","Transport",,"Accounts Payable",29804.60,"",599692.59
,"Bill","23-11-2024","2837",,"Stanley N. Karani General Transpoters","Transport charges for 1 load of Emit from McDave to UKL","Cost of Goods Sold","Transport",,"Accounts Payable",15000.00,"",614692.59
,"Bill","04-12-2024","2838",,"Stanley N. Karani General Transpoters","Transport charges for 1 load of Emit from McDave to UKL","Cost of Goods Sold","Transport",,"Accounts Payable",15000.00,"",629692.59
,"Bill","16-12-2024","0190175400000002052",,"Offshore Global Logistics Ltd","storage and deliveries to customers","Cost of Goods Sold","Transport",,"Accounts Payable",28814.31,"",658506.90
,"Bill","17-12-2024","2839",,"Stanley N. Karani General Transpoters","Transport charges for 1 load of Emit from McDave to UKL","Cost of Goods Sold","Transport",,"Accounts Payable",15000.00,"",673506.90
,"Bill","24-12-2024","2841",,"Stanley N. Karani General Transpoters","Transport charges for 1 load of Emit from McDave to UKL","Cost of Goods Sold","Transport",,"Accounts Payable",18000.00,"",691506.90
"Total Transport",,,,,,,,,,,691506.90,0.00,691506.90
"Handling Cost - Other",,,,,,,,,,,,,""
,"Bill","23-03-2024","0041408150000000016",,"Shaqshan Freight Ltd","-MULTIPLE-","Cost of Goods Sold","Handling Cost",,"Accounts Payable",31500.00,"",31500.00
,"Bill","10-04-2024","24MBAIM402096952",,"Tax Agency (Sales Taxes)","Railway Levy, MSS Levy & IDF Fees","Cost of Goods Sold","Handling Cost",,"Accounts Payable",88098.00,"",119598.00
,"Bill","11-04-2024","0172175160000000170",,"TELE SHIPPING AND LOGISTICS LTD","-MULTIPLE-","Cost of Goods Sold","Handling Cost",,"Accounts Payable",68700.00,"",188298.00
,"Bill","13-04-2024","0020594430000024636",,"FEDEX EXPRESS KENYA LIMITED","Handling and shipping of machine screen","Cost of Goods Sold","Handling Cost",,"Accounts Payable",2134.00,"",190432.00
,"Bill","17-04-2024","0110393050000038040",,"Consolbase Limited","Shore handling, Wharfage, Transfer charges and Terminal User Charges","Cost of Goods Sold","Handling Cost",,"Accounts Payable - USD",15497.30,"",205929.30
,"Bill","18-04-2024","0110393050000038072",,"Consolbase Limited","Shore handling, Wharfage, Transfer charges and Terminal User Charges","Cost of Goods Sold","Handling Cost",,"Accounts Payable - USD",982.50,"",206911.80
,"Credit","18-04-2024","0110393050000038060",,"Consolbase Limited","Shore handling, Wharfage, Transfer charges and Terminal User Charges","Cost of Goods Sold","Handling Cost",,"Accounts Payable - USD","",4460.55,202451.25
,"General Journal","20-04-2024","23668",,,,"Cost of Goods Sold","Handling Cost",,"Materials Usage Variance","",209317.25,-6866.00
,"Bill","22-04-2024","0041408150000000032",,"Shaqshan Freight Ltd","-MULTIPLE-","Cost of Goods Sold","Handling Cost",,"Accounts Payable",40500.00,"",33634.00
,"Cheque","27-08-2024","373",,"Acquilla Tent Makers","Tarpaulin for Whiting offloading","Cost of Goods Sold","Handling Cost",,"MPESA Account",8000.00,"",41634.00
"Total Handling Cost - Other",,,,,,,,,,,255411.80,213777.80,41634.00
"Total Handling Cost",,,,,,,,,,,1414891.98,213777.80,1201114.18
"Coding",,,,,,,,,,,,,""
"Solvent",,,,,,,,,,,,,""
,"Bill","12-03-2024","0090969110000038240",,"Statpack Industries Limited","Linx Marque Solvent 1505 1000ml","Cost of Goods Sold","Solvent",,"Accounts Payable",50760.00,"",50760.00
,"Bill","22-05-2024","0090969110000044312",,"Statpack Industries Limited","Linx Marque Solvent 1505 1000ml","Cost of Goods Sold","Solvent",,"Accounts Payable",101520.00,"",152280.00
,"Bill","11-11-2024","0090969110000057902",,"Statpack Industries Limited","Linx Marque Solvent 1505 1000ml","Cost of Goods Sold","Solvent",,"Accounts Payable",101520.00,"",253800.00
"Total Solvent",,,,,,,,,,,253800.00,0.00,253800.00
"Service Kit",,,,,,,,,,,,,""
,"Bill","28-05-2024","0090969110000044722",,"Statpack Industries Limited","8900 Linx Coder Service Kit","Cost of Goods Sold","Service Kit",,"Accounts Payable",100000.00,"",100000.00
"Total Service Kit",,,,,,,,,,,100000.00,0.00,100000.00
"Ink",,,,,,,,,,,,,""
,"Bill","28-05-2024","0090969110000044722",,"Statpack Industries Limited","Linx Marque Ink 1014 500ml","Cost of Goods Sold","Ink",,"Accounts Payable",9180.00,"",9180.00
,"Bill","27-06-2024","0090969110000046263",,"Statpack Industries Limited","8900 Linx Marque Ink 1014 500ml","Cost of Goods Sold","Ink",,"Accounts Payable",18360.00,"",27540.00
,"Bill","14-10-2024","0090969110000055498",,"Statpack Industries Limited","8900 Linx Marque Ink 1014 500ml","Cost of Goods Sold","Ink",,"Accounts Payable",18360.00,"",45900.00
"Total Ink",,,,,,,,,,,45900.00,0.00,45900.00
"Coding - Other",,,,,,,,,,,,,""
,"Cheque","24-03-2024","P1914",,,"Coding labour","Cost of Goods Sold","Coding",,"MPESA Account",9000.00,"",9000.00
"Total Coding - Other",,,,,,,,,,,9000.00,0.00,9000.00
"Total Coding",,,,,,,,,,,408700.00,0.00,408700.00
"Electricity",,,,,,,,,,,,,""
,"Bill","02-01-2024","2401I0000023345",,"Kenya Power & Lighting Company Ltd.","Dec 2023 Electricity Bill","Cost of Goods Sold","Electricity",,"Accounts Payable",666687.03,"",666687.03
,"Bill","01-02-2024","0020589440016406451",,"Kenya Power & Lighting Company Ltd.","Jan 2024 Electricity Bill","Cost of Goods Sold","Electricity",,"Accounts Payable",837815.56,"",1504502.59
,"Bill","01-03-2024","0020589440017945721",,"Kenya Power & Lighting Company Ltd.","Feb 2024 Electricity Bill","Cost of Goods Sold","Electricity",,"Accounts Payable",752195.21,"",2256697.80
,"Bill","01-04-2024","0020589440019314284",,"Kenya Power & Lighting Company Ltd.","Mar 2024 Electricity Bill","Cost of Goods Sold","Electricity",,"Accounts Payable",757820.45,"",3014518.25
,"Bill","01-05-2024","0020589440020677937",,"Kenya Power & Lighting Company Ltd.","-MULTIPLE-","Cost of Goods Sold","Electricity",,"Accounts Payable",685159.43,"",3699677.68
,"Bill","02-06-2024","0020589440022030970",,"Kenya Power & Lighting Company Ltd.","May 2024 Electricity Bill","Cost of Goods Sold","Electricity",,"Accounts Payable",565781.84,"",4265459.52
,"Bill","01-07-2024","0020589440023414973",,"Kenya Power & Lighting Company Ltd.","Jun 2024 Electricity Bill","Cost of Goods Sold","Electricity",,"Accounts Payable",604663.32,"",4870122.84
,"Bill","01-08-2024","0020589440024800302",,"Kenya Power & Lighting Company Ltd.","Jul 2024 Electricity Bill","Cost of Goods Sold","Electricity",,"Accounts Payable",637902.37,"",5508025.21
,"Bill","02-09-2024","0020116600000069610",,"Kenya Power & Lighting Company Ltd.","Aug 2024 Electricity Bill","Cost of Goods Sold","Electricity",,"Accounts Payable",659607.62,"",6167632.83
,"Bill","02-10-2024","0020589520000140282",,"Kenya Power & Lighting Company Ltd.","Sep 2024 Electricity Bill","Cost of Goods Sold","Electricity",,"Accounts Payable",672517.05,"",6840149.88
,"Bill","01-11-2024","0020589430000210566",,"Kenya Power & Lighting Company Ltd.","Oct 2024 Electricity Bill","Cost of Goods Sold","Electricity",,"Accounts Payable",720856.15,"",7561006.03
,"Bill","02-12-2024","0020589500000283663",,"Kenya Power & Lighting Company Ltd.","Nov 2024 Electricity Bill","Cost of Goods Sold","Electricity",,"Accounts Payable",695346.68,"",8256352.71
"Total Electricity",,,,,,,,,,,8256352.71,0.00,8256352.71
"Total Direct Cost",,,,,,,,,,,12965616.39,213777.80,12751838.59
"Domestos Powder",,,,,,,,,,,,,""
"Domestos Canister 12x900g",,,,,,,,,,,,,""
,"Invoice","05-01-2024","MC05276",,"Unilever Kenya Ltd:Domestos","Domestos Canister 12x900G","Cost of Goods Sold","Domestos Canister 12x900g",,"Accounts Receivable",45410.95,"",45410.95
,"Build Assembly","05-01-2024","9353",,,"24015","Cost of Goods Sold","Domestos Canister 12x900g","X","-SPLIT-",8.91,"",45419.86
,"Invoice","08-01-2024","MC05278",,"Unilever Kenya Ltd:Domestos","Domestos Canister 12x900G","Cost of Goods Sold","Domestos Canister 12x900g",,"Accounts Receivable",90840.23,"",136260.09
,"Invoice","19-01-2024","MC05334",,"Unilever Kenya Ltd:Domestos","Domestos Canister 12x900G","Cost of Goods Sold","Domestos Canister 12x900g",,"Accounts Receivable",45421.65,"",181681.74
,"Invoice","22-01-2024","MC05340",,"Unilever Kenya Ltd:Domestos","Domestos Canister 12x900G","Cost of Goods Sold","Domestos Canister 12x900g",,"Accounts Receivable",12328.73,"",194010.47
,"Invoice","26-01-2024","MC05358",,"Unilever Kenya Ltd:Domestos","Domestos Canister 12x900G","Cost of Goods Sold","Domestos Canister 12x900g",,"Accounts Receivable",90843.31,"",284853.78
,"Invoice","01-02-2024","MC05377",,"Unilever Kenya Ltd","Outer Domestos 12x900g","Cost of Goods Sold","Domestos Canister 12x900g",,"Accounts Receivable",361.47,"",285215.25
,"Invoice","07-02-2024","MC05390",,"Unilever Kenya Ltd:Domestos","Domestos Canister 12x900G","Cost of Goods Sold","Domestos Canister 12x900g",,"Accounts Receivable",172515.93,"",457731.18
,"Invoice","21-02-2024","MC05417",,"Unilever Kenya Ltd:Domestos","Domestos Canister 12x900G","Cost of Goods Sold","Domestos Canister 12x900g",,"Accounts Receivable",43754.04,"",501485.22
,"Invoice","28-02-2024","MC05453",,"Unilever Kenya Ltd:Domestos","Domestos Canister 12x900G","Cost of Goods Sold","Domestos Canister 12x900g",,"Accounts Receivable",175016.16,"",676501.38
,"Build Assembly","28-02-2024","9744",,,"24093","Cost of Goods Sold","Domestos Canister 12x900g","X","-SPLIT-",1370.73,"",677872.11
,"Invoice","05-03-2024","MC05467",,"Unilever Kenya Ltd:Domestos","Domestos Canister 12x900G","Cost of Goods Sold","Domestos Canister 12x900g",,"Accounts Receivable",119067.84,"",796939.95
,"Build Assembly","05-03-2024","9792",,,"24102","Cost of Goods Sold","Domestos Canister 12x900g","X","-SPLIT-",247.48,"",797187.43
,"Invoice","08-03-2024","MC05482",,"Unilever Kenya Ltd:Domestos","Domestos Canister 12x900G","Cost of Goods Sold","Domestos Canister 12x900g",,"Accounts Receivable",70124.95,"",867312.38
,"Invoice","14-03-2024","MC05495",,"Unilever Kenya Ltd:Domestos","Domestos Canister 12x900G","Cost of Goods Sold","Domestos Canister 12x900g",,"Accounts Receivable",32851.33,"",900163.71
,"Invoice","26-03-2024","MC05537",,"Unilever Kenya Ltd:Domestos","Domestos Canister 12x900G","Cost of Goods Sold","Domestos Canister 12x900g",,"Accounts Receivable",194580.93,"",1094744.64
,"Build Assembly","26-03-2024","9957",,,"24132","Cost of Goods Sold","Domestos Canister 12x900g","X","-SPLIT-",1681.69,"",1096426.33
,"Invoice","09-04-2024","MC05581",,"Unilever Kenya Ltd:Domestos","Domestos Canister 12x900G","Cost of Goods Sold","Domestos Canister 12x900g",,"Accounts Receivable",146685.32,"",1243111.65
,"Build Assembly","09-04-2024","10060",,,"24152","Cost of Goods Sold","Domestos Canister 12x900g","X","-SPLIT-",997.20,"",1244108.85
,"Invoice","11-04-2024","MC05593",,"Unilever Kenya Ltd:Domestos","Domestos Canister 12x900G","Cost of Goods Sold","Domestos Canister 12x900g",,"Accounts Receivable",43693.85,"",1287802.70
,"Invoice","19-04-2024","MC05620",,"Unilever Kenya Ltd:Domestos","Domestos Canister 12x900G","Cost of Goods Sold","Domestos Canister 12x900g",,"Accounts Receivable",44978.96,"",1332781.66
,"Build Assembly","19-04-2024","10164",,,"24165","Cost of Goods Sold","Domestos Canister 12x900g","X","-SPLIT-",33.78,"",1332815.44
,"Invoice","23-04-2024","MC05628",,"Unilever Kenya Ltd:Domestos","Domestos Canister 12x900G","Cost of Goods Sold","Domestos Canister 12x900g",,"Accounts Receivable",107389.89,"",1440205.33
,"Invoice","26-04-2024","MC05645",,"Unilever Kenya Ltd:Domestos","Domestos Canister 12x900G","Cost of Goods Sold","Domestos Canister 12x900g",,"Accounts Receivable",64305.32,"",1504510.65
,"Invoice","30-04-2024","MC05657",,"Unilever Kenya Ltd:Domestos","Domestos Canister 12x900G","Cost of Goods Sold","Domestos Canister 12x900g",,"Accounts Receivable",170650.61,"",1675161.26
,"Invoice","09-05-2024","MC05682",,"Unilever Kenya Ltd:Domestos","Domestos Canister 12x900G","Cost of Goods Sold","Domestos Canister 12x900g",,"Accounts Receivable",180366.01,"",1855527.27
,"Invoice","13-05-2024","MC05695",,"Unilever Kenya Ltd:Domestos","Domestos Canister 12x900G","Cost of Goods Sold","Domestos Canister 12x900g",,"Accounts Receivable",12883.29,"",1868410.56
,"Invoice","17-05-2024","MC05717",,"Unilever Kenya Ltd:Domestos","Domestos Canister 12x900G","Cost of Goods Sold","Domestos Canister 12x900g",,"Accounts Receivable",21901.58,"",1890312.14
,"Invoice","20-05-2024","MC05723",,"Unilever Kenya Ltd:Domestos","Domestos Canister 12x900G","Cost of Goods Sold","Domestos Canister 12x900g",,"Accounts Receivable",15517.11,"",1905829.25
,"Invoice","30-05-2024","MC05782",,"Unilever Kenya Ltd:Domestos","Domestos Canister 12x900G","Cost of Goods Sold","Domestos Canister 12x900g",,"Accounts Receivable",226300.59,"",2132129.84
,"Invoice","31-05-2024","MC05785",,"Unilever Kenya Ltd:Domestos","Domestos Canister 12x900G","Cost of Goods Sold","Domestos Canister 12x900g",,"Accounts Receivable",45260.12,"",2177389.96
,"Credit","13-06-2024","0010196450000039009",,"Allpack Industries Limited","Outer Domestos 12x900g","Cost of Goods Sold","Domestos Canister 12x900g",,"Accounts Payable","",0.06,2177389.90
,"Invoice","18-06-2024","MC05834",,"Unilever Kenya Ltd:Domestos","Domestos Canister 12x900G","Cost of Goods Sold","Domestos Canister 12x900g",,"Accounts Receivable",135133.78,"",2312523.68
,"Invoice","05-07-2024","MC05893",,"Unilever Kenya Ltd:Domestos","Domestos Canister 12x900G","Cost of Goods Sold","Domestos Canister 12x900g",,"Accounts Receivable",181243.16,"",2493766.84
,"Invoice","15-07-2024","MC05929",,"Unilever Kenya Ltd:Domestos","Domestos Canister 12x900G","Cost of Goods Sold","Domestos Canister 12x900g",,"Accounts Receivable",214902.60,"",2708669.44
,"Build Assembly","15-07-2024","10842",,,"24291","Cost of Goods Sold","Domestos Canister 12x900g","X","-SPLIT-","",351.16,2708318.28
,"Invoice","23-07-2024","MC05967",,"Unilever Kenya Ltd:Domestos","Domestos Canister 12x900G","Cost of Goods Sold","Domestos Canister 12x900g",,"Accounts Receivable",45222.69,"",2753540.97
,"Invoice","31-07-2024","MC05988",,"Unilever Kenya Ltd:Domestos","Domestos Canister 12x900G","Cost of Goods Sold","Domestos Canister 12x900g",,"Accounts Receivable",171573.94,"",2925114.91
,"Invoice","15-08-2024","MC06045",,"Unilever Kenya Ltd:Domestos","Domestos Canister 12x900G","Cost of Goods Sold","Domestos Canister 12x900g",,"Accounts Receivable",14093.57,"",2939208.48
,"Invoice","26-08-2024","MC06080",,"Unilever Kenya Ltd:Domestos","Domestos Canister 12x900G","Cost of Goods Sold","Domestos Canister 12x900g",,"Accounts Receivable",42710.95,"",2981919.43
,"Invoice","26-08-2024","MC06087",,"Unilever Kenya Ltd:Domestos","Domestos Canister 12x900G","Cost of Goods Sold","Domestos Canister 12x900g",,"Accounts Receivable",42710.95,"",3024630.38
,"Invoice","27-08-2024","MC06092",,"Unilever Kenya Ltd:Domestos","Domestos Canister 12x900G","Cost of Goods Sold","Domestos Canister 12x900g",,"Accounts Receivable",128132.84,"",3152763.22
,"Invoice","10-09-2024","MC06134",,"Unilever Kenya Ltd:Domestos","Domestos Canister 12x900G","Cost of Goods Sold","Domestos Canister 12x900g",,"Accounts Receivable",42774.79,"",3195538.01
,"Invoice","11-09-2024","MC06142",,"Unilever Kenya Ltd:Domestos","Domestos Canister 12x900G","Cost of Goods Sold","Domestos Canister 12x900g",,"Accounts Receivable",128324.36,"",3323862.37
,"Invoice","19-09-2024","MC06171",,"Unilever Kenya Ltd:Domestos","Domestos Canister 12x900G","Cost of Goods Sold","Domestos Canister 12x900g",,"Accounts Receivable",32952.85,"",3356815.22
,"Invoice","20-09-2024","MC06175",,"Unilever Kenya Ltd:Domestos","Domestos Canister 12x900G","Cost of Goods Sold","Domestos Canister 12x900g",,"Accounts Receivable",85433.31,"",3442248.53
,"Invoice","24-09-2024","MC06193",,"Unilever Kenya Ltd:Domestos","Domestos Canister 12x900G","Cost of Goods Sold","Domestos Canister 12x900g",,"Accounts Receivable",97027.83,"",3539276.36
,"Invoice","09-10-2024","MC06243",,"Unilever Kenya Ltd:Domestos","Domestos Canister 12x900G","Cost of Goods Sold","Domestos Canister 12x900g",,"Accounts Receivable",42622.90,"",3581899.26
,"Invoice","09-10-2024","MC06249",,"Unilever Kenya Ltd:Domestos","Domestos Canister 12x900G","Cost of Goods Sold","Domestos Canister 12x900g",,"Accounts Receivable",42622.90,"",3624522.16
,"Invoice","14-10-2024","MC06256",,"Unilever Kenya Ltd:Domestos","Domestos Canister 12x900G","Cost of Goods Sold","Domestos Canister 12x900g",,"Accounts Receivable",85245.80,"",3709767.96
,"Invoice","16-10-2024","MC06266",,"Unilever Kenya Ltd:Domestos","Domestos Canister 12x900G","Cost of Goods Sold","Domestos Canister 12x900g",,"Accounts Receivable",23747.04,"",3733515.00
,"Invoice","18-10-2024","MC06284",,"Unilever Kenya Ltd:Domestos","Domestos Canister 12x900G","Cost of Goods Sold","Domestos Canister 12x900g",,"Accounts Receivable",116299.62,"",3849814.62
,"Build Assembly","18-10-2024","11724",,,"24425","Cost of Goods Sold","Domestos Canister 12x900g","X","-SPLIT-","",2297.91,3847516.71
,"Invoice","22-10-2024","MC06287",,"Unilever Kenya Ltd:Domestos","Domestos Canister 12x900G","Cost of Goods Sold","Domestos Canister 12x900g",,"Accounts Receivable",83552.61,"",3931069.32
,"Invoice","29-10-2024","MC06318",,"Unilever Kenya Ltd:Domestos","Domestos Canister 12x900G","Cost of Goods Sold","Domestos Canister 12x900g",,"Accounts Receivable",150685.59,"",4081754.91
,"Invoice","14-11-2024","MC06363",,"Unilever Kenya Ltd:Domestos","Domestos Canister 12x900G","Cost of Goods Sold","Domestos Canister 12x900g",,"Accounts Receivable",14825.13,"",4096580.04
,"Invoice","20-11-2024","MC06390",,"Unilever Kenya Ltd:Domestos","Domestos Canister 12x900G","Cost of Goods Sold","Domestos Canister 12x900g",,"Accounts Receivable",159518.40,"",4256098.44
,"Build Assembly","20-11-2024","12003",,,"24473","Cost of Goods Sold","Domestos Canister 12x900g","X","-SPLIT-","",198.93,4255899.51
,"Invoice","28-11-2024","MC06420",,"Unilever Kenya Ltd:Domestos","Domestos Canister 12x900G","Cost of Goods Sold","Domestos Canister 12x900g",,"Accounts Receivable",229263.84,"",4485163.35
,"Invoice","02-12-2024","MC06434",,"Unilever Kenya Ltd:Domestos","Domestos Canister 12x900G","Cost of Goods Sold","Domestos Canister 12x900g",,"Accounts Receivable",41459.67,"",4526623.02
,"Invoice","04-12-2024","MC06437",,"Unilever Kenya Ltd:Domestos","Domestos Canister 12x900G","Cost of Goods Sold","Domestos Canister 12x900g",,"Accounts Receivable",124378.99,"",4651002.01
,"Invoice","17-12-2024","MC06479",,"Unilever Kenya Ltd:Domestos","Domestos Canister 12x900G","Cost of Goods Sold","Domestos Canister 12x900g",,"Accounts Receivable",124350.32,"",4775352.33
,"Invoice","18-12-2024","MC06485",,"Unilever Kenya Ltd:Domestos","Domestos Canister 12x900G","Cost of Goods Sold","Domestos Canister 12x900g",,"Accounts Receivable",114283.86,"",4889636.19
"Total Domestos Canister 12x900g",,,,,,,,,,,4892484.25,2848.06,4889636.19
"Domestos Canister 24x450g",,,,,,,,,,,,,""
,"Invoice","05-01-2024","MC05275",,"Unilever Kenya Ltd:Domestos","Domestos Canister 24x450G","Cost of Goods Sold","Domestos Canister 24x450g",,"Accounts Receivable",6283.07,"",6283.07
,"Invoice","08-01-2024","MC05282",,"Unilever Kenya Ltd:Domestos","Domestos Canister 24x450G","Cost of Goods Sold","Domestos Canister 24x450g",,"Accounts Receivable",90065.17,"",96348.24
,"Build Assembly","08-01-2024","9371",,,"24021","Cost of Goods Sold","Domestos Canister 24x450g","X","-SPLIT-",1.49,"",96349.73
,"Invoice","10-01-2024","MC05290",,"Unilever Kenya Ltd:Domestos","Domestos Canister 24x450G","Cost of Goods Sold","Domestos Canister 24x450g",,"Accounts Receivable",52364.53,"",148714.26
,"Invoice","19-01-2024","MC05337",,"Unilever Kenya Ltd:Domestos","Domestos Canister 24x450G","Cost of Goods Sold","Domestos Canister 24x450g",,"Accounts Receivable",61442.30,"",210156.56
,"Invoice","22-01-2024","MC05339",,"Unilever Kenya Ltd:Domestos","Domestos Canister 24x450G","Cost of Goods Sold","Domestos Canister 24x450g",,"Accounts Receivable",33513.98,"",243670.54
,"Invoice","30-01-2024","MC05371",,"Unilever Kenya Ltd:Domestos","Domestos Canister 24x450G","Cost of Goods Sold","Domestos Canister 24x450g",,"Accounts Receivable",150328.99,"",393999.53
,"Invoice","01-02-2024","MC05377",,"Unilever Kenya Ltd","Outer Domestos 24x450g","Cost of Goods Sold","Domestos Canister 24x450g",,"Accounts Receivable",393.88,"",394393.41
,"Invoice","21-02-2024","MC05421",,"Unilever Kenya Ltd:Domestos","Domestos Canister 24x450G","Cost of Goods Sold","Domestos Canister 24x450g",,"Accounts Receivable",62465.47,"",456858.88
,"Invoice","23-02-2024","MC05441",,"Unilever Kenya Ltd:Domestos","Domestos Canister 24x450G","Cost of Goods Sold","Domestos Canister 24x450g",,"Accounts Receivable",29516.65,"",486375.53
,"Invoice","05-03-2024","MC05466",,"Unilever Kenya Ltd:Domestos","Domestos Canister 24x450G","Cost of Goods Sold","Domestos Canister 24x450g",,"Accounts Receivable",196487.13,"",682862.66
,"Invoice","22-03-2024","MC05514",,"Unilever Kenya Ltd:Domestos","Domestos Canister 24x450G","Cost of Goods Sold","Domestos Canister 24x450g",,"Accounts Receivable",12280.45,"",695143.11
,"Invoice","26-03-2024","MC05536",,"Unilever Kenya Ltd:Domestos","Domestos Canister 24x450G","Cost of Goods Sold","Domestos Canister 24x450g",,"Accounts Receivable",20467.41,"",715610.52
,"Invoice","26-03-2024","MC05540",,"Unilever Kenya Ltd:Domestos","Domestos Canister 24x450G","Cost of Goods Sold","Domestos Canister 24x450g",,"Accounts Receivable",196584.31,"",912194.83
,"Invoice","11-04-2024","MC05587",,"Unilever Kenya Ltd:Domestos","Domestos Canister 24x450G","Cost of Goods Sold","Domestos Canister 24x450g",,"Accounts Receivable",100025.88,"",1012220.71
,"Invoice","11-04-2024","MC05592",,"Unilever Kenya Ltd:Domestos","Domestos Canister 24x450G","Cost of Goods Sold","Domestos Canister 24x450g",,"Accounts Receivable",108361.37,"",1120582.08
,"Invoice","30-04-2024","MC05656",,"Unilever Kenya Ltd:Domestos","Domestos Canister 24x450G","Cost of Goods Sold","Domestos Canister 24x450g",,"Accounts Receivable",106566.11,"",1227148.19
,"Invoice","06-05-2024","MC05672",,"Unilever Kenya Ltd:Domestos","Domestos Canister 24x450G","Cost of Goods Sold","Domestos Canister 24x450g",,"Accounts Receivable",86367.30,"",1313515.49
,"Invoice","13-05-2024","MC05694",,"Unilever Kenya Ltd:Domestos","Domestos Canister 24x450G","Cost of Goods Sold","Domestos Canister 24x450g",,"Accounts Receivable",14626.72,"",1328142.21
,"Invoice","17-05-2024","MC05716",,"Unilever Kenya Ltd:Domestos","Domestos Canister 24x450G","Cost of Goods Sold","Domestos Canister 24x450g",,"Accounts Receivable",18109.27,"",1346251.48
,"Invoice","20-05-2024","MC05722",,"Unilever Kenya Ltd:Domestos","Domestos Canister 24x450G","Cost of Goods Sold","Domestos Canister 24x450g",,"Accounts Receivable",67104.97,"",1413356.45
,"Invoice","31-05-2024","MC05784",,"Unilever Kenya Ltd:Domestos","Domestos Canister 24x450G","Cost of Goods Sold","Domestos Canister 24x450g",,"Accounts Receivable",58716.84,"",1472073.29
,"Invoice","06-06-2024","MC05794",,"Unilever Kenya Ltd:Domestos","Domestos Canister 24x450G","Cost of Goods Sold","Domestos Canister 24x450g",,"Accounts Receivable",100656.96,"",1572730.25
,"Invoice","10-06-2024","MC05808",,"Unilever Kenya Ltd:Domestos","Domestos Canister 24x450G","Cost of Goods Sold","Domestos Canister 24x450g",,"Accounts Receivable",200788.99,"",1773519.24
,"Credit","13-06-2024","0010196450000039009",,"Allpack Industries Limited","Outer Domestos 24x450g","Cost of Goods Sold","Domestos Canister 24x450g",,"Accounts Payable","",0.01,1773519.23
,"Invoice","14-06-2024","MC05825",,"Unilever Kenya Ltd:Domestos","Domestos Canister 24x450G","Cost of Goods Sold","Domestos Canister 24x450g",,"Accounts Receivable",100744.30,"",1874263.53
,"Invoice","12-07-2024","MC05918",,"Unilever Kenya Ltd:Domestos","Domestos Canister 24x450G","Cost of Goods Sold","Domestos Canister 24x450g",,"Accounts Receivable",38491.76,"",1912755.29
,"Invoice","15-07-2024","MC05928",,"Unilever Kenya Ltd:Domestos","Domestos Canister 24x450G","Cost of Goods Sold","Domestos Canister 24x450g",,"Accounts Receivable",167853.81,"",2080609.10
,"Invoice","23-07-2024","MC05962",,"Unilever Kenya Ltd:Domestos","Domestos Canister 24x450G","Cost of Goods Sold","Domestos Canister 24x450g",,"Accounts Receivable",58748.83,"",2139357.93
,"Invoice","26-07-2024","MC05974",,"Unilever Kenya Ltd:Domestos","Domestos Canister 24x450G","Cost of Goods Sold","Domestos Canister 24x450g",,"Accounts Receivable",33570.76,"",2172928.69
,"Invoice","01-08-2024","MC05995",,"Unilever Kenya Ltd:Domestos","Domestos Canister 24x450G","Cost of Goods Sold","Domestos Canister 24x450g",,"Accounts Receivable",66747.89,"",2239676.58
,"Invoice","08-08-2024","MC06009",,"Unilever Kenya Ltd:Domestos","Domestos Canister 24x450G","Cost of Goods Sold","Domestos Canister 24x450g",,"Accounts Receivable",51363.25,"",2291039.83
,"Invoice","08-08-2024","MC06014",,"Unilever Kenya Ltd:Domestos","Domestos Canister 24x450G","Cost of Goods Sold","Domestos Canister 24x450g",,"Accounts Receivable",32872.48,"",2323912.31
,"Invoice","12-08-2024","MC06034",,"Unilever Kenya Ltd:Domestos","Domestos Canister 24x450G","Cost of Goods Sold","Domestos Canister 24x450g",,"Accounts Receivable",143132.25,"",2467044.56
,"Build Assembly","12-08-2024","11102",,,"24331","Cost of Goods Sold","Domestos Canister 24x450g","X","-SPLIT-","",2105.77,2464938.79
,"Invoice","30-08-2024","MC06106",,"Unilever Kenya Ltd:Domestos","Domestos Canister 24x450G","Cost of Goods Sold","Domestos Canister 24x450g",,"Accounts Receivable",59661.73,"",2524600.52
,"Invoice","13-09-2024","MC06153",,"Unilever Kenya Ltd:Domestos","Domestos Canister 24x450G","Cost of Goods Sold","Domestos Canister 24x450g",,"Accounts Receivable",95458.78,"",2620059.30
,"Invoice","19-09-2024","MC06170",,"Unilever Kenya Ltd:Domestos","Domestos Canister 24x450G","Cost of Goods Sold","Domestos Canister 24x450g",,"Accounts Receivable",63630.73,"",2683690.03
,"Invoice","27-09-2024","MC06211",,"Unilever Kenya Ltd:Domestos","Domestos Canister 24x450G","Cost of Goods Sold","Domestos Canister 24x450g",,"Accounts Receivable",63630.73,"",2747320.76
,"Invoice","03-10-2024","MC06228",,"Unilever Kenya Ltd:Domestos","Domestos Canister 24x450G","Cost of Goods Sold","Domestos Canister 24x450g",,"Accounts Receivable",80201.23,"",2827521.99
,"Invoice","14-10-2024","MC06255",,"Unilever Kenya Ltd:Domestos","Domestos Canister 24x450G","Cost of Goods Sold","Domestos Canister 24x450g",,"Accounts Receivable",62872.19,"",2890394.18
,"Invoice","17-10-2024","MC06273",,"Unilever Kenya Ltd:Domestos","Domestos Canister 24x450G","Cost of Goods Sold","Domestos Canister 24x450g",,"Accounts Receivable",127068.01,"",3017462.19
,"Invoice","22-10-2024","MC06286",,"Unilever Kenya Ltd:Domestos","Domestos Canister 24x450G","Cost of Goods Sold","Domestos Canister 24x450g",,"Accounts Receivable",13898.07,"",3031360.26
,"Invoice","29-10-2024","MC06317",,"Unilever Kenya Ltd:Domestos","Domestos Canister 24x450G","Cost of Goods Sold","Domestos Canister 24x450g",,"Accounts Receivable",180285.17,"",3211645.43
,"Invoice","07-11-2024","MC06343",,"Unilever Kenya Ltd:Domestos","Domestos Canister 24x450G","Cost of Goods Sold","Domestos Canister 24x450g",,"Accounts Receivable",31128.38,"",3242773.81
,"Invoice","14-11-2024","MC06362",,"Unilever Kenya Ltd:Domestos","Domestos Canister 24x450G","Cost of Goods Sold","Domestos Canister 24x450g",,"Accounts Receivable",190997.98,"",3433771.79
,"Invoice","04-12-2024","MC06438",,"Unilever Kenya Ltd:Domestos","Domestos Canister 24x450G","Cost of Goods Sold","Domestos Canister 24x450g",,"Accounts Receivable",166377.98,"",3600149.77
,"Invoice","17-12-2024","MC06480",,"Unilever Kenya Ltd:Domestos","Domestos Canister 24x450G","Cost of Goods Sold","Domestos Canister 24x450g",,"Accounts Receivable",91331.14,"",3691480.91
,"Invoice","24-12-2024","MC06513",,"Unilever Kenya Ltd:Domestos","Domestos Canister 24x450G","Cost of Goods Sold","Domestos Canister 24x450g",,"Accounts Receivable",107218.85,"",3798699.76
"Total Domestos Canister 24x450g",,,,,,,,,,,3800805.54,2105.78,3798699.76
"Domestos Sachet 60x100g",,,,,,,,,,,,,""
,"Build Assembly","04-01-2024","9343",,,"Water","Cost of Goods Sold","Domestos Sachet 60x100g","X","Domestos Mix","",108.00,-108.00
,"Build Assembly","09-01-2024","9378",,,"Water","Cost of Goods Sold","Domestos Sachet 60x100g","X","Domestos Mix","",72.00,-180.00
,"Build Assembly","24-01-2024","9482",,,"Water","Cost of Goods Sold","Domestos Sachet 60x100g","X","Domestos Mix","",36.00,-216.00
,"Build Assembly","24-01-2024","9485",,,"Water","Cost of Goods Sold","Domestos Sachet 60x100g","X","Zelia Green Multipurpos Liq Mix","",337.46,-553.46
,"Build Assembly","24-01-2024","9486",,,"Water","Cost of Goods Sold","Domestos Sachet 60x100g","X","Zelia Bleach Mix","",57.14,-610.60
,"Build Assembly","25-01-2024","9488",,,"Water","Cost of Goods Sold","Domestos Sachet 60x100g","X","Domestos Mix","",36.00,-646.60
,"Build Assembly","25-01-2024","9489",,,"Water","Cost of Goods Sold","Domestos Sachet 60x100g","X","Zelia Liquid Hadnwash Mix","",166.91,-813.51
,"Build Assembly","31-01-2024","9539",,,"Water","Cost of Goods Sold","Domestos Sachet 60x100g","X","Domestos Mix","",36.00,-849.51
,"Build Assembly","01-02-2024","9547",,,"Water","Cost of Goods Sold","Domestos Sachet 60x100g","X","Domestos Mix","",36.00,-885.51
,"Build Assembly","01-02-2024","9550",,,"Water","Cost of Goods Sold","Domestos Sachet 60x100g","X","Zelia Green Multipurpos Liq Mix","",337.46,-1222.97
,"Build Assembly","05-02-2024","9577",,,"Water","Cost of Goods Sold","Domestos Sachet 60x100g","X","Zelia Green Multipurpos Liq Mix","",337.46,-1560.43
,"Build Assembly","06-02-2024","9587",,,"Water","Cost of Goods Sold","Domestos Sachet 60x100g","X","Zelia Green Multipurpos Liq Mix","",337.46,-1897.89
,"Build Assembly","12-02-2024","9631",,,"Water","Cost of Goods Sold","Domestos Sachet 60x100g","X","Zelia Toilet Cleaner Liquid Mix","",142.76,-2040.65
,"Build Assembly","12-02-2024","9632",,,"Water","Cost of Goods Sold","Domestos Sachet 60x100g","X","Zelia Bleach Mix","",57.14,-2097.79
,"Build Assembly","26-02-2024","9724",,,"Water","Cost of Goods Sold","Domestos Sachet 60x100g","X","Zelia Green Multipurpos Liq Mix","",337.46,-2435.25
,"Build Assembly","27-02-2024","9732",,,"Water","Cost of Goods Sold","Domestos Sachet 60x100g","X","Zelia Bleach Mix","",57.14,-2492.39
,"Build Assembly","27-02-2024","9735",,,"Water","Cost of Goods Sold","Domestos Sachet 60x100g","X","Domestos Mix","",72.00,-2564.39
,"Build Assembly","28-02-2024","9742",,,"Water","Cost of Goods Sold","Domestos Sachet 60x100g","X","Domestos Mix","",72.00,-2636.39
,"Build Assembly","28-02-2024","9765",,,"Water","Cost of Goods Sold","Domestos Sachet 60x100g","X","Zelia Bleach Mix","",57.14,-2693.53
,"Build Assembly","04-03-2024","9783",,,"Water","Cost of Goods Sold","Domestos Sachet 60x100g","X","Domestos Mix","",72.00,-2765.53
,"Build Assembly","06-03-2024","9798",,,"Water","Cost of Goods Sold","Domestos Sachet 60x100g","X","Zelia Toilet Cleaner Liquid Mix","",153.16,-2918.69
,"Build Assembly","07-03-2024","9806",,,"Water","Cost of Goods Sold","Domestos Sachet 60x100g","X","Zelia Green Mpse Liq Lite Mix","",176.19,-3094.88
,"Build Assembly","11-03-2024","9837",,,"Water","Cost of Goods Sold","Domestos Sachet 60x100g","X","Zelia Green Multipurpos Liq Mix","",337.46,-3432.34
,"Build Assembly","19-03-2024","9898",,,"Water","Cost of Goods Sold","Domestos Sachet 60x100g","X","Zelia Toilet Cleaner Liquid Mix","",153.16,-3585.50
,"Build Assembly","20-03-2024","9904",,,"Water","Cost of Goods Sold","Domestos Sachet 60x100g","X","Zelia Toilet Cleaner Liquid Mix","",153.16,-3738.66
,"Build Assembly","22-03-2024","10005",,,"Water","Cost of Goods Sold","Domestos Sachet 60x100g","X","Zelia Dishwashing Paste Mix","",32.54,-3771.20
,"Build Assembly","25-03-2024","9949",,,"Water","Cost of Goods Sold","Domestos Sachet 60x100g","X","Domestos Mix","",72.00,-3843.20
,"Build Assembly","26-03-2024","9952",,,"Water","Cost of Goods Sold","Domestos Sachet 60x100g","X","Domestos Mix","",54.00,-3897.20
,"Build Assembly","26-03-2024","9965",,,"Water","Cost of Goods Sold","Domestos Sachet 60x100g","X","Zelia Green Mpse Liq Lite Mix","",175.21,-4072.41
,"Build Assembly","28-03-2024","10006",,,"Water","Cost of Goods Sold","Domestos Sachet 60x100g","X","Zelia Dishwashing Paste Mix","",28.84,-4101.25
,"Build Assembly","02-04-2024","10003",,,"Water","Cost of Goods Sold","Domestos Sachet 60x100g","X","Zelia Liquid Hadnwash Mix","",170.91,-4272.16
,"Build Assembly","04-04-2024","10028",,,"Water","Cost of Goods Sold","Domestos Sachet 60x100g","X","Zelia Green Multipurpos Liq Mix","",344.22,-4616.38
,"Build Assembly","05-04-2024","10039",,,"Water","Cost of Goods Sold","Domestos Sachet 60x100g","X","Zelia Dishwashing Paste Mix","",57.67,-4674.05
,"Build Assembly","08-04-2024","10059",,,"Water","Cost of Goods Sold","Domestos Sachet 60x100g","X","Domestos Mix","",90.00,-4764.05
,"Build Assembly","09-04-2024","10058",,,"Water","Cost of Goods Sold","Domestos Sachet 60x100g","X","Zelia Liquid Hadnwash Mix","",341.82,-5105.87
,"Build Assembly","09-04-2024","10064",,,"Water","Cost of Goods Sold","Domestos Sachet 60x100g","X","Domestos Mix","",36.00,-5141.87
,"Build Assembly","11-04-2024","10077",,,"Water","Cost of Goods Sold","Domestos Sachet 60x100g","X","Zelia Toilet Cleaner Liquid Mix","",153.16,-5295.03
,"Build Assembly","12-04-2024","10095",,,"Water","Cost of Goods Sold","Domestos Sachet 60x100g","X","Zelia Dishwashing Paste Mix","",57.67,-5352.70
,"Build Assembly","15-04-2024","10107",,,"Water","Cost of Goods Sold","Domestos Sachet 60x100g","X","Zelia Green Multipurpos Liq Mix","",120.48,-5473.18
,"Build Assembly","16-04-2024","10118",,,"Water","Cost of Goods Sold","Domestos Sachet 60x100g","X","Domestos Mix","",72.00,-5545.18
,"Build Assembly","18-04-2024","10134",,,"Water","Cost of Goods Sold","Domestos Sachet 60x100g","X","Zelia Apple Handwash Liquid Mix","",170.91,-5716.09
,"Build Assembly","18-04-2024","10137",,,"Water","Cost of Goods Sold","Domestos Sachet 60x100g","X","Zelia Green Multipurpos Liq Mix","",344.22,-6060.31
,"Build Assembly","19-04-2024","10157",,,"Water","Cost of Goods Sold","Domestos Sachet 60x100g","X","Zelia Green Multipurpos Liq Mix","",344.22,-6404.53
,"Build Assembly","22-04-2024","10171",,,"Water","Cost of Goods Sold","Domestos Sachet 60x100g","X","Zelia Liquid Hadnwash Mix","",170.91,-6575.44
,"Build Assembly","22-04-2024","10172",,,"Water","Cost of Goods Sold","Domestos Sachet 60x100g","X","Zelia Apple Handwash Liquid Mix","",170.91,-6746.35
,"Build Assembly","23-04-2024","10187",,,"Water","Cost of Goods Sold","Domestos Sachet 60x100g","X","Domestos Mix","",90.00,-6836.35
,"Build Assembly","23-04-2024","10192",,,"Water","Cost of Goods Sold","Domestos Sachet 60x100g","X","Zelia Bleach Mix","",57.14,-6893.49
,"Build Assembly","24-04-2024","10196",,,"Water","Cost of Goods Sold","Domestos Sachet 60x100g","X","Domestos Mix","",36.00,-6929.49
,"Build Assembly","24-04-2024","10200",,,"Water","Cost of Goods Sold","Domestos Sachet 60x100g","X","Carneli Sweet Vanilla Shower Ge","",314.50,-7243.99
,"Build Assembly","02-05-2024","10254",,,"Water","Cost of Goods Sold","Domestos Sachet 60x100g","X","Zelia Toilet Cleaner Liquid Mix","",153.16,-7397.15
,"Build Assembly","03-05-2024","10260",,,"Water","Cost of Goods Sold","Domestos Sachet 60x100g","X","Zelia Toilet Cleaner Liquid Mix","",76.58,-7473.73
,"Build Assembly","06-05-2024","10280",,,"Water","Cost of Goods Sold","Domestos Sachet 60x100g","X","Zelia Bleach Mix","",57.14,-7530.87
,"Build Assembly","06-05-2024","10284",,,"Water","Cost of Goods Sold","Domestos Sachet 60x100g","X","Domestos Mix","",54.00,-7584.87
,"Build Assembly","07-05-2024","10299",,,"Water","Cost of Goods Sold","Domestos Sachet 60x100g","X","Zelia Carpet Cleaner Mix","",83.70,-7668.57
,"Build Assembly","07-05-2024","10291",,,"Water","Cost of Goods Sold","Domestos Sachet 60x100g","X","Domestos Mix","",18.00,-7686.57
,"Build Assembly","08-05-2024","10302",,,"Water","Cost of Goods Sold","Domestos Sachet 60x100g","X","Carneli Normal Shower Gel Mix","",251.60,-7938.17
,"Build Assembly","13-05-2024","10344",,,"Water","Cost of Goods Sold","Domestos Sachet 60x100g","X","Zelia Bleach Mix","",57.14,-7995.31
,"Build Assembly","14-05-2024","10355",,,"Water","Cost of Goods Sold","Domestos Sachet 60x100g","X","Zelia Green Multipurpos Liq Mix","",688.43,-8683.74
,"Build Assembly","15-05-2024","10358",,,"Water","Cost of Goods Sold","Domestos Sachet 60x100g","X","Domestos Mix","",90.00,-8773.74
,"Build Assembly","16-05-2024","10371",,,"Water","Cost of Goods Sold","Domestos Sachet 60x100g","X","Domestos Mix","",90.00,-8863.74
,"Build Assembly","16-05-2024","10400",,,"Water","Cost of Goods Sold","Domestos Sachet 60x100g","X","Zelia Liquid Hadnwash Mix","",170.91,-9034.65
,"Build Assembly","20-05-2024","10401",,,"Water","Cost of Goods Sold","Domestos Sachet 60x100g","X","Zelia Apple Handwash Liquid Mix","",170.91,-9205.56
,"Build Assembly","21-05-2024","10416",,,"Water","Cost of Goods Sold","Domestos Sachet 60x100g","X","Zelia Toilet Cleaner Liquid Mix","",153.16,-9358.72
,"Build Assembly","22-05-2024","10431",,,"Water","Cost of Goods Sold","Domestos Sachet 60x100g","X","Zelia Toilet Cleaner Liquid Mix","",153.16,-9511.88
,"Build Assembly","27-05-2024","10457",,,"Water","Cost of Goods Sold","Domestos Sachet 60x100g","X","Zelia Green Multipurpos Liq Mix","",344.22,-9856.10
,"Build Assembly","31-05-2024","10499",,,"Water","Cost of Goods Sold","Domestos Sachet 60x100g","X","Domestos Mix","",72.00,-9928.10
,"Build Assembly","31-05-2024","10501",,,"Water","Cost of Goods Sold","Domestos Sachet 60x100g","X","Zelia Dishwashing Paste Mix","",57.67,-9985.77
,"Build Assembly","04-06-2024","10528",,,"Water","Cost of Goods Sold","Domestos Sachet 60x100g","X","Zelia Bleach Mix","",171.43,-10157.20
,"Build Assembly","04-06-2024","10529",,,"Water","Cost of Goods Sold","Domestos Sachet 60x100g","X","Zelia Toilet Cleaner Liquid Mix","",153.16,-10310.36
,"Build Assembly","05-06-2024","10530",,,"Water","Cost of Goods Sold","Domestos Sachet 60x100g","X","Zelia Toilet Cleaner Liquid Mix","",153.16,-10463.52
,"Build Assembly","05-06-2024","10531",,,"Water","Cost of Goods Sold","Domestos Sachet 60x100g","X","Zelia Liquid Hadnwash Mix","",341.82,-10805.34
,"Build Assembly","06-06-2024","10548",,,"Water","Cost of Goods Sold","Domestos Sachet 60x100g","X","Zelia Apple Handwash Liquid Mix","",341.82,-11147.16
,"Build Assembly","07-06-2024","10566",,,"Water","Cost of Goods Sold","Domestos Sachet 60x100g","X","Zelia Dishwashing Paste Mix","",57.67,-11204.83
,"Build Assembly","07-06-2024","10569",,,"Water","Cost of Goods Sold","Domestos Sachet 60x100g","X","Domestos Mix","",54.00,-11258.83
,"Build Assembly","13-06-2024","10607",,,"Water","Cost of Goods Sold","Domestos Sachet 60x100g","X","Domestos Mix","",90.00,-11348.83
,"Build Assembly","14-06-2024","10615",,,"Water","Cost of Goods Sold","Domestos Sachet 60x100g","X","Zelia Toilet Cleaner Liquid Mix","",153.16,-11501.99
,"Build Assembly","19-06-2024","10643",,,"Water","Cost of Goods Sold","Domestos Sachet 60x100g","X","Zelia Green Multipurpos Liq Mix","",344.22,-11846.21
,"Build Assembly","19-06-2024","10645",,,"Water","Cost of Goods Sold","Domestos Sachet 60x100g","X","Zelia Green Mpse Liq Lite Mix","",350.42,-12196.63
,"Build Assembly","27-06-2024","10709",,,"Water","Cost of Goods Sold","Domestos Sachet 60x100g","X","Domestos Mix","",72.00,-12268.63
,"Build Assembly","03-07-2024","10741",,,"Water","Cost of Goods Sold","Domestos Sachet 60x100g","X","Zelia Green Multipurpos Liq Mix","",688.43,-12957.06
,"Build Assembly","04-07-2024","10743",,,"Water","Cost of Goods Sold","Domestos Sachet 60x100g","X","Zelia Bleach Mix","",57.14,-13014.20
,"Build Assembly","08-07-2024","10787",,,"Water","Cost of Goods Sold","Domestos Sachet 60x100g","X","Zelia Apple Handwash Liquid Mix","",341.82,-13356.02
,"Build Assembly","09-07-2024","10795",,,"Water","Cost of Goods Sold","Domestos Sachet 60x100g","X","Domestos Mix","",90.00,-13446.02
,"Build Assembly","09-07-2024","10815",,,"Water","Cost of Goods Sold","Domestos Sachet 60x100g","X","Zelia Toilet Cleaner Liquid Mix","",76.58,-13522.60
,"Build Assembly","10-07-2024","10799",,,"Water","Cost of Goods Sold","Domestos Sachet 60x100g","X","Domestos Mix","",36.00,-13558.60
,"Build Assembly","18-07-2024","10875",,,"Water","Cost of Goods Sold","Domestos Sachet 60x100g","X","Zelia Dishwashing Paste Mix","",57.67,-13616.27
,"Build Assembly","19-07-2024","10887",,,"Water","Cost of Goods Sold","Domestos Sachet 60x100g","X","Zelia Dishwashing Paste Mix","",57.67,-13673.94
,"Build Assembly","22-07-2024","10908",,,"Water","Cost of Goods Sold","Domestos Sachet 60x100g","X","Fuel Gel Mix","",13.71,-13687.65
,"Build Assembly","26-07-2024","10941",,,"Water","Cost of Goods Sold","Domestos Sachet 60x100g","X","Domestos Mix","",72.00,-13759.65
,"Build Assembly","26-07-2024","11042",,,"Water","Cost of Goods Sold","Domestos Sachet 60x100g","X","Zelia Liquid Hadnwash Mix","",341.82,-14101.47
,"Build Assembly","29-07-2024","10961",,,"Water","Cost of Goods Sold","Domestos Sachet 60x100g","X","Domestos Mix","",18.00,-14119.47
,"Build Assembly","29-07-2024","11043",,,"Water","Cost of Goods Sold","Domestos Sachet 60x100g","X","Zelia Toilet Cleaner Liquid Mix","",147.56,-14267.03
,"Build Assembly","30-07-2024","11044",,,"Water","Cost of Goods Sold","Domestos Sachet 60x100g","X","Zelia Toilet Cleaner Liquid Mix","",149.16,-14416.19
,"Build Assembly","31-07-2024","10987",,,"Water","Cost of Goods Sold","Domestos Sachet 60x100g","X","Zelia Green Multipurpos Liq Mix","",679.16,-15095.35
,"Build Assembly","31-07-2024","11045",,,"Water","Cost of Goods Sold","Domestos Sachet 60x100g","X","Zelia Toilet Cleaner Liquid Mix","",151.16,-15246.51
,"Build Assembly","06-08-2024","11052",,,"Water","Cost of Goods Sold","Domestos Sachet 60x100g","X","Zelia Green Multipurpos Liq Mix","",339.58,-15586.09
,"Build Assembly","08-08-2024","11076",,,"Water","Cost of Goods Sold","Domestos Sachet 60x100g","X","Domestos Mix","",72.00,-15658.09
,"Build Assembly","08-08-2024","11319",,,"Water","Cost of Goods Sold","Domestos Sachet 60x100g","X","Zelia Apple Handwash Liquid Mix","",333.82,-15991.91
,"Build Assembly","12-08-2024","11106",,,"Water","Cost of Goods Sold","Domestos Sachet 60x100g","X","Zelia Bleach Mix","",142.86,-16134.77
,"Build Assembly","12-08-2024","11320",,,"Water","Cost of Goods Sold","Domestos Sachet 60x100g","X","Zelia Apple Handwash Liquid Mix","",333.82,-16468.59
,"Build Assembly","13-08-2024","11321",,,"Water","Cost of Goods Sold","Domestos Sachet 60x100g","X","Zelia Apple Handwash Liquid Mix","",333.82,-16802.41
,"Build Assembly","13-08-2024","11322",,,"Water","Cost of Goods Sold","Domestos Sachet 60x100g","X","Zelia Liquid Hadnwash Mix","",333.82,-17136.23
,"Build Assembly","14-08-2024","11124",,,"Water","Cost of Goods Sold","Domestos Sachet 60x100g","X","Zelia Dishwashing Paste Mix","",57.67,-17193.90
,"Build Assembly","14-08-2024","11128",,,"Water","Cost of Goods Sold","Domestos Sachet 60x100g","X","Domestos Mix","",72.00,-17265.90
,"Build Assembly","14-08-2024","11129",,,"Water","Cost of Goods Sold","Domestos Sachet 60x100g","X","Zelia Toilet Cleaner Liquid Mix","",302.32,-17568.22
,"Build Assembly","14-08-2024","11130",,,"Water","Cost of Goods Sold","Domestos Sachet 60x100g","X","Zelia Green Multipurpos Liq Mix","",339.58,-17907.80
,"Build Assembly","16-08-2024","11323",,,"Water","Cost of Goods Sold","Domestos Sachet 60x100g","X","Zelia Apple Handwash Liquid Mix","",333.82,-18241.62
,"Build Assembly","19-08-2024","11172",,,"Water","Cost of Goods Sold","Domestos Sachet 60x100g","X","Zelia Dishwashing Paste Mix","",57.67,-18299.29
,"Build Assembly","20-08-2024","11181",,,"Water","Cost of Goods Sold","Domestos Sachet 60x100g","X","Zelia Carpet Cleaner Mix","",80.02,-18379.31
,"Build Assembly","20-08-2024","11190",,,"Water","Cost of Goods Sold","Domestos Sachet 60x100g","X","Fuel Gel Mix","",13.28,-18392.59
,"Build Assembly","22-08-2024","11208",,,"Water","Cost of Goods Sold","Domestos Sachet 60x100g","X","Zelia Dishwashing Paste Mix","",57.67,-18450.26
,"Build Assembly","23-08-2024","11223",,,"Water","Cost of Goods Sold","Domestos Sachet 60x100g","X","Zelia Dishwashing Paste Mix","",57.67,-18507.93
,"Build Assembly","27-08-2024","11245",,,"Water","Cost of Goods Sold","Domestos Sachet 60x100g","X","Zelia Liquid Hadnwash Mix","",417.27,-18925.20
,"Build Assembly","28-08-2024","11255",,,"Water","Cost of Goods Sold","Domestos Sachet 60x100g","X","Domestos Mix","",72.00,-18997.20
,"Build Assembly","29-08-2024","11267",,,"Water","Cost of Goods Sold","Domestos Sachet 60x100g","X","Zelia Carpet Cleaner Mix","",80.02,-19077.22
,"Build Assembly","29-08-2024","11272",,,"Water","Cost of Goods Sold","Domestos Sachet 60x100g","X","Zelia Toilet Cleaner Liquid Mix","",151.16,-19228.38
,"Build Assembly","30-08-2024","11282",,,"Water","Cost of Goods Sold","Domestos Sachet 60x100g","X","Zelia Toilet Cleaner Liquid Mix","",151.16,-19379.54
,"Build Assembly","03-09-2024","11329",,,"Water","Cost of Goods Sold","Domestos Sachet 60x100g","X","Zelia Liquid Hadnwash Mix","",333.82,-19713.36
,"Build Assembly","04-09-2024","11339",,,"Water","Cost of Goods Sold","Domestos Sachet 60x100g","X","Zelia Apple Handwash Liquid Mix","",333.82,-20047.18
,"Build Assembly","06-09-2024","11353",,,"Water","Cost of Goods Sold","Domestos Sachet 60x100g","X","Zelia Bleach Mix","",114.29,-20161.47
,"Build Assembly","09-09-2024","11474",,,"Water","Cost of Goods Sold","Domestos Sachet 60x100g","X","Zelia Green Multipurpos Liq Mix","",339.58,-20501.05
,"Build Assembly","10-09-2024","11479",,,"Water","Cost of Goods Sold","Domestos Sachet 60x100g","X","Zelia Green Mpse Liq Lite Mix","",175.21,-20676.26
,"Build Assembly","10-09-2024","11481",,,"Water","Cost of Goods Sold","Domestos Sachet 60x100g","X","Zelia Toilet Cleaner Liquid Mix","",302.32,-20978.58
,"Build Assembly","11-09-2024","11400",,,"Water","Cost of Goods Sold","Domestos Sachet 60x100g","X","Zelia Toilet Cleaner Liquid Mix","",151.16,-21129.74
,"Build Assembly","12-09-2024","11403",,,"Water","Cost of Goods Sold","Domestos Sachet 60x100g","X","Zelia Green Multipurpos Liq Mix","",339.58,-21469.32
,"Build Assembly","12-09-2024","11485",,,"Water","Cost of Goods Sold","Domestos Sachet 60x100g","X","Zelia Carpet Cleaner Mix","",160.05,-21629.37
,"Build Assembly","13-09-2024","11413",,,"Water","Cost of Goods Sold","Domestos Sachet 60x100g","X","Domestos Mix","",72.00,-21701.37
,"Build Assembly","13-09-2024","11414",,,"Water","Cost of Goods Sold","Domestos Sachet 60x100g","X","Domestos Mix","",72.00,-21773.37
,"Build Assembly","13-09-2024","11416",,,"Water","Cost of Goods Sold","Domestos Sachet 60x100g","X","Zelia Dishwashing Paste Mix","",57.67,-21831.04
,"Build Assembly","20-09-2024","11492",,,"Water","Cost of Goods Sold","Domestos Sachet 60x100g","X","Zelia Dishwashing Paste Mix","",57.67,-21888.71
,"Build Assembly","23-09-2024","11511",,,"Water","Cost of Goods Sold","Domestos Sachet 60x100g","X","Zelia Liquid Hadnwash Mix","",333.82,-22222.53
,"Build Assembly","23-09-2024","11512",,,"Water","Cost of Goods Sold","Domestos Sachet 60x100g","X","Zelia Toilet Cleaner Liquid Mix","",453.48,-22676.01
,"Build Assembly","23-09-2024","11513",,,"Water","Cost of Goods Sold","Domestos Sachet 60x100g","X","Zelia Bleach Mix","",114.29,-22790.30
,"Build Assembly","24-09-2024","11526",,,"Water","Cost of Goods Sold","Domestos Sachet 60x100g","X","Zelia Dishwashing Paste Mix","",57.67,-22847.97
,"Build Assembly","24-09-2024","11527",,,"Water","Cost of Goods Sold","Domestos Sachet 60x100g","X","Zelia Toilet Cleaner Liquid Mix","",151.16,-22999.13
,"Build Assembly","25-09-2024","11540",,,"Water","Cost of Goods Sold","Domestos Sachet 60x100g","X","Zelia Dishwashing Paste Mix","",115.34,-23114.47
,"Build Assembly","26-09-2024","11558",,,"Water","Cost of Goods Sold","Domestos Sachet 60x100g","X","Zelia Dishwashing Paste Mix","",115.34,-23229.81
,"Build Assembly","30-09-2024","11574",,,"Water","Cost of Goods Sold","Domestos Sachet 60x100g","X","Zelia Bleach Mix","",114.29,-23344.10
,"Build Assembly","30-09-2024","11585",,,"Water","Cost of Goods Sold","Domestos Sachet 60x100g","X","Domestos Mix","",72.00,-23416.10
,"Build Assembly","01-10-2024","11591",,,"Water","Cost of Goods Sold","Domestos Sachet 60x100g","X","Domestos Mix","",54.00,-23470.10
,"Build Assembly","01-10-2024","11602",,,"Water","Cost of Goods Sold","Domestos Sachet 60x100g","X","Crimson Body Wash Mix","",128.30,-23598.40
,"Build Assembly","04-10-2024","11618",,,"Water","Cost of Goods Sold","Domestos Sachet 60x100g","X","Zelia Apple Handwash Liquid Mix","",333.82,-23932.22
,"Build Assembly","07-10-2024","11644",,,"Water","Cost of Goods Sold","Domestos Sachet 60x100g","X","Zelia Green Multipurpos Liq Mix","",679.16,-24611.38
,"Build Assembly","08-10-2024","11639",,,"Water","Cost of Goods Sold","Domestos Sachet 60x100g","X","Zelia Green Multipurpos Liq Mix","",339.58,-24950.96
,"Build Assembly","08-10-2024","11640",,,"Water","Cost of Goods Sold","Domestos Sachet 60x100g","X","Zelia Green Mpse Liq Lite Mix","",350.42,-25301.38
,"Build Assembly","09-10-2024","11656",,,"Water","Cost of Goods Sold","Domestos Sachet 60x100g","X","Zelia Bleach Mix","",57.14,-25358.52
,"Build Assembly","11-10-2024","11668",,,"Water","Cost of Goods Sold","Domestos Sachet 60x100g","X","Zelia Bleach Mix","",114.29,-25472.81
,"Build Assembly","14-10-2024","11686",,,"Water","Cost of Goods Sold","Domestos Sachet 60x100g","X","Zelia Toilet Cleaner Liquid Mix","",151.16,-25623.97
,"Build Assembly","14-10-2024","11685",,,"Water","Cost of Goods Sold","Domestos Sachet 60x100g","X","Zelia Bleach Mix","",97.14,-25721.11
,"Build Assembly","15-10-2024","11692",,,"Water","Cost of Goods Sold","Domestos Sachet 60x100g","X","Zelia Surface Cleaner Mix","",58.65,-25779.76
,"Build Assembly","17-10-2024","11714",,,"Water","Cost of Goods Sold","Domestos Sachet 60x100g","X","Domestos Mix","",72.00,-25851.76
,"Build Assembly","22-10-2024","11741",,,"Water","Cost of Goods Sold","Domestos Sachet 60x100g","X","Zelia Dishwashing Paste Mix","",57.67,-25909.43
,"Build Assembly","24-10-2024","11757",,,"Water","Cost of Goods Sold","Domestos Sachet 60x100g","X","Domestos Mix","",72.00,-25981.43
,"Build Assembly","24-10-2024","11762",,,"Water","Cost of Goods Sold","Domestos Sachet 60x100g","X","Zelia Liquid Hadnwash Mix","",333.82,-26315.25
,"Build Assembly","25-10-2024","11763",,,"Water","Cost of Goods Sold","Domestos Sachet 60x100g","X","Zelia Apple Handwash Liquid Mix","",333.82,-26649.07
,"Build Assembly","25-10-2024","11766",,,"Water","Cost of Goods Sold","Domestos Sachet 60x100g","X","Domestos Mix","",54.00,-26703.07
,"Build Assembly","29-10-2024","11796",,,"Water","Cost of Goods Sold","Domestos Sachet 60x100g","X","Zelia Green Multipurpos Liq Mix","",339.58,-27042.65
,"Build Assembly","30-10-2024","11803",,,"Water","Cost of Goods Sold","Domestos Sachet 60x100g","X","Zelia Bleach Mix","",114.29,-27156.94
,"Build Assembly","31-10-2024","11814",,,"Water","Cost of Goods Sold","Domestos Sachet 60x100g","X","Zelia Bleach Mix","",57.14,-27214.08
,"Build Assembly","04-11-2024","11833",,,"Water","Cost of Goods Sold","Domestos Sachet 60x100g","X","Zelia Dishwashing Paste Mix","",57.67,-27271.75
,"Build Assembly","04-11-2024","11834",,,"Water","Cost of Goods Sold","Domestos Sachet 60x100g","X","Zelia Bleach Mix","",57.14,-27328.89
,"Build Assembly","05-11-2024","11842",,,"Water","Cost of Goods Sold","Domestos Sachet 60x100g","X","Domestos Mix","",36.00,-27364.89
,"Build Assembly","05-11-2024","11843",,,"Water","Cost of Goods Sold","Domestos Sachet 60x100g","X","Zelia Dishwashing Paste Mix","",57.67,-27422.56
,"Build Assembly","06-11-2024","11852",,,"Water","Cost of Goods Sold","Domestos Sachet 60x100g","X","Domestos Mix","",36.00,-27458.56
,"Build Assembly","06-11-2024","11862",,,"Water","Cost of Goods Sold","Domestos Sachet 60x100g","X","Fuel Gel Mix","",13.28,-27471.84
,"Build Assembly","06-11-2024","11895",,,"Water","Cost of Goods Sold","Domestos Sachet 60x100g","X","Zelia Carpet Cleaner Mix","",160.05,-27631.89
,"Build Assembly","14-11-2024","11944",,,"Water","Cost of Goods Sold","Domestos Sachet 60x100g","X","Zelia Liquid Hadnwash Mix","",333.82,-27965.71
,"Build Assembly","19-11-2024","11992",,,"Water","Cost of Goods Sold","Domestos Sachet 60x100g","X","Domestos Mix","",36.00,-28001.71
,"Build Assembly","19-11-2024","11995",,,"Water","Cost of Goods Sold","Domestos Sachet 60x100g","X","Fuel Gel Mix","",26.56,-28028.27
,"Build Assembly","20-11-2024","12005",,,"Water","Cost of Goods Sold","Domestos Sachet 60x100g","X","Domestos Mix","",36.00,-28064.27
,"Build Assembly","26-11-2024","12056",,,"Water","Cost of Goods Sold","Domestos Sachet 60x100g","X","Domestos Mix","",72.00,-28136.27
,"Build Assembly","26-11-2024","12059",,,"Water","Cost of Goods Sold","Domestos Sachet 60x100g","X","Zelia Toilet Cleaner Liquid Mix","",302.32,-28438.59
,"Build Assembly","27-11-2024","12069",,,"Water","Cost of Goods Sold","Domestos Sachet 60x100g","X","Domestos Mix","",72.00,-28510.59
,"Build Assembly","27-11-2024","12070",,,"Water","Cost of Goods Sold","Domestos Sachet 60x100g","X","Zelia Toilet Cleaner Liquid Mix","",151.16,-28661.75
,"Build Assembly","28-11-2024","12082",,,"Water","Cost of Goods Sold","Domestos Sachet 60x100g","X","Domestos Mix","",54.00,-28715.75
,"Build Assembly","29-11-2024","12096",,,"Water","Cost of Goods Sold","Domestos Sachet 60x100g","X","Zelia Toilet Cleaner Liquid Mix","",151.16,-28866.91
,"Build Assembly","03-12-2024","12127",,,"Water","Cost of Goods Sold","Domestos Sachet 60x100g","X","Zelia Carpet Cleaner Mix","",160.05,-29026.96
,"Build Assembly","03-12-2024","12128",,,"Water","Cost of Goods Sold","Domestos Sachet 60x100g","X","Zelia Green Multipurpos Liq Mix","",339.58,-29366.54
,"Build Assembly","04-12-2024","12141",,,"Water","Cost of Goods Sold","Domestos Sachet 60x100g","X","Domestos Mix","",72.00,-29438.54
,"Build Assembly","05-12-2024","12148",,,"Water","Cost of Goods Sold","Domestos Sachet 60x100g","X","Zelia Dishwashing Paste Mix","",57.67,-29496.21
,"Build Assembly","09-12-2024","12176",,,"Water","Cost of Goods Sold","Domestos Sachet 60x100g","X","Zelia Dishwashing Paste Mix","",57.67,-29553.88
,"Build Assembly","09-12-2024","12177",,,"Water","Cost of Goods Sold","Domestos Sachet 60x100g","X","Zelia Bleach Mix","",57.14,-29611.02
,"Build Assembly","10-12-2024","12186",,,"Water","Cost of Goods Sold","Domestos Sachet 60x100g","X","Zelia Dishwashing Paste Mix","",57.67,-29668.69
,"Build Assembly","11-12-2024","12195",,,"Water","Cost of Goods Sold","Domestos Sachet 60x100g","X","Zelia Dishwashing Paste Mix","",57.67,-29726.36
,"Build Assembly","11-12-2024","12198",,,"Water","Cost of Goods Sold","Domestos Sachet 60x100g","X","Domestos Mix","",54.00,-29780.36
,"Build Assembly","17-12-2024","12273",,,"Water","Cost of Goods Sold","Domestos Sachet 60x100g","X","Zelia Toilet Cleaner Liquid Mix","",151.16,-29931.52
,"Build Assembly","17-12-2024","12275",,,"Water","Cost of Goods Sold","Domestos Sachet 60x100g","X","Zelia Liquid Hadnwash Mix","",333.82,-30265.34
,"Build Assembly","18-12-2024","12257",,,"Water","Cost of Goods Sold","Domestos Sachet 60x100g","X","Zelia Toilet Cleaner Liquid Mix","",151.16,-30416.50
,"Build Assembly","18-12-2024","12259",,,"Water","Cost of Goods Sold","Domestos Sachet 60x100g","X","Zelia Liquid Hadnwash Mix","",333.82,-30750.32
,"Build Assembly","19-12-2024","12261",,,"Water","Cost of Goods Sold","Domestos Sachet 60x100g","X","Domestos Mix","",36.00,-30786.32
,"Build Assembly","20-12-2024","12293",,,"Water","Cost of Goods Sold","Domestos Sachet 60x100g","X","Domestos Mix","",36.00,-30822.32
,"Build Assembly","23-12-2024","12325",,,"Water","Cost of Goods Sold","Domestos Sachet 60x100g","X","Zelia Apple Handwash Liquid Mix","",333.82,-31156.14
"Total Domestos Sachet 60x100g",,,,,,,,,,,0.00,31156.14,-31156.14
"Domestos Powder - Other",,,,,,,,,,,,,""
,"Credit","06-06-2024","0190275610000046011",,"Ashut Plastics Limited","Cap Domestos Blue","Cost of Goods Sold","Domestos Powder",,"Accounts Payable","",0.73,-0.73
"Total Domestos Powder - Other",,,,,,,,,,,0.00,0.73,-0.73
"Total Domestos Powder",,,,,,,,,,,8693289.79,36110.71,8657179.08
"Origination Charges",,,,,,,,,,,,,""
,"Bill","22-04-2024","0110145040000021990",,"UNEECO Paper Products LTD","-MULTIPLE-","Cost of Goods Sold","Origination Charges",,"Accounts Payable",25000.00,"",25000.00
,"Bill","22-04-2024","0110145040000021989",,"UNEECO Paper Products LTD","-MULTIPLE-","Cost of Goods Sold","Origination Charges",,"Accounts Payable",25000.00,"",50000.00
,"Bill","22-04-2024","0110145040000021994",,"UNEECO Paper Products LTD","Extra plates","Cost of Goods Sold","Origination Charges",,"Accounts Payable",7500.00,"",57500.00
,"Bill","07-06-2024","0110145040000023339",,"UNEECO Paper Products LTD","-MULTIPLE-","Cost of Goods Sold","Origination Charges",,"Accounts Payable",33000.00,"",90500.00
,"Bill","21-06-2024","0090967790000000625",,"Unique Packaging (Ke) Limited","Zelia Scourer Lid Sticker Plates","Cost of Goods Sold","Origination Charges",,"Accounts Payable",20000.00,"",110500.00
,"Bill","19-07-2024","0110159720000010059",,"Colour Labels Limited","Plates Charges","Cost of Goods Sold","Origination Charges",,"Accounts Payable",48000.00,"",158500.00
,"Cheque","14-08-2024","1379831",,"Barcodes Kenya Limited","50 barcodes","Cost of Goods Sold","Origination Charges",,"MPESA Account",30000.00,"",188500.00
"Total Origination Charges",,,,,,,,,,,188500.00,0.00,188500.00
"Materials Usage Variance",,,,,,,,,,,,,""
,"Stock Adjust","08-01-2024","399",,,,"Cost of Goods Sold","Materials Usage Variance",,"Domestos Mix","",1299.40,-1299.40
,"Stock Adjust","09-01-2024","400",,,,"Cost of Goods Sold","Materials Usage Variance",,"Vim Mix Lavender","",3253.66,-4553.06
,"Stock Adjust","15-01-2024","401",,,,"Cost of Goods Sold","Materials Usage Variance",,"Sunlight Mix Lemon","",3443.86,-7996.92
,"Stock Adjust","19-01-2024","410",,,,"Cost of Goods Sold","Materials Usage Variance",,"-SPLIT-","","",-7996.92
,"Stock Adjust","25-01-2024","402",,,,"Cost of Goods Sold","Materials Usage Variance",,"-SPLIT-","",3363.20,-11360.12
,"Stock Adjust","26-01-2024","403",,,,"Cost of Goods Sold","Materials Usage Variance",,"Vim Mix Lavender","",1901.53,-13261.65
,"Stock Adjust","02-02-2024","404",,,,"Cost of Goods Sold","Materials Usage Variance",,"Zelia Green Multipurpos Liq Mix","",594.86,-13856.51
,"Stock Adjust","05-02-2024","405",,,,"Cost of Goods Sold","Materials Usage Variance",,"Sunlight Mix Lemon","",564.31,-14420.82
,"Stock Adjust","07-02-2024","406",,,,"Cost of Goods Sold","Materials Usage Variance",,"Whiting","",62918.33,-77339.15
,"Stock Adjust","07-02-2024","407",,,,"Cost of Goods Sold","Materials Usage Variance",,"Sunlight Mix Lemon","",772.79,-78111.94
,"Stock Adjust","08-02-2024","408",,,,"Cost of Goods Sold","Materials Usage Variance",,"Whiting","",76529.30,-154641.24
,"Stock Adjust","15-02-2024","409",,,,"Cost of Goods Sold","Materials Usage Variance",,"-SPLIT-","",11461.86,-166103.10
,"Stock Adjust","16-02-2024","411",,,,"Cost of Goods Sold","Materials Usage Variance",,"-SPLIT-","","",-166103.10
,"Stock Adjust","16-02-2024","412",,,,"Cost of Goods Sold","Materials Usage Variance",,"Vim Mix Lavender","",1804.45,-167907.55
,"Stock Adjust","21-02-2024","413",,,,"Cost of Goods Sold","Materials Usage Variance",,"Vim Mix Lemon SA","",839.46,-168747.01
,"Stock Adjust","22-02-2024","414",,,,"Cost of Goods Sold","Materials Usage Variance",,"Sunlight Mix Lavender","",186.51,-168933.52
,"Stock Adjust","23-02-2024","415",,,,"Cost of Goods Sold","Materials Usage Variance",,"-SPLIT-",20.48,"",-168913.04
,"Stock Adjust","29-02-2024","416",,,,"Cost of Goods Sold","Materials Usage Variance",,"Zelia Green Multipurpos Liq Mix","",416.95,-169329.99
,"Stock Adjust","01-03-2024","417",,,,"Cost of Goods Sold","Materials Usage Variance",,"-SPLIT-",301638.75,"",132308.76
,"Stock Adjust","05-03-2024","418",,,,"Cost of Goods Sold","Materials Usage Variance",,"Domestos Mix","",1556.71,130752.05
,"Stock Adjust","07-03-2024","419",,,,"Cost of Goods Sold","Materials Usage Variance",,"Zelia Toilet Cleaner Liquid Mix","",210.40,130541.65
,"Stock Adjust","08-03-2024","420",,,,"Cost of Goods Sold","Materials Usage Variance",,"Sunlight Mix Lemon","",790.63,129751.02
,"Stock Adjust","11-03-2024","421",,,,"Cost of Goods Sold","Materials Usage Variance",,"Sunlight Mix Lemon","",199.14,129551.88
,"Stock Adjust","14-03-2024","422",,,,"Cost of Goods Sold","Materials Usage Variance",,"Vim Mix Lemon SA","",4979.01,124572.87
,"Stock Adjust","15-03-2024","423",,,,"Cost of Goods Sold","Materials Usage Variance",,"Vim Mix Lavender SA","",5446.45,119126.42
,"Stock Adjust","15-03-2024","430",,,,"Cost of Goods Sold","Materials Usage Variance",,"-SPLIT-","","",119126.42
,"Stock Adjust","19-03-2024","424",,,,"Cost of Goods Sold","Materials Usage Variance",,"Zelia Toilet Cleaner Liquid Mix","",175.73,118950.69
,"Stock Adjust","22-03-2024","425",,,,"Cost of Goods Sold","Materials Usage Variance",,"Sunlight Mix Lemon","",396.78,118553.91
,"Stock Adjust","26-03-2024","426",,,,"Cost of Goods Sold","Materials Usage Variance",,"-SPLIT-","",899.09,117654.82
,"Stock Adjust","03-04-2024","427",,,,"Cost of Goods Sold","Materials Usage Variance",,"Zelia Liquid Hadnwash Mix","",127.79,117527.03
,"Stock Adjust","05-04-2024","428",,,,"Cost of Goods Sold","Materials Usage Variance",,"Zelia Green Multipurpos Liq Mix","",212.80,117314.23
,"Stock Adjust","08-04-2024","429",,,,"Cost of Goods Sold","Materials Usage Variance",,"-SPLIT-","",26767.00,90547.23
,"Stock Adjust","09-04-2024","431",,,,"Cost of Goods Sold","Materials Usage Variance",,"-SPLIT-","",2867.32,87679.91
,"Stock Adjust","11-04-2024","432",,,,"Cost of Goods Sold","Materials Usage Variance",,"-SPLIT-","",1217.42,86462.49
,"Stock Adjust","11-04-2024","433",,,,"Cost of Goods Sold","Materials Usage Variance",,"Sunlight Mix Lavender","",1512.55,84949.94
,"Stock Adjust","11-04-2024","435",,,,"Cost of Goods Sold","Materials Usage Variance",,"Zelia Liquid Hadnwash Mix","",59.53,84890.41
,"Stock Adjust","19-04-2024","434",,,,"Cost of Goods Sold","Materials Usage Variance",,"-SPLIT-","","",84890.41
,"General Journal","20-04-2024","23668",,,,"Cost of Goods Sold","Materials Usage Variance",,"-SPLIT-",337446.37,"",422336.78
,"Stock Adjust","20-04-2024","446",,,,"Cost of Goods Sold","Materials Usage Variance",,"Perfume GNC 0213C","",337446.37,84890.41
,"Stock Adjust","22-04-2024","436",,,,"Cost of Goods Sold","Materials Usage Variance",,"Domestos Mix","",1538.71,83351.70
,"Stock Adjust","25-04-2024","450",,,,"Cost of Goods Sold","Materials Usage Variance",,"Sunlight Mix Lemon","",2399.21,80952.49
,"Stock Adjust","29-04-2024","437",,,,"Cost of Goods Sold","Materials Usage Variance",,"Domestos Mix","",269.88,80682.61
,"Stock Adjust","06-05-2024","438",,,,"Cost of Goods Sold","Materials Usage Variance",,"-SPLIT-","",297.70,80384.91
,"Stock Adjust","07-05-2024","439",,,,"Cost of Goods Sold","Materials Usage Variance",,"Disonium Sulphate",0.00,"",80384.91
,"Stock Adjust","07-05-2024","440",,,,"Cost of Goods Sold","Materials Usage Variance",,"Zelia Machine Wash 5L Sticker","",5.85,80379.06
,"Stock Adjust","08-05-2024","441",,,,"Cost of Goods Sold","Materials Usage Variance",,"Domestos Mix","",1082.16,79296.90
,"Stock Adjust","08-05-2024","469",,,,"Cost of Goods Sold","Materials Usage Variance",,"Carneli Normal Shower Gel Mix","",638.42,78658.48
,"Stock Adjust","13-05-2024","442",,,,"Cost of Goods Sold","Materials Usage Variance",,"Vim Mix Lemon SA","",1862.17,76796.31
,"Stock Adjust","14-05-2024","443",,,,"Cost of Goods Sold","Materials Usage Variance",,"Carneli Normal Shower Gel Mix","",446.90,76349.41
,"Stock Adjust","16-05-2024","444",,,,"Cost of Goods Sold","Materials Usage Variance",,"Vim Mix Lavender SA","",988.60,75360.81
,"Stock Adjust","17-05-2024","447",,,,"Cost of Goods Sold","Materials Usage Variance",,"-SPLIT-","","",75360.81
,"Stock Adjust","20-05-2024","445",,,,"Cost of Goods Sold","Materials Usage Variance",,"-SPLIT-","",5066.93,70293.88
,"Stock Adjust","29-05-2024","448",,,,"Cost of Goods Sold","Materials Usage Variance",,"Sunlight Mix Lavender","",184.87,70109.01
,"Stock Adjust","31-05-2024","449",,,,"Cost of Goods Sold","Materials Usage Variance",,"Labels 500g Lemon","",3764.46,66344.55
,"Stock Adjust","03-06-2024","451",,,,"Cost of Goods Sold","Materials Usage Variance",,"-SPLIT-","",223350.32,-157005.77
,"Stock Adjust","05-06-2024","452",,,,"Cost of Goods Sold","Materials Usage Variance",,"-SPLIT-","",1290.99,-158296.76
,"Stock Adjust","06-06-2024","453",,,,"Cost of Goods Sold","Materials Usage Variance",,"-SPLIT-","",825.01,-159121.77
,"Stock Adjust","07-06-2024","454",,,,"Cost of Goods Sold","Materials Usage Variance",,"Sunlight Mix Lemon","",1750.64,-160872.41
,"Stock Adjust","07-06-2024","455",,,,"Cost of Goods Sold","Materials Usage Variance",,"Sleeve Sunlight Lemon 500g","",1077.10,-161949.51
,"Stock Adjust","13-06-2024","456",,,,"Cost of Goods Sold","Materials Usage Variance",,"-SPLIT-","",10549.88,-172499.39
,"Stock Adjust","14-06-2024","457",,,,"Cost of Goods Sold","Materials Usage Variance",,"Vim Mix Lemon SA","",1454.83,-173954.22
,"Stock Adjust","14-06-2024","458",,,,"Cost of Goods Sold","Materials Usage Variance",,"-SPLIT-","","",-173954.22
,"Stock Adjust","14-06-2024","463",,,,"Cost of Goods Sold","Materials Usage Variance",,"Zelia Toilet Cleaner Liquid Mix","",265.59,-174219.81
,"Stock Adjust","18-06-2024","459",,,,"Cost of Goods Sold","Materials Usage Variance",,"Domestos Mix","",1703.24,-175923.05
,"Stock Adjust","19-06-2024","461",,,,"Cost of Goods Sold","Materials Usage Variance",,"Vim Mix Lemon","",7060.85,-182983.90
,"Stock Adjust","28-06-2024","462",,,,"Cost of Goods Sold","Materials Usage Variance",,"Domestos Mix","",156.98,-183140.88
,"Stock Adjust","01-07-2024","464",,,,"Cost of Goods Sold","Materials Usage Variance",,"-SPLIT-",17209.21,"",-165931.67
,"Stock Adjust","03-07-2024","465",,,,"Cost of Goods Sold","Materials Usage Variance",,"Disonium Sulphate","","",-165931.67
,"Stock Adjust","03-07-2024","466",,,,"Cost of Goods Sold","Materials Usage Variance",,"Vim Mix Lemon","",1447.75,-167379.42
,"Stock Adjust","12-07-2024","467",,,,"Cost of Goods Sold","Materials Usage Variance",,"-SPLIT-","","",-167379.42
,"Stock Adjust","12-07-2024","468",,,,"Cost of Goods Sold","Materials Usage Variance",,"Sunlight Mix Lavender","",620.50,-167999.92
,"Stock Adjust","22-07-2024","470",,,,"Cost of Goods Sold","Materials Usage Variance",,"Sunlight Mix Lavender","",1114.94,-169114.86
,"Stock Adjust","22-07-2024","471",,,,"Cost of Goods Sold","Materials Usage Variance",,"Carbomer","",95.00,-169209.86
,"Stock Adjust","26-07-2024","473",,,,"Cost of Goods Sold","Materials Usage Variance",,"-SPLIT-","",4387.33,-173597.19
,"Stock Adjust","31-07-2024","474",,,,"Cost of Goods Sold","Materials Usage Variance",,"Vim Mix Lemon","",17060.41,-190657.60
,"Stock Adjust","31-07-2024","477",,,,"Cost of Goods Sold","Materials Usage Variance",,"Vim Mix Lemon","",520.39,-191177.99
,"Stock Adjust","01-08-2024","475",,,,"Cost of Goods Sold","Materials Usage Variance",,"Zelia Green Multipurpos Liq Mix","",123.57,-191301.56
,"Stock Adjust","02-08-2024","476",,,,"Cost of Goods Sold","Materials Usage Variance",,"-SPLIT-","",1341.31,-192642.87
,"Stock Adjust","05-08-2024","478",,,,"Cost of Goods Sold","Materials Usage Variance",,"-SPLIT-","",13919.37,-206562.24
,"Stock Adjust","07-08-2024","479",,,,"Cost of Goods Sold","Materials Usage Variance",,"Sunlight Mix Lavender","",154.37,-206716.61
,"Stock Adjust","08-08-2024","494",,,,"Cost of Goods Sold","Materials Usage Variance",,"Sodium Lauryl Ether Sulphate","",269.32,-206985.93
,"Stock Adjust","09-08-2024","480",,,,"Cost of Goods Sold","Materials Usage Variance",,"Vim Mix Lemon","",974.49,-207960.42
,"Stock Adjust","13-08-2024","481",,,,"Cost of Goods Sold","Materials Usage Variance",,"-SPLIT-","",3837.18,-211797.60
,"Stock Adjust","13-08-2024","482",,,,"Cost of Goods Sold","Materials Usage Variance",,"Vim Mix Lavender SA","",50.67,-211848.27
,"Stock Adjust","15-08-2024","483",,,,"Cost of Goods Sold","Materials Usage Variance",,"Zelia Liquid Hadnwash Mix","",16.18,-211864.45
,"Stock Adjust","16-08-2024","484",,,,"Cost of Goods Sold","Materials Usage Variance",,"Domestos Mix","",3637.80,-215502.25
,"Stock Adjust","16-08-2024","485",,,,"Cost of Goods Sold","Materials Usage Variance",,"-SPLIT-","","",-215502.25
,"Stock Adjust","21-08-2024","486",,,,"Cost of Goods Sold","Materials Usage Variance",,"Candle Can Lid","","",-215502.25
,"Stock Adjust","21-08-2024","487",,,,"Cost of Goods Sold","Materials Usage Variance",,"Vim Mix Lavender","",625.57,-216127.82
,"Stock Adjust","21-08-2024","492",,,,"Cost of Goods Sold","Materials Usage Variance",,"28MM White ROPP Cap","","",-216127.82
,"Stock Adjust","23-08-2024","488",,,,"Cost of Goods Sold","Materials Usage Variance",,"Vim Mix Lavender","",4734.71,-220862.53
,"Stock Adjust","26-08-2024","489",,,,"Cost of Goods Sold","Materials Usage Variance",,"Sunlight Mix Lavender","",183.11,-221045.64
,"Stock Adjust","29-08-2024","490",,,,"Cost of Goods Sold","Materials Usage Variance",,"Vim Mix Lavender","",3317.65,-224363.29
,"Stock Adjust","30-08-2024","491",,,,"Cost of Goods Sold","Materials Usage Variance",,"-SPLIT-","",6803.74,-231167.03
,"Stock Adjust","02-09-2024","493",,,,"Cost of Goods Sold","Materials Usage Variance",,"-SPLIT-",111642.29,"",-119524.74
,"Stock Adjust","02-09-2024","495",,,,"Cost of Goods Sold","Materials Usage Variance",,"-SPLIT-","",7118.88,-126643.62
,"Stock Adjust","02-09-2024","496",,,,"Cost of Goods Sold","Materials Usage Variance",,"-SPLIT-","",16213.78,-142857.40
,"Stock Adjust","02-09-2024","497",,,,"Cost of Goods Sold","Materials Usage Variance",,"-SPLIT-",2078.31,"",-140779.09
,"Stock Adjust","02-09-2024","498",,,,"Cost of Goods Sold","Materials Usage Variance",,"-SPLIT-","",16386.71,-157165.80
,"Stock Adjust","02-09-2024","499",,,,"Cost of Goods Sold","Materials Usage Variance",,"-SPLIT-","",2223.94,-159389.74
,"Stock Adjust","02-09-2024","503",,,,"Cost of Goods Sold","Materials Usage Variance",,"-SPLIT-","",55952.53,-215342.27
,"Stock Adjust","02-09-2024","504",,,,"Cost of Goods Sold","Materials Usage Variance",,"-SPLIT-","",45.53,-215387.80
,"Stock Adjust","06-09-2024","508",,,,"Cost of Goods Sold","Materials Usage Variance",,"Zelia Liquid Hadnwash Mix","",67.84,-215455.64
,"Stock Adjust","06-09-2024","509",,,,"Cost of Goods Sold","Materials Usage Variance",,"Zelia Bleach Mix","",357.14,-215812.78
,"Stock Adjust","10-09-2024","500",,,,"Cost of Goods Sold","Materials Usage Variance",,"Vim Mix Lavender SA","",142.89,-215955.67
,"Stock Adjust","10-09-2024","501",,,,"Cost of Goods Sold","Materials Usage Variance",,"Outer 500g Lemon Fresh Pouch","",1742.19,-217697.86
,"Stock Adjust","10-09-2024","510",,,,"Cost of Goods Sold","Materials Usage Variance",,"Zelia Green Multipurpos Liq Mix","",104.35,-217802.21
,"Stock Adjust","11-09-2024","511",,,,"Cost of Goods Sold","Materials Usage Variance",,"Zelia Toilet Cleaner Liquid Mix","",1443.40,-219245.61
,"Stock Adjust","12-09-2024","505",,,,"Cost of Goods Sold","Materials Usage Variance",,"Disonium Sulphate","","",-219245.61
,"Stock Adjust","13-09-2024","506",,,,"Cost of Goods Sold","Materials Usage Variance",,"-SPLIT-","","",-219245.61
,"Stock Adjust","13-09-2024","507",,,,"Cost of Goods Sold","Materials Usage Variance",,"Sunlight Mix Lavender","",1235.77,-220481.38
,"Stock Adjust","23-09-2024","512",,,,"Cost of Goods Sold","Materials Usage Variance",,"Zelia Bleach Mix","",35.71,-220517.09
,"Stock Adjust","24-09-2024","513",,,,"Cost of Goods Sold","Materials Usage Variance",,"-SPLIT-","",479.48,-220996.57
,"Stock Adjust","26-09-2024","514",,,,"Cost of Goods Sold","Materials Usage Variance",,"Labels 500g Lemon","",92.71,-221089.28
,"Stock Adjust","30-09-2024","515",,,,"Cost of Goods Sold","Materials Usage Variance",,"Labels 500g Lemon","",13716.00,-234805.28
,"Stock Adjust","02-10-2024","516",,,,"Cost of Goods Sold","Materials Usage Variance",,"-SPLIT-","",26256.63,-261061.91
,"Stock Adjust","04-10-2024","517",,,,"Cost of Goods Sold","Materials Usage Variance",,"Domestos Mix","",4595.77,-265657.68
,"Stock Adjust","09-10-2024","526",,,,"Cost of Goods Sold","Materials Usage Variance",,"Zelia Bleach Mix","",285.71,-265943.39
,"Stock Adjust","14-10-2024","518",,,,"Cost of Goods Sold","Materials Usage Variance",,"Sodium Hypochlorite","",31.81,-265975.20
,"Stock Adjust","14-10-2024","527",,,,"Cost of Goods Sold","Materials Usage Variance",,"Zelia Bleach Mix","",357.14,-266332.34
,"Stock Adjust","17-10-2024","519",,,,"Cost of Goods Sold","Materials Usage Variance",,"Cap Lemon Yellow","",543.84,-266876.18
,"Stock Adjust","22-10-2024","528",,,,"Cost of Goods Sold","Materials Usage Variance",,"Paste Layer Pads","",214.50,-267090.68
,"Stock Adjust","24-10-2024","529",,,,"Cost of Goods Sold","Materials Usage Variance",,"-SPLIT-","",247.23,-267337.91
,"Stock Adjust","25-10-2024","520",,,,"Cost of Goods Sold","Materials Usage Variance",,"-SPLIT-","","",-267337.91
,"Stock Adjust","25-10-2024","530",,,,"Cost of Goods Sold","Materials Usage Variance",,"-SPLIT-","",191.47,-267529.38
,"Stock Adjust","28-10-2024","521",,,,"Cost of Goods Sold","Materials Usage Variance",,"-SPLIT-","",9097.98,-276627.36
,"Stock Adjust","30-10-2024","522",,,,"Cost of Goods Sold","Materials Usage Variance",,"Vim Mix Lemon","",32179.10,-308806.46
,"Stock Adjust","30-10-2024","523",,,,"Cost of Goods Sold","Materials Usage Variance",,"Sunlight Mix Lavender","",61.27,-308867.73
,"Stock Adjust","31-10-2024","531",,,,"Cost of Goods Sold","Materials Usage Variance",,"Zelia Bleach Mix","",2571.42,-311439.15
,"Stock Adjust","04-11-2024","532",,,,"Cost of Goods Sold","Materials Usage Variance",,"-SPLIT-","",300.38,-311739.53
,"Stock Adjust","05-11-2024","524",,,,"Cost of Goods Sold","Materials Usage Variance",,"Vim Mix Lavender","",1050.47,-312790.00
,"Stock Adjust","05-11-2024","533",,,,"Cost of Goods Sold","Materials Usage Variance",,"Paste Layer Pads","",126.04,-312916.04
,"Stock Adjust","05-11-2024","534",,,,"Cost of Goods Sold","Materials Usage Variance",,"-SPLIT-","",148.79,-313064.83
,"Stock Adjust","06-11-2024","525",,,,"Cost of Goods Sold","Materials Usage Variance",,"Vim Mix Lemon SA","",4363.80,-317428.63
,"Stock Adjust","08-11-2024","535",,,,"Cost of Goods Sold","Materials Usage Variance",,"-SPLIT-","",3753.08,-321181.71
,"Stock Adjust","11-11-2024","536",,,,"Cost of Goods Sold","Materials Usage Variance",,"-SPLIT-","",17911.21,-339092.92
,"Stock Adjust","15-11-2024","537",,,,"Cost of Goods Sold","Materials Usage Variance",,"-SPLIT-","","",-339092.92
,"Stock Adjust","18-11-2024","538",,,,"Cost of Goods Sold","Materials Usage Variance",,"Vim Mix Lemon SA","",6210.37,-345303.29
,"Stock Adjust","19-11-2024","539",,,,"Cost of Goods Sold","Materials Usage Variance",,"Vim Mix Lavender","",4198.12,-349501.41
,"Stock Adjust","20-11-2024","540",,,,"Cost of Goods Sold","Materials Usage Variance",,"Sunlight Mix Lemon","",1392.85,-350894.26
,"Stock Adjust","22-11-2024","541",,,,"Cost of Goods Sold","Materials Usage Variance",,"Sunlight Mix Lavender","",2937.24,-353831.50
,"Stock Adjust","25-11-2024","542",,,,"Cost of Goods Sold","Materials Usage Variance",,"Canister 1 Kg","",1264.04,-355095.54
,"Stock Adjust","26-11-2024","543",,,,"Cost of Goods Sold","Materials Usage Variance",,"Lids Lemon","",5544.00,-360639.54
,"Stock Adjust","27-11-2024","544",,,,"Cost of Goods Sold","Materials Usage Variance",,"-SPLIT-","",5296.94,-365936.48
,"Stock Adjust","29-11-2024","545",,,,"Cost of Goods Sold","Materials Usage Variance",,"Zelia Toilet Cleaner Liquid Mix","",128.07,-366064.55
,"Stock Adjust","04-12-2024","546",,,,"Cost of Goods Sold","Materials Usage Variance",,"Zelia Carpet Cleaner Mix","",1669.50,-367734.05
,"Stock Adjust","05-12-2024","547",,,,"Cost of Goods Sold","Materials Usage Variance",,"Vim Mix Lavender","",4983.90,-372717.95
,"Stock Adjust","05-12-2024","554",,,,"Cost of Goods Sold","Materials Usage Variance",,"Zelia Carpet Cleaner Mix","",1092.00,-373809.95
,"Stock Adjust","10-12-2024","548",,,,"Cost of Goods Sold","Materials Usage Variance",,"Labels 1 Kg Lemon","",1217.99,-375027.94
,"Stock Adjust","17-12-2024","549",,,,"Cost of Goods Sold","Materials Usage Variance",,"Sunlight Mix Lemon","",3547.35,-378575.29
,"Stock Adjust","18-12-2024","550",,,,"Cost of Goods Sold","Materials Usage Variance",,"Sunlight Mix Lemon","",1113.17,-379688.46
,"Stock Adjust","19-12-2024","551",,,,"Cost of Goods Sold","Materials Usage Variance",,"Fuel Gel 200ML Label","",15.71,-379704.17
,"Stock Adjust","20-12-2024","552",,,,"Cost of Goods Sold","Materials Usage Variance",,"Sunlight Mix Lemon","",561.00,-380265.17
,"Stock Adjust","20-12-2024","553",,,,"Cost of Goods Sold","Materials Usage Variance",,"-SPLIT-","","",-380265.17
,"Stock Adjust","21-12-2024","555",,,,"Cost of Goods Sold","Materials Usage Variance",,"Fuel Gel 200ML Label","",14.00,-380279.17
,"Stock Adjust","21-12-2024","556",,,,"Cost of Goods Sold","Materials Usage Variance",,"-SPLIT-","",87482.25,-467761.42
"Total Materials Usage Variance",,,,,,,,,,,770035.41,1237796.83,-467761.42
"Adjuct & Emit 4",,,,,,,,,,,,,""
,"Invoice","12-01-2024","MC05303",,"Unilever Kenya Ltd:Emit","Emit 6 Processing Fee","Cost of Goods Sold","Adjuct & Emit 4",,"Accounts Receivable",0.00,"",0.00
,"Invoice","12-01-2024","MC05304",,"Unilever Kenya Ltd:Emit","Adjunct Emit Processing Fee","Cost of Goods Sold","Adjuct & Emit 4",,"Accounts Receivable",0.00,"",0.00
,"Invoice","05-02-2024","MC05382",,"Unilever Kenya Ltd:Emit","Adjunct Emit Processing Fee","Cost of Goods Sold","Adjuct & Emit 4",,"Accounts Receivable",0.00,"",0.00
,"Invoice","05-02-2024","MC05383",,"Unilever Kenya Ltd:Emit","Emit 6 Processing Fee","Cost of Goods Sold","Adjuct & Emit 4",,"Accounts Receivable",0.00,"",0.00
,"Invoice","04-03-2024","MC05460",,"Unilever Kenya Ltd:Emit","Adjunct Emit Processing Fee","Cost of Goods Sold","Adjuct & Emit 4",,"Accounts Receivable",0.00,"",0.00
,"Invoice","04-03-2024","MC05461",,"Unilever Kenya Ltd:Emit","Emit 6 Processing Fee","Cost of Goods Sold","Adjuct & Emit 4",,"Accounts Receivable",0.00,"",0.00
,"Invoice","23-03-2024","MC05524",,"Unilever Kenya Ltd:Emit","Emit 6 Processing Fee","Cost of Goods Sold","Adjuct & Emit 4",,"Accounts Receivable",0.00,"",0.00
,"Invoice","23-03-2024","MC05525",,"Unilever Kenya Ltd:Emit","Adjunct Emit Processing Fee","Cost of Goods Sold","Adjuct & Emit 4",,"Accounts Receivable",0.00,"",0.00
,"Invoice","04-04-2024","MC05565",,"Unilever Kenya Ltd:Emit","Adjunct Emit Processing Fee","Cost of Goods Sold","Adjuct & Emit 4",,"Accounts Receivable",0.00,"",0.00
,"Invoice","04-04-2024","MC05566",,"Unilever Kenya Ltd:Emit","Emit 6 Processing Fee","Cost of Goods Sold","Adjuct & Emit 4",,"Accounts Receivable",0.00,"",0.00
,"Invoice","19-04-2024","MC05611",,"Unilever Kenya Ltd:Emit","Adjunct Emit Processing Fee","Cost of Goods Sold","Adjuct & Emit 4",,"Accounts Receivable",0.00,"",0.00
,"Invoice","19-04-2024","MC05612",,"Unilever Kenya Ltd:Emit","Emit 6 Processing Fee","Cost of Goods Sold","Adjuct & Emit 4",,"Accounts Receivable",0.00,"",0.00
,"Invoice","15-05-2024","MC05704",,"Unilever Kenya Ltd:Emit","Adjunct Emit Processing Fee","Cost of Goods Sold","Adjuct & Emit 4",,"Accounts Receivable",0.00,"",0.00
,"Invoice","15-05-2024","MC05706",,"Unilever Kenya Ltd:Emit","Emit 6 Processing Fee","Cost of Goods Sold","Adjuct & Emit 4",,"Accounts Receivable",0.00,"",0.00
,"Invoice","28-05-2024","MC05757",,"Unilever Kenya Ltd:Emit","Adjunct Emit Processing Fee","Cost of Goods Sold","Adjuct & Emit 4",,"Accounts Receivable",0.00,"",0.00
,"Invoice","30-05-2024","MC05772",,"Unilever Kenya Ltd:Emit","Adjunct Emit Processing Fee","Cost of Goods Sold","Adjuct & Emit 4",,"Accounts Receivable",0.00,"",0.00
,"Invoice","30-05-2024","MC05774",,"Unilever Kenya Ltd:Emit","Emit 6 Processing Fee","Cost of Goods Sold","Adjuct & Emit 4",,"Accounts Receivable",0.00,"",0.00
,"Invoice","07-06-2024","MC05795",,"Unilever Kenya Ltd:Emit","Adjunct Emit Processing Fee","Cost of Goods Sold","Adjuct & Emit 4",,"Accounts Receivable",0.00,"",0.00
,"Invoice","07-06-2024","MC05797",,"Unilever Kenya Ltd:Emit","Emit 6 Processing Fee","Cost of Goods Sold","Adjuct & Emit 4",,"Accounts Receivable",0.00,"",0.00
,"Invoice","24-06-2024","MC05852",,"Unilever Kenya Ltd:Emit","Adjunct Emit Processing Fee","Cost of Goods Sold","Adjuct & Emit 4",,"Accounts Receivable",0.00,"",0.00
,"Invoice","24-06-2024","MC05854",,"Unilever Kenya Ltd:Emit","Emit 6 Processing Fee","Cost of Goods Sold","Adjuct & Emit 4",,"Accounts Receivable",0.00,"",0.00
,"Invoice","04-07-2024","MC05881",,"Unilever Kenya Ltd:Emit","Adjunct Emit Processing Fee","Cost of Goods Sold","Adjuct & Emit 4",,"Accounts Receivable",0.00,"",0.00
,"Invoice","04-07-2024","MC05882",,"Unilever Kenya Ltd:Emit","Emit 6 Processing Fee","Cost of Goods Sold","Adjuct & Emit 4",,"Accounts Receivable",0.00,"",0.00
,"Invoice","18-07-2024","MC05946",,"Unilever Kenya Ltd:Emit","Emit 6 Processing Fee","Cost of Goods Sold","Adjuct & Emit 4",,"Accounts Receivable",0.00,"",0.00
,"Invoice","18-07-2024","MC05947",,"Unilever Kenya Ltd:Emit","Adjunct Emit Processing Fee","Cost of Goods Sold","Adjuct & Emit 4",,"Accounts Receivable",0.00,"",0.00
,"Invoice","02-08-2024","MC05996",,"Unilever Kenya Ltd:Emit","Adjunct Emit Processing Fee","Cost of Goods Sold","Adjuct & Emit 4",,"Accounts Receivable",0.00,"",0.00
,"Invoice","02-08-2024","MC05997",,"Unilever Kenya Ltd:Emit","Emit 6 Processing Fee","Cost of Goods Sold","Adjuct & Emit 4",,"Accounts Receivable",0.00,"",0.00
,"Invoice","15-08-2024","MC06037",,"Unilever Kenya Ltd:Emit","Adjunct Emit Processing Fee","Cost of Goods Sold","Adjuct & Emit 4",,"Accounts Receivable",0.00,"",0.00
,"Invoice","15-08-2024","MC06039",,"Unilever Kenya Ltd:Emit","Emit 6 Processing Fee","Cost of Goods Sold","Adjuct & Emit 4",,"Accounts Receivable",0.00,"",0.00
,"Invoice","04-09-2024","MC06110",,"Unilever Kenya Ltd:Emit","Adjunct Emit Processing Fee","Cost of Goods Sold","Adjuct & Emit 4",,"Accounts Receivable",0.00,"",0.00
,"Invoice","04-09-2024","MC06112",,"Unilever Kenya Ltd:Emit","Emit 6 Processing Fee","Cost of Goods Sold","Adjuct & Emit 4",,"Accounts Receivable",0.00,"",0.00
,"Invoice","18-09-2024","MC06161",,"Unilever Kenya Ltd:Emit","Adjunct Emit Processing Fee","Cost of Goods Sold","Adjuct & Emit 4",,"Accounts Receivable",0.00,"",0.00
,"Invoice","18-09-2024","MC06162",,"Unilever Kenya Ltd:Emit","Emit 6 Processing Fee","Cost of Goods Sold","Adjuct & Emit 4",,"Accounts Receivable",0.00,"",0.00
,"Invoice","25-09-2024","MC06199",,"Unilever Kenya Ltd:Emit","Emit 6 Processing Fee","Cost of Goods Sold","Adjuct & Emit 4",,"Accounts Receivable",0.00,"",0.00
,"Invoice","08-11-2024","MC06348",,"Unilever Kenya Ltd:Emit","Adjunct Emit Processing Fee","Cost of Goods Sold","Adjuct & Emit 4",,"Accounts Receivable",0.00,"",0.00
,"Invoice","08-11-2024","MC06350",,"Unilever Kenya Ltd:Emit","Emit 6 Processing Fee","Cost of Goods Sold","Adjuct & Emit 4",,"Accounts Receivable",0.00,"",0.00
,"Invoice","21-11-2024","MC06392",,"Unilever Kenya Ltd:Emit","Adjunct Emit Processing Fee","Cost of Goods Sold","Adjuct & Emit 4",,"Accounts Receivable",0.00,"",0.00
,"Invoice","21-11-2024","MC06394",,"Unilever Kenya Ltd:Emit","Emit 6 Processing Fee","Cost of Goods Sold","Adjuct & Emit 4",,"Accounts Receivable",0.00,"",0.00
,"Invoice","04-12-2024","MC06441",,"Unilever Kenya Ltd:Emit","Adjunct Emit Processing Fee","Cost of Goods Sold","Adjuct & Emit 4",,"Accounts Receivable",0.00,"",0.00
,"Invoice","04-12-2024","MC06443",,"Unilever Kenya Ltd:Emit","Emit 6 Processing Fee","Cost of Goods Sold","Adjuct & Emit 4",,"Accounts Receivable",0.00,"",0.00
,"Invoice","17-12-2024","MC06481",,"Unilever Kenya Ltd:Emit","Adjunct Emit Processing Fee","Cost of Goods Sold","Adjuct & Emit 4",,"Accounts Receivable",0.00,"",0.00
,"Invoice","17-12-2024","MC06483",,"Unilever Kenya Ltd:Emit","Emit 6 Processing Fee","Cost of Goods Sold","Adjuct & Emit 4",,"Accounts Receivable",0.00,"",0.00
,"Invoice","23-12-2024","MC06500",,"Unilever Kenya Ltd","Adjunct Emit Processing Fee","Cost of Goods Sold","Adjuct & Emit 4",,"Accounts Receivable",0.00,"",0.00
,"Invoice","23-12-2024","MC06502",,"Unilever Kenya Ltd","Emit 6 Processing Fee","Cost of Goods Sold","Adjuct & Emit 4",,"Accounts Receivable",0.00,"",0.00
"Total Adjuct & Emit 4",,,,,,,,,,,0.00,0.00,0.00
"Freight and Shipping Costs",,,,,,,,,,,,,""
"Vim Materials' Freight",,,,,,,,,,,,,""
,"Bill","14-02-2024","0040094900000007441",,"TATA Chemicals Magadi Ltd","Freight","Cost of Goods Sold","Vim Materials' Freight",,"Accounts Payable",32906.40,"",32906.40
,"Bill","20-04-2024","25059457",,"Givaudan MEA FZE","Freight","Cost of Goods Sold","Vim Materials' Freight",,"Accounts Payable - USD",128129.12,"",161035.52
,"General Journal","20-04-2024","23668",,,,"Cost of Goods Sold","Vim Materials' Freight",,"Materials Usage Variance","",128129.12,32906.40
"Total Vim Materials' Freight",,,,,,,,,,,161035.52,128129.12,32906.40
"Freight and Shipping Costs - Other",,,,,,,,,,,,,""
,"Cheque","08-01-2024","196",,"Julie Cube Movers","RMPM Transportation","Cost of Goods Sold","Freight and Shipping Costs",,"MPESA Account",3500.00,"",3500.00
,"Cheque","24-01-2024","197",,"Julie Cube Movers","RMPM Transportation","Cost of Goods Sold","Freight and Shipping Costs",,"MPESA Account",3500.00,"",7000.00
,"Cheque","05-03-2024","403",,"Nene Truck Transport","RMPM Transportation","Cost of Goods Sold","Freight and Shipping Costs",,"Cash Account",9000.00,"",16000.00
,"Cheque","25-03-2024","199",,"Julie Cube Movers","RMPM Transportation","Cost of Goods Sold","Freight and Shipping Costs",,"MPESA Account",3500.00,"",19500.00
,"Cheque","02-04-2024","200",,"Julie Cube Movers","RMPM Transportation","Cost of Goods Sold","Freight and Shipping Costs",,"MPESA Account",3500.00,"",23000.00
,"Cheque","13-04-2024","P1967",,,"Chege delivery of GP packaging","Cost of Goods Sold","Freight and Shipping Costs",,"MPESA Account",700.00,"",23700.00
,"Cheque","02-05-2024","P1996",,,"Chege delivery of GP packaging","Cost of Goods Sold","Freight and Shipping Costs",,"MPESA Account",700.00,"",24400.00
,"Cheque","07-05-2024","P2008",,,"Chege delivery of UKL materials","Cost of Goods Sold","Freight and Shipping Costs",,"MPESA Account",3500.00,"",27900.00
,"Bill","27-05-2024","0190175400000001366",,"Offshore Global Logistics Ltd","LOCAL TRANSPORT 30MT  OF POWDER SODIUM  CARBONATE PACKAGED IN  50KG BAGS FROM KAJIADO  TO MCDAVE...","Cost of Goods Sold","Freight and Shipping Costs",,"Accounts Payable",28450.00,"",56350.00
,"Bill","27-05-2024","OGLINV240590",,"Offshore Global Logistics Ltd","Kajiado Cess","Cost of Goods Sold","Freight and Shipping Costs",,"Accounts Payable",2500.00,"",58850.00
,"Cheque","28-05-2024","P2063",,,"Chege delivery of UKL materials","Cost of Goods Sold","Freight and Shipping Costs",,"MPESA Account",3500.00,"",62350.00
,"Cheque","05-06-2024","P2086",,,"Chege delivery of UKL materials","Cost of Goods Sold","Freight and Shipping Costs",,"MPESA Account",3500.00,"",65850.00
,"Cheque","11-06-2024","423",,"Nene Truck Transport","RMPM Transportation","Cost of Goods Sold","Freight and Shipping Costs",,"MPESA Account",9000.00,"",74850.00
,"Cheque","21-06-2024","P2111",,,"Chege delivery of UKL materials","Cost of Goods Sold","Freight and Shipping Costs",,"MPESA Account",3500.00,"",78350.00
,"Cheque","22-07-2024","P2169",,,"Chege delivery of UKL materials","Cost of Goods Sold","Freight and Shipping Costs",,"MPESA Account",3500.00,"",81850.00
,"Cheque","09-08-2024","P2208",,,"Paul Kamau SLES delivery","Cost of Goods Sold","Freight and Shipping Costs",,"MPESA Account",1000.00,"",82850.00
,"Cheque","23-08-2024","P2232",,,"Chege delivery of UKL materials","Cost of Goods Sold","Freight and Shipping Costs",,"MPESA Account",3500.00,"",86350.00
,"Cheque","26-08-2024","P2238",,,"Chege delivery of GP packaging","Cost of Goods Sold","Freight and Shipping Costs",,"MPESA Account",700.00,"",87050.00
,"Cheque","27-09-2024","P2310",,,"Chege delivery of GP packaging","Cost of Goods Sold","Freight and Shipping Costs",,"MPESA Account",700.00,"",87750.00
,"Bill","30-09-2024","0190175400000001793",,"Offshore Global Logistics Ltd","LOCAL TRANSPORT 10MT  OF POWDER SODIUM  CARBONATE PACKAGED IN  50KG BAGS FROM KAJIADO  TO MCDAVE...","Cost of Goods Sold","Freight and Shipping Costs",,"Accounts Payable",16550.00,"",104300.00
,"Cheque","14-11-2024","856",,"Varis Holdings","Transport from Unilever to McDave","Cost of Goods Sold","Freight and Shipping Costs",,"MPESA Account",4700.00,"",109000.00
,"Bill","28-11-2024","0190175400000002003",,"Offshore Global Logistics Ltd","LOCAL TRANSPORT 10MT  OF POWDER SODIUM  CARBONATE PACKAGED IN  50KG BAGS FROM KAJIADO  TO MCDAVE...","Cost of Goods Sold","Freight and Shipping Costs",,"Accounts Payable",16550.00,"",125550.00
,"Cheque","13-12-2024","P2469",,,"Chege delivery of GP packaging","Cost of Goods Sold","Freight and Shipping Costs",,"MPESA Account",700.00,"",126250.00
,"Cheque","19-12-2024","P2486",,,"Aloise Gakere delivery of UKL materials","Cost of Goods Sold","Freight and Shipping Costs",,"MPESA Account",3700.00,"",129950.00
,"Cheque","24-12-2024","P2501",,,"Chege delivery of Magadi","Cost of Goods Sold","Freight and Shipping Costs",,"MPESA Account",2200.00,"",132150.00
"Total Freight and Shipping Costs - Other",,,,,,,,,,,132150.00,0.00,132150.00
"Total Freight and Shipping Costs",,,,,,,,,,,293185.52,128129.12,165056.40
"Sunlight Scouring Powder",,,,,,,,,,,,,""
"Sunlight Lavender",,,,,,,,,,,,,""
"Sunlight Scouring Powd Lav 1Kg",,,,,,,,,,,,,""
,"Invoice","09-01-2024","MC05284",,"Unilever Kenya Ltd:Sunlight Scouring Pwd","Sunlight Scouring Powd Lavender 12X1KG","Cost of Goods Sold","Sunlight Scouring Powd Lav 1Kg",,"Accounts Receivable",32762.10,"",32762.10
,"Invoice","10-01-2024","MC05289",,"Unilever Kenya Ltd:Sunlight Scouring Pwd","Sunlight Scouring Powd Lavender 12X1KG","Cost of Goods Sold","Sunlight Scouring Powd Lav 1Kg",,"Accounts Receivable",25481.63,"",58243.73
,"Invoice","11-01-2024","MC05292",,"Unilever Kenya Ltd:Sunlight Scouring Pwd","Sunlight Scouring Powd Lavender 12X1KG","Cost of Goods Sold","Sunlight Scouring Powd Lav 1Kg",,"Accounts Receivable",25481.63,"",83725.36
,"Invoice","16-01-2024","MC05324",,"Unilever Kenya Ltd:Sunlight Scouring Pwd","Sunlight Scouring Powd Lavender 12X1KG","Cost of Goods Sold","Sunlight Scouring Powd Lav 1Kg",,"Accounts Receivable",25481.63,"",109206.99
,"Invoice","26-01-2024","MC05353",,"Unilever Kenya Ltd:Sunlight Scouring Pwd","Sunlight Scouring Powd Lavender 12X1KG","Cost of Goods Sold","Sunlight Scouring Powd Lav 1Kg",,"Accounts Receivable",7289.87,"",116496.86
,"Invoice","29-01-2024","MC05366",,"Unilever Kenya Ltd:Sunlight Scouring Pwd","Sunlight Scouring Powd Lavender 12X1KG","Cost of Goods Sold","Sunlight Scouring Powd Lav 1Kg",,"Accounts Receivable",76543.64,"",193040.50
,"Invoice","01-02-2024","MC05377",,"Unilever Kenya Ltd","Outer Sunlight Lavender 12x1Kg","Cost of Goods Sold","Sunlight Scouring Powd Lav 1Kg",,"Accounts Receivable",433.71,"",193474.21
,"Invoice","13-02-2024","MC05404",,"Unilever Kenya Ltd:Sunlight Scouring Pwd","Sunlight Scouring Powd Lavender 12X1KG","Cost of Goods Sold","Sunlight Scouring Powd Lav 1Kg",,"Accounts Receivable",25514.55,"",218988.76
,"Invoice","21-02-2024","MC05416",,"Unilever Kenya Ltd:Sunlight Scouring Pwd","Sunlight Scouring Powd Lavender 12X1KG","Cost of Goods Sold","Sunlight Scouring Powd Lav 1Kg",,"Accounts Receivable",28949.05,"",247937.81
,"Invoice","27-02-2024","MC05449",,"Unilever Kenya Ltd:Sunlight Scouring Pwd","Sunlight Scouring Powd Lavender 12X1KG","Cost of Goods Sold","Sunlight Scouring Powd Lav 1Kg",,"Accounts Receivable",25651.05,"",273588.86
,"Invoice","28-02-2024","MC05452",,"Unilever Kenya Ltd:Sunlight Scouring Pwd","Sunlight Scouring Powd Lavender 12X1KG","Cost of Goods Sold","Sunlight Scouring Powd Lav 1Kg",,"Accounts Receivable",51302.11,"",324890.97
,"Invoice","22-03-2024","MC05513",,"Unilever Kenya Ltd:Sunlight Scouring Pwd","Sunlight Scouring Powd Lavender 12X1KG","Cost of Goods Sold","Sunlight Scouring Powd Lav 1Kg",,"Accounts Receivable",36644.36,"",361535.33
,"Build Assembly","22-03-2024","9923",,,"24125","Cost of Goods Sold","Sunlight Scouring Powd Lav 1Kg","X","-SPLIT-",308.96,"",361844.29
,"Invoice","26-03-2024","MC05535",,"Unilever Kenya Ltd:Sunlight Scouring Pwd","Sunlight Scouring Powd Lavender 12X1KG","Cost of Goods Sold","Sunlight Scouring Powd Lav 1Kg",,"Accounts Receivable",51999.61,"",413843.90
,"Invoice","26-03-2024","MC05541",,"Unilever Kenya Ltd:Sunlight Scouring Pwd","Sunlight Scouring Powd Lavender 12X1KG","Cost of Goods Sold","Sunlight Scouring Powd Lav 1Kg",,"Accounts Receivable",25999.80,"",439843.70
,"Invoice","09-04-2024","MC05582",,"Unilever Kenya Ltd:Sunlight Scouring Pwd","Sunlight Scouring Powd Lavender 12X1KG","Cost of Goods Sold","Sunlight Scouring Powd Lav 1Kg",,"Accounts Receivable",6314.24,"",446157.94
,"Invoice","11-04-2024","MC05590",,"Unilever Kenya Ltd:Sunlight Scouring Pwd","Sunlight Scouring Powd Lavender 12X1KG","Cost of Goods Sold","Sunlight Scouring Powd Lav 1Kg",,"Accounts Receivable",115884.84,"",562042.78
,"Build Assembly","11-04-2024","10084",,,"24154","Cost of Goods Sold","Sunlight Scouring Powd Lav 1Kg","X","-SPLIT-","",203.70,561839.08
,"Invoice","06-05-2024","MC05671",,"Unilever Kenya Ltd:Sunlight Scouring Pwd","Sunlight Scouring Powd Lavender 12X1KG","Cost of Goods Sold","Sunlight Scouring Powd Lav 1Kg",,"Accounts Receivable",77478.02,"",639317.10
,"Invoice","21-05-2024","MC05728",,"Unilever Kenya Ltd:Sunlight Scouring Pwd","Sunlight Scouring Powd Lavender 12X1KG","Cost of Goods Sold","Sunlight Scouring Powd Lav 1Kg",,"Accounts Receivable",25826.01,"",665143.11
,"Invoice","23-05-2024","MC05734",,"Unilever Kenya Ltd:Sunlight Scouring Pwd","Sunlight Scouring Powd Lavender 12X1KG","Cost of Goods Sold","Sunlight Scouring Powd Lav 1Kg",,"Accounts Receivable",7378.86,"",672521.97
,"Invoice","30-05-2024","MC05778",,"Unilever Kenya Ltd:Sunlight Scouring Pwd","Sunlight Scouring Powd Lavender 12X1KG","Cost of Goods Sold","Sunlight Scouring Powd Lav 1Kg",,"Accounts Receivable",111225.65,"",783747.62
,"Credit","13-06-2024","0010196450000039009",,"Allpack Industries Limited","Outer Sunlight Lavender 12x1Kg","Cost of Goods Sold","Sunlight Scouring Powd Lav 1Kg",,"Accounts Payable","",0.01,783747.61
,"Invoice","28-06-2024","MC05873",,"Unilever Kenya Ltd:Sunlight Scouring Pwd","Sunlight Scouring Powd Lavender 12X1KG","Cost of Goods Sold","Sunlight Scouring Powd Lav 1Kg",,"Accounts Receivable",77864.60,"",861612.21
,"Invoice","08-07-2024","MC05902",,"Unilever Kenya Ltd:Sunlight Scouring Pwd","Sunlight Scouring Powd Lavender 12X1KG","Cost of Goods Sold","Sunlight Scouring Powd Lav 1Kg",,"Accounts Receivable",58213.06,"",919825.27
,"Invoice","15-07-2024","MC05927",,"Unilever Kenya Ltd:Sunlight Scouring Pwd","Sunlight Scouring Powd Lavender 12X1KG","Cost of Goods Sold","Sunlight Scouring Powd Lav 1Kg",,"Accounts Receivable",51909.73,"",971735.00
,"Invoice","23-07-2024","MC05961",,"Unilever Kenya Ltd:Sunlight Scouring Pwd","Sunlight Scouring Powd Lavender 12X1KG","Cost of Goods Sold","Sunlight Scouring Powd Lav 1Kg",,"Accounts Receivable",7415.68,"",979150.68
,"Invoice","08-08-2024","MC06013",,"Unilever Kenya Ltd:Sunlight Scouring Pwd","Sunlight Scouring Powd Lavender 12X1KG","Cost of Goods Sold","Sunlight Scouring Powd Lav 1Kg",,"Accounts Receivable",25875.62,"",1005026.30
,"Invoice","09-08-2024","MC06026",,"Unilever Kenya Ltd:Sunlight Scouring Pwd","Sunlight Scouring Powd Lavender 12X1KG","Cost of Goods Sold","Sunlight Scouring Powd Lav 1Kg",,"Accounts Receivable",59513.92,"",1064540.22
,"Invoice","29-08-2024","MC06101",,"Unilever Kenya Ltd:Sunlight Scouring Pwd","Sunlight Scouring Powd Lavender 12X1KG","Cost of Goods Sold","Sunlight Scouring Powd Lav 1Kg",,"Accounts Receivable",25808.37,"",1090348.59
,"Invoice","06-09-2024","MC06128",,"Unilever Kenya Ltd:Sunlight Scouring Pwd","Sunlight Scouring Powd Lavender 12X1KG","Cost of Goods Sold","Sunlight Scouring Powd Lav 1Kg",,"Accounts Receivable",109501.24,"",1199849.83
,"Invoice","27-09-2024","MC06210",,"Unilever Kenya Ltd:Sunlight Scouring Pwd","Sunlight Scouring Powd Lavender 12X1KG","Cost of Goods Sold","Sunlight Scouring Powd Lav 1Kg",,"Accounts Receivable",51751.11,"",1251600.94
,"Invoice","16-10-2024","MC06267",,"Unilever Kenya Ltd:Sunlight Scouring Pwd","Sunlight Scouring Powd Lavender 12X1KG","Cost of Goods Sold","Sunlight Scouring Powd Lav 1Kg",,"Accounts Receivable",43249.14,"",1294850.08
,"Invoice","18-10-2024","MC06283",,"Unilever Kenya Ltd:Sunlight Scouring Pwd","Sunlight Scouring Powd Lavender 12X1KG","Cost of Goods Sold","Sunlight Scouring Powd Lav 1Kg",,"Accounts Receivable",38813.33,"",1333663.41
,"Invoice","31-10-2024","MC06326",,"Unilever Kenya Ltd:Sunlight Scouring Pwd","Sunlight Scouring Powd Lavender 12X1KG","Cost of Goods Sold","Sunlight Scouring Powd Lav 1Kg",,"Accounts Receivable",103311.69,"",1436975.10
,"Invoice","07-11-2024","MC06342",,"Unilever Kenya Ltd:Sunlight Scouring Pwd","Sunlight Scouring Powd Lavender 12X1KG","Cost of Goods Sold","Sunlight Scouring Powd Lav 1Kg",,"Accounts Receivable",8117.35,"",1445092.45
,"Invoice","20-11-2024","MC06384",,"Unilever Kenya Ltd:Sunlight Scouring Pwd","Sunlight Scouring Powd Lavender 12X1KG","Cost of Goods Sold","Sunlight Scouring Powd Lav 1Kg",,"Accounts Receivable",72239.40,"",1517331.85
,"Invoice","23-11-2024","MC06408",,"Unilever Kenya Ltd:Sunlight Scouring Pwd","Sunlight Scouring Powd Lavender 12X1KG","Cost of Goods Sold","Sunlight Scouring Powd Lav 1Kg",,"Accounts Receivable",60964.26,"",1578296.11
,"Invoice","11-12-2024","MC06462",,"Unilever Kenya Ltd:Sunlight Scouring Pwd","Sunlight Scouring Powd Lavender 12X1KG","Cost of Goods Sold","Sunlight Scouring Powd Lav 1Kg",,"Accounts Receivable",25606.49,"",1603902.60
,"Invoice","17-12-2024","MC06474",,"Unilever Kenya Ltd:Sunlight Scouring Pwd","Sunlight Scouring Powd Lavender 12X1KG","Cost of Goods Sold","Sunlight Scouring Powd Lav 1Kg",,"Accounts Receivable",80321.84,"",1684224.44
"Total Sunlight Scouring Powd Lav 1Kg",,,,,,,,,,,1684428.15,203.71,1684224.44
"Sunlight Scouring Powd Lav 500g",,,,,,,,,,,,,""
,"Invoice","15-01-2024","MC05314",,"Unilever Kenya Ltd:Sunlight Scouring Pwd","Sunlight Scouring Powd Lavender 24X500G","Cost of Goods Sold","Sunlight Scouring Powd Lav 500g",,"Accounts Receivable",83843.94,"",83843.94
,"Invoice","15-01-2024","MC05319",,"Unilever Kenya Ltd:Sunlight Scouring Pwd","Sunlight Scouring Powd Lavender 24X500G","Cost of Goods Sold","Sunlight Scouring Powd Lav 500g",,"Accounts Receivable",20122.54,"",103966.48
,"Invoice","17-01-2024","MC05330",,"Unilever Kenya Ltd:Sunlight Scouring Pwd","Sunlight Scouring Powd Lavender 24X500G","Cost of Goods Sold","Sunlight Scouring Powd Lav 500g",,"Accounts Receivable",20122.54,"",124089.02
,"Invoice","29-01-2024","MC05367",,"Unilever Kenya Ltd:Sunlight Scouring Pwd","Sunlight Scouring Powd Lavender 24X500G","Cost of Goods Sold","Sunlight Scouring Powd Lav 500g",,"Accounts Receivable",79478.67,"",203567.69
,"Invoice","01-02-2024","MC05377",,"Unilever Kenya Ltd","Outer Sunlight Lavender 24x500g","Cost of Goods Sold","Sunlight Scouring Powd Lav 500g",,"Accounts Receivable",511.93,"",204079.62
,"Invoice","07-02-2024","MC05389",,"Unilever Kenya Ltd:Sunlight Scouring Pwd","Sunlight Scouring Powd Lavender 24X500G","Cost of Goods Sold","Sunlight Scouring Powd Lav 500g",,"Accounts Receivable",33916.75,"",237996.37
,"Invoice","19-02-2024","MC05413",,"Unilever Kenya Ltd:Sunlight Scouring Pwd","Sunlight Scouring Powd Lavender 24X500G","Cost of Goods Sold","Sunlight Scouring Powd Lav 500g",,"Accounts Receivable",21004.22,"",259000.59
,"Invoice","21-02-2024","MC05420",,"Unilever Kenya Ltd:Sunlight Scouring Pwd","Sunlight Scouring Powd Lavender 24X500G","Cost of Goods Sold","Sunlight Scouring Powd Lav 500g",,"Accounts Receivable",80656.21,"",339656.80
,"Invoice","23-02-2024","MC05440",,"Unilever Kenya Ltd:Sunlight Scouring Pwd","Sunlight Scouring Powd Lavender 24X500G","Cost of Goods Sold","Sunlight Scouring Powd Lav 500g",,"Accounts Receivable",72173.32,"",411830.12
,"Invoice","29-02-2024","MC05455",,"Unilever Kenya Ltd:Sunlight Scouring Pwd","Sunlight Scouring Powd Lavender 24X500G","Cost of Goods Sold","Sunlight Scouring Powd Lav 500g",,"Accounts Receivable",181231.46,"",593061.58
,"Invoice","11-03-2024","MC05486",,"Unilever Kenya Ltd:Sunlight Scouring Pwd","Sunlight Scouring Powd Lavender 24X500G","Cost of Goods Sold","Sunlight Scouring Powd Lav 500g",,"Accounts Receivable",45307.86,"",638369.44
,"Invoice","11-04-2024","MC05588",,"Unilever Kenya Ltd:Sunlight Scouring Pwd","Sunlight Scouring Powd Lavender 24X500G","Cost of Goods Sold","Sunlight Scouring Powd Lav 500g",,"Accounts Receivable",67470.87,"",705840.31
,"Invoice","11-04-2024","MC05591",,"Unilever Kenya Ltd:Sunlight Scouring Pwd","Sunlight Scouring Powd Lavender 24X500G","Cost of Goods Sold","Sunlight Scouring Powd Lav 500g",,"Accounts Receivable",63227.42,"",769067.73
,"Build Assembly","11-04-2024","10085",,,"24154","Cost of Goods Sold","Sunlight Scouring Powd Lav 500g","X","-SPLIT-",0.01,"",769067.74
,"Invoice","12-04-2024","MC05595",,"Unilever Kenya Ltd:Sunlight Scouring Pwd","Sunlight Scouring Powd Lavender 24X500G","Cost of Goods Sold","Sunlight Scouring Powd Lav 500g",,"Accounts Receivable",61105.70,"",830173.44
,"Invoice","23-05-2024","MC05735",,"Unilever Kenya Ltd:Sunlight Scouring Pwd","Sunlight Scouring Powd Lavender 24X500G","Cost of Goods Sold","Sunlight Scouring Powd Lav 500g",,"Accounts Receivable",132310.41,"",962483.85
,"Invoice","07-06-2024","MC05802",,"Unilever Kenya Ltd:Sunlight Scouring Pwd","Sunlight Scouring Powd Lavender 24X500G","Cost of Goods Sold","Sunlight Scouring Powd Lav 500g",,"Accounts Receivable",60922.93,"",1023406.78
,"Credit","13-06-2024","0010196450000039009",,"Allpack Industries Limited","Outer Sunlight Lavender 24x500g","Cost of Goods Sold","Sunlight Scouring Powd Lav 500g",,"Accounts Payable","",0.03,1023406.75
,"Invoice","18-06-2024","MC05835",,"Unilever Kenya Ltd:Sunlight Scouring Pwd","Sunlight Scouring Powd Lavender 24X500G","Cost of Goods Sold","Sunlight Scouring Powd Lav 500g",,"Accounts Receivable",40615.29,"",1064022.04
,"Invoice","02-07-2024","MC05876",,"Unilever Kenya Ltd:Sunlight Scouring Pwd","Sunlight Scouring Powd Lavender 24X500G","Cost of Goods Sold","Sunlight Scouring Powd Lav 500g",,"Accounts Receivable",84178.93,"",1148200.97
,"Invoice","04-07-2024","MC05890",,"Unilever Kenya Ltd:Sunlight Scouring Pwd","Sunlight Scouring Powd Lavender 24X500G","Cost of Goods Sold","Sunlight Scouring Powd Lav 500g",,"Accounts Receivable",60913.40,"",1209114.37
,"Invoice","09-07-2024","MC05906",,"Unilever Kenya Ltd:Sunlight Scouring Pwd","Sunlight Scouring Powd Lavender 24X500G","Cost of Goods Sold","Sunlight Scouring Powd Lav 500g",,"Accounts Receivable",5499.13,"",1214613.50
,"Invoice","12-07-2024","MC05913",,"Unilever Kenya Ltd:Sunlight Scouring Pwd","Sunlight Scouring Powd Lavender 24X500G","Cost of Goods Sold","Sunlight Scouring Powd Lav 500g",,"Accounts Receivable",60913.40,"",1275526.90
,"Build Assembly","12-07-2024","10811",,,"24285","Cost of Goods Sold","Sunlight Scouring Powd Lav 500g","X","-SPLIT-",19.69,"",1275546.59
,"Invoice","26-07-2024","MC05973",,"Unilever Kenya Ltd:Sunlight Scouring Pwd","Sunlight Scouring Powd Lavender 24X500G","Cost of Goods Sold","Sunlight Scouring Powd Lav 500g",,"Accounts Receivable",85412.03,"",1360958.62
,"Invoice","01-08-2024","MC05993",,"Unilever Kenya Ltd:Sunlight Scouring Pwd","Sunlight Scouring Powd Lavender 24X500G","Cost of Goods Sold","Sunlight Scouring Powd Lav 500g",,"Accounts Receivable",48202.83,"",1409161.45
,"Invoice","08-08-2024","MC06008",,"Unilever Kenya Ltd:Sunlight Scouring Pwd","Sunlight Scouring Powd Lavender 24X500G","Cost of Goods Sold","Sunlight Scouring Powd Lav 500g",,"Accounts Receivable",81029.92,"",1490191.37
,"Invoice","15-08-2024","MC06044",,"Unilever Kenya Ltd:Sunlight Scouring Pwd","Sunlight Scouring Powd Lavender 24X500G","Cost of Goods Sold","Sunlight Scouring Powd Lav 500g",,"Accounts Receivable",29542.16,"",1519733.53
,"Invoice","21-08-2024","MC06059",,"Unilever Kenya Ltd:Sunlight Scouring Pwd","Sunlight Scouring Powd Lavender 24X500G","Cost of Goods Sold","Sunlight Scouring Powd Lav 500g",,"Accounts Receivable",16881.23,"",1536614.76
,"Invoice","30-08-2024","MC06105",,"Unilever Kenya Ltd:Sunlight Scouring Pwd","Sunlight Scouring Powd Lavender 24X500G","Cost of Goods Sold","Sunlight Scouring Powd Lav 500g",,"Accounts Receivable",40310.89,"",1576925.65
,"Invoice","10-09-2024","MC06135",,"Unilever Kenya Ltd:Sunlight Scouring Pwd","Sunlight Scouring Powd Lavender 24X500G","Cost of Goods Sold","Sunlight Scouring Powd Lav 500g",,"Accounts Receivable",4199.05,"",1581124.70
,"Invoice","13-09-2024","MC06152",,"Unilever Kenya Ltd:Sunlight Scouring Pwd","Sunlight Scouring Powd Lavender 24X500G","Cost of Goods Sold","Sunlight Scouring Powd Lav 500g",,"Accounts Receivable",60466.33,"",1641591.03
,"Invoice","24-09-2024","MC06192",,"Unilever Kenya Ltd:Sunlight Scouring Pwd","Sunlight Scouring Powd Lavender 24X500G","Cost of Goods Sold","Sunlight Scouring Powd Lav 500g",,"Accounts Receivable",60585.82,"",1702176.85
,"Invoice","03-10-2024","MC06226",,"Unilever Kenya Ltd:Sunlight Scouring Pwd","Sunlight Scouring Powd Lavender 24X500G","Cost of Goods Sold","Sunlight Scouring Powd Lav 500g",,"Accounts Receivable",68579.79,"",1770756.64
,"Invoice","17-10-2024","MC06272",,"Unilever Kenya Ltd:Sunlight Scouring Pwd","Sunlight Scouring Powd Lavender 24X500G","Cost of Goods Sold","Sunlight Scouring Powd Lav 500g",,"Accounts Receivable",60585.82,"",1831342.46
,"Invoice","25-10-2024","MC06298",,"Unilever Kenya Ltd:Sunlight Scouring Pwd","Sunlight Scouring Powd Lavender 24X500G","Cost of Goods Sold","Sunlight Scouring Powd Lav 500g",,"Accounts Receivable",45018.63,"",1876361.09
,"Invoice","29-10-2024","MC06316",,"Unilever Kenya Ltd:Sunlight Scouring Pwd","Sunlight Scouring Powd Lavender 24X500G","Cost of Goods Sold","Sunlight Scouring Powd Lav 500g",,"Accounts Receivable",40390.55,"",1916751.64
,"Invoice","18-11-2024","MC06371",,"Unilever Kenya Ltd:Sunlight Scouring Pwd","Sunlight Scouring Powd Lavender 24X500G","Cost of Goods Sold","Sunlight Scouring Powd Lav 500g",,"Accounts Receivable",111074.01,"",2027825.65
,"Build Assembly","18-11-2024","11981",,,"24471","Cost of Goods Sold","Sunlight Scouring Powd Lav 500g","X","-SPLIT-","",955.28,2026870.37
,"Invoice","21-11-2024","MC06397",,"Unilever Kenya Ltd:Sunlight Scouring Pwd","Sunlight Scouring Powd Lavender 24X500G","Cost of Goods Sold","Sunlight Scouring Powd Lav 500g",,"Accounts Receivable",57979.17,"",2084849.54
,"Invoice","28-11-2024","MC06425",,"Unilever Kenya Ltd:Sunlight Scouring Pwd","Sunlight Scouring Powd Lavender 24X500G","Cost of Goods Sold","Sunlight Scouring Powd Lav 500g",,"Accounts Receivable",79990.26,"",2164839.80
,"Invoice","11-12-2024","MC06459",,"Unilever Kenya Ltd:Sunlight Scouring Pwd","Sunlight Scouring Powd Lavender 24X500G","Cost of Goods Sold","Sunlight Scouring Powd Lav 500g",,"Accounts Receivable",12498.48,"",2177338.28
,"Invoice","14-12-2024","MC06469",,"Unilever Kenya Ltd:Sunlight Scouring Pwd","Sunlight Scouring Powd Lavender 24X500G","Cost of Goods Sold","Sunlight Scouring Powd Lav 500g",,"Accounts Receivable",59992.70,"",2237330.98
,"Build Assembly","14-12-2024","12226",,,"24506","Cost of Goods Sold","Sunlight Scouring Powd Lav 500g","X","-SPLIT-",2539.85,"",2239870.83
,"Invoice","23-12-2024","MC06499",,"Unilever Kenya Ltd:Sunlight Scouring Pwd","Sunlight Scouring Powd Lavender 24X500G","Cost of Goods Sold","Sunlight Scouring Powd Lav 500g",,"Accounts Receivable",40938.07,"",2280808.90
,"Invoice","24-12-2024","MC06516",,"Unilever Kenya Ltd:Sunlight Scouring Pwd","Sunlight Scouring Powd Lavender 24X500G","Cost of Goods Sold","Sunlight Scouring Powd Lav 500g",,"Accounts Receivable",25586.29,"",2306395.19
"Total Sunlight Scouring Powd Lav 500g",,,,,,,,,,,2307350.50,955.31,2306395.19
"Total Sunlight Lavender",,,,,,,,,,,3991778.65,1159.02,3990619.63
"Sunlight Lemon",,,,,,,,,,,,,""
"Sunlight Scourg Powd Lemon 1Kg",,,,,,,,,,,,,""
,"Invoice","16-01-2024","MC05323",,"Unilever Kenya Ltd:Sunlight Scouring Pwd","Sunlight Scouring Powd Lemon 12X1KG","Cost of Goods Sold","Sunlight Scourg Powd Lemon 1Kg",,"Accounts Receivable",25903.50,"",25903.50
,"Invoice","26-01-2024","MC05354",,"Unilever Kenya Ltd:Sunlight Scouring Pwd","Sunlight Scouring Powd Lemon 12X1KG","Cost of Goods Sold","Sunlight Scourg Powd Lemon 1Kg",,"Accounts Receivable",25903.50,"",51807.00
,"Invoice","29-01-2024","MC05365",,"Unilever Kenya Ltd:Sunlight Scouring Pwd","Sunlight Scouring Powd Lemon 12X1KG","Cost of Goods Sold","Sunlight Scourg Powd Lemon 1Kg",,"Accounts Receivable",51807.00,"",103614.00
,"Invoice","30-01-2024","MC05370",,"Unilever Kenya Ltd:Sunlight Scouring Pwd","Sunlight Scouring Powd Lemon 12X1KG","Cost of Goods Sold","Sunlight Scourg Powd Lemon 1Kg",,"Accounts Receivable",11841.59,"",115455.59
,"Invoice","01-02-2024","MC05377",,"Unilever Kenya Ltd","Outer Sunlight Lemon 12x1Kg","Cost of Goods Sold","Sunlight Scourg Powd Lemon 1Kg",,"Accounts Receivable",215.67,"",115671.26
,"Invoice","23-02-2024","MC05439",,"Unilever Kenya Ltd:Sunlight Scouring Pwd","Sunlight Scouring Powd Lemon 12X1KG","Cost of Goods Sold","Sunlight Scourg Powd Lemon 1Kg",,"Accounts Receivable",115231.48,"",230902.74
,"Invoice","03-04-2024","MC05556",,"Unilever Kenya Ltd:Sunlight Scouring Pwd","Sunlight Scouring Powd Lemon 12X1KG","Cost of Goods Sold","Sunlight Scourg Powd Lemon 1Kg",,"Accounts Receivable",78312.66,"",309215.40
,"Build Assembly","03-04-2024","10012",,,"24143","Cost of Goods Sold","Sunlight Scourg Powd Lemon 1Kg","X","-SPLIT-",842.90,"",310058.30
,"Invoice","05-04-2024","MC05574",,"Unilever Kenya Ltd:Sunlight Scouring Pwd","Sunlight Scouring Powd Lemon 12X1KG","Cost of Goods Sold","Sunlight Scourg Powd Lemon 1Kg",,"Accounts Receivable",33923.81,"",343982.11
,"Invoice","26-04-2024","MC05644",,"Unilever Kenya Ltd:Sunlight Scouring Pwd","Sunlight Scouring Powd Lemon 12X1KG","Cost of Goods Sold","Sunlight Scourg Powd Lemon 1Kg",,"Accounts Receivable",52902.27,"",396884.38
,"Invoice","14-05-2024","MC05698",,"Unilever Kenya Ltd:Sunlight Scouring Pwd","Sunlight Scouring Powd Lemon 12X1KG","Cost of Goods Sold","Sunlight Scourg Powd Lemon 1Kg",,"Accounts Receivable",52902.27,"",449786.65
,"Invoice","23-05-2024","MC05733",,"Unilever Kenya Ltd:Sunlight Scouring Pwd","Sunlight Scouring Powd Lemon 12X1KG","Cost of Goods Sold","Sunlight Scourg Powd Lemon 1Kg",,"Accounts Receivable",15492.81,"",465279.46
,"Invoice","30-05-2024","MC05779",,"Unilever Kenya Ltd:Sunlight Scouring Pwd","Sunlight Scouring Powd Lemon 12X1KG","Cost of Goods Sold","Sunlight Scourg Powd Lemon 1Kg",,"Accounts Receivable",112044.99,"",577324.45
,"Invoice","09-07-2024","MC05905",,"Unilever Kenya Ltd:Sunlight Scouring Pwd","Sunlight Scouring Powd Lemon 12X1KG","Cost of Goods Sold","Sunlight Scourg Powd Lemon 1Kg",,"Accounts Receivable",52307.09,"",629631.54
,"Invoice","12-07-2024","MC05917",,"Unilever Kenya Ltd:Sunlight Scouring Pwd","Sunlight Scouring Powd Lemon 12X1KG","Cost of Goods Sold","Sunlight Scourg Powd Lemon 1Kg",,"Accounts Receivable",41098.43,"",670729.97
,"Invoice","26-07-2024","MC05972",,"Unilever Kenya Ltd:Sunlight Scouring Pwd","Sunlight Scouring Powd Lemon 12X1KG","Cost of Goods Sold","Sunlight Scourg Powd Lemon 1Kg",,"Accounts Receivable",18681.11,"",689411.08
,"Invoice","02-08-2024","MC06000",,"Unilever Kenya Ltd:Sunlight Scouring Pwd","Sunlight Scouring Powd Lemon 12X1KG","Cost of Goods Sold","Sunlight Scourg Powd Lemon 1Kg",,"Accounts Receivable",52307.09,"",741718.17
,"Build Assembly","02-08-2024","11018",,,"24315","Cost of Goods Sold","Sunlight Scourg Powd Lemon 1Kg","X","-SPLIT-","",165.84,741552.33
,"Invoice","15-08-2024","MC06043",,"Unilever Kenya Ltd:Sunlight Scouring Pwd","Sunlight Scouring Powd Lemon 12X1KG","Cost of Goods Sold","Sunlight Scourg Powd Lemon 1Kg",,"Accounts Receivable",26070.63,"",767622.96
,"Invoice","21-08-2024","MC06058",,"Unilever Kenya Ltd:Sunlight Scouring Pwd","Sunlight Scouring Powd Lemon 12X1KG","Cost of Goods Sold","Sunlight Scourg Powd Lemon 1Kg",,"Accounts Receivable",33146.94,"",800769.90
,"Invoice","11-09-2024","MC06141",,"Unilever Kenya Ltd:Sunlight Scouring Pwd","Sunlight Scouring Powd Lemon 12X1KG","Cost of Goods Sold","Sunlight Scourg Powd Lemon 1Kg",,"Accounts Receivable",26158.03,"",826927.93
,"Invoice","17-09-2024","MC06160",,"Unilever Kenya Ltd:Sunlight Scouring Pwd","Sunlight Scouring Powd Lemon 12X1KG","Cost of Goods Sold","Sunlight Scourg Powd Lemon 1Kg",,"Accounts Receivable",47084.45,"",874012.38
,"Invoice","27-09-2024","MC06215",,"Unilever Kenya Ltd:Sunlight Scouring Pwd","Sunlight Scouring Powd Lemon 12X1KG","Cost of Goods Sold","Sunlight Scourg Powd Lemon 1Kg",,"Accounts Receivable",26158.03,"",900170.41
,"Invoice","03-10-2024","MC06234",,"Unilever Kenya Ltd:Sunlight Scouring Pwd","Sunlight Scouring Powd Lemon 12X1KG","Cost of Goods Sold","Sunlight Scourg Powd Lemon 1Kg",,"Accounts Receivable",63724.81,"",963895.22
,"Invoice","25-10-2024","MC06302",,"Unilever Kenya Ltd:Sunlight Scouring Pwd","Sunlight Scouring Powd Lemon 12X1KG","Cost of Goods Sold","Sunlight Scourg Powd Lemon 1Kg",,"Accounts Receivable",58880.23,"",1022775.45
,"Invoice","20-11-2024","MC06389",,"Unilever Kenya Ltd:Sunlight Scouring Pwd","Sunlight Scouring Powd Lemon 12X1KG","Cost of Goods Sold","Sunlight Scourg Powd Lemon 1Kg",,"Accounts Receivable",62606.83,"",1085382.28
,"Build Assembly","20-11-2024","12002",,,"24473","Cost of Goods Sold","Sunlight Scourg Powd Lemon 1Kg","X","-SPLIT-","",512.71,1084869.57
,"Invoice","21-11-2024","MC06396",,"Unilever Kenya Ltd:Sunlight Scouring Pwd","Sunlight Scouring Powd Lemon 12X1KG","Cost of Goods Sold","Sunlight Scourg Powd Lemon 1Kg",,"Accounts Receivable",51745.10,"",1136614.67
,"Invoice","18-12-2024","MC06484",,"Unilever Kenya Ltd:Sunlight Scouring Pwd","Sunlight Scouring Powd Lemon 12X1KG","Cost of Goods Sold","Sunlight Scourg Powd Lemon 1Kg",,"Accounts Receivable",103490.20,"",1240104.87
,"Build Assembly","18-12-2024","12264",,,"24513","Cost of Goods Sold","Sunlight Scourg Powd Lemon 1Kg","X","-SPLIT-","",383.18,1239721.69
"Total Sunlight Scourg Powd Lemon 1Kg",,,,,,,,,,,1240783.42,1061.73,1239721.69
"Sunlight Scourg Powd Lemon 500g",,,,,,,,,,,,,""
,"Invoice","15-01-2024","MC05313",,"Unilever Kenya Ltd:Sunlight Scouring Pwd","Sunlight Scouring Powd Lemon 24X500G","Cost of Goods Sold","Sunlight Scourg Powd Lemon 500g",,"Accounts Receivable",383768.91,"",383768.91
,"Build Assembly","15-01-2024","9426",,,"24031","Cost of Goods Sold","Sunlight Scourg Powd Lemon 500g","X","-SPLIT-",223.91,"",383992.82
,"Invoice","01-02-2024","MC05377",,"Unilever Kenya Ltd","Outer Sunlight Lemon 24x500g","Cost of Goods Sold","Sunlight Scourg Powd Lemon 500g",,"Accounts Receivable",157.55,"",384150.37
,"Invoice","07-02-2024","MC05388",,"Unilever Kenya Ltd:Sunlight Scouring Pwd","Sunlight Scouring Powd Lemon 24X500G","Cost of Goods Sold","Sunlight Scourg Powd Lemon 500g",,"Accounts Receivable",61116.64,"",445267.01
,"Invoice","13-02-2024","MC05403",,"Unilever Kenya Ltd:Sunlight Scouring Pwd","Sunlight Scouring Powd Lemon 24X500G","Cost of Goods Sold","Sunlight Scourg Powd Lemon 500g",,"Accounts Receivable",20428.67,"",465695.68
,"Invoice","19-02-2024","MC05412",,"Unilever Kenya Ltd:Sunlight Scouring Pwd","Sunlight Scouring Powd Lemon 24X500G","Cost of Goods Sold","Sunlight Scourg Powd Lemon 500g",,"Accounts Receivable",127679.19,"",593374.87
,"Invoice","22-02-2024","MC05433",,"Unilever Kenya Ltd:Sunlight Scouring Pwd","Sunlight Scouring Powd Lemon 24X500G","Cost of Goods Sold","Sunlight Scourg Powd Lemon 500g",,"Accounts Receivable",45964.51,"",639339.38
,"Invoice","08-03-2024","MC05481",,"Unilever Kenya Ltd:Sunlight Scouring Pwd","Sunlight Scouring Powd Lemon 24X500G","Cost of Goods Sold","Sunlight Scourg Powd Lemon 500g",,"Accounts Receivable",122572.02,"",761911.40
,"Build Assembly","08-03-2024","9818",,,"24105","Cost of Goods Sold","Sunlight Scourg Powd Lemon 500g","X","-SPLIT-",1937.53,"",763848.93
,"Invoice","11-03-2024","MC05487",,"Unilever Kenya Ltd:Sunlight Scouring Pwd","Sunlight Scouring Powd Lemon 24X500G","Cost of Goods Sold","Sunlight Scourg Powd Lemon 500g",,"Accounts Receivable",72198.28,"",836047.21
,"Build Assembly","11-03-2024","9835",,,"24111","Cost of Goods Sold","Sunlight Scourg Powd Lemon 500g","X","-SPLIT-",223.31,"",836270.52
,"Invoice","23-03-2024","MC05523",,"Unilever Kenya Ltd:Sunlight Scouring Pwd","Sunlight Scouring Powd Lemon 24X500G","Cost of Goods Sold","Sunlight Scourg Powd Lemon 500g",,"Accounts Receivable",65919.16,"",902189.68
,"Invoice","26-03-2024","MC05534",,"Unilever Kenya Ltd:Sunlight Scouring Pwd","Sunlight Scouring Powd Lemon 24X500G","Cost of Goods Sold","Sunlight Scourg Powd Lemon 500g",,"Accounts Receivable",62575.70,"",964765.38
,"Invoice","03-04-2024","MC05559",,"Unilever Kenya Ltd:Sunlight Scouring Pwd","Sunlight Scouring Powd Lemon 24X500G","Cost of Goods Sold","Sunlight Scourg Powd Lemon 500g",,"Accounts Receivable",41717.13,"",1006482.51
,"Invoice","11-04-2024","MC05586",,"Unilever Kenya Ltd:Sunlight Scouring Pwd","Sunlight Scouring Powd Lemon 24X500G","Cost of Goods Sold","Sunlight Scourg Powd Lemon 500g",,"Accounts Receivable",215529.32,"",1222011.83
,"Invoice","19-04-2024","MC05619",,"Unilever Kenya Ltd:Sunlight Scouring Pwd","Sunlight Scouring Powd Lemon 24X500G","Cost of Goods Sold","Sunlight Scourg Powd Lemon 500g",,"Accounts Receivable",41631.42,"",1263643.25
,"Build Assembly","19-04-2024","10163",,,"24165","Cost of Goods Sold","Sunlight Scourg Powd Lemon 500g","X","-SPLIT-",169.67,"",1263812.92
,"Invoice","26-04-2024","MC05643",,"Unilever Kenya Ltd:Sunlight Scouring Pwd","Sunlight Scouring Powd Lemon 24X500G","Cost of Goods Sold","Sunlight Scourg Powd Lemon 500g",,"Accounts Receivable",41802.11,"",1305615.03
,"Invoice","09-05-2024","MC05684",,"Unilever Kenya Ltd:Sunlight Scouring Pwd","Sunlight Scouring Powd Lemon 24X500G","Cost of Goods Sold","Sunlight Scourg Powd Lemon 500g",,"Accounts Receivable",120738.53,"",1426353.56
,"Invoice","09-05-2024","MC05689",,"Unilever Kenya Ltd:Sunlight Scouring Pwd","Sunlight Scouring Powd Lemon 24X500G","Cost of Goods Sold","Sunlight Scourg Powd Lemon 500g",,"Accounts Receivable",249266.64,"",1675620.20
,"Build Assembly","09-05-2024","10319",,,"24194","Cost of Goods Sold","Sunlight Scourg Powd Lemon 500g","X","-SPLIT-","",2807.33,1672812.87
,"Invoice","09-05-2024","MC05691",,"Unilever Kenya Ltd:Sunlight Scouring Pwd","Sunlight Scouring Powd Lemon 24X500G","Cost of Goods Sold","Sunlight Scourg Powd Lemon 500g",,"Accounts Receivable",60429.37,"",1733242.24
,"Invoice","17-05-2024","MC05715",,"Unilever Kenya Ltd:Sunlight Scouring Pwd","Sunlight Scouring Powd Lemon 24X500G","Cost of Goods Sold","Sunlight Scourg Powd Lemon 500g",,"Accounts Receivable",82286.80,"",1815529.04
,"Build Assembly","17-05-2024","10388",,,"24205","Cost of Goods Sold","Sunlight Scourg Powd Lemon 500g","X","-SPLIT-","",223.75,1815305.29
,"Invoice","20-05-2024","MC05721",,"Unilever Kenya Ltd:Sunlight Scouring Pwd","Sunlight Scouring Powd Lemon 24X500G","Cost of Goods Sold","Sunlight Scourg Powd Lemon 500g",,"Accounts Receivable",41031.52,"",1856336.81
,"Invoice","07-06-2024","MC05805",,"Unilever Kenya Ltd:Sunlight Scouring Pwd","Sunlight Scouring Powd Lemon 24X500G","Cost of Goods Sold","Sunlight Scourg Powd Lemon 500g",,"Accounts Receivable",213739.29,"",2070076.10
,"Credit","13-06-2024","0010196450000039009",,"Allpack Industries Limited","Outer Sunlight Lemon 24x500g","Cost of Goods Sold","Sunlight Scourg Powd Lemon 500g",,"Accounts Payable","",0.02,2070076.08
,"Invoice","24-06-2024","MC05860",,"Unilever Kenya Ltd:Sunlight Scouring Pwd","Sunlight Scouring Powd Lemon 24X500G","Cost of Goods Sold","Sunlight Scourg Powd Lemon 500g",,"Accounts Receivable",41045.52,"",2111121.60
,"Invoice","08-07-2024","MC05901",,"Unilever Kenya Ltd:Sunlight Scouring Pwd","Sunlight Scouring Powd Lemon 24X500G","Cost of Goods Sold","Sunlight Scourg Powd Lemon 500g",,"Accounts Receivable",71142.21,"",2182263.81
,"Invoice","15-07-2024","MC05926",,"Unilever Kenya Ltd:Sunlight Scouring Pwd","Sunlight Scouring Powd Lemon 24X500G","Cost of Goods Sold","Sunlight Scourg Powd Lemon 500g",,"Accounts Receivable",40896.12,"",2223159.93
,"Invoice","26-07-2024","MC05971",,"Unilever Kenya Ltd:Sunlight Scouring Pwd","Sunlight Scouring Powd Lemon 24X500G","Cost of Goods Sold","Sunlight Scourg Powd Lemon 500g",,"Accounts Receivable",24225.19,"",2247385.12
,"Invoice","02-08-2024","MC05999",,"Unilever Kenya Ltd:Sunlight Scouring Pwd","Sunlight Scouring Powd Lemon 24X500G","Cost of Goods Sold","Sunlight Scourg Powd Lemon 500g",,"Accounts Receivable",45443.80,"",2292828.92
,"Invoice","06-08-2024","MC06003",,"Unilever Kenya Ltd:Sunlight Scouring Pwd","Sunlight Scouring Powd Lemon 24X500G","Cost of Goods Sold","Sunlight Scourg Powd Lemon 500g",,"Accounts Receivable",122316.02,"",2415144.94
,"Invoice","09-08-2024","MC06025",,"Unilever Kenya Ltd:Sunlight Scouring Pwd","Sunlight Scouring Powd Lemon 24X500G","Cost of Goods Sold","Sunlight Scourg Powd Lemon 500g",,"Accounts Receivable",40815.84,"",2455960.78
,"Invoice","15-08-2024","MC06042",,"Unilever Kenya Ltd:Sunlight Scouring Pwd","Sunlight Scouring Powd Lemon 24X500G","Cost of Goods Sold","Sunlight Scourg Powd Lemon 500g",,"Accounts Receivable",30611.88,"",2486572.66
,"Invoice","30-08-2024","MC06104",,"Unilever Kenya Ltd:Sunlight Scouring Pwd","Sunlight Scouring Powd Lemon 24X500G","Cost of Goods Sold","Sunlight Scourg Powd Lemon 500g",,"Accounts Receivable",40757.43,"",2527330.09
,"Invoice","04-09-2024","MC06119",,"Unilever Kenya Ltd:Sunlight Scouring Pwd","Sunlight Scouring Powd Lemon 24X500G","Cost of Goods Sold","Sunlight Scourg Powd Lemon 500g",,"Accounts Receivable",212278.28,"",2739608.37
,"Invoice","11-09-2024","MC06140",,"Unilever Kenya Ltd:Sunlight Scouring Pwd","Sunlight Scouring Powd Lemon 24X500G","Cost of Goods Sold","Sunlight Scourg Powd Lemon 500g",,"Accounts Receivable",38210.09,"",2777818.46
,"Invoice","21-09-2024","MC06181",,"Unilever Kenya Ltd:Sunlight Scouring Pwd","Sunlight Scouring Powd Lemon 24X500G","Cost of Goods Sold","Sunlight Scourg Powd Lemon 500g",,"Accounts Receivable",148638.60,"",2926457.06
,"Invoice","24-09-2024","MC06191",,"Unilever Kenya Ltd:Sunlight Scouring Pwd","Sunlight Scouring Powd Lemon 24X500G","Cost of Goods Sold","Sunlight Scourg Powd Lemon 500g",,"Accounts Receivable",40769.44,"",2967226.50
,"Invoice","23-10-2024","MC06289",,"Unilever Kenya Ltd:Sunlight Scouring Pwd","Sunlight Scouring Powd Lemon 24X500G","Cost of Goods Sold","Sunlight Scourg Powd Lemon 500g",,"Accounts Receivable",384857.02,"",3352083.52
,"Invoice","24-10-2024","MC06294",,"Unilever Kenya Ltd:Sunlight Scouring Pwd","Sunlight Scouring Powd Lemon 24X500G","Cost of Goods Sold","Sunlight Scourg Powd Lemon 500g",,"Accounts Receivable",122203.77,"",3474287.29
,"Invoice","30-10-2024","MC06324",,"Unilever Kenya Ltd:Sunlight Scouring Pwd","Sunlight Scouring Powd Lemon 24X500G","Cost of Goods Sold","Sunlight Scourg Powd Lemon 500g",,"Accounts Receivable",322970.35,"",3797257.64
,"Invoice","08-11-2024","MC06347",,"Unilever Kenya Ltd:Sunlight Scouring Pwd","Sunlight Scouring Powd Lemon 24X500G","Cost of Goods Sold","Sunlight Scourg Powd Lemon 500g",,"Accounts Receivable",391708.80,"",4188966.44
,"Invoice","23-11-2024","MC06409",,"Unilever Kenya Ltd:Sunlight Scouring Pwd","Sunlight Scouring Powd Lemon 24X500G","Cost of Goods Sold","Sunlight Scourg Powd Lemon 500g",,"Accounts Receivable",20217.23,"",4209183.67
,"Invoice","28-11-2024","MC06424",,"Unilever Kenya Ltd:Sunlight Scouring Pwd","Sunlight Scouring Powd Lemon 24X500G","Cost of Goods Sold","Sunlight Scourg Powd Lemon 500g",,"Accounts Receivable",76446.54,"",4285630.21
,"Invoice","19-12-2024","MC06488",,"Unilever Kenya Ltd:Sunlight Scouring Pwd","Sunlight Scouring Powd Lemon 24X500G","Cost of Goods Sold","Sunlight Scourg Powd Lemon 500g",,"Accounts Receivable",327906.68,"",4613536.89
"Total Sunlight Scourg Powd Lemon 500g",,,,,,,,,,,4616567.99,3031.10,4613536.89
"Total Sunlight Lemon",,,,,,,,,,,5857351.41,4092.83,5853258.58
"Total Sunlight Scouring Powder",,,,,,,,,,,9849130.06,5251.85,9843878.21
"Vim",,,,,,,,,,,,,""
"Vim Lavender Fresh",,,,,,,,,,,,,""
"Vim Pwd Lav Fresh SA 24X500G",,,,,,,,,,,,,""
,"Invoice","29-02-2024","MC05456",,"Unilever Kenya Ltd:Vim SA","Vim Powder Lavender Fresh SA 24X500G","Cost of Goods Sold","Vim Pwd Lav Fresh SA 24X500G",,"Accounts Receivable",815689.48,"",815689.48
,"Invoice","25-03-2024","MC05531",,"Unilever Kenya Ltd:Vim SA","Vim Powder Lavender Fresh SA 24X500G","Cost of Goods Sold","Vim Pwd Lav Fresh SA 24X500G",,"Accounts Receivable",827000.66,"",1642690.14
,"Invoice","28-03-2024","MC05547",,"Unilever Kenya Ltd:Vim SA","Vim Powder Lavender Fresh SA 24X500G","Cost of Goods Sold","Vim Pwd Lav Fresh SA 24X500G",,"Accounts Receivable",163358.16,"",1806048.30
,"Invoice","29-05-2024","MC05771",,"Unilever Kenya Ltd:Vim SA","Vim Powder Lavender Fresh SA 24X500G","Cost of Goods Sold","Vim Pwd Lav Fresh SA 24X500G",,"Accounts Receivable",110508.62,"",1916556.92
,"Credit","13-06-2024","0010196450000039009",,"Allpack Industries Limited","Outer Vim Lavender 500g SA","Cost of Goods Sold","Vim Pwd Lav Fresh SA 24X500G",,"Accounts Payable","",0.09,1916556.83
,"Invoice","19-06-2024","MC05841",,"Unilever Kenya Ltd:Vim SA","Vim Powder Lavender Fresh SA 24X500G","Cost of Goods Sold","Vim Pwd Lav Fresh SA 24X500G",,"Accounts Receivable",324761.75,"",2241318.58
,"Invoice","26-06-2024","MC05869",,"Unilever Kenya Ltd:Vim SA","Vim Powder Lavender Fresh SA 24X500G","Cost of Goods Sold","Vim Pwd Lav Fresh SA 24X500G",,"Accounts Receivable",109607.09,"",2350925.67
,"Invoice","27-07-2024","MC05978",,"Unilever Kenya Ltd:Vim SA","Vim Powder Lavender Fresh SA 24X500G","Cost of Goods Sold","Vim Pwd Lav Fresh SA 24X500G",,"Accounts Receivable",520180.64,"",2871106.31
,"Invoice","27-07-2024","MC05980",,"Unilever Kenya Ltd:Vim SA","Vim Powder Lavender Fresh SA 24X500G","Cost of Goods Sold","Vim Pwd Lav Fresh SA 24X500G",,"Accounts Receivable",366053.04,"",3237159.35
,"Invoice","27-07-2024","MC05982",,"Unilever Kenya Ltd:Vim SA","Vim Powder Lavender Fresh SA 24X500G","Cost of Goods Sold","Vim Pwd Lav Fresh SA 24X500G",,"Accounts Receivable",301030.46,"",3538189.81
,"Invoice","16-08-2024","MC06047",,"Unilever Kenya Ltd:Vim SA","Vim Powder Lavender Fresh SA 24X500G","Cost of Goods Sold","Vim Pwd Lav Fresh SA 24X500G",,"Accounts Receivable",327458.09,"",3865647.90
,"Invoice","29-08-2024","MC06098",,"Unilever Kenya Ltd:Vim SA","Vim Powder Lavender Fresh SA 24X500G","Cost of Goods Sold","Vim Pwd Lav Fresh SA 24X500G",,"Accounts Receivable",181027.20,"",4046675.10
,"Invoice","23-09-2024","MC06189",,"Unilever Kenya Ltd:Vim SA","Vim Powder Lavender Fresh SA 24X500G","Cost of Goods Sold","Vim Pwd Lav Fresh SA 24X500G",,"Accounts Receivable",441082.44,"",4487757.54
,"Invoice","19-11-2024","MC06382",,"Unilever Kenya Ltd:Vim SA","Vim Powder Lavender Fresh SA 24X500G","Cost of Goods Sold","Vim Pwd Lav Fresh SA 24X500G",,"Accounts Receivable",645886.78,"",5133644.32
"Total Vim Pwd Lav Fresh SA 24X500G",,,,,,,,,,,5133644.41,0.09,5133644.32
"Vim Lavender Fresh 12x1Kg",,,,,,,,,,,,,""
,"Invoice","01-02-2024","MC05377",,"Unilever Kenya Ltd","Outer Vim Lavender Fresh 12x1Kg","Cost of Goods Sold","Vim Lavender Fresh 12x1Kg",,"Accounts Receivable",1120.54,"",1120.54
,"Credit","13-06-2024","0010196450000039009",,"Allpack Industries Limited","Outer Vim Lavender Fresh 12x1Kg","Cost of Goods Sold","Vim Lavender Fresh 12x1Kg",,"Accounts Payable","",0.10,1120.44
"Total Vim Lavender Fresh 12x1Kg",,,,,,,,,,,1120.54,0.10,1120.44
"Vim Lavender Fresh 24x500g",,,,,,,,,,,,,""
,"Invoice","01-02-2024","MC05377",,"Unilever Kenya Ltd","Outer Vim Lavender Fresh 24x500g","Cost of Goods Sold","Vim Lavender Fresh 24x500g",,"Accounts Receivable",433.27,"",433.27
,"Credit","13-06-2024","0010196450000039009",,"Allpack Industries Limited","Outer Vim Lavender Fresh 24x500g","Cost of Goods Sold","Vim Lavender Fresh 24x500g",,"Accounts Payable","",0.14,433.13
,"Invoice","12-07-2024","MC05920",,"Unilever Kenya Ltd","Outer Vim Lavender Fresh 24x500g","Cost of Goods Sold","Vim Lavender Fresh 24x500g",,"Accounts Receivable",3938.79,"",4371.92
"Total Vim Lavender Fresh 24x500g",,,,,,,,,,,4372.06,0.14,4371.92
"Total Vim Lavender Fresh",,,,,,,,,,,5139137.01,0.33,5139136.68
"Vim Lemon Fresh",,,,,,,,,,,,,""
"Vim Pwd Lemon Fresh SA 24X500G",,,,,,,,,,,,,""
,"Invoice","29-02-2024","MC05457",,"Unilever Kenya Ltd:Vim SA","Vim Powder Lemon Fresh SA 24X500G","Cost of Goods Sold","Vim Pwd Lemon Fresh SA 24X500G",,"Accounts Receivable",807332.29,"",807332.29
,"Invoice","25-03-2024","MC05528",,"Unilever Kenya Ltd:Vim SA","Vim Powder Lemon Fresh SA 24X500G","Cost of Goods Sold","Vim Pwd Lemon Fresh SA 24X500G",,"Accounts Receivable",817986.32,"",1625318.61
,"Invoice","28-03-2024","MC05546",,"Unilever Kenya Ltd:Vim SA","Vim Powder Lemon Fresh SA 24X500G","Cost of Goods Sold","Vim Pwd Lemon Fresh SA 24X500G",,"Accounts Receivable",323155.09,"",1948473.70
,"Invoice","22-05-2024","MC05729",,"Unilever Kenya Ltd:Vim SA","Vim Powder Lemon Fresh SA 24X500G","Cost of Goods Sold","Vim Pwd Lemon Fresh SA 24X500G",,"Accounts Receivable",815655.93,"",2764129.63
,"Invoice","29-05-2024","MC05770",,"Unilever Kenya Ltd:Vim SA","Vim Powder Lemon Fresh SA 24X500G","Cost of Goods Sold","Vim Pwd Lemon Fresh SA 24X500G",,"Accounts Receivable",253759.62,"",3017889.25
,"Credit","13-06-2024","0010196450000039009",,"Allpack Industries Limited","Outer Vim Lemon 500g SA","Cost of Goods Sold","Vim Pwd Lemon Fresh SA 24X500G",,"Accounts Payable","",0.07,3017889.18
,"Invoice","19-06-2024","MC05840",,"Unilever Kenya Ltd:Vim SA","Vim Powder Lemon Fresh SA 24X500G","Cost of Goods Sold","Vim Pwd Lemon Fresh SA 24X500G",,"Accounts Receivable",400072.16,"",3417961.34
,"Invoice","26-06-2024","MC05868",,"Unilever Kenya Ltd:Vim SA","Vim Powder Lemon Fresh SA 24X500G","Cost of Goods Sold","Vim Pwd Lemon Fresh SA 24X500G",,"Accounts Receivable",252045.46,"",3670006.80
,"Invoice","25-07-2024","MC05968",,"Unilever Kenya Ltd:Vim SA","Vim Powder Lemon Fresh SA 24X500G","Cost of Goods Sold","Vim Pwd Lemon Fresh SA 24X500G",,"Accounts Receivable",784646.11,"",4454652.91
,"Invoice","27-07-2024","MC05977",,"Unilever Kenya Ltd:Vim SA","Vim Powder Lemon Fresh SA 24X500G","Cost of Goods Sold","Vim Pwd Lemon Fresh SA 24X500G",,"Accounts Receivable",268064.42,"",4722717.33
,"Invoice","27-07-2024","MC05979",,"Unilever Kenya Ltd:Vim SA","Vim Powder Lemon Fresh SA 24X500G","Cost of Goods Sold","Vim Pwd Lemon Fresh SA 24X500G",,"Accounts Receivable",421244.09,"",5143961.42
,"Invoice","27-07-2024","MC05981",,"Unilever Kenya Ltd:Vim SA","Vim Powder Lemon Fresh SA 24X500G","Cost of Goods Sold","Vim Pwd Lemon Fresh SA 24X500G",,"Accounts Receivable",59835.81,"",5203797.23
,"Invoice","16-08-2024","MC06046",,"Unilever Kenya Ltd:Vim SA","Vim Powder Lemon Fresh SA 24X500G","Cost of Goods Sold","Vim Pwd Lemon Fresh SA 24X500G",,"Accounts Receivable",432131.26,"",5635928.49
,"Invoice","29-08-2024","MC06097",,"Unilever Kenya Ltd:Vim SA","Vim Powder Lemon Fresh SA 24X500G","Cost of Goods Sold","Vim Pwd Lemon Fresh SA 24X500G",,"Accounts Receivable",179059.91,"",5814988.40
,"Invoice","23-09-2024","MC06188",,"Unilever Kenya Ltd:Vim SA","Vim Powder Lemon Fresh SA 24X500G","Cost of Goods Sold","Vim Pwd Lemon Fresh SA 24X500G",,"Accounts Receivable",279015.39,"",6094003.79
,"Invoice","18-11-2024","MC06373",,"Unilever Kenya Ltd:Vim SA","Vim Powder Lemon Fresh SA 24X500G","Cost of Goods Sold","Vim Pwd Lemon Fresh SA 24X500G",,"Accounts Receivable",780882.80,"",6874886.59
,"Invoice","19-11-2024","MC06381",,"Unilever Kenya Ltd:Vim SA","Vim Powder Lemon Fresh SA 24X500G","Cost of Goods Sold","Vim Pwd Lemon Fresh SA 24X500G",,"Accounts Receivable",117498.45,"",6992385.04
"Total Vim Pwd Lemon Fresh SA 24X500G",,,,,,,,,,,6992385.11,0.07,6992385.04
"Vim Lemon Fresh 24x500g",,,,,,,,,,,,,""
,"Invoice","01-02-2024","MC05377",,"Unilever Kenya Ltd","-MULTIPLE-","Cost of Goods Sold","Vim Lemon Fresh 24x500g",,"Accounts Receivable",2292.45,"",2292.45
,"Invoice","09-04-2024","MC05583",,"Unilever Kenya Ltd","Outer Vim Lemon Fresh 500g","Cost of Goods Sold","Vim Lemon Fresh 24x500g",,"Accounts Receivable",5908.19,"",8200.64
,"Credit","13-06-2024","0010196450000039009",,"Allpack Industries Limited","-MULTIPLE-","Cost of Goods Sold","Vim Lemon Fresh 24x500g",,"Accounts Payable","",0.47,8200.17
,"Invoice","12-07-2024","MC05920",,"Unilever Kenya Ltd","Outer Vim Lemon Fresh 500g","Cost of Goods Sold","Vim Lemon Fresh 24x500g",,"Accounts Receivable",3938.79,"",12138.96
,"Invoice","25-10-2024","MC06303",,"Unilever Kenya Ltd","Outer Vim Lemon Fresh 500g","Cost of Goods Sold","Vim Lemon Fresh 24x500g",,"Accounts Receivable",2757.16,"",14896.12
"Total Vim Lemon Fresh 24x500g",,,,,,,,,,,14896.59,0.47,14896.12
"Vim Lemon Fresh Pouch 24x500g",,,,,,,,,,,,,""
,"Invoice","01-02-2024","MC05377",,"Unilever Kenya Ltd","Outer 500g Lemon Fresh Pouch","Cost of Goods Sold","Vim Lemon Fresh Pouch 24x500g",,"Accounts Receivable",329.60,"",329.60
,"Credit","13-06-2024","0010196450000039009",,"Allpack Industries Limited","Outer 500g Lemon Fresh Pouch","Cost of Goods Sold","Vim Lemon Fresh Pouch 24x500g",,"Accounts Payable","",0.07,329.53
"Total Vim Lemon Fresh Pouch 24x500g",,,,,,,,,,,329.60,0.07,329.53
"Total Vim Lemon Fresh",,,,,,,,,,,7007611.30,0.61,7007610.69
"Vim - Other",,,,,,,,,,,,,""
,"Invoice","04-01-2024","MC05270",,"Unilever Kenya Ltd:Vim","Vim Lemon Fresh 24x500g","Cost of Goods Sold","Vim",,"Accounts Receivable",361777.29,"",361777.29
,"Invoice","04-01-2024","MC05271",,"Unilever Kenya Ltd:Vim","Vim Lemon Fresh Pouch 24x500g","Cost of Goods Sold","Vim",,"Accounts Receivable",42798.92,"",404576.21
,"Invoice","05-01-2024","MC05273",,"Unilever Kenya Ltd:Vim","Vim Lemon Fresh 24x500g","Cost of Goods Sold","Vim",,"Accounts Receivable",286062.93,"",690639.14
,"Invoice","05-01-2024","MC05274",,"Unilever Kenya Ltd:Vim","Vim Lemon Fresh Pouch 24x500g","Cost of Goods Sold","Vim",,"Accounts Receivable",46383.94,"",737023.08
,"Invoice","08-01-2024","MC05277",,"Unilever Kenya Ltd:Vim","Vim Lemon Fresh 24x500g","Cost of Goods Sold","Vim",,"Accounts Receivable",361871.69,"",1098894.77
,"Invoice","08-01-2024","MC05279",,"Unilever Kenya Ltd:Vim","Vim Lemon Fresh 24x500g","Cost of Goods Sold","Vim",,"Accounts Receivable",80415.94,"",1179310.71
,"Invoice","08-01-2024","MC05280",,"Unilever Kenya Ltd:Vim","Vim Lemon Fresh 12x1Kg","Cost of Goods Sold","Vim",,"Accounts Receivable",145221.19,"",1324531.90
,"Invoice","08-01-2024","MC05281",,"Unilever Kenya Ltd:Vim","Vim Lavender Fresh 24x500g","Cost of Goods Sold","Vim",,"Accounts Receivable",120970.09,"",1445501.99
,"Invoice","09-01-2024","MC05283",,"Unilever Kenya Ltd:Vim","Vim Lavender Fresh 24x500g","Cost of Goods Sold","Vim",,"Accounts Receivable",134858.65,"",1580360.64
,"Invoice","09-01-2024","MC05285",,"Unilever Kenya Ltd:Vim","Vim Lavender Fresh 12x1Kg","Cost of Goods Sold","Vim",,"Accounts Receivable",203115.98,"",1783476.62
,"Invoice","09-01-2024","MC05286",,"Unilever Kenya Ltd:Vim","Vim Lemon Fresh 12x1Kg","Cost of Goods Sold","Vim",,"Accounts Receivable",58024.93,"",1841501.55
,"Build Assembly","09-01-2024","9379",,,"24022","Cost of Goods Sold","Vim","X","-SPLIT-",0.21,"",1841501.76
,"Invoice","10-01-2024","MC05287",,"Unilever Kenya Ltd:Vim","Vim Lemon Fresh 24x500g","Cost of Goods Sold","Vim",,"Accounts Receivable",106835.65,"",1948337.41
,"Invoice","10-01-2024","MC05288",,"Unilever Kenya Ltd:Vim","Vim Lemon Fresh 12x1Kg","Cost of Goods Sold","Vim",,"Accounts Receivable",252282.36,"",2200619.77
,"Invoice","10-01-2024","MC05291",,"Unilever Kenya Ltd:Vim","Vim Scourer Lmn 12X(1Kg+ Vim Lvr 1Kg)","Cost of Goods Sold","Vim",,"Accounts Receivable",7806.86,"",2208426.63
,"Build Assembly","10-01-2024","9387",,,"24023","Cost of Goods Sold","Vim","X","-SPLIT-",143.68,"",2208570.31
,"Invoice","11-01-2024","MC05293",,"Unilever Kenya Ltd:Vim","Vim Lemon Fresh Pouch 24x500g","Cost of Goods Sold","Vim",,"Accounts Receivable",27068.67,"",2235638.98
,"Invoice","11-01-2024","MC05294",,"Unilever Kenya Ltd:Vim","Vim Lemon Fresh 12x1Kg","Cost of Goods Sold","Vim",,"Accounts Receivable",86857.21,"",2322496.19
,"Invoice","11-01-2024","MC05295",,"Unilever Kenya Ltd:Vim","Vim Scourer Lmn 12X(1Kg+ Vim Lvr 1Kg)","Cost of Goods Sold","Vim",,"Accounts Receivable",54648.03,"",2377144.22
,"Invoice","11-01-2024","MC05296",,"Unilever Kenya Ltd:Vim","Vim Lemon Fresh 24x500g","Cost of Goods Sold","Vim",,"Accounts Receivable",221528.73,"",2598672.95
,"Invoice","12-01-2024","MC05297",,"Unilever Kenya Ltd:Vim","Vim Lemon Fresh 24x500g","Cost of Goods Sold","Vim",,"Accounts Receivable",391454.19,"",2990127.14
,"Invoice","15-01-2024","MC05316",,"Unilever Kenya Ltd:Vim","Vim Lemon Fresh 24x500g","Cost of Goods Sold","Vim",,"Accounts Receivable",302086.84,"",3292213.98
,"Invoice","15-01-2024","MC05317",,"Unilever Kenya Ltd:Vim","Vim Lavender Fresh 24x500g","Cost of Goods Sold","Vim",,"Accounts Receivable",40331.98,"",3332545.96
,"Invoice","15-01-2024","MC05318",,"Unilever Kenya Ltd:Vim","Vim Lavender Fresh 12x1Kg","Cost of Goods Sold","Vim",,"Accounts Receivable",50779.20,"",3383325.16
,"Invoice","16-01-2024","MC05320",,"Unilever Kenya Ltd:Vim","Vim Lemon Fresh 12x1Kg","Cost of Goods Sold","Vim",,"Accounts Receivable",126141.18,"",3509466.34
,"Invoice","16-01-2024","MC05321",,"Unilever Kenya Ltd:Vim","Vim Lavender Fresh 12x1Kg","Cost of Goods Sold","Vim",,"Accounts Receivable",42436.90,"",3551903.24
,"Invoice","16-01-2024","MC05322",,"Unilever Kenya Ltd:Vim","Vim Lavender Fresh 24x500g","Cost of Goods Sold","Vim",,"Accounts Receivable",60497.97,"",3612401.21
,"Invoice","16-01-2024","MC05325",,"Unilever Kenya Ltd:Vim","Vim Lemon Fresh 24x500g","Cost of Goods Sold","Vim",,"Accounts Receivable",161118.11,"",3773519.32
,"Build Assembly","16-01-2024","9438",,,"24032","Cost of Goods Sold","Vim","X","-SPLIT-",31.68,"",3773551.00
,"Invoice","17-01-2024","MC05326",,"Unilever Kenya Ltd:Vim","Vim Lavender Fresh 24x500g","Cost of Goods Sold","Vim",,"Accounts Receivable",92427.45,"",3865978.45
,"Invoice","17-01-2024","MC05327",,"Unilever Kenya Ltd:Vim","Vim Lemon Fresh Pouch 24x500g","Cost of Goods Sold","Vim",,"Accounts Receivable",57111.91,"",3923090.36
,"Invoice","17-01-2024","MC05328",,"Unilever Kenya Ltd:Vim","Vim Lemon Fresh 12x1Kg","Cost of Goods Sold","Vim",,"Accounts Receivable",37851.85,"",3960942.21
,"Invoice","17-01-2024","MC05329",,"Unilever Kenya Ltd:Vim","Vim Lemon Fresh 24x500g","Cost of Goods Sold","Vim",,"Accounts Receivable",170770.14,"",4131712.35
,"Invoice","19-01-2024","MC05332",,"Unilever Kenya Ltd:Vim","Vim Lemon Fresh 12x1Kg","Cost of Goods Sold","Vim",,"Accounts Receivable",201918.55,"",4333630.90
,"Invoice","19-01-2024","MC05333",,"Unilever Kenya Ltd:Vim","Vim Lavender Fresh 24x500g","Cost of Goods Sold","Vim",,"Accounts Receivable",60502.98,"",4394133.88
,"Invoice","19-01-2024","MC05335",,"Unilever Kenya Ltd:Vim","Vim Lavender Fresh 12x1Kg","Cost of Goods Sold","Vim",,"Accounts Receivable",80183.62,"",4474317.50
,"Invoice","19-01-2024","MC05336",,"Unilever Kenya Ltd:Vim","Vim Scourer Lmn 12X(1Kg+ Vim Lvr 1Kg)","Cost of Goods Sold","Vim",,"Accounts Receivable",35130.88,"",4509448.38
,"Invoice","22-01-2024","MC05338",,"Unilever Kenya Ltd:Vim","Vim Lemon Fresh 24x500g","Cost of Goods Sold","Vim",,"Accounts Receivable",105734.83,"",4615183.21
,"Invoice","22-01-2024","MC05341",,"Unilever Kenya Ltd:Vim","Vim Lemon Fresh 12x1Kg","Cost of Goods Sold","Vim",,"Accounts Receivable",298190.43,"",4913373.64
,"Invoice","25-01-2024","MC05349",,"Unilever Kenya Ltd:Vim","Vim Lemon Fresh 24x500g","Cost of Goods Sold","Vim",,"Accounts Receivable",386246.19,"",5299619.83
,"Invoice","26-01-2024","MC05351",,"Unilever Kenya Ltd:Vim","Vim Lavender Fresh 24x500g","Cost of Goods Sold","Vim",,"Accounts Receivable",141173.62,"",5440793.45
,"Invoice","26-01-2024","MC05352",,"Unilever Kenya Ltd:Vim","Vim Lavender Fresh 12x1Kg","Cost of Goods Sold","Vim",,"Accounts Receivable",152385.15,"",5593178.60
,"Invoice","26-01-2024","MC05355",,"Unilever Kenya Ltd:Vim","Vim Lemon Fresh 12x1Kg","Cost of Goods Sold","Vim",,"Accounts Receivable",124962.74,"",5718141.34
,"Invoice","26-01-2024","MC05356",,"Unilever Kenya Ltd:Vim","Vim Lavender Fresh 12x1Kg","Cost of Goods Sold","Vim",,"Accounts Receivable",119731.19,"",5837872.53
,"Invoice","26-01-2024","MC05357",,"Unilever Kenya Ltd:Vim","Vim Scourer Lmn 12X(1Kg+ Vim Lvr 1Kg)","Cost of Goods Sold","Vim",,"Accounts Receivable",54065.05,"",5891937.58
,"Invoice","26-01-2024","MC05359",,"Unilever Kenya Ltd:Vim","Vim Lemon Fresh 24x500g","Cost of Goods Sold","Vim",,"Accounts Receivable",99891.26,"",5991828.84
,"Invoice","26-01-2024","MC05360",,"Unilever Kenya Ltd:Vim","Vim Lemon Fresh 12x1Kg","Cost of Goods Sold","Vim",,"Accounts Receivable",134245.69,"",6126074.53
,"Invoice","26-01-2024","MC05362",,"Unilever Kenya Ltd:Vim","Vim Lemon Fresh 24x500g","Cost of Goods Sold","Vim",,"Accounts Receivable",416213.57,"",6542288.10
,"Invoice","26-01-2024","MC05363",,"Unilever Kenya Ltd:Vim","Vim Lemon Fresh 12x1Kg","Cost of Goods Sold","Vim",,"Accounts Receivable",178518.20,"",6720806.30
,"Invoice","29-01-2024","MC05364",,"Unilever Kenya Ltd:Vim","Vim Lavender Fresh 24x500g","Cost of Goods Sold","Vim",,"Accounts Receivable",215962.02,"",6936768.32
,"Invoice","30-01-2024","MC05368",,"Unilever Kenya Ltd:Vim","Vim Lemon Fresh Pouch 24x500g","Cost of Goods Sold","Vim",,"Accounts Receivable",83290.03,"",7020058.35
,"Invoice","30-01-2024","MC05369",,"Unilever Kenya Ltd:Vim","Vim Lavender Fresh 12x1Kg","Cost of Goods Sold","Vim",,"Accounts Receivable",184676.29,"",7204734.64
,"Invoice","30-01-2024","MC05372",,"Unilever Kenya Ltd:Vim","Vim Lemon Fresh 24x500g","Cost of Goods Sold","Vim",,"Accounts Receivable",624320.36,"",7829055.00
,"Build Assembly","30-01-2024","9533",,,"24052","Cost of Goods Sold","Vim","X","-SPLIT-","",416.76,7828638.24
,"Invoice","01-02-2024","MC05374",,"Unilever Kenya Ltd:Vim","Vim Lemon Fresh 24x500g","Cost of Goods Sold","Vim",,"Accounts Receivable",139071.16,"",7967709.40
,"Invoice","01-02-2024","MC05375",,"Unilever Kenya Ltd:Vim","Vim Lemon Fresh 12x1Kg","Cost of Goods Sold","Vim",,"Accounts Receivable",283594.22,"",8251303.62
,"Invoice","01-02-2024","MC05376",,"Unilever Kenya Ltd:Vim","Vim Scourer Lmn 12X(1Kg+ Vim Lvr 1Kg)","Cost of Goods Sold","Vim",,"Accounts Receivable",27015.02,"",8278318.64
,"Invoice","01-02-2024","MC05377",,"Unilever Kenya Ltd","Outer Vim Lemon fresh + Lavender 6x2x1kg","Cost of Goods Sold","Vim",,"Accounts Receivable",1337.41,"",8279656.05
,"Invoice","02-02-2024","MC05380",,"Unilever Kenya Ltd:Vim","Vim Lemon Fresh 24x500g","Cost of Goods Sold","Vim",,"Accounts Receivable",186201.72,"",8465857.77
,"Invoice","02-02-2024","MC05381",,"Unilever Kenya Ltd:Vim","Vim Lemon Fresh 12x1Kg","Cost of Goods Sold","Vim",,"Accounts Receivable",240237.71,"",8706095.48
,"Invoice","05-02-2024","MC05386",,"Unilever Kenya Ltd:Vim","Vim Lemon Fresh 24x500g","Cost of Goods Sold","Vim",,"Accounts Receivable",744717.64,"",9450813.12
,"Invoice","07-02-2024","MC05387",,"Unilever Kenya Ltd:Vim","Vim Lavender Fresh 24x500g","Cost of Goods Sold","Vim",,"Accounts Receivable",160011.24,"",9610824.36
,"Invoice","07-02-2024","MC05391",,"Unilever Kenya Ltd:Vim","Vim Scourer Lmn 12X(1Kg+ Vim Lvr 1Kg)","Cost of Goods Sold","Vim",,"Accounts Receivable",26243.17,"",9637067.53
,"Invoice","07-02-2024","MC05392",,"Unilever Kenya Ltd:Vim","Vim Lemon Fresh 24x500g","Cost of Goods Sold","Vim",,"Accounts Receivable",198591.37,"",9835658.90
,"Invoice","07-02-2024","MC05393",,"Unilever Kenya Ltd:Vim","Vim Lavender Fresh 12x1Kg","Cost of Goods Sold","Vim",,"Accounts Receivable",252892.65,"",10088551.55
,"Invoice","12-02-2024","MC05397",,"Unilever Kenya Ltd:Vim","Vim Lavender Fresh 24x500g","Cost of Goods Sold","Vim",,"Accounts Receivable",249184.17,"",10337735.72
,"Invoice","12-02-2024","MC05398",,"Unilever Kenya Ltd:Vim","Vim Lavender Fresh 12x1Kg","Cost of Goods Sold","Vim",,"Accounts Receivable",75867.79,"",10413603.51
,"Invoice","12-02-2024","MC05399",,"Unilever Kenya Ltd:Vim","Vim Scourer Lmn 12X(1Kg+ Vim Lvr 1Kg)","Cost of Goods Sold","Vim",,"Accounts Receivable",90137.01,"",10503740.52
,"Invoice","13-02-2024","MC05401",,"Unilever Kenya Ltd:Vim","Vim Lemon Fresh 24x500g","Cost of Goods Sold","Vim",,"Accounts Receivable",311591.07,"",10815331.59
,"Invoice","13-02-2024","MC05402",,"Unilever Kenya Ltd:Vim","Vim Lemon Fresh Pouch 24x500g","Cost of Goods Sold","Vim",,"Accounts Receivable",43439.05,"",10858770.64
,"Invoice","15-02-2024","MC05408",,"Unilever Kenya Ltd:Vim","Vim Lemon Fresh 24x500g","Cost of Goods Sold","Vim",,"Accounts Receivable",830582.84,"",11689353.48
,"Invoice","16-02-2024","MC05409",,"Unilever Kenya Ltd:Vim","Vim Lemon Fresh 12x1Kg","Cost of Goods Sold","Vim",,"Accounts Receivable",149636.56,"",11838990.04
,"Invoice","16-02-2024","MC05410",,"Unilever Kenya Ltd:Vim","Vim Lavender Fresh 12x1Kg","Cost of Goods Sold","Vim",,"Accounts Receivable",291738.64,"",12130728.68
,"Invoice","16-02-2024","MC05411",,"Unilever Kenya Ltd:Vim","Vim Scourer Lmn 12X(1Kg+ Vim Lvr 1Kg)","Cost of Goods Sold","Vim",,"Accounts Receivable",54568.47,"",12185297.15
,"Invoice","21-02-2024","MC05414",,"Unilever Kenya Ltd:Vim","Vim Lemon Fresh 24x500g","Cost of Goods Sold","Vim",,"Accounts Receivable",299992.18,"",12485289.33
,"Invoice","21-02-2024","MC05415",,"Unilever Kenya Ltd:Vim","Vim Lemon Fresh Pouch 24x500g","Cost of Goods Sold","Vim",,"Accounts Receivable",43755.49,"",12529044.82
,"Invoice","21-02-2024","MC05418",,"Unilever Kenya Ltd:Vim","Vim Lemon Fresh Pouch 24x500g","Cost of Goods Sold","Vim",,"Accounts Receivable",78699.12,"",12607743.94
,"Invoice","21-02-2024","MC05419",,"Unilever Kenya Ltd:Vim","Vim Lavender Fresh 24x500g","Cost of Goods Sold","Vim",,"Accounts Receivable",200014.05,"",12807757.99
,"Invoice","22-02-2024","MC05423",,"Unilever Kenya Ltd:Vim","Vim Lemon Fresh 12x1Kg","Cost of Goods Sold","Vim",,"Accounts Receivable",245530.97,"",13053288.96
,"Invoice","22-02-2024","MC05424",,"Unilever Kenya Ltd:Vim","Vim Lavender Fresh 12x1Kg","Cost of Goods Sold","Vim",,"Accounts Receivable",178771.32,"",13232060.28
,"Invoice","22-02-2024","MC05425",,"Unilever Kenya Ltd:Vim","Vim Scourer Lmn 12X(1Kg+ Vim Lvr 1Kg)","Cost of Goods Sold","Vim",,"Accounts Receivable",62376.91,"",13294437.19
,"Invoice","22-02-2024","MC05426",,"Unilever Kenya Ltd:Vim","Vim Lemon Fresh 24x500g","Cost of Goods Sold","Vim",,"Accounts Receivable",624983.72,"",13919420.91
,"Invoice","22-02-2024","MC05427",,"Unilever Kenya Ltd:Vim","Vim Lemon Fresh 12x1Kg","Cost of Goods Sold","Vim",,"Accounts Receivable",142543.38,"",14061964.29
,"Invoice","22-02-2024","MC05430",,"Unilever Kenya Ltd:Vim","Vim Lemon Fresh 24x500g","Cost of Goods Sold","Vim",,"Accounts Receivable",77497.98,"",14139462.27
,"Invoice","22-02-2024","MC05431",,"Unilever Kenya Ltd:Vim","Vim Lemon Fresh 12x1Kg","Cost of Goods Sold","Vim",,"Accounts Receivable",149670.55,"",14289132.82
,"Invoice","22-02-2024","MC05432",,"Unilever Kenya Ltd:Vim","Vim Lavender Fresh 24x500g","Cost of Goods Sold","Vim",,"Accounts Receivable",120008.43,"",14409141.25
,"Invoice","23-02-2024","MC05435",,"Unilever Kenya Ltd:Vim","Vim Lemon Fresh Pouch 24x500g","Cost of Goods Sold","Vim",,"Accounts Receivable",8811.87,"",14417953.12
,"Invoice","23-02-2024","MC05436",,"Unilever Kenya Ltd:Vim","Vim Lemon Fresh 12x1Kg","Cost of Goods Sold","Vim",,"Accounts Receivable",86238.74,"",14504191.86
,"Invoice","23-02-2024","MC05437",,"Unilever Kenya Ltd:Vim","Vim Lavender Fresh 24x500g","Cost of Goods Sold","Vim",,"Accounts Receivable",26251.84,"",14530443.70
,"Invoice","23-02-2024","MC05438",,"Unilever Kenya Ltd:Vim","Vim Lavender Fresh 12x1Kg","Cost of Goods Sold","Vim",,"Accounts Receivable",16417.77,"",14546861.47
,"Invoice","23-02-2024","MC05442",,"Unilever Kenya Ltd:Vim","Vim Scourer Lmn 12X(1Kg+ Vim Lvr 1Kg)","Cost of Goods Sold","Vim",,"Accounts Receivable",26510.19,"",14573371.66
,"Invoice","27-02-2024","MC05447",,"Unilever Kenya Ltd:Vim","Vim Lemon Fresh 24x500g","Cost of Goods Sold","Vim",,"Accounts Receivable",340404.37,"",14913776.03
,"Invoice","27-02-2024","MC05448",,"Unilever Kenya Ltd:Vim","Vim Lemon Fresh Pouch 24x500g","Cost of Goods Sold","Vim",,"Accounts Receivable",43831.32,"",14957607.35
,"Invoice","28-02-2024","MC05450",,"Unilever Kenya Ltd:Vim","Vim Lemon Fresh Pouch 24x500g","Cost of Goods Sold","Vim",,"Accounts Receivable",43222.55,"",15000829.90
,"Invoice","28-02-2024","MC05451",,"Unilever Kenya Ltd:Vim","Vim Lemon Fresh 12x1Kg","Cost of Goods Sold","Vim",,"Accounts Receivable",299341.10,"",15300171.00
,"Build Assembly","28-02-2024","9745",,,"24093","Cost of Goods Sold","Vim","X","-SPLIT-",4699.96,"",15304870.96
,"Invoice","29-02-2024","MC05454",,"Unilever Kenya Ltd:Vim","Vim Lavender Fresh 12x1Kg","Cost of Goods Sold","Vim",,"Accounts Receivable",271457.50,"",15576328.46
,"Invoice","29-02-2024","MC05458",,"Unilever Kenya Ltd:Vim","Vim Lemon Fresh 24x500g","Cost of Goods Sold","Vim",,"Accounts Receivable",417173.64,"",15993502.10
,"Invoice","05-03-2024","MC05464",,"Unilever Kenya Ltd:Vim","Vim Lemon Fresh 24x500g","Cost of Goods Sold","Vim",,"Accounts Receivable",384746.76,"",16378248.86
,"Invoice","05-03-2024","MC05465",,"Unilever Kenya Ltd:Vim","Vim Lemon Fresh 12x1Kg","Cost of Goods Sold","Vim",,"Accounts Receivable",116191.41,"",16494440.27
,"Invoice","05-03-2024","MC05468",,"Unilever Kenya Ltd:Vim","Vim Scourer Lmn 12X(1Kg+ Vim Lvr 1Kg)","Cost of Goods Sold","Vim",,"Accounts Receivable",115735.78,"",16610176.05
,"Build Assembly","05-03-2024","9791",,,"24102","Cost of Goods Sold","Vim","X","-SPLIT-",22.64,"",16610198.69
,"Invoice","06-03-2024","MC05472",,"Unilever Kenya Ltd:Vim","Vim Lemon Fresh 24x500g","Cost of Goods Sold","Vim",,"Accounts Receivable",369254.44,"",16979453.13
,"Build Assembly","06-03-2024","9800",,,"24103","Cost of Goods Sold","Vim","X","-SPLIT-",998.92,"",16980452.05
,"Invoice","07-03-2024","MC05474",,"Unilever Kenya Ltd:Vim","Vim Lemon Fresh 24x500g","Cost of Goods Sold","Vim",,"Accounts Receivable",230641.63,"",17211093.68
,"Invoice","07-03-2024","MC05475",,"Unilever Kenya Ltd:Vim","Vim Lemon Fresh Pouch 24x500g","Cost of Goods Sold","Vim",,"Accounts Receivable",77422.61,"",17288516.29
,"Invoice","07-03-2024","MC05476",,"Unilever Kenya Ltd:Vim","Vim Lavender Fresh 24x500g","Cost of Goods Sold","Vim",,"Accounts Receivable",72921.79,"",17361438.08
,"Build Assembly","07-03-2024","9809",,,"24104","Cost of Goods Sold","Vim","X","-SPLIT-",662.31,"",17362100.39
,"Invoice","08-03-2024","MC05478",,"Unilever Kenya Ltd:Vim","Vim Lemon Fresh 24x500g","Cost of Goods Sold","Vim",,"Accounts Receivable",60496.17,"",17422596.56
,"Invoice","08-03-2024","MC05479",,"Unilever Kenya Ltd:Vim","Vim Lavender Fresh 24x500g","Cost of Goods Sold","Vim",,"Accounts Receivable",338400.15,"",17760996.71
,"Invoice","08-03-2024","MC05480",,"Unilever Kenya Ltd:Vim","Vim Lemon Fresh 12x1Kg","Cost of Goods Sold","Vim",,"Accounts Receivable",305003.16,"",18065999.87
,"Invoice","11-03-2024","MC05485",,"Unilever Kenya Ltd:Vim","Vim Lemon Fresh 24x500g","Cost of Goods Sold","Vim",,"Accounts Receivable",651398.68,"",18717398.55
,"Build Assembly","11-03-2024","9839",,,"24111","Cost of Goods Sold","Vim","X","-SPLIT-",754.35,"",18718152.90
,"Invoice","12-03-2024","MC05488",,"Unilever Kenya Ltd:Vim","Vim Lemon Fresh Pouch 24x500g","Cost of Goods Sold","Vim",,"Accounts Receivable",76652.40,"",18794805.30
,"Invoice","12-03-2024","MC05489",,"Unilever Kenya Ltd:Vim","Vim Lavender Fresh 24x500g","Cost of Goods Sold","Vim",,"Accounts Receivable",152322.26,"",18947127.56
,"Invoice","12-03-2024","MC05490",,"Unilever Kenya Ltd:Vim","Vim Lavender Fresh 12x1Kg","Cost of Goods Sold","Vim",,"Accounts Receivable",103019.94,"",19050147.50
,"Invoice","12-03-2024","MC05491",,"Unilever Kenya Ltd:Vim","Vim Scourer Lmn 12X(1Kg+ Vim Lvr 1Kg)","Cost of Goods Sold","Vim",,"Accounts Receivable",105569.80,"",19155717.30
,"Invoice","14-03-2024","MC05493",,"Unilever Kenya Ltd:Vim","Vim Lemon Fresh Pouch 24x500g","Cost of Goods Sold","Vim",,"Accounts Receivable",151458.81,"",19307176.11
,"Invoice","14-03-2024","MC05494",,"Unilever Kenya Ltd:Vim","Vim Lemon Fresh 12x1Kg","Cost of Goods Sold","Vim",,"Accounts Receivable",153852.72,"",19461028.83
,"Invoice","19-03-2024","MC05498",,"Unilever Kenya Ltd:Vim","Vim Lemon Fresh 24x500g","Cost of Goods Sold","Vim",,"Accounts Receivable",400484.35,"",19861513.18
,"Invoice","19-03-2024","MC05500",,"Unilever Kenya Ltd:Vim","Vim Lemon Fresh 24x500g","Cost of Goods Sold","Vim",,"Accounts Receivable",398369.86,"",20259883.04
,"Build Assembly","19-03-2024","9895",,,"24122","Cost of Goods Sold","Vim","X","-SPLIT-",190.70,"",20260073.74
,"Invoice","20-03-2024","MC05505",,"Unilever Kenya Ltd:Vim","Vim Lemon Fresh 24x500g","Cost of Goods Sold","Vim",,"Accounts Receivable",341969.05,"",20602042.79
,"Invoice","20-03-2024","MC05506",,"Unilever Kenya Ltd:Vim","Vim Scourer Lmn 12X(1Kg+ Vim Lvr 1Kg)","Cost of Goods Sold","Vim",,"Accounts Receivable",63271.68,"",20665314.47
,"Invoice","21-03-2024","MC05508",,"Unilever Kenya Ltd:Vim","Vim Lemon Fresh 12x1Kg","Cost of Goods Sold","Vim",,"Accounts Receivable",249390.44,"",20914704.91
,"Invoice","21-03-2024","MC05509",,"Unilever Kenya Ltd:Vim","Vim Lavender Fresh 12x1Kg","Cost of Goods Sold","Vim",,"Accounts Receivable",257549.85,"",21172254.76
,"Build Assembly","21-03-2024","9916",,,"24124","Cost of Goods Sold","Vim","X","-SPLIT-",209.90,"",21172464.66
,"Invoice","22-03-2024","MC05510",,"Unilever Kenya Ltd:Vim","Vim Lemon Fresh 24x500g","Cost of Goods Sold","Vim",,"Accounts Receivable",60727.08,"",21233191.74
,"Invoice","22-03-2024","MC05511",,"Unilever Kenya Ltd:Vim","Vim Lavender Fresh 24x500g","Cost of Goods Sold","Vim",,"Accounts Receivable",236386.57,"",21469578.31
,"Invoice","22-03-2024","MC05512",,"Unilever Kenya Ltd:Vim","Vim Lavender Fresh 12x1Kg","Cost of Goods Sold","Vim",,"Accounts Receivable",14729.13,"",21484307.44
,"Build Assembly","22-03-2024","9922",,,"24125","Cost of Goods Sold","Vim","X","-SPLIT-",93.82,"",21484401.26
,"Invoice","22-03-2024","MC05515",,"Unilever Kenya Ltd:Vim","Vim Lemon Fresh 24x500g","Cost of Goods Sold","Vim",,"Accounts Receivable",295201.07,"",21779602.33
,"Invoice","22-03-2024","MC05516",,"Unilever Kenya Ltd:Vim","Vim Lemon Fresh 12x1Kg","Cost of Goods Sold","Vim",,"Accounts Receivable",238401.83,"",22018004.16
,"Invoice","22-03-2024","MC05517",,"Unilever Kenya Ltd:Vim","Vim Lavender Fresh 24x500g","Cost of Goods Sold","Vim",,"Accounts Receivable",12728.92,"",22030733.08
,"Invoice","22-03-2024","MC05518",,"Unilever Kenya Ltd:Vim","Vim Lavender Fresh 12x1Kg","Cost of Goods Sold","Vim",,"Accounts Receivable",7364.57,"",22038097.65
,"Invoice","23-03-2024","MC05519",,"Unilever Kenya Ltd:Vim","Vim Lemon Fresh 24x500g","Cost of Goods Sold","Vim",,"Accounts Receivable",52714.48,"",22090812.13
,"Invoice","23-03-2024","MC05520",,"Unilever Kenya Ltd:Vim","Vim Lemon Fresh 12x1Kg","Cost of Goods Sold","Vim",,"Accounts Receivable",236201.19,"",22327013.32
,"Invoice","23-03-2024","MC05521",,"Unilever Kenya Ltd:Vim","Vim Lavender Fresh 24x500g","Cost of Goods Sold","Vim",,"Accounts Receivable",31822.29,"",22358835.61
,"Invoice","23-03-2024","MC05522",,"Unilever Kenya Ltd:Vim","Vim Lavender Fresh 12x1Kg","Cost of Goods Sold","Vim",,"Accounts Receivable",25775.98,"",22384611.59
,"Invoice","23-03-2024","MC05527",,"Unilever Kenya Ltd:Vim","Vim Lavender Fresh 12x1Kg","Cost of Goods Sold","Vim",,"Accounts Receivable",515519.66,"",22900131.25
,"Build Assembly","23-03-2024","9933",,,"24126","Cost of Goods Sold","Vim","X","-SPLIT-","",31.64,22900099.61
,"Build Assembly","23-03-2024","9934",,,"24126","Cost of Goods Sold","Vim","X","-SPLIT-",1252.81,"",22901352.42
,"Invoice","26-03-2024","MC05532",,"Unilever Kenya Ltd:Vim","Vim Lavender Fresh 24x500g","Cost of Goods Sold","Vim",,"Accounts Receivable",7637.35,"",22908989.77
,"Invoice","26-03-2024","MC05533",,"Unilever Kenya Ltd:Vim","Vim Lavender Fresh 12x1Kg","Cost of Goods Sold","Vim",,"Accounts Receivable",101196.27,"",23010186.04
,"Invoice","26-03-2024","MC05538",,"Unilever Kenya Ltd:Vim","Vim Scourer Lmn 12X(1Kg+ Vim Lvr 1Kg)","Cost of Goods Sold","Vim",,"Accounts Receivable",63271.68,"",23073457.72
,"Invoice","26-03-2024","MC05539",,"Unilever Kenya Ltd:Vim","Vim Lavender Fresh 24x500g","Cost of Goods Sold","Vim",,"Accounts Receivable",264761.48,"",23338219.20
,"Build Assembly","26-03-2024","9973",,,"24132","Cost of Goods Sold","Vim","X","-SPLIT-",1279.79,"",23339498.99
,"Invoice","27-03-2024","MC05543",,"Unilever Kenya Ltd:Vim","Vim Lemon Fresh 12x1Kg","Cost of Goods Sold","Vim",,"Accounts Receivable",513480.86,"",23852979.85
,"Build Assembly","27-03-2024","9971",,,"24133","Cost of Goods Sold","Vim","X","-SPLIT-","",2505.36,23850474.49
,"Invoice","28-03-2024","MC05544",,"Unilever Kenya Ltd:Vim","Vim Lemon Fresh 24x500g","Cost of Goods Sold","Vim",,"Accounts Receivable",312276.36,"",24162750.85
,"Invoice","28-03-2024","MC05545",,"Unilever Kenya Ltd:Vim","Vim Lemon Fresh 12x1Kg","Cost of Goods Sold","Vim",,"Accounts Receivable",72266.54,"",24235017.39
,"Invoice","28-03-2024","MC05548",,"Unilever Kenya Ltd:Vim","Vim Lemon Fresh 24x500g","Cost of Goods Sold","Vim",,"Accounts Receivable",342036.93,"",24577054.32
,"Invoice","28-03-2024","MC05549",,"Unilever Kenya Ltd:Vim","Vim Lemon Fresh Pouch 24x500g","Cost of Goods Sold","Vim",,"Accounts Receivable",38171.22,"",24615225.54
,"Invoice","28-03-2024","MC05550",,"Unilever Kenya Ltd:Vim","Vim Lavender Fresh 24x500g","Cost of Goods Sold","Vim",,"Accounts Receivable",17480.27,"",24632705.81
,"Build Assembly","28-03-2024","9980",,,"24134","Cost of Goods Sold","Vim","X","-SPLIT-","",211.45,24632494.36
,"Invoice","02-04-2024","MC05551",,"Unilever Kenya Ltd:Vim","Vim Lemon Fresh 24x500g","Cost of Goods Sold","Vim",,"Accounts Receivable",241333.83,"",24873828.19
,"Invoice","02-04-2024","MC05552",,"Unilever Kenya Ltd:Vim","Vim Lavender Fresh 24x500g","Cost of Goods Sold","Vim",,"Accounts Receivable",163717.65,"",25037545.84
,"Build Assembly","02-04-2024","9996",,,"24142","Cost of Goods Sold","Vim","X","-SPLIT-","",1735.91,25035809.93
,"Invoice","03-04-2024","MC05554",,"Unilever Kenya Ltd:Vim","Vim Lemon Fresh Pouch 24x500g","Cost of Goods Sold","Vim",,"Accounts Receivable",22344.13,"",25058154.06
,"Invoice","03-04-2024","MC05555",,"Unilever Kenya Ltd:Vim","Vim Lavender Fresh 24x500g","Cost of Goods Sold","Vim",,"Accounts Receivable",308779.60,"",25366933.66
,"Invoice","03-04-2024","MC05557",,"Unilever Kenya Ltd:Vim","Vim Lemon Fresh Pouch 24x500g","Cost of Goods Sold","Vim",,"Accounts Receivable",49963.95,"",25416897.61
,"Invoice","03-04-2024","MC05558",,"Unilever Kenya Ltd:Vim","Vim Lemon Fresh 24x500g","Cost of Goods Sold","Vim",,"Accounts Receivable",288694.45,"",25705592.06
,"Build Assembly","03-04-2024","10014",,,"24143","Cost of Goods Sold","Vim","X","-SPLIT-","",506.99,25705085.07
,"Invoice","04-04-2024","MC05560",,"Unilever Kenya Ltd:Vim","Vim Scourer Lmn 12X(1Kg+ Vim Lvr 1Kg)","Cost of Goods Sold","Vim",,"Accounts Receivable",127402.07,"",25832487.14
,"Invoice","04-04-2024","MC05561",,"Unilever Kenya Ltd:Vim","Vim Lavender Fresh 12x1Kg","Cost of Goods Sold","Vim",,"Accounts Receivable",140600.99,"",25973088.13
,"Invoice","04-04-2024","MC05562",,"Unilever Kenya Ltd:Vim","Vim Lemon Fresh 24x500g","Cost of Goods Sold","Vim",,"Accounts Receivable",171674.20,"",26144762.33
,"Invoice","04-04-2024","MC05568",,"Unilever Kenya Ltd:Vim","Vim Lemon Fresh 24x500g","Cost of Goods Sold","Vim",,"Accounts Receivable",240594.50,"",26385356.83
,"Invoice","04-04-2024","MC05569",,"Unilever Kenya Ltd:Vim","Vim Lemon Fresh 12x1Kg","Cost of Goods Sold","Vim",,"Accounts Receivable",153292.66,"",26538649.49
,"Invoice","04-04-2024","MC05570",,"Unilever Kenya Ltd:Vim","Vim Lemon Fresh Pouch 24x500g","Cost of Goods Sold","Vim",,"Accounts Receivable",34670.00,"",26573319.49
,"Build Assembly","04-04-2024","10024",,,"24144","Cost of Goods Sold","Vim","X","-SPLIT-",0.01,"",26573319.50
,"Build Assembly","04-04-2024","10023",,,"24144","Cost of Goods Sold","Vim","X","-SPLIT-","",176.11,26573143.39
,"Build Assembly","04-04-2024","10027",,,"24144","Cost of Goods Sold","Vim","X","-SPLIT-","",680.11,26572463.28
,"Invoice","05-04-2024","MC05571",,"Unilever Kenya Ltd:Vim","Vim Lemon Fresh 24x500g","Cost of Goods Sold","Vim",,"Accounts Receivable",18786.71,"",26591249.99
,"Invoice","05-04-2024","MC05572",,"Unilever Kenya Ltd:Vim","Vim Lemon Fresh Pouch 24x500g","Cost of Goods Sold","Vim",,"Accounts Receivable",42340.39,"",26633590.38
,"Invoice","05-04-2024","MC05573",,"Unilever Kenya Ltd:Vim","Vim Lemon Fresh 12x1Kg","Cost of Goods Sold","Vim",,"Accounts Receivable",252537.47,"",26886127.85
,"Invoice","05-04-2024","MC05575",,"Unilever Kenya Ltd:Vim","Vim Scourer Lmn 12X(1Kg+ Vim Lvr 1Kg)","Cost of Goods Sold","Vim",,"Accounts Receivable",108863.69,"",26994991.54
,"Build Assembly","05-04-2024","10033",,,"24145","Cost of Goods Sold","Vim","X","-SPLIT-","",16.10,26994975.44
,"Build Assembly","05-04-2024","10035",,,"24145","Cost of Goods Sold","Vim","X","-SPLIT-","",31.48,26994943.96
,"Invoice","09-04-2024","MC05579",,"Unilever Kenya Ltd:Vim","Vim Lemon Fresh 24x500g","Cost of Goods Sold","Vim",,"Accounts Receivable",172841.30,"",27167785.26
,"Invoice","09-04-2024","MC05580",,"Unilever Kenya Ltd:Vim","Vim Lemon Fresh 12x1Kg","Cost of Goods Sold","Vim",,"Accounts Receivable",152585.60,"",27320370.86
,"Invoice","11-04-2024","MC05584",,"Unilever Kenya Ltd:Vim","Vim Lemon Fresh Pouch 24x500g","Cost of Goods Sold","Vim",,"Accounts Receivable",11343.86,"",27331714.72
,"Invoice","11-04-2024","MC05585",,"Unilever Kenya Ltd:Vim","Vim Lavender Fresh 12x1Kg","Cost of Goods Sold","Vim",,"Accounts Receivable",5858.40,"",27337573.12
,"Invoice","11-04-2024","MC05589",,"Unilever Kenya Ltd:Vim","Vim Lavender Fresh 12x1Kg","Cost of Goods Sold","Vim",,"Accounts Receivable",146460.00,"",27484033.12
,"Build Assembly","11-04-2024","10083",,,"24154","Cost of Goods Sold","Vim","X","-SPLIT-",1026.41,"",27485059.53
,"Invoice","12-04-2024","MC05594",,"Unilever Kenya Ltd:Vim","Vim Lemon Fresh Pouch 24x500g","Cost of Goods Sold","Vim",,"Accounts Receivable",44439.81,"",27529499.34
,"Invoice","12-04-2024","MC05596",,"Unilever Kenya Ltd:Vim","Vim Scourer Lmn 12X(1Kg+ Vim Lvr 1Kg)","Cost of Goods Sold","Vim",,"Accounts Receivable",8255.07,"",27537754.41
,"Invoice","12-04-2024","MC05597",,"Unilever Kenya Ltd:Vim","Vim Lavender Fresh 24x500g","Cost of Goods Sold","Vim",,"Accounts Receivable",191412.37,"",27729166.78
,"Build Assembly","12-04-2024","10092",,,"24155","Cost of Goods Sold","Vim","X","-SPLIT-",6.43,"",27729173.21
,"Invoice","12-04-2024","MC05598",,"Unilever Kenya Ltd:Vim","Vim Lavender Fresh 24x500g","Cost of Goods Sold","Vim",,"Accounts Receivable",115875.18,"",27845048.39
,"Invoice","12-04-2024","MC05599",,"Unilever Kenya Ltd:Vim","Vim Lemon Fresh 12x1Kg","Cost of Goods Sold","Vim",,"Accounts Receivable",278287.07,"",28123335.46
,"Build Assembly","12-04-2024","10094",,,"24155","Cost of Goods Sold","Vim","X","-SPLIT-",1870.69,"",28125206.15
,"Invoice","15-04-2024","MC05600",,"Unilever Kenya Ltd:Vim","Vim Lemon Fresh 24x500g","Cost of Goods Sold","Vim",,"Accounts Receivable",380751.85,"",28505958.00
,"Invoice","15-04-2024","MC05601",,"Unilever Kenya Ltd:Vim","Vim Lemon Fresh 12x1Kg","Cost of Goods Sold","Vim",,"Accounts Receivable",25601.89,"",28531559.89
,"Build Assembly","15-04-2024","10105",,,"24161","Cost of Goods Sold","Vim","X","-SPLIT-",2251.72,"",28533811.61
,"Invoice","16-04-2024","MC05602",,"Unilever Kenya Ltd:Vim","Vim Lemon Fresh 12x1Kg","Cost of Goods Sold","Vim",,"Accounts Receivable",478572.94,"",29012384.55
,"Build Assembly","16-04-2024","10112",,,"24162","Cost of Goods Sold","Vim","X","-SPLIT-",445.72,"",29012830.27
,"Invoice","17-04-2024","MC05604",,"Unilever Kenya Ltd:Vim","Vim Lemon Fresh 24x500g","Cost of Goods Sold","Vim",,"Accounts Receivable",377492.41,"",29390322.68
,"Invoice","18-04-2024","MC05605",,"Unilever Kenya Ltd:Vim","Vim Lemon Fresh 24x500g","Cost of Goods Sold","Vim",,"Accounts Receivable",141493.77,"",29531816.45
,"Invoice","18-04-2024","MC05606",,"Unilever Kenya Ltd:Vim","Vim Lemon Fresh Pouch 24x500g","Cost of Goods Sold","Vim",,"Accounts Receivable",62262.53,"",29594078.98
,"Invoice","18-04-2024","MC05607",,"Unilever Kenya Ltd:Vim","Vim Lemon Fresh 12x1Kg","Cost of Goods Sold","Vim",,"Accounts Receivable",209804.51,"",29803883.49
,"Invoice","18-04-2024","MC05608",,"Unilever Kenya Ltd:Vim","Vim Lemon Fresh 24x500g","Cost of Goods Sold","Vim",,"Accounts Receivable",262774.14,"",30066657.63
,"Invoice","18-04-2024","MC05609",,"Unilever Kenya Ltd:Vim","Vim Lavender Fresh 12x1Kg","Cost of Goods Sold","Vim",,"Accounts Receivable",167330.55,"",30233988.18
,"Build Assembly","18-04-2024","10144",,,"24164","Cost of Goods Sold","Vim","X","-SPLIT-",1737.27,"",30235725.45
,"Invoice","19-04-2024","MC05616",,"Unilever Kenya Ltd:Vim","Vim Lemon Fresh Pouch 24x500g","Cost of Goods Sold","Vim",,"Accounts Receivable",44668.20,"",30280393.65
,"Invoice","19-04-2024","MC05617",,"Unilever Kenya Ltd:Vim","Vim Lavender Fresh 24x500g","Cost of Goods Sold","Vim",,"Accounts Receivable",204393.72,"",30484787.37
,"Invoice","19-04-2024","MC05618",,"Unilever Kenya Ltd:Vim","Vim Lavender Fresh 12x1Kg","Cost of Goods Sold","Vim",,"Accounts Receivable",126893.65,"",30611681.02
,"Invoice","23-04-2024","MC05625",,"Unilever Kenya Ltd:Vim","Vim Lemon Fresh Pouch 24x500g","Cost of Goods Sold","Vim",,"Accounts Receivable",29468.60,"",30641149.62
,"Invoice","23-04-2024","MC05626",,"Unilever Kenya Ltd:Vim","Vim Lavender Fresh 24x500g","Cost of Goods Sold","Vim",,"Accounts Receivable",135114.26,"",30776263.88
,"Invoice","23-04-2024","MC05627",,"Unilever Kenya Ltd:Vim","Vim Lavender Fresh 12x1Kg","Cost of Goods Sold","Vim",,"Accounts Receivable",207524.63,"",30983788.51
,"Invoice","23-04-2024","MC05629",,"Unilever Kenya Ltd:Vim","Vim Lemon Fresh 24x500g","Cost of Goods Sold","Vim",,"Accounts Receivable",390969.01,"",31374757.52
,"Invoice","24-04-2024","MC05632",,"Unilever Kenya Ltd:Vim","Vim Lemon Fresh 24x500g","Cost of Goods Sold","Vim",,"Accounts Receivable",202137.17,"",31576894.69
,"Invoice","24-04-2024","MC05633",,"Unilever Kenya Ltd:Vim","Vim Lemon Fresh Pouch 24x500g","Cost of Goods Sold","Vim",,"Accounts Receivable",22334.10,"",31599228.79
,"Invoice","24-04-2024","MC05634",,"Unilever Kenya Ltd:Vim","Vim Lemon Fresh 12x1Kg","Cost of Goods Sold","Vim",,"Accounts Receivable",128376.89,"",31727605.68
,"Invoice","24-04-2024","MC05635",,"Unilever Kenya Ltd:Vim","Vim Scourer Lmn 12X(1Kg+ Vim Lvr 1Kg)","Cost of Goods Sold","Vim",,"Accounts Receivable",101812.56,"",31829418.24
,"Build Assembly","24-04-2024","10197",,,"24173","Cost of Goods Sold","Vim","X","-SPLIT-",17.01,"",31829435.25
,"Build Assembly","24-04-2024","10198",,,"24173","Cost of Goods Sold","Vim","X","-SPLIT-",253.00,"",31829688.25
,"Invoice","25-04-2024","MC05637",,"Unilever Kenya Ltd:Vim","Vim Lemon Fresh Pouch 24x500g","Cost of Goods Sold","Vim",,"Accounts Receivable",64569.85,"",31894258.10
,"Invoice","25-04-2024","MC05638",,"Unilever Kenya Ltd:Vim","Vim Lemon Fresh 12x1Kg","Cost of Goods Sold","Vim",,"Accounts Receivable",420803.48,"",32315061.58
,"Build Assembly","25-04-2024","10209",,,"24174","Cost of Goods Sold","Vim","X","-SPLIT-",6.41,"",32315067.99
,"Build Assembly","25-04-2024","10211",,,"24174","Cost of Goods Sold","Vim","X","-SPLIT-",6.23,"",32315074.22
,"Invoice","26-04-2024","MC05639",,"Unilever Kenya Ltd:Vim","Vim Lemon Fresh 24x500g","Cost of Goods Sold","Vim",,"Accounts Receivable",109108.33,"",32424182.55
,"Invoice","26-04-2024","MC05640",,"Unilever Kenya Ltd:Vim","Vim Lemon Fresh Pouch 24x500g","Cost of Goods Sold","Vim",,"Accounts Receivable",44715.03,"",32468897.58
,"Invoice","26-04-2024","MC05641",,"Unilever Kenya Ltd:Vim","Vim Lavender Fresh 24x500g","Cost of Goods Sold","Vim",,"Accounts Receivable",231044.12,"",32699941.70
,"Invoice","26-04-2024","MC05642",,"Unilever Kenya Ltd:Vim","Vim Lemon Fresh 24x500g","Cost of Goods Sold","Vim",,"Accounts Receivable",279721.73,"",32979663.43
,"Invoice","29-04-2024","MC05646",,"Unilever Kenya Ltd:Vim","Vim Lemon Fresh 24x500g","Cost of Goods Sold","Vim",,"Accounts Receivable",80768.84,"",33060432.27
,"Invoice","29-04-2024","MC05647",,"Unilever Kenya Ltd:Vim","Vim Lemon Fresh 12x1Kg","Cost of Goods Sold","Vim",,"Accounts Receivable",244456.09,"",33304888.36
,"Invoice","29-04-2024","MC05648",,"Unilever Kenya Ltd:Vim","Vim Lavender Fresh 24x500g","Cost of Goods Sold","Vim",,"Accounts Receivable",31544.77,"",33336433.13
,"Invoice","29-04-2024","MC05649",,"Unilever Kenya Ltd:Vim","Vim Lavender Fresh 12x1Kg","Cost of Goods Sold","Vim",,"Accounts Receivable",89309.71,"",33425742.84
,"Build Assembly","29-04-2024","10235",,,"24181","Cost of Goods Sold","Vim","X","-SPLIT-","",1610.34,33424132.50
,"Invoice","30-04-2024","MC05654",,"Unilever Kenya Ltd:Vim","Vim Lemon Fresh Pouch 24x500g","Cost of Goods Sold","Vim",,"Accounts Receivable",50146.69,"",33474279.19
,"Invoice","30-04-2024","MC05655",,"Unilever Kenya Ltd:Vim","Vim Lemon Fresh 12x1Kg","Cost of Goods Sold","Vim",,"Accounts Receivable",229778.35,"",33704057.54
,"Build Assembly","30-04-2024","10243",,,"24182","Cost of Goods Sold","Vim","X","-SPLIT-",56.57,"",33704114.11
,"Invoice","03-05-2024","MC05658",,"Unilever Kenya Ltd:Vim","Vim Lemon Fresh 24x500g","Cost of Goods Sold","Vim",,"Accounts Receivable",100828.08,"",33804942.19
,"Invoice","03-05-2024","MC05659",,"Unilever Kenya Ltd:Vim","Vim Lemon Fresh Pouch 24x500g","Cost of Goods Sold","Vim",,"Accounts Receivable",63207.00,"",33868149.19
,"Invoice","03-05-2024","MC05660",,"Unilever Kenya Ltd:Vim","Vim Lavender Fresh 24x500g","Cost of Goods Sold","Vim",,"Accounts Receivable",236990.51,"",34105139.70
,"Invoice","03-05-2024","MC05661",,"Unilever Kenya Ltd:Vim","Vim Lemon Fresh 24x500g","Cost of Goods Sold","Vim",,"Accounts Receivable",60496.85,"",34165636.55
,"Invoice","03-05-2024","MC05662",,"Unilever Kenya Ltd:Vim","Vim Lemon Fresh 12x1Kg","Cost of Goods Sold","Vim",,"Accounts Receivable",295114.55,"",34460751.10
,"Invoice","03-05-2024","MC05663",,"Unilever Kenya Ltd:Vim","Vim Scourer Lmn 12X(1Kg+ Vim Lvr 1Kg)","Cost of Goods Sold","Vim",,"Accounts Receivable",133992.85,"",34594743.95
,"Invoice","03-05-2024","MC05664",,"Unilever Kenya Ltd:Vim","Vim Lemon Fresh 24x500g","Cost of Goods Sold","Vim",,"Accounts Receivable",160064.58,"",34754808.53
,"Invoice","03-05-2024","MC05665",,"Unilever Kenya Ltd:Vim","Vim Lavender Fresh 24x500g","Cost of Goods Sold","Vim",,"Accounts Receivable",243761.67,"",34998570.20
,"Invoice","03-05-2024","MC05666",,"Unilever Kenya Ltd:Vim","Vim Lemon Fresh 24x500g","Cost of Goods Sold","Vim",,"Accounts Receivable",221821.78,"",35220391.98
,"Invoice","03-05-2024","MC05667",,"Unilever Kenya Ltd:Vim","Vim Lemon Fresh 12x1Kg","Cost of Goods Sold","Vim",,"Accounts Receivable",168010.76,"",35388402.74
,"Invoice","03-05-2024","MC05668",,"Unilever Kenya Ltd:Vim","Vim Lavender Fresh 24x500g","Cost of Goods Sold","Vim",,"Accounts Receivable",40626.94,"",35429029.68
,"Build Assembly","03-05-2024","10258",,,"24185","Cost of Goods Sold","Vim","X","-SPLIT-",872.18,"",35429901.86
,"Invoice","06-05-2024","MC05669",,"Unilever Kenya Ltd:Vim","Vim Lavender Fresh 24x500g","Cost of Goods Sold","Vim",,"Accounts Receivable",61127.32,"",35491029.18
,"Invoice","06-05-2024","MC05670",,"Unilever Kenya Ltd:Vim","Vim Lavender Fresh 12x1Kg","Cost of Goods Sold","Vim",,"Accounts Receivable",276058.38,"",35767087.56
,"Invoice","07-05-2024","MC05673",,"Unilever Kenya Ltd:Vim","Vim Lemon Fresh Pouch 24x500g","Cost of Goods Sold","Vim",,"Accounts Receivable",82230.47,"",35849318.03
,"Invoice","07-05-2024","MC05674",,"Unilever Kenya Ltd:Vim","Vim Lemon Fresh 12x1Kg","Cost of Goods Sold","Vim",,"Accounts Receivable",339908.68,"",36189226.71
,"Invoice","07-05-2024","MC05675",,"Unilever Kenya Ltd:Vim","Vim Lavender Fresh 12x1Kg","Cost of Goods Sold","Vim",,"Accounts Receivable",51599.70,"",36240826.41
,"Build Assembly","07-05-2024","10293",,,"24192","Cost of Goods Sold","Vim",,"-SPLIT-",152.56,"",36240978.97
,"Build Assembly","07-05-2024","10295",,,"24192","Cost of Goods Sold","Vim","X","-SPLIT-",100.84,"",36241079.81
,"Invoice","08-05-2024","MC05677",,"Unilever Kenya Ltd:Vim","Vim Lemon Fresh 24x500g","Cost of Goods Sold","Vim",,"Accounts Receivable",266330.49,"",36507410.30
,"Invoice","08-05-2024","MC05678",,"Unilever Kenya Ltd:Vim","Vim Lemon Fresh Pouch 24x500g","Cost of Goods Sold","Vim",,"Accounts Receivable",63803.73,"",36571214.03
,"Invoice","08-05-2024","MC05679",,"Unilever Kenya Ltd:Vim","Vim Lemon Fresh 12x1Kg","Cost of Goods Sold","Vim",,"Accounts Receivable",51215.80,"",36622429.83
,"Invoice","08-05-2024","MC05680",,"Unilever Kenya Ltd:Vim","Vim Lavender Fresh 24x500g","Cost of Goods Sold","Vim",,"Accounts Receivable",20375.77,"",36642805.60
,"Build Assembly","08-05-2024","10309",,,"24193","Cost of Goods Sold","Vim","X","-SPLIT-",0.01,"",36642805.61
,"Invoice","09-05-2024","MC05683",,"Unilever Kenya Ltd:Vim","Vim Lavender Fresh 24x500g","Cost of Goods Sold","Vim",,"Accounts Receivable",169695.13,"",36812500.74
,"Invoice","09-05-2024","MC05685",,"Unilever Kenya Ltd:Vim","Vim Lemon Fresh 24x500g","Cost of Goods Sold","Vim",,"Accounts Receivable",40327.54,"",36852828.28
,"Invoice","09-05-2024","MC05686",,"Unilever Kenya Ltd:Vim","Vim Lemon Fresh Pouch 24x500g","Cost of Goods Sold","Vim",,"Accounts Receivable",34213.60,"",36887041.88
,"Invoice","09-05-2024","MC05687",,"Unilever Kenya Ltd:Vim","Vim Lavender Fresh 24x500g","Cost of Goods Sold","Vim",,"Accounts Receivable",33598.79,"",36920640.67
,"Invoice","09-05-2024","MC05688",,"Unilever Kenya Ltd:Vim","Vim Lavender Fresh 12x1Kg","Cost of Goods Sold","Vim",,"Accounts Receivable",40588.15,"",36961228.82
,"Credit Note","09-05-2024","CN01060",,"Unilever Kenya Ltd:Vim","Vim Lemon Fresh 24x500g","Cost of Goods Sold","Vim",,"Accounts Receivable","",6721.26,36954507.56
,"Credit Note","09-05-2024","CN01061",,"Unilever Kenya Ltd:Vim","Vim Lavender Fresh 24x500g","Cost of Goods Sold","Vim",,"Accounts Receivable","",850.60,36953656.96
,"Invoice","09-05-2024","MC05690",,"Unilever Kenya Ltd:Vim","Vim Lemon Fresh 24x500g","Cost of Goods Sold","Vim",,"Accounts Receivable",205418.43,"",37159075.39
,"Invoice","09-05-2024","MC05692",,"Unilever Kenya Ltd:Vim","Vim Scourer Lmn 12X(1Kg+ Vim Lvr 1Kg)","Cost of Goods Sold","Vim",,"Accounts Receivable",126857.14,"",37285932.53
,"Build Assembly","09-05-2024","10320",,,"24165","Cost of Goods Sold","Vim","X","-SPLIT-","",239.20,37285693.33
,"Invoice","13-05-2024","MC05693",,"Unilever Kenya Ltd:Vim","Vim Lavender Fresh 12x1Kg","Cost of Goods Sold","Vim",,"Accounts Receivable",455325.24,"",37741018.57
,"Build Assembly","13-05-2024","10338",,,"24201","Cost of Goods Sold","Vim","X","-SPLIT-",1072.18,"",37742090.75
,"Invoice","14-05-2024","MC05697",,"Unilever Kenya Ltd:Vim","Vim Lemon Fresh 24x500g","Cost of Goods Sold","Vim",,"Accounts Receivable",334382.56,"",38076473.31
,"Invoice","15-05-2024","MC05707",,"Unilever Kenya Ltd:Vim","Vim Lemon Fresh 24x500g","Cost of Goods Sold","Vim",,"Accounts Receivable",185674.74,"",38262148.05
,"Invoice","15-05-2024","MC05708",,"Unilever Kenya Ltd:Vim","Vim Lemon Fresh 12x1Kg","Cost of Goods Sold","Vim",,"Accounts Receivable",246226.55,"",38508374.60
,"Build Assembly","15-05-2024","10359",,,"24203","Cost of Goods Sold","Vim","X","-SPLIT-",153.78,"",38508528.38
,"Invoice","16-05-2024","MC05709",,"Unilever Kenya Ltd:Vim","Vim Lemon Fresh Pouch 24x500g","Cost of Goods Sold","Vim",,"Accounts Receivable",8655.17,"",38517183.55
,"Invoice","16-05-2024","MC05710",,"Unilever Kenya Ltd:Vim","Vim Lemon Fresh 12x1Kg","Cost of Goods Sold","Vim",,"Accounts Receivable",462824.16,"",38980007.71
,"Invoice","16-05-2024","MC05711",,"Unilever Kenya Ltd:Vim","Vim Lavender Fresh 24x500g","Cost of Goods Sold","Vim",,"Accounts Receivable",20470.23,"",39000477.94
,"Build Assembly","16-05-2024","10373",,,"24","Cost of Goods Sold","Vim","X","-SPLIT-","",120.88,39000357.06
,"Invoice","17-05-2024","MC05714",,"Unilever Kenya Ltd:Vim","Vim Lavender Fresh 24x500g","Cost of Goods Sold","Vim",,"Accounts Receivable",286583.24,"",39286940.30
,"Invoice","20-05-2024","MC05720",,"Unilever Kenya Ltd:Vim","Vim Lemon Fresh 24x500g","Cost of Goods Sold","Vim",,"Accounts Receivable",302416.47,"",39589356.77
,"Invoice","21-05-2024","MC05724",,"Unilever Kenya Ltd:Vim","Vim Lemon Fresh 24x500g","Cost of Goods Sold","Vim",,"Accounts Receivable",239706.53,"",39829063.30
,"Invoice","21-05-2024","MC05725",,"Unilever Kenya Ltd:Vim","Vim Lavender Fresh 24x500g","Cost of Goods Sold","Vim",,"Accounts Receivable",122821.39,"",39951884.69
,"Invoice","21-05-2024","MC05726",,"Unilever Kenya Ltd:Vim","Vim Scourer Lmn 12X(1Kg+ Vim Lvr 1Kg)","Cost of Goods Sold","Vim",,"Accounts Receivable",55554.82,"",40007439.51
,"Invoice","21-05-2024","MC05727",,"Unilever Kenya Ltd:Vim","Vim Lemon Fresh 24x500g","Cost of Goods Sold","Vim",,"Accounts Receivable",382858.76,"",40390298.27
,"Invoice","23-05-2024","MC05732",,"Unilever Kenya Ltd:Vim","Vim Lemon Fresh 12x1Kg","Cost of Goods Sold","Vim",,"Accounts Receivable",179987.17,"",40570285.44
,"Invoice","23-05-2024","MC05736",,"Unilever Kenya Ltd:Vim","Vim Scourer Lmn 12X(1Kg+ Vim Lvr 1Kg)","Cost of Goods Sold","Vim",,"Accounts Receivable",87300.44,"",40657585.88
,"Invoice","23-05-2024","MC05737",,"Unilever Kenya Ltd:Vim","Vim Lemon Fresh 24x500g","Cost of Goods Sold","Vim",,"Accounts Receivable",798055.02,"",41455640.90
,"Build Assembly","23-05-2024","10435",,,"24214","Cost of Goods Sold","Vim","X","-SPLIT-","",776.57,41454864.33
,"Invoice","24-05-2024","MC05740",,"Unilever Kenya Ltd:Vim","Vim Lemon Fresh 24x500g","Cost of Goods Sold","Vim",,"Accounts Receivable",158331.54,"",41613195.87
,"Invoice","24-05-2024","MC05742",,"Unilever Kenya Ltd:Vim","Vim Lemon Fresh Pouch 24x500g","Cost of Goods Sold","Vim",,"Accounts Receivable",19291.35,"",41632487.22
,"Invoice","24-05-2024","MC05743",,"Unilever Kenya Ltd:Vim","Vim Lemon Fresh 12x1Kg","Cost of Goods Sold","Vim",,"Accounts Receivable",94725.61,"",41727212.83
,"Invoice","24-05-2024","MC05744",,"Unilever Kenya Ltd:Vim","Vim Lavender Fresh 24x500g","Cost of Goods Sold","Vim",,"Accounts Receivable",14926.22,"",41742139.05
,"Invoice","24-05-2024","MC05745",,"Unilever Kenya Ltd:Vim","Vim Lavender Fresh 12x1Kg","Cost of Goods Sold","Vim",,"Accounts Receivable",103315.29,"",41845454.34
,"Invoice","24-05-2024","MC05751",,"Unilever Kenya Ltd:Vim","Vim Lemon Fresh 24x500g","Cost of Goods Sold","Vim",,"Accounts Receivable",181430.31,"",42026884.65
,"Invoice","24-05-2024","MC05752",,"Unilever Kenya Ltd:Vim","Vim Lavender Fresh 24x500g","Cost of Goods Sold","Vim",,"Accounts Receivable",79748.61,"",42106633.26
,"Invoice","24-05-2024","MC05753",,"Unilever Kenya Ltd:Vim","Vim Lavender Fresh 12x1Kg","Cost of Goods Sold","Vim",,"Accounts Receivable",160138.70,"",42266771.96
,"Build Assembly","24-05-2024","10445",,,"24215","Cost of Goods Sold","Vim","X","-SPLIT-","",106.14,42266665.82
,"Build Assembly","24-05-2024","10446",,,"24215","Cost of Goods Sold","Vim","X","-SPLIT-","",397.29,42266268.53
,"Build Assembly","24-05-2024","10447",,,"24215","Cost of Goods Sold","Vim","X","-SPLIT-","",298.89,42265969.64
,"Invoice","27-05-2024","MC05755",,"Unilever Kenya Ltd:Vim","Vim Lavender Fresh 24x500g","Cost of Goods Sold","Vim",,"Accounts Receivable",379552.21,"",42645521.85
,"Invoice","27-05-2024","MC05756",,"Unilever Kenya Ltd:Vim","Vim Lavender Fresh 12x1Kg","Cost of Goods Sold","Vim",,"Accounts Receivable",25828.82,"",42671350.67
,"Build Assembly","27-05-2024","10459",,,"24221","Cost of Goods Sold","Vim","X","-SPLIT-","",1998.68,42669351.99
,"Credit Note","27-05-2024","CN01062",,"Unilever Kenya Ltd:Vim","Vim Lavender Fresh 12x1Kg","Cost of Goods Sold","Vim",,"Accounts Receivable","",25828.82,42643523.17
,"Invoice","27-05-2024","MC05754",,"Unilever Kenya Ltd:Vim","Vim Lavender Fresh 12x1Kg","Cost of Goods Sold","Vim",,"Accounts Receivable",25828.82,"",42669351.99
,"Build Assembly","27-05-2024","10460",,,"24221","Cost of Goods Sold","Vim","X","-SPLIT-","",39.10,42669312.89
,"Invoice","28-05-2024","MC05759",,"Unilever Kenya Ltd:Vim","Vim Lemon Fresh 24x500g","Cost of Goods Sold","Vim",,"Accounts Receivable",181430.31,"",42850743.20
,"Invoice","28-05-2024","MC05760",,"Unilever Kenya Ltd:Vim","Vim Lavender Fresh 24x500g","Cost of Goods Sold","Vim",,"Accounts Receivable",225172.55,"",43075915.75
,"Build Assembly","28-05-2024","10470",,,"24222","Cost of Goods Sold","Vim","X","-SPLIT-","",1405.98,43074509.77
,"Invoice","29-05-2024","MC05766",,"Unilever Kenya Ltd:Vim","Vim Lemon Fresh 24x500g","Cost of Goods Sold","Vim",,"Accounts Receivable",60476.77,"",43134986.54
,"Invoice","29-05-2024","MC05767",,"Unilever Kenya Ltd:Vim","Vim Lemon Fresh Pouch 24x500g","Cost of Goods Sold","Vim",,"Accounts Receivable",65945.42,"",43200931.96
,"Invoice","29-05-2024","MC05768",,"Unilever Kenya Ltd:Vim","Vim Lavender Fresh 24x500g","Cost of Goods Sold","Vim",,"Accounts Receivable",108492.88,"",43309424.84
,"Invoice","29-05-2024","MC05769",,"Unilever Kenya Ltd:Vim","Vim Lavender Fresh 12x1Kg","Cost of Goods Sold","Vim",,"Accounts Receivable",191094.27,"",43500519.11
,"Invoice","30-05-2024","MC05777",,"Unilever Kenya Ltd:Vim","Vim Lemon Fresh 12x1Kg","Cost of Goods Sold","Vim",,"Accounts Receivable",245807.47,"",43746326.58
,"Invoice","30-05-2024","MC05780",,"Unilever Kenya Ltd:Vim","Vim Scourer Lmn 12X(1Kg+ Vim Lvr 1Kg)","Cost of Goods Sold","Vim",,"Accounts Receivable",83332.23,"",43829658.81
,"Invoice","30-05-2024","MC05781",,"Unilever Kenya Ltd:Vim","Vim Lemon Fresh 24x500g","Cost of Goods Sold","Vim",,"Accounts Receivable",241907.07,"",44071565.88
,"Invoice","31-05-2024","MC05783",,"Unilever Kenya Ltd:Vim","Vim Lemon Fresh 24x500g","Cost of Goods Sold","Vim",,"Accounts Receivable",335950.69,"",44407516.57
,"Invoice","04-06-2024","MC05786",,"Unilever Kenya Ltd:Vim","Vim Lemon Fresh 24x500g","Cost of Goods Sold","Vim",,"Accounts Receivable",253355.94,"",44660872.51
,"Invoice","04-06-2024","MC05787",,"Unilever Kenya Ltd:Vim","Vim Lemon Fresh Pouch 24x500g","Cost of Goods Sold","Vim",,"Accounts Receivable",32127.05,"",44692999.56
,"Invoice","04-06-2024","MC05788",,"Unilever Kenya Ltd:Vim","Vim Lemon Fresh 12x1Kg","Cost of Goods Sold","Vim",,"Accounts Receivable",127429.97,"",44820429.53
,"Invoice","06-06-2024","MC05791",,"Unilever Kenya Ltd:Vim","Vim Lemon Fresh 24x500g","Cost of Goods Sold","Vim",,"Accounts Receivable",60302.90,"",44880732.43
,"Invoice","06-06-2024","MC05792",,"Unilever Kenya Ltd:Vim","Vim Lemon Fresh Pouch 24x500g","Cost of Goods Sold","Vim",,"Accounts Receivable",40511.57,"",44921244.00
,"Invoice","06-06-2024","MC05793",,"Unilever Kenya Ltd:Vim","Vim Lavender Fresh 12x1Kg","Cost of Goods Sold","Vim",,"Accounts Receivable",303252.36,"",45224496.36
,"Invoice","07-06-2024","MC05798",,"Unilever Kenya Ltd:Vim","Vim Lemon Fresh 24x500g","Cost of Goods Sold","Vim",,"Accounts Receivable",20100.97,"",45244597.33
,"Invoice","07-06-2024","MC05799",,"Unilever Kenya Ltd:Vim","Vim Lemon Fresh Pouch 24x500g","Cost of Goods Sold","Vim",,"Accounts Receivable",38667.32,"",45283264.65
,"Invoice","07-06-2024","MC05800",,"Unilever Kenya Ltd:Vim","Vim Lemon Fresh 12x1Kg","Cost of Goods Sold","Vim",,"Accounts Receivable",226116.65,"",45509381.30
,"Invoice","07-06-2024","MC05801",,"Unilever Kenya Ltd:Vim","Vim Lavender Fresh 12x1Kg","Cost of Goods Sold","Vim",,"Accounts Receivable",128652.52,"",45638033.82
,"Invoice","10-06-2024","MC05806",,"Unilever Kenya Ltd:Vim","Vim Lemon Fresh 24x500g","Cost of Goods Sold","Vim",,"Accounts Receivable",164789.74,"",45802823.56
,"Invoice","10-06-2024","MC05807",,"Unilever Kenya Ltd:Vim","Vim Lemon Fresh Pouch 24x500g","Cost of Goods Sold","Vim",,"Accounts Receivable",37739.30,"",45840562.86
,"Invoice","10-06-2024","MC05809",,"Unilever Kenya Ltd:Vim","Vim Scourer Lmn 12X(1Kg+ Vim Lvr 1Kg)","Cost of Goods Sold","Vim",,"Accounts Receivable",43551.30,"",45884114.16
,"Invoice","11-06-2024","MC05811",,"Unilever Kenya Ltd:Vim","Vim Lemon Fresh 24x500g","Cost of Goods Sold","Vim",,"Accounts Receivable",301069.14,"",46185183.30
,"Invoice","11-06-2024","MC05812",,"Unilever Kenya Ltd:Vim","Vim Lemon Fresh 12x1Kg","Cost of Goods Sold","Vim",,"Accounts Receivable",84111.02,"",46269294.32
,"Invoice","11-06-2024","MC05813",,"Unilever Kenya Ltd:Vim","Vim Scourer Lmn 12X(1Kg+ Vim Lvr 1Kg)","Cost of Goods Sold","Vim",,"Accounts Receivable",27714.47,"",46297008.79
,"Invoice","11-06-2024","MC05814",,"Unilever Kenya Ltd:Plastics","-MULTIPLE-","Cost of Goods Sold","Vim",,"Accounts Receivable",71248.15,"",46368256.94
,"Invoice","12-06-2024","MC05816",,"Unilever Kenya Ltd:Vim","Vim Lemon Fresh 24x500g","Cost of Goods Sold","Vim",,"Accounts Receivable",200584.01,"",46568840.95
,"Invoice","12-06-2024","MC05817",,"Unilever Kenya Ltd:Vim","Vim Lemon Fresh 12x1Kg","Cost of Goods Sold","Vim",,"Accounts Receivable",254881.89,"",46823722.84
,"Invoice","13-06-2024","MC05821",,"Unilever Kenya Ltd:Vim","Vim Lemon Fresh 24x500g","Cost of Goods Sold","Vim",,"Accounts Receivable",334299.80,"",47158022.64
,"Invoice","13-06-2024","MC05822",,"Unilever Kenya Ltd:Vim","Vim Lemon Fresh 24x500g","Cost of Goods Sold","Vim",,"Accounts Receivable",200579.88,"",47358602.52
,"Invoice","13-06-2024","MC05823",,"Unilever Kenya Ltd:Vim","Vim Lemon Fresh 12x1Kg","Cost of Goods Sold","Vim",,"Accounts Receivable",251563.16,"",47610165.68
,"Credit","13-06-2024","0010196450000039009",,"Allpack Industries Limited","Outer Vim Lemon fresh + Lavender 6x2x1kg","Cost of Goods Sold","Vim",,"Accounts Payable","",0.08,47610165.60
,"Invoice","14-06-2024","MC05824",,"Unilever Kenya Ltd:Vim","Vim Lemon Fresh 24x500g","Cost of Goods Sold","Vim",,"Accounts Receivable",284572.70,"",47894738.30
,"Invoice","14-06-2024","MC05826",,"Unilever Kenya Ltd:Vim","Vim Scourer Lmn 12X(1Kg+ Vim Lvr 1Kg)","Cost of Goods Sold","Vim",,"Accounts Receivable",55069.86,"",47949808.16
,"Invoice","18-06-2024","MC05833",,"Unilever Kenya Ltd:Vim","Vim Lemon Fresh Pouch 24x500g","Cost of Goods Sold","Vim",,"Accounts Receivable",85252.04,"",48035060.20
,"Invoice","18-06-2024","MC05836",,"Unilever Kenya Ltd:Vim","Vim Lavender Fresh 24x500g","Cost of Goods Sold","Vim",,"Accounts Receivable",218463.13,"",48253523.33
,"Invoice","19-06-2024","MC05838",,"Unilever Kenya Ltd:Vim","Vim Lemon Fresh 12x1Kg","Cost of Goods Sold","Vim",,"Accounts Receivable",437969.70,"",48691493.03
,"Invoice","19-06-2024","MC05839",,"Unilever Kenya Ltd:Vim","Vim Lavender Fresh 24x500g","Cost of Goods Sold","Vim",,"Accounts Receivable",40644.30,"",48732137.33
,"Build Assembly","19-06-2024","10652",,,"24253","Cost of Goods Sold","Vim","X","-SPLIT-","",96.49,48732040.84
,"Invoice","21-06-2024","MC05846",,"Unilever Kenya Ltd:Vim","Vim Lemon Fresh 24x500g","Cost of Goods Sold","Vim",,"Accounts Receivable",300783.86,"",49032824.70
,"Invoice","21-06-2024","MC05847",,"Unilever Kenya Ltd:Vim","Vim Lavender Fresh 24x500g","Cost of Goods Sold","Vim",,"Accounts Receivable",101351.10,"",49134175.80
,"Invoice","24-06-2024","MC05848",,"Unilever Kenya Ltd:Vim","Vim Lemon Fresh 24x500g","Cost of Goods Sold","Vim",,"Accounts Receivable",200134.11,"",49334309.91
,"Invoice","24-06-2024","MC05849",,"Unilever Kenya Ltd:Vim","Vim Lavender Fresh 24x500g","Cost of Goods Sold","Vim",,"Accounts Receivable",121621.32,"",49455931.23
,"Invoice","24-06-2024","MC05850",,"Unilever Kenya Ltd:Vim","Vim Lavender Fresh 12x1Kg","Cost of Goods Sold","Vim",,"Accounts Receivable",102750.31,"",49558681.54
,"Invoice","24-06-2024","MC05855",,"Unilever Kenya Ltd:Vim","Vim Lemon Fresh 24x500g","Cost of Goods Sold","Vim",,"Accounts Receivable",687961.02,"",50246642.56
,"Invoice","24-06-2024","MC05856",,"Unilever Kenya Ltd:Vim","Vim Lavender Fresh 24x500g","Cost of Goods Sold","Vim",,"Accounts Receivable",126688.88,"",50373331.44
,"Invoice","24-06-2024","MC05857",,"Unilever Kenya Ltd:Vim","Vim Lemon Fresh 24x500g","Cost of Goods Sold","Vim",,"Accounts Receivable",47948.79,"",50421280.23
,"Invoice","24-06-2024","MC05858",,"Unilever Kenya Ltd:Vim","Vim Lemon Fresh 12x1Kg","Cost of Goods Sold","Vim",,"Accounts Receivable",203391.80,"",50624672.03
,"Invoice","24-06-2024","MC05859",,"Unilever Kenya Ltd:Vim","Vim Lavender Fresh 24x500g","Cost of Goods Sold","Vim",,"Accounts Receivable",131756.43,"",50756428.46
,"Invoice","26-06-2024","MC05867",,"Unilever Kenya Ltd:Vim","Vim Lemon Fresh 24x500g","Cost of Goods Sold","Vim",,"Accounts Receivable",208473.04,"",50964901.50
,"Build Assembly","26-06-2024","10699",,,"24263","Cost of Goods Sold","Vim","X","-SPLIT-","",197.71,50964703.79
,"Invoice","28-06-2024","MC05870",,"Unilever Kenya Ltd:Vim","Vim Lemon Fresh 24x500g","Cost of Goods Sold","Vim",,"Accounts Receivable",393314.73,"",51358018.52
,"Invoice","28-06-2024","MC05871",,"Unilever Kenya Ltd:Vim","Vim Lemon Fresh 24x500g","Cost of Goods Sold","Vim",,"Accounts Receivable",39998.11,"",51398016.63
,"Invoice","28-06-2024","MC05872",,"Unilever Kenya Ltd:Vim","Vim Lemon Fresh 12x1Kg","Cost of Goods Sold","Vim",,"Accounts Receivable",363931.90,"",51761948.53
,"Invoice","02-07-2024","MC05875",,"Unilever Kenya Ltd:Vim","Vim Lavender Fresh 12x1Kg","Cost of Goods Sold","Vim",,"Accounts Receivable",381583.35,"",52143531.88
,"Invoice","02-07-2024","MC05877",,"Unilever Kenya Ltd:Vim","Vim Lavender Fresh 24x500g","Cost of Goods Sold","Vim",,"Accounts Receivable",304324.06,"",52447855.94
,"Invoice","02-07-2024","MC05878",,"Unilever Kenya Ltd:Vim","Vim Scourer Lmn 12X(1Kg+ Vim Lvr 1Kg)","Cost of Goods Sold","Vim",,"Accounts Receivable",117752.30,"",52565608.24
,"Credit Note","03-07-2024","CN01063",,"Unilever Kenya Ltd:Vim","Vim Lavender Fresh 24x500g","Cost of Goods Sold","Vim",,"Accounts Receivable","",304324.06,52261284.18
,"Invoice","03-07-2024","MC05879",,"Unilever Kenya Ltd:Vim","Vim Lemon Fresh 24x500g","Cost of Goods Sold","Vim",,"Accounts Receivable",300307.29,"",52561591.47
,"Invoice","04-07-2024","MC05887",,"Unilever Kenya Ltd:Vim","Vim Lemon Fresh Pouch 24x500g","Cost of Goods Sold","Vim",,"Accounts Receivable",92900.75,"",52654492.22
,"Invoice","04-07-2024","MC05888",,"Unilever Kenya Ltd:Vim","Vim Lemon Fresh 12x1Kg","Cost of Goods Sold","Vim",,"Accounts Receivable",152262.52,"",52806754.74
,"Invoice","04-07-2024","MC05889",,"Unilever Kenya Ltd:Vim","Vim Lavender Fresh 24x500g","Cost of Goods Sold","Vim",,"Accounts Receivable",108204.11,"",52914958.85
,"Invoice","05-07-2024","MC05891",,"Unilever Kenya Ltd:Vim","Vim Lemon Fresh 12x1Kg","Cost of Goods Sold","Vim",,"Accounts Receivable",151899.99,"",53066858.84
,"Invoice","05-07-2024","MC05892",,"Unilever Kenya Ltd:Vim","Vim Lavender Fresh 24x500g","Cost of Goods Sold","Vim",,"Accounts Receivable",202795.42,"",53269654.26
,"Invoice","05-07-2024","MC05894",,"Unilever Kenya Ltd:Vim","Vim Lemon Fresh Pouch 24x500g","Cost of Goods Sold","Vim",,"Accounts Receivable",120369.74,"",53390024.00
,"Invoice","05-07-2024","MC05895",,"Unilever Kenya Ltd:Vim","Vim Lemon Fresh 12x1Kg","Cost of Goods Sold","Vim",,"Accounts Receivable",202654.17,"",53592678.17
,"Invoice","05-07-2024","MC05896",,"Unilever Kenya Ltd:Vim","Vim Lavender Fresh 12x1Kg","Cost of Goods Sold","Vim",,"Accounts Receivable",137957.06,"",53730635.23
,"Invoice","05-07-2024","MC05897",,"Unilever Kenya Ltd:Vim","Vim Lemon Fresh 24x500g","Cost of Goods Sold","Vim",,"Accounts Receivable",312825.01,"",54043460.24
,"Invoice","05-07-2024","MC05898",,"Unilever Kenya Ltd:Vim","Vim Lavender Fresh 24x500g","Cost of Goods Sold","Vim",,"Accounts Receivable",211245.23,"",54254705.47
,"Invoice","08-07-2024","MC05899",,"Unilever Kenya Ltd:Vim","Vim Lemon Fresh 24x500g","Cost of Goods Sold","Vim",,"Accounts Receivable",120044.00,"",54374749.47
,"Invoice","08-07-2024","MC05900",,"Unilever Kenya Ltd:Vim","Vim Lavender Fresh 24x500g","Cost of Goods Sold","Vim",,"Accounts Receivable",141956.79,"",54516706.26
,"Invoice","09-07-2024","MC05903",,"Unilever Kenya Ltd:Vim","Vim Lemon Fresh 24x500g","Cost of Goods Sold","Vim",,"Accounts Receivable",260065.10,"",54776771.36
,"Invoice","09-07-2024","MC05904",,"Unilever Kenya Ltd:Vim","Vim Lemon Fresh Pouch 24x500g","Cost of Goods Sold","Vim",,"Accounts Receivable",25925.78,"",54802697.14
,"Invoice","09-07-2024","MC05907",,"Unilever Kenya Ltd:Vim","Vim Scourer Lmn 12X(1Kg+ Vim Lvr 1Kg)","Cost of Goods Sold","Vim",,"Accounts Receivable",54885.64,"",54857582.78
,"Invoice","09-07-2024","MC05908",,"Unilever Kenya Ltd:Vim","Vim Lemon Fresh 12x1Kg","Cost of Goods Sold","Vim",,"Accounts Receivable",408757.30,"",55266340.08
,"Invoice","09-07-2024","MC05909",,"Unilever Kenya Ltd:Vim","Vim Scourer Lmn 12X(1Kg+ Vim Lvr 1Kg)","Cost of Goods Sold","Vim",,"Accounts Receivable",61158.28,"",55327498.36
,"Invoice","12-07-2024","MC05911",,"Unilever Kenya Ltd:Vim","Vim Lemon Fresh Pouch 24x500g","Cost of Goods Sold","Vim",,"Accounts Receivable",94186.37,"",55421684.73
,"Invoice","12-07-2024","MC05912",,"Unilever Kenya Ltd:Vim","Vim Lavender Fresh 12x1Kg","Cost of Goods Sold","Vim",,"Accounts Receivable",308168.13,"",55729852.86
,"Invoice","12-07-2024","MC05914",,"Unilever Kenya Ltd:Vim","Vim Lemon Fresh 24x500g","Cost of Goods Sold","Vim",,"Accounts Receivable",99887.87,"",55829740.73
,"Invoice","12-07-2024","MC05915",,"Unilever Kenya Ltd:Vim","Vim Lemon Fresh 12x1Kg","Cost of Goods Sold","Vim",,"Accounts Receivable",126583.98,"",55956324.71
,"Invoice","12-07-2024","MC05916",,"Unilever Kenya Ltd:Vim","Vim Lavender Fresh 12x1Kg","Cost of Goods Sold","Vim",,"Accounts Receivable",77042.03,"",56033366.74
,"Invoice","12-07-2024","MC05919",,"Unilever Kenya Ltd:Vim","Vim Scourer Lmn 12X(1Kg+ Vim Lvr 1Kg)","Cost of Goods Sold","Vim",,"Accounts Receivable",82316.40,"",56115683.14
,"Invoice","15-07-2024","MC05925",,"Unilever Kenya Ltd:Vim","Vim Lavender Fresh 24x500g","Cost of Goods Sold","Vim",,"Accounts Receivable",58303.68,"",56173986.82
,"Invoice","15-07-2024","MC05930",,"Unilever Kenya Ltd:Vim","Vim Scourer Lmn 12X(1Kg+ Vim Lvr 1Kg)","Cost of Goods Sold","Vim",,"Accounts Receivable",73788.67,"",56247775.49
,"Build Assembly","15-07-2024","10844",,,"24291","Cost of Goods Sold","Vim","X","-SPLIT-","",142.01,56247633.48
,"Invoice","16-07-2024","MC05934",,"Unilever Kenya Ltd:Vim","Vim Lavender Fresh 24x500g","Cost of Goods Sold","Vim",,"Accounts Receivable",400373.99,"",56648007.47
,"Build Assembly","16-07-2024","10853",,,"24292","Cost of Goods Sold","Vim","X","-SPLIT-","",123.88,56647883.59
,"Invoice","17-07-2024","MC05935",,"Unilever Kenya Ltd:Vim","Vim Lemon Fresh 24x500g","Cost of Goods Sold","Vim",,"Accounts Receivable",233487.90,"",56881371.49
,"Invoice","17-07-2024","MC05936",,"Unilever Kenya Ltd:Vim","Vim Lemon Fresh 12x1Kg","Cost of Goods Sold","Vim",,"Accounts Receivable",101304.36,"",56982675.85
,"Invoice","17-07-2024","MC05937",,"Unilever Kenya Ltd:Vim","Vim Lavender Fresh 12x1Kg","Cost of Goods Sold","Vim",,"Accounts Receivable",93282.75,"",57075958.60
,"Invoice","17-07-2024","MC05943",,"Unilever Kenya Ltd:Vim","Vim Lemon Fresh 24x500g","Cost of Goods Sold","Vim",,"Accounts Receivable",219753.31,"",57295711.91
,"Invoice","17-07-2024","MC05944",,"Unilever Kenya Ltd:Vim","Vim Lemon Fresh Pouch 24x500g","Cost of Goods Sold","Vim",,"Accounts Receivable",74386.65,"",57370098.56
,"Invoice","17-07-2024","MC05945",,"Unilever Kenya Ltd:Vim","Vim Lemon Fresh 12x1Kg","Cost of Goods Sold","Vim",,"Accounts Receivable",115776.42,"",57485874.98
,"Invoice","18-07-2024","MC05948",,"Unilever Kenya Ltd:Vim","Vim Lemon Fresh 24x500g","Cost of Goods Sold","Vim",,"Accounts Receivable",353318.34,"",57839193.32
,"Invoice","18-07-2024","MC05949",,"Unilever Kenya Ltd:Vim","Vim Lemon Fresh Pouch 24x500g","Cost of Goods Sold","Vim",,"Accounts Receivable",38409.97,"",57877603.29
,"Invoice","18-07-2024","MC05950",,"Unilever Kenya Ltd:Vim","Vim Lemon Fresh 24x500g","Cost of Goods Sold","Vim",,"Accounts Receivable",159804.76,"",58037408.05
,"Invoice","18-07-2024","MC05951",,"Unilever Kenya Ltd:Vim","Vim Lemon Fresh Pouch 24x500g","Cost of Goods Sold","Vim",,"Accounts Receivable",42404.61,"",58079812.66
,"Invoice","18-07-2024","MC05952",,"Unilever Kenya Ltd:Vim","Vim Lemon Fresh 12x1Kg","Cost of Goods Sold","Vim",,"Accounts Receivable",215219.62,"",58295032.28
,"Build Assembly","18-07-2024","10877",,,"24294","Cost of Goods Sold","Vim","X","-SPLIT-","",6.87,58295025.41
,"Invoice","19-07-2024","MC05953",,"Unilever Kenya Ltd:Vim","Vim Lemon Fresh 24x500g","Cost of Goods Sold","Vim",,"Accounts Receivable",59923.03,"",58354948.44
,"Invoice","19-07-2024","MC05954",,"Unilever Kenya Ltd:Vim","Vim Lemon Fresh 12x1Kg","Cost of Goods Sold","Vim",,"Accounts Receivable",50639.91,"",58405588.35
,"Invoice","19-07-2024","MC05955",,"Unilever Kenya Ltd:Vim","Vim Lavender Fresh 24x500g","Cost of Goods Sold","Vim",,"Accounts Receivable",101058.26,"",58506646.61
,"Invoice","19-07-2024","MC05956",,"Unilever Kenya Ltd:Vim","Vim Lavender Fresh 12x1Kg","Cost of Goods Sold","Vim",,"Accounts Receivable",256070.28,"",58762716.89
,"Invoice","23-07-2024","MC05959",,"Unilever Kenya Ltd:Vim","Vim Lemon Fresh 24x500g","Cost of Goods Sold","Vim",,"Accounts Receivable",202656.37,"",58965373.26
,"Invoice","23-07-2024","MC05960",,"Unilever Kenya Ltd:Vim","Vim Lemon Fresh 12x1Kg","Cost of Goods Sold","Vim",,"Accounts Receivable",99109.54,"",59064482.80
,"Invoice","23-07-2024","MC05963",,"Unilever Kenya Ltd:Vim","Vim Lavender Fresh 24x500g","Cost of Goods Sold","Vim",,"Accounts Receivable",40423.30,"",59104906.10
,"Invoice","23-07-2024","MC05964",,"Unilever Kenya Ltd:Vim","Vim Lemon Fresh 24x500g","Cost of Goods Sold","Vim",,"Accounts Receivable",159794.75,"",59264700.85
,"Invoice","23-07-2024","MC05965",,"Unilever Kenya Ltd:Vim","Vim Lemon Fresh 12x1Kg","Cost of Goods Sold","Vim",,"Accounts Receivable",75959.86,"",59340660.71
,"Invoice","23-07-2024","MC05966",,"Unilever Kenya Ltd:Vim","Vim Lavender Fresh 24x500g","Cost of Goods Sold","Vim",,"Accounts Receivable",147797.70,"",59488458.41
,"Invoice","26-07-2024","MC05969",,"Unilever Kenya Ltd:Vim","Vim Lemon Fresh Pouch 24x500g","Cost of Goods Sold","Vim",,"Accounts Receivable",111010.83,"",59599469.24
,"Invoice","26-07-2024","MC05970",,"Unilever Kenya Ltd:Vim","Vim Lavender Fresh 12x1Kg","Cost of Goods Sold","Vim",,"Accounts Receivable",51214.06,"",59650683.30
,"Invoice","26-07-2024","MC05975",,"Unilever Kenya Ltd:Vim","Vim Scourer Lmn 12X(1Kg+ Vim Lvr 1Kg)","Cost of Goods Sold","Vim",,"Accounts Receivable",106569.85,"",59757253.15
,"Invoice","31-07-2024","MC05986",,"Unilever Kenya Ltd:Vim","Vim Lemon Fresh 24x500g","Cost of Goods Sold","Vim",,"Accounts Receivable",239697.40,"",59996950.55
,"Invoice","31-07-2024","MC05987",,"Unilever Kenya Ltd:Vim","Vim Lemon Fresh Pouch 24x500g","Cost of Goods Sold","Vim",,"Accounts Receivable",88681.12,"",60085631.67
,"Invoice","01-08-2024","MC05991",,"Unilever Kenya Ltd:Vim","Vim Lemon Fresh 24x500g","Cost of Goods Sold","Vim",,"Accounts Receivable",19974.78,"",60105606.45
,"Invoice","01-08-2024","MC05992",,"Unilever Kenya Ltd:Vim","Vim Lemon Fresh 12x1Kg","Cost of Goods Sold","Vim",,"Accounts Receivable",371489.93,"",60477096.38
,"Invoice","01-08-2024","MC05994",,"Unilever Kenya Ltd:Vim","Vim Lemon Fresh 24x500g","Cost of Goods Sold","Vim",,"Accounts Receivable",332080.77,"",60809177.15
,"Invoice","02-08-2024","MC05998",,"Unilever Kenya Ltd:Vim","Vim Lemon Fresh 24x500g","Cost of Goods Sold","Vim",,"Accounts Receivable",295439.51,"",61104616.66
,"Invoice","06-08-2024","MC06001",,"Unilever Kenya Ltd:Vim","Vim Lemon Fresh 24x500g","Cost of Goods Sold","Vim",,"Accounts Receivable",179739.54,"",61284356.20
,"Invoice","06-08-2024","MC06002",,"Unilever Kenya Ltd:Vim","Vim Lemon Fresh 12x1Kg","Cost of Goods Sold","Vim",,"Accounts Receivable",126459.16,"",61410815.36
,"Invoice","08-08-2024","MC06007",,"Unilever Kenya Ltd:Vim","Vim Lemon Fresh 12x1Kg","Cost of Goods Sold","Vim",,"Accounts Receivable",305760.39,"",61716575.75
,"Invoice","08-08-2024","MC06010",,"Unilever Kenya Ltd:Vim","Vim Scourer Lmn 12X(1Kg+ Vim Lvr 1Kg)","Cost of Goods Sold","Vim",,"Accounts Receivable",27426.23,"",61744001.98
,"Invoice","08-08-2024","MC06011",,"Unilever Kenya Ltd:Vim","Vim Lemon Fresh 24x500g","Cost of Goods Sold","Vim",,"Accounts Receivable",279586.21,"",62023588.19
,"Invoice","08-08-2024","MC06012",,"Unilever Kenya Ltd:Vim","Vim Lavender Fresh 24x500g","Cost of Goods Sold","Vim",,"Accounts Receivable",65278.72,"",62088866.91
,"Invoice","09-08-2024","MC06023",,"Unilever Kenya Ltd:Vim","Vim Lemon Fresh 24x500g","Cost of Goods Sold","Vim",,"Accounts Receivable",162964.35,"",62251831.26
,"Invoice","09-08-2024","MC06024",,"Unilever Kenya Ltd:Vim","Vim Lavender Fresh 12x1Kg","Cost of Goods Sold","Vim",,"Accounts Receivable",25498.88,"",62277330.14
,"Invoice","09-08-2024","MC06027",,"Unilever Kenya Ltd:Vim","Vim Scourer Lmn 12X(1Kg+ Vim Lvr 1Kg)","Cost of Goods Sold","Vim",,"Accounts Receivable",117540.98,"",62394871.12
,"Invoice","12-08-2024","MC06028",,"Unilever Kenya Ltd:Vim","Vim Lemon Fresh 24x500g","Cost of Goods Sold","Vim",,"Accounts Receivable",326724.60,"",62721595.72
,"Invoice","12-08-2024","MC06029",,"Unilever Kenya Ltd:Vim","Vim Lemon Fresh Pouch 24x500g","Cost of Goods Sold","Vim",,"Accounts Receivable",61462.99,"",62783058.71
,"Invoice","12-08-2024","MC06032",,"Unilever Kenya Ltd:Vim","Vim Lemon Fresh Pouch 24x500g","Cost of Goods Sold","Vim",,"Accounts Receivable",56545.95,"",62839604.66
,"Invoice","12-08-2024","MC06033",,"Unilever Kenya Ltd:Vim","Vim Lavender Fresh 12x1Kg","Cost of Goods Sold","Vim",,"Accounts Receivable",249524.72,"",63089129.38
,"Invoice","12-08-2024","MC06035",,"Unilever Kenya Ltd:Vim","Vim Lemon Fresh 12x1Kg","Cost of Goods Sold","Vim",,"Accounts Receivable",50658.53,"",63139787.91
,"Invoice","15-08-2024","MC06040",,"Unilever Kenya Ltd:Vim","Vim Lemon Fresh 24x500g","Cost of Goods Sold","Vim",,"Accounts Receivable",93528.03,"",63233315.94
,"Invoice","15-08-2024","MC06041",,"Unilever Kenya Ltd:Vim","Vim Lavender Fresh 24x500g","Cost of Goods Sold","Vim",,"Accounts Receivable",170988.13,"",63404304.07
,"Invoice","19-08-2024","MC06048",,"Unilever Kenya Ltd:Vim","Vim Lemon Fresh 24x500g","Cost of Goods Sold","Vim",,"Accounts Receivable",79810.59,"",63484114.66
,"Invoice","19-08-2024","MC06049",,"Unilever Kenya Ltd:Vim","Vim Lemon Fresh 12x1Kg","Cost of Goods Sold","Vim",,"Accounts Receivable",378778.75,"",63862893.41
,"Invoice","20-08-2024","MC06051",,"Unilever Kenya Ltd:Vim","Vim Lemon Fresh 12x1Kg","Cost of Goods Sold","Vim",,"Accounts Receivable",126552.69,"",63989446.10
,"Invoice","20-08-2024","MC06052",,"Unilever Kenya Ltd:Vim","Vim Lavender Fresh 24x500g","Cost of Goods Sold","Vim",,"Accounts Receivable",291859.04,"",64281305.14
,"Invoice","20-08-2024","MC06053",,"Unilever Kenya Ltd:Vim","Vim Lemon Fresh 24x500g","Cost of Goods Sold","Vim",,"Accounts Receivable",789792.29,"",65071097.43
,"Build Assembly","20-08-2024","11184",,,,"Cost of Goods Sold","Vim","X","-SPLIT-",3.43,"",65071100.86
,"Invoice","21-08-2024","MC06055",,"Unilever Kenya Ltd:Vim","Vim Lemon Fresh 24x500g","Cost of Goods Sold","Vim",,"Accounts Receivable",79810.59,"",65150911.45
,"Invoice","21-08-2024","MC06056",,"Unilever Kenya Ltd:Vim","Vim Lemon Fresh Pouch 24x500g","Cost of Goods Sold","Vim",,"Accounts Receivable",82192.01,"",65233103.46
,"Invoice","21-08-2024","MC06057",,"Unilever Kenya Ltd:Vim","Vim Lavender Fresh 12x1Kg","Cost of Goods Sold","Vim",,"Accounts Receivable",35364.10,"",65268467.56
,"Invoice","21-08-2024","MC06060",,"Unilever Kenya Ltd:Vim","Vim Scourer Lmn 12X(1Kg+ Vim Lvr 1Kg)","Cost of Goods Sold","Vim",,"Accounts Receivable",125046.21,"",65393513.77
,"Build Assembly","21-08-2024","11194",,,"24343","Cost of Goods Sold","Vim","X","-SPLIT-",137.95,"",65393651.72
,"Build Assembly","21-08-2024","11195",,,"24333","Cost of Goods Sold","Vim","X","-SPLIT-",18.06,"",65393669.78
,"Build Assembly","21-08-2024","11192",,,,"Cost of Goods Sold","Vim","X","-SPLIT-",64.54,"",65393734.32
,"Invoice","23-08-2024","MC06072",,"Unilever Kenya Ltd:Vim","Vim Lemon Fresh 24x500g","Cost of Goods Sold","Vim",,"Accounts Receivable",299643.77,"",65693378.09
,"Invoice","23-08-2024","MC06073",,"Unilever Kenya Ltd:Vim","Vim Lemon Fresh 12x1Kg","Cost of Goods Sold","Vim",,"Accounts Receivable",107089.12,"",65800467.21
,"Invoice","23-08-2024","MC06074",,"Unilever Kenya Ltd:Vim","Vim Lemon Fresh 24x500g","Cost of Goods Sold","Vim",,"Accounts Receivable",416171.90,"",66216639.11
,"Invoice","23-08-2024","MC06075",,"Unilever Kenya Ltd:Vim","Vim Lemon Fresh 24x500g","Cost of Goods Sold","Vim",,"Accounts Receivable",283413.06,"",66500052.17
,"Invoice","23-08-2024","MC06076",,"Unilever Kenya Ltd:Vim","Vim Lemon Fresh 12x1Kg","Cost of Goods Sold","Vim",,"Accounts Receivable",126625.65,"",66626677.82
,"Invoice","26-08-2024","MC06077",,"Unilever Kenya Ltd:Vim","Vim Lemon Fresh 24x500g","Cost of Goods Sold","Vim",,"Accounts Receivable",79905.00,"",66706582.82
,"Invoice","26-08-2024","MC06078",,"Unilever Kenya Ltd:Vim","Vim Lemon Fresh 12x1Kg","Cost of Goods Sold","Vim",,"Accounts Receivable",202601.03,"",66909183.85
,"Invoice","26-08-2024","MC06079",,"Unilever Kenya Ltd:Vim","Vim Lavender Fresh 12x1Kg","Cost of Goods Sold","Vim",,"Accounts Receivable",178099.78,"",67087283.63
,"Invoice","26-08-2024","MC06083",,"Unilever Kenya Ltd:Vim","Vim Lemon Fresh 24x500g","Cost of Goods Sold","Vim",,"Accounts Receivable",106540.01,"",67193823.64
,"Invoice","26-08-2024","MC06084",,"Unilever Kenya Ltd:Vim","Vim Lemon Fresh 12x1Kg","Cost of Goods Sold","Vim",,"Accounts Receivable",126625.65,"",67320449.29
,"Invoice","26-08-2024","MC06085",,"Unilever Kenya Ltd:Vim","Vim Lavender Fresh 24x500g","Cost of Goods Sold","Vim",,"Accounts Receivable",80861.38,"",67401310.67
,"Invoice","26-08-2024","MC06086",,"Unilever Kenya Ltd:Vim","Vim Lavender Fresh 12x1Kg","Cost of Goods Sold","Vim",,"Accounts Receivable",92684.58,"",67493995.25
,"Build Assembly","26-08-2024","11240",,,"24351","Cost of Goods Sold","Vim","X","-SPLIT-","",159.57,67493835.68
,"Invoice","27-08-2024","MC06088",,"Unilever Kenya Ltd:Vim","Vim Lemon Fresh 24x500g","Cost of Goods Sold","Vim",,"Accounts Receivable",79777.35,"",67573613.03
,"Invoice","27-08-2024","MC06089",,"Unilever Kenya Ltd:Vim","Vim Lemon Fresh Pouch 24x500g","Cost of Goods Sold","Vim",,"Accounts Receivable",20895.82,"",67594508.85
,"Invoice","27-08-2024","MC06090",,"Unilever Kenya Ltd:Vim","Vim Lemon Fresh 12x1Kg","Cost of Goods Sold","Vim",,"Accounts Receivable",138202.85,"",67732711.70
,"Invoice","27-08-2024","MC06091",,"Unilever Kenya Ltd:Vim","Vim Lavender Fresh 24x500g","Cost of Goods Sold","Vim",,"Accounts Receivable",101076.72,"",67833788.42
,"Build Assembly","27-08-2024","11251",,,"24352","Cost of Goods Sold","Vim","X","-SPLIT-","",618.82,67833169.60
,"Invoice","28-08-2024","MC06093",,"Unilever Kenya Ltd:Vim","Vim Lemon Fresh 24x500g","Cost of Goods Sold","Vim",,"Accounts Receivable",789381.62,"",68622551.22
,"Build Assembly","28-08-2024","11256",,,"24353","Cost of Goods Sold","Vim","X","-SPLIT-",272.80,"",68622824.02
,"Invoice","29-08-2024","MC06094",,"Unilever Kenya Ltd:Vim","Vim Lemon Fresh 24x500g","Cost of Goods Sold","Vim",,"Accounts Receivable",231117.95,"",68853941.97
,"Invoice","29-08-2024","MC06095",,"Unilever Kenya Ltd:Vim","Vim Lavender Fresh 24x500g","Cost of Goods Sold","Vim",,"Accounts Receivable",80366.32,"",68934308.29
,"Invoice","29-08-2024","MC06096",,"Unilever Kenya Ltd:Vim","Vim Lavender Fresh 12x1Kg","Cost of Goods Sold","Vim",,"Accounts Receivable",101771.30,"",69036079.59
,"Invoice","29-08-2024","MC06099",,"Unilever Kenya Ltd:Vim","Vim Lemon Fresh 24x500g","Cost of Goods Sold","Vim",,"Accounts Receivable",299289.43,"",69335369.02
,"Invoice","29-08-2024","MC06100",,"Unilever Kenya Ltd:Vim","Vim Lemon Fresh 12x1Kg","Cost of Goods Sold","Vim",,"Accounts Receivable",101300.52,"",69436669.54
,"Build Assembly","29-08-2024","11268",,,"24354","Cost of Goods Sold","Vim","X","-SPLIT-",897.74,"",69437567.28
,"Invoice","30-08-2024","MC06102",,"Unilever Kenya Ltd:Vim","Vim Lemon Fresh Pouch 24x500g","Cost of Goods Sold","Vim",,"Accounts Receivable",97926.49,"",69535493.77
,"Invoice","30-08-2024","MC06103",,"Unilever Kenya Ltd:Vim","Vim Lavender Fresh 12x1Kg","Cost of Goods Sold","Vim",,"Accounts Receivable",201725.26,"",69737219.03
,"Invoice","04-09-2024","MC06113",,"Unilever Kenya Ltd:Vim","Vim Lemon Fresh 12x1Kg","Cost of Goods Sold","Vim",,"Accounts Receivable",317669.74,"",70054888.77
,"Invoice","04-09-2024","MC06114",,"Unilever Kenya Ltd:Vim","Vim Lavender Fresh 24x500g","Cost of Goods Sold","Vim",,"Accounts Receivable",80366.32,"",70135255.09
,"Invoice","04-09-2024","MC06115",,"Unilever Kenya Ltd:Vim","Vim Scourer Lmn 12X(1Kg+ Vim Lvr 1Kg)","Cost of Goods Sold","Vim",,"Accounts Receivable",62475.44,"",70197730.53
,"Invoice","04-09-2024","MC06117",,"Unilever Kenya Ltd:Vim","Vim Lemon Fresh 24x500g","Cost of Goods Sold","Vim",,"Accounts Receivable",41560.51,"",70239291.04
,"Invoice","04-09-2024","MC06118",,"Unilever Kenya Ltd:Vim","Vim Lemon Fresh 12x1Kg","Cost of Goods Sold","Vim",,"Accounts Receivable",72362.13,"",70311653.17
,"Invoice","05-09-2024","MC06124",,"Unilever Kenya Ltd:Vim","Vim Lemon Fresh 24x500g","Cost of Goods Sold","Vim",,"Accounts Receivable",498761.68,"",70810414.85
,"Invoice","05-09-2024","MC06125",,"Unilever Kenya Ltd:Vim","Vim Lemon Fresh 12x1Kg","Cost of Goods Sold","Vim",,"Accounts Receivable",289321.89,"",71099736.74
,"Invoice","06-09-2024","MC06126",,"Unilever Kenya Ltd:Vim","Vim Lemon Fresh Pouch 24x500g","Cost of Goods Sold","Vim",,"Accounts Receivable",127024.78,"",71226761.52
,"Invoice","06-09-2024","MC06127",,"Unilever Kenya Ltd:Vim","Vim Lavender Fresh 12x1Kg","Cost of Goods Sold","Vim",,"Accounts Receivable",51068.35,"",71277829.87
,"Invoice","06-09-2024","MC06129",,"Unilever Kenya Ltd:Vim","Vim Scourer Lmn 12X(1Kg+ Vim Lvr 1Kg)","Cost of Goods Sold","Vim",,"Accounts Receivable",171026.50,"",71448856.37
,"Invoice","09-09-2024","MC06130",,"Unilever Kenya Ltd:Vim","Vim Lemon Fresh 24x500g","Cost of Goods Sold","Vim",,"Accounts Receivable",623469.66,"",72072326.03
,"Invoice","09-09-2024","MC06131",,"Unilever Kenya Ltd:Vim","Vim Lemon Fresh 12x1Kg","Cost of Goods Sold","Vim",,"Accounts Receivable",144660.94,"",72216986.97
,"Build Assembly","09-09-2024","11375",,,"24371","Cost of Goods Sold","Vim","X","-SPLIT-","",236.14,72216750.83
,"Invoice","10-09-2024","MC06132",,"Unilever Kenya Ltd:Vim","Vim Lemon Fresh 12x1Kg","Cost of Goods Sold","Vim",,"Accounts Receivable",177209.66,"",72393960.49
,"Invoice","10-09-2024","MC06133",,"Unilever Kenya Ltd:Vim","Vim Lavender Fresh 12x1Kg","Cost of Goods Sold","Vim",,"Accounts Receivable",280875.95,"",72674836.44
,"Invoice","11-09-2024","MC06138",,"Unilever Kenya Ltd:Vim","Vim Lemon Fresh 12x1Kg","Cost of Goods Sold","Vim",,"Accounts Receivable",123554.16,"",72798390.60
,"Invoice","11-09-2024","MC06139",,"Unilever Kenya Ltd:Vim","Vim Lavender Fresh 24x500g","Cost of Goods Sold","Vim",,"Accounts Receivable",160732.64,"",72959123.24
,"Invoice","12-09-2024","MC06148",,"Unilever Kenya Ltd:Vim","Vim Lemon Fresh 24x500g","Cost of Goods Sold","Vim",,"Accounts Receivable",398444.80,"",73357568.04
,"Build Assembly","12-09-2024","11407",,,"24374","Cost of Goods Sold","Vim","X","-SPLIT-",582.73,"",73358150.77
,"Invoice","13-09-2024","MC06150",,"Unilever Kenya Ltd:Vim","Vim Lemon Fresh 12x1Kg","Cost of Goods Sold","Vim",,"Accounts Receivable",212065.17,"",73570215.94
,"Invoice","13-09-2024","MC06151",,"Unilever Kenya Ltd:Vim","Vim Lavender Fresh 12x1Kg","Cost of Goods Sold","Vim",,"Accounts Receivable",127452.13,"",73697668.07
,"Invoice","16-09-2024","MC06154",,"Unilever Kenya Ltd:Vim","Vim Lemon Fresh 24x500g","Cost of Goods Sold","Vim",,"Accounts Receivable",205279.88,"",73902947.95
,"Invoice","16-09-2024","MC06155",,"Unilever Kenya Ltd:Vim","Vim Lavender Fresh 24x500g","Cost of Goods Sold","Vim",,"Accounts Receivable",181010.92,"",74083958.87
,"Credit Note","17-09-2024","CN01068",,"Unilever Kenya Ltd:Vim","Vim Lavender Fresh 24x500g","Cost of Goods Sold","Vim",,"Accounts Receivable","",181010.92,73902947.95
,"Invoice","17-09-2024","MC06156",,"Unilever Kenya Ltd:Vim","Vim Lavender Fresh 24x500g","Cost of Goods Sold","Vim",,"Accounts Receivable",164250.65,"",74067198.60
,"Invoice","17-09-2024","MC06157",,"Unilever Kenya Ltd:Vim","Vim Lemon Fresh 24x500g","Cost of Goods Sold","Vim",,"Accounts Receivable",199866.82,"",74267065.42
,"Invoice","17-09-2024","MC06158",,"Unilever Kenya Ltd:Vim","Vim Lemon Fresh Pouch 24x500g","Cost of Goods Sold","Vim",,"Accounts Receivable",48744.88,"",74315810.30
,"Invoice","17-09-2024","MC06159",,"Unilever Kenya Ltd:Vim","Vim Lavender Fresh 24x500g","Cost of Goods Sold","Vim",,"Accounts Receivable",100561.62,"",74416371.92
,"Invoice","19-09-2024","MC06167",,"Unilever Kenya Ltd:Vim","Vim Lemon Fresh Pouch 24x500g","Cost of Goods Sold","Vim",,"Accounts Receivable",78078.18,"",74494450.10
,"Invoice","19-09-2024","MC06168",,"Unilever Kenya Ltd:Vim","Vim Lemon Fresh 12x1Kg","Cost of Goods Sold","Vim",,"Accounts Receivable",177252.13,"",74671702.23
,"Invoice","19-09-2024","MC06169",,"Unilever Kenya Ltd:Vim","Vim Lavender Fresh 12x1Kg","Cost of Goods Sold","Vim",,"Accounts Receivable",119440.85,"",74791143.08
,"Invoice","19-09-2024","MC06172",,"Unilever Kenya Ltd:Plastics","Vim Powder Canister 500g","Cost of Goods Sold","Vim",,"Accounts Receivable",113856.07,"",74904999.15
,"Invoice","20-09-2024","MC06173",,"Unilever Kenya Ltd:Vim","Vim Lemon Fresh 24x500g","Cost of Goods Sold","Vim",,"Accounts Receivable",187763.87,"",75092763.02
,"Invoice","20-09-2024","MC06174",,"Unilever Kenya Ltd:Vim","Vim Lavender Fresh 24x500g","Cost of Goods Sold","Vim",,"Accounts Receivable",120862.95,"",75213625.97
,"Invoice","20-09-2024","MC06176",,"Unilever Kenya Ltd:Vim","Vim Scourer Lmn 12X(1Kg+ Vim Lvr 1Kg)","Cost of Goods Sold","Vim",,"Accounts Receivable",54679.41,"",75268305.38
,"Invoice","20-09-2024","MC06177",,"Unilever Kenya Ltd:Plastics","Vim Powder Canister 500g","Cost of Goods Sold","Vim",,"Accounts Receivable",115530.43,"",75383835.81
,"Invoice","21-09-2024","MC06180",,"Unilever Kenya Ltd:Vim","Vim Lemon Fresh 24x500g","Cost of Goods Sold","Vim",,"Accounts Receivable",239804.85,"",75623640.66
,"Invoice","23-09-2024","MC06182",,"Unilever Kenya Ltd:Vim","Vim Lemon Fresh 24x500g","Cost of Goods Sold","Vim",,"Accounts Receivable",199837.38,"",75823478.04
,"Invoice","23-09-2024","MC06183",,"Unilever Kenya Ltd:Vim","Vim Lemon Fresh 12x1Kg","Cost of Goods Sold","Vim",,"Accounts Receivable",251139.51,"",76074617.55
,"Invoice","23-09-2024","MC06184",,"Unilever Kenya Ltd:Vim","Vim Lemon Fresh 24x500g","Cost of Goods Sold","Vim",,"Accounts Receivable",59951.21,"",76134568.76
,"Invoice","23-09-2024","MC06185",,"Unilever Kenya Ltd:Vim","Vim Lavender Fresh 24x500g","Cost of Goods Sold","Vim",,"Accounts Receivable",183392.74,"",76317961.50
,"Invoice","23-09-2024","MC06186",,"Unilever Kenya Ltd:Vim","Vim Lavender Fresh 12x1Kg","Cost of Goods Sold","Vim",,"Accounts Receivable",127452.13,"",76445413.63
,"Invoice","23-09-2024","MC06187",,"Unilever Kenya Ltd:Vim","Vim Scourer Lmn 12X(1Kg+ Vim Lvr 1Kg)","Cost of Goods Sold","Vim",,"Accounts Receivable",54679.41,"",76500093.04
,"Invoice","24-09-2024","MC06190",,"Unilever Kenya Ltd:Vim","Vim Lemon Fresh 12x1Kg","Cost of Goods Sold","Vim",,"Accounts Receivable",285567.01,"",76785660.05
,"Invoice","25-09-2024","MC06200",,"Unilever Kenya Ltd:Vim","Vim Lemon Fresh 24x500g","Cost of Goods Sold","Vim",,"Accounts Receivable",288098.89,"",77073758.94
,"Invoice","25-09-2024","MC06201",,"Unilever Kenya Ltd:Vim","Vim Lemon Fresh 12x1Kg","Cost of Goods Sold","Vim",,"Accounts Receivable",50771.60,"",77124530.54
,"Invoice","25-09-2024","MC06202",,"Unilever Kenya Ltd:Vim","Vim Lavender Fresh 12x1Kg","Cost of Goods Sold","Vim",,"Accounts Receivable",72465.64,"",77196996.18
,"Build Assembly","25-09-2024","11539",,,"24393","Cost of Goods Sold","Vim","X","-SPLIT-",131.66,"",77197127.84
,"Invoice","26-09-2024","MC06203",,"Unilever Kenya Ltd:Vim","Vim Lemon Fresh 24x500g","Cost of Goods Sold","Vim",,"Accounts Receivable",351573.63,"",77548701.47
,"Invoice","26-09-2024","MC06204",,"Unilever Kenya Ltd:Vim","Vim Lemon Fresh Pouch 24x500g","Cost of Goods Sold","Vim",,"Accounts Receivable",44360.16,"",77593061.63
,"Build Assembly","26-09-2024","11547",,,"24394","Cost of Goods Sold","Vim","X","-SPLIT-","",29.95,77593031.68
,"Invoice","27-09-2024","MC06207",,"Unilever Kenya Ltd:Vim","Vim Lemon Fresh Pouch 24x500g","Cost of Goods Sold","Vim",,"Accounts Receivable",48056.84,"",77641088.52
,"Invoice","27-09-2024","MC06208",,"Unilever Kenya Ltd:Vim","Vim Lemon Fresh 12x1Kg","Cost of Goods Sold","Vim",,"Accounts Receivable",297389.90,"",77938478.42
,"Invoice","27-09-2024","MC06209",,"Unilever Kenya Ltd:Vim","Vim Lavender Fresh 12x1Kg","Cost of Goods Sold","Vim",,"Accounts Receivable",25490.43,"",77963968.85
,"Invoice","27-09-2024","MC06212",,"Unilever Kenya Ltd:Vim","Vim Lemon Fresh 24x500g","Cost of Goods Sold","Vim",,"Accounts Receivable",199647.56,"",78163616.41
,"Invoice","27-09-2024","MC06213",,"Unilever Kenya Ltd:Vim","Vim Lavender Fresh 24x500g","Cost of Goods Sold","Vim",,"Accounts Receivable",100727.33,"",78264343.74
,"Invoice","27-09-2024","MC06214",,"Unilever Kenya Ltd:Vim","Vim Lavender Fresh 12x1Kg","Cost of Goods Sold","Vim",,"Accounts Receivable",101961.70,"",78366305.44
,"Build Assembly","27-09-2024","11556",,,"24395","Cost of Goods Sold","Vim","X","-SPLIT-",151.27,"",78366456.71
,"Invoice","30-09-2024","MC06219",,"Unilever Kenya Ltd:Vim","Vim Lemon Fresh 12x1Kg","Cost of Goods Sold","Vim",,"Accounts Receivable",380761.28,"",78747217.99
,"Invoice","30-09-2024","MC06220",,"Unilever Kenya Ltd:Vim","Vim Lavender Fresh 12x1Kg","Cost of Goods Sold","Vim",,"Accounts Receivable",102114.60,"",78849332.59
,"Invoice","30-09-2024","MC06221",,"Unilever Kenya Ltd:Vim","Vim Scourer Lmn 12X(1Kg+ Vim Lvr 1Kg)","Cost of Goods Sold","Vim",,"Accounts Receivable",7839.29,"",78857171.88
,"Invoice","30-09-2024","MC06222",,"Unilever Kenya Ltd:Vim","Vim Lemon Fresh 24x500g","Cost of Goods Sold","Vim",,"Accounts Receivable",374339.18,"",79231511.06
,"Invoice","30-09-2024","MC06223",,"Unilever Kenya Ltd:Vim","Vim Scourer Lmn 12X(1Kg+ Vim Lvr 1Kg)","Cost of Goods Sold","Vim",,"Accounts Receivable",27437.51,"",79258948.57
,"Invoice","03-10-2024","MC06225",,"Unilever Kenya Ltd:Vim","Vim Lemon Fresh Pouch 24x500g","Cost of Goods Sold","Vim",,"Accounts Receivable",132989.84,"",79391938.41
,"Invoice","03-10-2024","MC06227",,"Unilever Kenya Ltd:Vim","Vim Lavender Fresh 24x500g","Cost of Goods Sold","Vim",,"Accounts Receivable",69260.51,"",79461198.92
,"Invoice","03-10-2024","MC06229",,"Unilever Kenya Ltd:Vim","Vim Scourer Lmn 12X(1Kg+ Vim Lvr 1Kg)","Cost of Goods Sold","Vim",,"Accounts Receivable",62714.31,"",79523913.23
,"Invoice","03-10-2024","MC06230",,"Unilever Kenya Ltd:Vim","Vim Lemon Fresh 24x500g","Cost of Goods Sold","Vim",,"Accounts Receivable",186301.77,"",79710215.00
,"Invoice","03-10-2024","MC06232",,"Unilever Kenya Ltd:Vim","Vim Lavender Fresh 24x500g","Cost of Goods Sold","Vim",,"Accounts Receivable",80594.04,"",79790809.04
,"Invoice","03-10-2024","MC06233",,"Unilever Kenya Ltd:Vim","Vim Lavender Fresh 12x1Kg","Cost of Goods Sold","Vim",,"Accounts Receivable",76621.78,"",79867430.82
,"Invoice","04-10-2024","MC06235",,"Unilever Kenya Ltd:Vim","Vim Lemon Fresh 24x500g","Cost of Goods Sold","Vim",,"Accounts Receivable",398328.96,"",80265759.78
,"Build Assembly","04-10-2024","11619",,,"24405","Cost of Goods Sold","Vim","X","-SPLIT-",1446.09,"",80267205.87
,"Invoice","07-10-2024","MC06236",,"Unilever Kenya Ltd:Vim","Vim Lemon Fresh 24x500g","Cost of Goods Sold","Vim",,"Accounts Receivable",392697.16,"",80659903.03
,"Build Assembly","07-10-2024","11633",,,"24411","Cost of Goods Sold","Vim","X","-SPLIT-","",77.50,80659825.53
,"Invoice","08-10-2024","MC06239",,"Unilever Kenya Ltd:Vim","Vim Lemon Fresh 24x500g","Cost of Goods Sold","Vim",,"Accounts Receivable",387189.66,"",81047015.19
,"Build Assembly","08-10-2024","11646",,,"24412","Cost of Goods Sold","Vim","X","-SPLIT-",47.97,"",81047063.16
,"Invoice","09-10-2024","MC06244",,"Unilever Kenya Ltd:Vim","Vim Lavender Fresh 24x500g","Cost of Goods Sold","Vim",,"Accounts Receivable",213658.17,"",81260721.33
,"Invoice","09-10-2024","MC06245",,"Unilever Kenya Ltd:Vim","Vim Lemon Fresh 12x1Kg","Cost of Goods Sold","Vim",,"Accounts Receivable",175070.06,"",81435791.39
,"Invoice","09-10-2024","MC06247",,"Unilever Kenya Ltd:Vim","Vim Lemon Fresh 12x1Kg","Cost of Goods Sold","Vim",,"Accounts Receivable",126600.25,"",81562391.64
,"Invoice","09-10-2024","MC06248",,"Unilever Kenya Ltd:Vim","Vim Lavender Fresh 12x1Kg","Cost of Goods Sold","Vim",,"Accounts Receivable",254311.32,"",81816702.96
,"Invoice","09-10-2024","MC06250",,"Unilever Kenya Ltd:Vim","Vim Scourer Lmn 12X(1Kg+ Vim Lvr 1Kg)","Cost of Goods Sold","Vim",,"Accounts Receivable",109799.26,"",81926502.22
,"Invoice","11-10-2024","MC06252",,"Unilever Kenya Ltd:Vim","Vim Lemon Fresh 24x500g","Cost of Goods Sold","Vim",,"Accounts Receivable",625249.17,"",82551751.39
,"Invoice","14-10-2024","MC06253",,"Unilever Kenya Ltd:Vim","Vim Lemon Fresh 12x1Kg","Cost of Goods Sold","Vim",,"Accounts Receivable",218350.80,"",82770102.19
,"Invoice","14-10-2024","MC06254",,"Unilever Kenya Ltd:Vim","Vim Lavender Fresh 24x500g","Cost of Goods Sold","Vim",,"Accounts Receivable",120891.07,"",82890993.26
,"Invoice","14-10-2024","MC06257",,"Unilever Kenya Ltd:Vim","Vim Lemon Fresh Pouch 24x500g","Cost of Goods Sold","Vim",,"Accounts Receivable",79323.91,"",82970317.17
,"Invoice","14-10-2024","MC06258",,"Unilever Kenya Ltd:Vim","Vim Lemon Fresh 12x1Kg","Cost of Goods Sold","Vim",,"Accounts Receivable",25645.23,"",82995962.40
,"Invoice","14-10-2024","MC06259",,"Unilever Kenya Ltd:Vim","Vim Lavender Fresh 24x500g","Cost of Goods Sold","Vim",,"Accounts Receivable",282079.16,"",83278041.56
,"Build Assembly","14-10-2024","11687",,,"24421","Cost of Goods Sold","Vim","X","-SPLIT-",46.73,"",83278088.29
,"Invoice","15-10-2024","MC06260",,"Unilever Kenya Ltd:Vim","Vim Lemon Fresh 12x1Kg","Cost of Goods Sold","Vim",,"Accounts Receivable",174374.29,"",83452462.58
,"Invoice","15-10-2024","MC06261",,"Unilever Kenya Ltd:Vim","Vim Lavender Fresh 24x500g","Cost of Goods Sold","Vim",,"Accounts Receivable",85641.11,"",83538103.69
,"Invoice","15-10-2024","MC06262",,"Unilever Kenya Ltd:Vim","Vim Lavender Fresh 12x1Kg","Cost of Goods Sold","Vim",,"Accounts Receivable",199160.66,"",83737264.35
,"Build Assembly","15-10-2024","11693",,,"24422","Cost of Goods Sold","Vim","X","-SPLIT-",70.63,"",83737334.98
,"Invoice","16-10-2024","MC06263",,"Unilever Kenya Ltd:Vim","Vim Lemon Fresh 24x500g","Cost of Goods Sold","Vim",,"Accounts Receivable",100414.96,"",83837749.94
,"Invoice","16-10-2024","MC06264",,"Unilever Kenya Ltd:Vim","Vim Lemon Fresh Pouch 24x500g","Cost of Goods Sold","Vim",,"Accounts Receivable",98845.03,"",83936594.97
,"Invoice","16-10-2024","MC06265",,"Unilever Kenya Ltd:Vim","Vim Lemon Fresh 12x1Kg","Cost of Goods Sold","Vim",,"Accounts Receivable",175845.80,"",84112440.77
,"Invoice","17-10-2024","MC06270",,"Unilever Kenya Ltd:Vim","Vim Lemon Fresh 24x500g","Cost of Goods Sold","Vim",,"Accounts Receivable",102022.75,"",84214463.52
,"Invoice","17-10-2024","MC06271",,"Unilever Kenya Ltd:Vim","Vim Lemon Fresh Pouch 24x500g","Cost of Goods Sold","Vim",,"Accounts Receivable",75295.74,"",84289759.26
,"Invoice","17-10-2024","MC06274",,"Unilever Kenya Ltd:Vim","Vim Scourer Lmn 12X(1Kg+ Vim Lvr 1Kg)","Cost of Goods Sold","Vim",,"Accounts Receivable",91222.85,"",84380982.11
,"Invoice","17-10-2024","MC06275",,"Unilever Kenya Ltd:Vim","Vim Lavender Fresh 24x500g","Cost of Goods Sold","Vim",,"Accounts Receivable",181357.65,"",84562339.76
,"Invoice","17-10-2024","MC06276",,"Unilever Kenya Ltd:Vim","Vim Lavender Fresh 12x1Kg","Cost of Goods Sold","Vim",,"Accounts Receivable",272628.80,"",84834968.56
,"Build Assembly","17-10-2024","11718",,,"24424","Cost of Goods Sold","Vim","X","-SPLIT-",467.66,"",84835436.22
,"Invoice","18-10-2024","MC06277",,"Unilever Kenya Ltd:Vim","Vim Lemon Fresh 24x500g","Cost of Goods Sold","Vim",,"Accounts Receivable",265259.16,"",85100695.38
,"Invoice","18-10-2024","MC06278",,"Unilever Kenya Ltd:Vim","Vim Lavender Fresh 24x500g","Cost of Goods Sold","Vim",,"Accounts Receivable",140157.84,"",85240853.22
,"Invoice","18-10-2024","MC06279",,"Unilever Kenya Ltd:Vim","Vim Lemon Fresh 24x500g","Cost of Goods Sold","Vim",,"Accounts Receivable",765170.66,"",86006023.88
,"Invoice","18-10-2024","MC06280",,"Unilever Kenya Ltd:Vim","Vim Lemon Fresh 24x500g","Cost of Goods Sold","Vim",,"Accounts Receivable",40384.01,"",86046407.89
,"Invoice","18-10-2024","MC06281",,"Unilever Kenya Ltd:Vim","Vim Lemon Fresh Pouch 24x500g","Cost of Goods Sold","Vim",,"Accounts Receivable",62901.38,"",86109309.27
,"Invoice","18-10-2024","MC06282",,"Unilever Kenya Ltd:Vim","Vim Lemon Fresh 12x1Kg","Cost of Goods Sold","Vim",,"Accounts Receivable",212265.75,"",86321575.02
,"Build Assembly","18-10-2024","11726",,,"24425","Cost of Goods Sold","Vim","X","-SPLIT-",0.02,"",86321575.04
,"Invoice","22-10-2024","MC06285",,"Unilever Kenya Ltd:Vim","Vim Lemon Fresh 24x500g","Cost of Goods Sold","Vim",,"Accounts Receivable",265259.16,"",86586834.20
,"Invoice","22-10-2024","MC06288",,"Unilever Kenya Ltd:Vim","Vim Scourer Lmn 12X(1Kg+ Vim Lvr 1Kg)","Cost of Goods Sold","Vim",,"Accounts Receivable",92016.09,"",86678850.29
,"Build Assembly","22-10-2024","11740",,,"24432","Cost of Goods Sold","Vim","X","-SPLIT-",5659.69,"",86684509.98
,"Invoice","24-10-2024","MC06291",,"Unilever Kenya Ltd:Vim","Vim Lemon Fresh 24x500g","Cost of Goods Sold","Vim",,"Accounts Receivable",343214.66,"",87027724.64
,"Invoice","24-10-2024","MC06292",,"Unilever Kenya Ltd:Vim","Vim Lemon Fresh 12x1Kg","Cost of Goods Sold","Vim",,"Accounts Receivable",80031.59,"",87107756.23
,"Invoice","24-10-2024","MC06293",,"Unilever Kenya Ltd:Vim","Vim Lemon Fresh 12x1Kg","Cost of Goods Sold","Vim",,"Accounts Receivable",371956.33,"",87479712.56
,"Build Assembly","24-10-2024","11753",,,"24434","Cost of Goods Sold","Vim","X","-SPLIT-",540.61,"",87480253.17
,"Invoice","25-10-2024","MC06295",,"Unilever Kenya Ltd:Vim","Vim Lemon Fresh 12x1Kg","Cost of Goods Sold","Vim",,"Accounts Receivable",160333.80,"",87640586.97
,"Invoice","25-10-2024","MC06296",,"Unilever Kenya Ltd:Vim","Vim Lavender Fresh 24x500g","Cost of Goods Sold","Vim",,"Accounts Receivable",37880.52,"",87678467.49
,"Invoice","25-10-2024","MC06297",,"Unilever Kenya Ltd:Vim","Vim Lavender Fresh 12x1Kg","Cost of Goods Sold","Vim",,"Accounts Receivable",229927.90,"",87908395.39
,"Invoice","25-10-2024","MC06301",,"Unilever Kenya Ltd:Vim","Vim Lemon Fresh 24x500g","Cost of Goods Sold","Vim",,"Accounts Receivable",20853.55,"",87929248.94
,"Invoice","25-10-2024","MC06304",,"Unilever Kenya Ltd:Vim","Vim Lavender Fresh 24x500g","Cost of Goods Sold","Vim",,"Accounts Receivable",305990.43,"",88235239.37
,"Build Assembly","25-10-2024","11769",,,"24435","Cost of Goods Sold","Vim","X","-SPLIT-",298.17,"",88235537.54
,"Build Assembly","25-10-2024","11770",,,"24435","Cost of Goods Sold","Vim","X","-SPLIT-",442.01,"",88235979.55
,"Invoice","28-10-2024","MC06305",,"Unilever Kenya Ltd:Vim","Vim Lemon Fresh 24x500g","Cost of Goods Sold","Vim",,"Accounts Receivable",417070.98,"",88653050.53
,"Invoice","29-10-2024","MC06314",,"Unilever Kenya Ltd:Vim","Vim Lemon Fresh Pouch 24x500g","Cost of Goods Sold","Vim",,"Accounts Receivable",109945.49,"",88762996.02
,"Invoice","29-10-2024","MC06315",,"Unilever Kenya Ltd:Vim","Vim Lavender Fresh 24x500g","Cost of Goods Sold","Vim",,"Accounts Receivable",52642.04,"",88815638.06
,"Invoice","30-10-2024","MC06319",,"Unilever Kenya Ltd:Vim","Vim Lemon Fresh 24x500g","Cost of Goods Sold","Vim",,"Accounts Receivable",227762.06,"",89043400.12
,"Invoice","30-10-2024","MC06320",,"Unilever Kenya Ltd:Vim","Vim Lemon Fresh 12x1Kg","Cost of Goods Sold","Vim",,"Accounts Receivable",112997.15,"",89156397.27
,"Invoice","30-10-2024","MC06321",,"Unilever Kenya Ltd:Vim","Vim Scourer Lmn 12X(1Kg+ Vim Lvr 1Kg)","Cost of Goods Sold","Vim",,"Accounts Receivable",91222.85,"",89247620.12
,"Invoice","30-10-2024","MC06323",,"Unilever Kenya Ltd:Vim","Vim Lemon Fresh 24x500g","Cost of Goods Sold","Vim",,"Accounts Receivable",433832.49,"",89681452.61
,"Invoice","31-10-2024","MC06325",,"Unilever Kenya Ltd:Vim","Vim Lemon Fresh 24x500g","Cost of Goods Sold","Vim",,"Accounts Receivable",313081.51,"",89994534.12
,"Invoice","04-11-2024","MC06327",,"Unilever Kenya Ltd:Vim","Vim Lemon Fresh 12x1Kg","Cost of Goods Sold","Vim",,"Accounts Receivable",79992.32,"",90074526.44
,"Invoice","04-11-2024","MC06328",,"Unilever Kenya Ltd:Vim","Vim Lavender Fresh 24x500g","Cost of Goods Sold","Vim",,"Accounts Receivable",342628.21,"",90417154.65
,"Build Assembly","04-11-2024","11836",,,"24444","Cost of Goods Sold","Vim","X","-SPLIT-",5.20,"",90417159.85
,"Invoice","05-11-2024","MC06329",,"Unilever Kenya Ltd:Vim","Vim Lemon Fresh 12x1Kg","Cost of Goods Sold","Vim",,"Accounts Receivable",291827.98,"",90708987.83
,"Invoice","05-11-2024","MC06330",,"Unilever Kenya Ltd:Vim","Vim Lavender Fresh 12x1Kg","Cost of Goods Sold","Vim",,"Accounts Receivable",207143.80,"",90916131.63
,"Invoice","06-11-2024","MC06331",,"Unilever Kenya Ltd:Vim","Vim Lemon Fresh 24x500g","Cost of Goods Sold","Vim",,"Accounts Receivable",307019.07,"",91223150.70
,"Invoice","06-11-2024","MC06332",,"Unilever Kenya Ltd:Vim","Vim Lemon Fresh Pouch 24x500g","Cost of Goods Sold","Vim",,"Accounts Receivable",111879.86,"",91335030.56
,"Build Assembly","06-11-2024","11856",,,"24453","Cost of Goods Sold","Vim","X","-SPLIT-","",255.89,91334774.67
,"Build Assembly","06-11-2024","11857",,,"24453","Cost of Goods Sold","Vim","X","-SPLIT-",116.96,"",91334891.63
,"Invoice","07-11-2024","MC06339",,"Unilever Kenya Ltd:Vim","Vim Lemon Fresh Pouch 24x500g","Cost of Goods Sold","Vim",,"Accounts Receivable",37154.20,"",91372045.83
,"Invoice","07-11-2024","MC06340",,"Unilever Kenya Ltd:Vim","Vim Lemon Fresh 12x1Kg","Cost of Goods Sold","Vim",,"Accounts Receivable",167137.84,"",91539183.67
,"Invoice","07-11-2024","MC06341",,"Unilever Kenya Ltd:Vim","Vim Lavender Fresh 24x500g","Cost of Goods Sold","Vim",,"Accounts Receivable",15115.95,"",91554299.62
,"Invoice","07-11-2024","MC06344",,"Unilever Kenya Ltd:Vim","Vim Scourer Lmn 12X(1Kg+ Vim Lvr 1Kg)","Cost of Goods Sold","Vim",,"Accounts Receivable",119767.07,"",91674066.69
,"Invoice","07-11-2024","MC06345",,"Unilever Kenya Ltd:Vim","Vim Lemon Fresh 24x500g","Cost of Goods Sold","Vim",,"Accounts Receivable",648213.96,"",92322280.65
,"Build Assembly","07-11-2024","11866",,,"24454","Cost of Goods Sold","Vim","X","-SPLIT-","",153.64,92322127.01
,"Build Assembly","07-11-2024","11867",,,"24453","Cost of Goods Sold","Vim","X","-SPLIT-","",0.04,92322126.97
,"Invoice","13-11-2024","MC06353",,"Unilever Kenya Ltd:Vim","Vim Lemon Fresh 24x500g","Cost of Goods Sold","Vim",,"Accounts Receivable",366145.78,"",92688272.75
,"Invoice","13-11-2024","MC06354",,"Unilever Kenya Ltd:Vim","Vim Lemon Fresh Pouch 24x500g","Cost of Goods Sold","Vim",,"Accounts Receivable",46941.20,"",92735213.95
,"Invoice","14-11-2024","MC06360",,"Unilever Kenya Ltd:Vim","Vim Lemon Fresh 24x500g","Cost of Goods Sold","Vim",,"Accounts Receivable",222787.16,"",92958001.11
,"Invoice","14-11-2024","MC06361",,"Unilever Kenya Ltd:Vim","Vim Lemon Fresh Pouch 24x500g","Cost of Goods Sold","Vim",,"Accounts Receivable",23472.88,"",92981473.99
,"Invoice","15-11-2024","MC06364",,"Unilever Kenya Ltd:Vim","Vim Lemon Fresh 12x1Kg","Cost of Goods Sold","Vim",,"Accounts Receivable",514775.93,"",93496249.92
,"Invoice","15-11-2024","MC06365",,"Unilever Kenya Ltd:Vim","Vim Lavender Fresh 24x500g","Cost of Goods Sold","Vim",,"Accounts Receivable",400152.80,"",93896402.72
,"Invoice","15-11-2024","MC06368",,"Unilever Kenya Ltd:Vim","Vim Lemon Fresh 24x500g","Cost of Goods Sold","Vim",,"Accounts Receivable",647322.18,"",94543724.90
,"Build Assembly","15-11-2024","11960",,,"24465","Cost of Goods Sold","Vim","X","-SPLIT-",693.98,"",94544418.88
,"Build Assembly","15-11-2024","11961",,,"24465","Cost of Goods Sold","Vim","X","-SPLIT-","",2338.04,94542080.84
,"Invoice","18-11-2024","MC06369",,"Unilever Kenya Ltd:Vim","Vim Lemon Fresh 24x500g","Cost of Goods Sold","Vim",,"Accounts Receivable",62142.93,"",94604223.77
,"Invoice","18-11-2024","MC06370",,"Unilever Kenya Ltd:Vim","Vim Lavender Fresh 12x1Kg","Cost of Goods Sold","Vim",,"Accounts Receivable",260746.01,"",94864969.78
,"Build Assembly","18-11-2024","11980",,,"24471","Cost of Goods Sold","Vim","X","-SPLIT-","",58.03,94864911.75
,"Invoice","19-11-2024","MC06375",,"Unilever Kenya Ltd:Vim","Vim Lemon Fresh 24x500g","Cost of Goods Sold","Vim",,"Accounts Receivable",409066.53,"",95273978.28
,"Build Assembly","19-11-2024","11993",,,"24472","Cost of Goods Sold","Vim","X","-SPLIT-",1232.05,"",95275210.33
,"Invoice","20-11-2024","MC06383",,"Unilever Kenya Ltd:Vim","Vim Lemon Fresh 24x500g","Cost of Goods Sold","Vim",,"Accounts Receivable",334944.88,"",95610155.21
,"Invoice","20-11-2024","MC06385",,"Unilever Kenya Ltd:Vim","Vim Scourer Lmn 12X(1Kg+ Vim Lvr 1Kg)","Cost of Goods Sold","Vim",,"Accounts Receivable",28041.60,"",95638196.81
,"Invoice","20-11-2024","MC06386",,"Unilever Kenya Ltd:Vim","Vim Lemon Fresh 24x500g","Cost of Goods Sold","Vim",,"Accounts Receivable",62802.17,"",95700998.98
,"Invoice","20-11-2024","MC06387",,"Unilever Kenya Ltd:Vim","Vim Lemon Fresh Pouch 24x500g","Cost of Goods Sold","Vim",,"Accounts Receivable",117383.83,"",95818382.81
,"Invoice","20-11-2024","MC06388",,"Unilever Kenya Ltd:Vim","Vim Lemon Fresh 12x1Kg","Cost of Goods Sold","Vim",,"Accounts Receivable",14828.66,"",95833211.47
,"Invoice","20-11-2024","MC06391",,"Unilever Kenya Ltd:Vim","Vim Scourer Lmn 12X(1Kg+ Vim Lvr 1Kg)","Cost of Goods Sold","Vim",,"Accounts Receivable",92136.69,"",95925348.16
,"Invoice","21-11-2024","MC06395",,"Unilever Kenya Ltd:Vim","Vim Lavender Fresh 24x500g","Cost of Goods Sold","Vim",,"Accounts Receivable",220408.32,"",96145756.48
,"Invoice","21-11-2024","MC06398",,"Unilever Kenya Ltd:Vim","Vim Scourer Lmn 12X(1Kg+ Vim Lvr 1Kg)","Cost of Goods Sold","Vim",,"Accounts Receivable",112166.40,"",96257922.88
,"Build Assembly","21-11-2024","12018",,,"24474","Cost of Goods Sold","Vim","X","-SPLIT-","",735.03,96257187.85
,"Build Assembly","21-11-2024","12021",,,"24465","Cost of Goods Sold","Vim","X","-SPLIT-","",337.38,96256850.47
,"Invoice","22-11-2024","MC06401",,"Unilever Kenya Ltd:Vim","Vim Lemon Fresh 24x500g","Cost of Goods Sold","Vim",,"Accounts Receivable",653249.64,"",96910100.11
,"Invoice","22-11-2024","MC06402",,"Unilever Kenya Ltd:Vim","Vim Lemon Fresh 12x1Kg","Cost of Goods Sold","Vim",,"Accounts Receivable",113848.66,"",97023948.77
,"Invoice","22-11-2024","MC06403",,"Unilever Kenya Ltd:Vim","Vim Lavender Fresh 24x500g","Cost of Goods Sold","Vim",,"Accounts Receivable",119820.55,"",97143769.32
,"Invoice","22-11-2024","MC06404",,"Unilever Kenya Ltd:Vim","Vim Lavender Fresh 12x1Kg","Cost of Goods Sold","Vim",,"Accounts Receivable",197224.70,"",97340994.02
,"Invoice","23-11-2024","MC06405",,"Unilever Kenya Ltd:Vim","Vim Lemon Fresh 24x500g","Cost of Goods Sold","Vim",,"Accounts Receivable",79696.46,"",97420690.48
,"Invoice","23-11-2024","MC06406",,"Unilever Kenya Ltd:Vim","Vim Lemon Fresh 12x1Kg","Cost of Goods Sold","Vim",,"Accounts Receivable",202100.47,"",97622790.95
,"Invoice","23-11-2024","MC06407",,"Unilever Kenya Ltd:Vim","Vim Lavender Fresh 24x500g","Cost of Goods Sold","Vim",,"Accounts Receivable",29539.10,"",97652330.05
,"Build Assembly","23-11-2024","12038",,,"24476","Cost of Goods Sold","Vim","X","-SPLIT-",312.92,"",97652642.97
,"Credit Note","25-11-2024","CN01075",,"Unilever Kenya Ltd:Vim","Vim Lemon Fresh 12x1Kg","Cost of Goods Sold","Vim",,"Accounts Receivable","",202100.47,97450542.50
,"Invoice","25-11-2024","MC06410",,"Unilever Kenya Ltd:Vim","Vim Lemon Fresh 12x1Kg","Cost of Goods Sold","Vim",,"Accounts Receivable",201718.43,"",97652260.93
,"Invoice","26-11-2024","MC06413",,"Unilever Kenya Ltd:Vim","Vim Lemon Fresh 24x500g","Cost of Goods Sold","Vim",,"Accounts Receivable",83821.77,"",97736082.70
,"Invoice","26-11-2024","MC06414",,"Unilever Kenya Ltd:Vim","Vim Lemon Fresh 12x1Kg","Cost of Goods Sold","Vim",,"Accounts Receivable",409614.23,"",98145696.93
,"Invoice","26-11-2024","MC06417",,"Unilever Kenya Ltd:Vim","Vim Lemon Fresh 24x500g","Cost of Goods Sold","Vim",,"Accounts Receivable",404701.98,"",98550398.91
,"Build Assembly","26-11-2024","12057",,,"24482","Cost of Goods Sold","Vim","X","-SPLIT-",29.97,"",98550428.88
,"Invoice","28-11-2024","MC06418",,"Unilever Kenya Ltd:Vim","Vim Lemon Fresh 24x500g","Cost of Goods Sold","Vim",,"Accounts Receivable",125752.87,"",98676181.75
,"Invoice","28-11-2024","MC06419",,"Unilever Kenya Ltd:Vim","Vim Lavender Fresh 12x1Kg","Cost of Goods Sold","Vim",,"Accounts Receivable",123305.64,"",98799487.39
,"Invoice","28-11-2024","MC06421",,"Unilever Kenya Ltd:Vim","Vim Scourer Lmn 12X(1Kg+ Vim Lvr 1Kg)","Cost of Goods Sold","Vim",,"Accounts Receivable",60701.10,"",98860188.49
,"Invoice","28-11-2024","MC06422",,"Unilever Kenya Ltd:Vim","Vim Lemon Fresh 24x500g","Cost of Goods Sold","Vim",,"Accounts Receivable",167670.49,"",99027858.98
,"Invoice","28-11-2024","MC06423",,"Unilever Kenya Ltd:Vim","Vim Lemon Fresh Pouch 24x500g","Cost of Goods Sold","Vim",,"Accounts Receivable",95302.35,"",99123161.33
,"Invoice","30-11-2024","MC06428",,"Unilever Kenya Ltd:Vim","Vim Lemon Fresh 12x1Kg","Cost of Goods Sold","Vim",,"Accounts Receivable",112650.62,"",99235811.95
,"Invoice","30-11-2024","MC06429",,"Unilever Kenya Ltd:Vim","Vim Lavender Fresh 24x500g","Cost of Goods Sold","Vim",,"Accounts Receivable",200353.56,"",99436165.51
,"Invoice","30-11-2024","MC06430",,"Unilever Kenya Ltd:Vim","Vim Lavender Fresh 12x1Kg","Cost of Goods Sold","Vim",,"Accounts Receivable",126840.35,"",99563005.86
,"Build Assembly","30-11-2024","12106",,,"24486","Cost of Goods Sold","Vim","X","-SPLIT-",15.17,"",99563021.03
,"Invoice","02-12-2024","MC06431",,"Unilever Kenya Ltd:Vim","Vim Lavender Fresh 24x500g","Cost of Goods Sold","Vim",,"Accounts Receivable",180318.21,"",99743339.24
,"Invoice","02-12-2024","MC06432",,"Unilever Kenya Ltd:Vim","Vim Lavender Fresh 12x1Kg","Cost of Goods Sold","Vim",,"Accounts Receivable",61608.17,"",99804947.41
,"Invoice","02-12-2024","MC06433",,"Unilever Kenya Ltd:Vim","Vim Lemon Fresh 12x1Kg","Cost of Goods Sold","Vim",,"Accounts Receivable",164792.15,"",99969739.56
,"Invoice","04-12-2024","MC06439",,"Unilever Kenya Ltd:Vim","Vim Lemon Fresh Pouch 24x500g","Cost of Goods Sold","Vim",,"Accounts Receivable",47658.69,"",100017398.25
,"Invoice","04-12-2024","MC06440",,"Unilever Kenya Ltd:Vim","Vim Lemon Fresh 24x500g","Cost of Goods Sold","Vim",,"Accounts Receivable",188491.39,"",100205889.64
,"Invoice","04-12-2024","MC06444",,"Unilever Kenya Ltd:Vim","Vim Lavender Fresh 12x1Kg","Cost of Goods Sold","Vim",,"Accounts Receivable",50645.68,"",100256535.32
,"Invoice","04-12-2024","MC06445",,"Unilever Kenya Ltd:Vim","Vim Lemon Fresh 24x500g","Cost of Goods Sold","Vim",,"Accounts Receivable",143113.83,"",100399649.15
,"Invoice","04-12-2024","MC06446",,"Unilever Kenya Ltd:Vim","Vim Lemon Fresh 12x1Kg","Cost of Goods Sold","Vim",,"Accounts Receivable",268266.29,"",100667915.44
,"Build Assembly","04-12-2024","12146",,,"24493","Cost of Goods Sold","Vim","X","-SPLIT-","",864.97,100667050.47
,"Invoice","05-12-2024","MC06448",,"Unilever Kenya Ltd:Vim","Vim Scourer Lmn 12X(1Kg+ Vim Lvr 1Kg)","Cost of Goods Sold","Vim",,"Accounts Receivable",83989.96,"",100751040.43
,"Invoice","05-12-2024","MC06449",,"Unilever Kenya Ltd:Vim","Vim Lemon Fresh 12x1Kg","Cost of Goods Sold","Vim",,"Accounts Receivable",106960.54,"",100858000.97
,"Invoice","05-12-2024","MC06450",,"Unilever Kenya Ltd:Vim","Vim Lemon Fresh Pouch 24x500g","Cost of Goods Sold","Vim",,"Accounts Receivable",71323.77,"",100929324.74
,"Invoice","05-12-2024","MC06451",,"Unilever Kenya Ltd:Vim","Vim Lavender Fresh 12x1Kg","Cost of Goods Sold","Vim",,"Accounts Receivable",253228.43,"",101182553.17
,"Build Assembly","05-12-2024","12150",,,"24486","Cost of Goods Sold","Vim","X","-SPLIT-",0.83,"",101182554.00
,"Build Assembly","05-12-2024","12152",,,"24494","Cost of Goods Sold","Vim","X","-SPLIT-",103.28,"",101182657.28
,"Invoice","11-12-2024","MC06457",,"Unilever Kenya Ltd:Vim","Vim Lemon Fresh Pouch 24x500g","Cost of Goods Sold","Vim",,"Accounts Receivable",47493.78,"",101230151.06
,"Invoice","11-12-2024","MC06458",,"Unilever Kenya Ltd:Vim","Vim Lemon Fresh 12x1Kg","Cost of Goods Sold","Vim",,"Accounts Receivable",447493.90,"",101677644.96
,"Invoice","11-12-2024","MC06460",,"Unilever Kenya Ltd:Vim","Vim Lemon Fresh 24x500g","Cost of Goods Sold","Vim",,"Accounts Receivable",141970.90,"",101819615.86
,"Invoice","11-12-2024","MC06461",,"Unilever Kenya Ltd:Vim","Vim Lavender Fresh 24x500g","Cost of Goods Sold","Vim",,"Accounts Receivable",240252.86,"",102059868.72
,"Invoice","13-12-2024","MC06464",,"Unilever Kenya Ltd:Vim","Vim Lemon Fresh 12x1Kg","Cost of Goods Sold","Vim",,"Accounts Receivable",265819.03,"",102325687.75
,"Invoice","13-12-2024","MC06465",,"Unilever Kenya Ltd:Vim","Vim Lavender Fresh 12x1Kg","Cost of Goods Sold","Vim",,"Accounts Receivable",180314.38,"",102506002.13
,"Invoice","14-12-2024","MC06466",,"Unilever Kenya Ltd:Vim","Vim Lemon Fresh 24x500g","Cost of Goods Sold","Vim",,"Accounts Receivable",215652.00,"",102721654.13
,"Invoice","14-12-2024","MC06467",,"Unilever Kenya Ltd:Vim","Vim Lemon Fresh Pouch 24x500g","Cost of Goods Sold","Vim",,"Accounts Receivable",133475.29,"",102855129.42
,"Invoice","14-12-2024","MC06468",,"Unilever Kenya Ltd:Vim","Vim Lemon Fresh 12x1Kg","Cost of Goods Sold","Vim",,"Accounts Receivable",26773.14,"",102881902.56
,"Invoice","16-12-2024","MC06470",,"Unilever Kenya Ltd:Vim","Vim Lavender Fresh 12x1Kg","Cost of Goods Sold","Vim",,"Accounts Receivable",246389.38,"",103128291.94
,"Invoice","16-12-2024","MC06471",,"Unilever Kenya Ltd:Vim","Vim Lavender Fresh 24x500g","Cost of Goods Sold","Vim",,"Accounts Receivable",203531.48,"",103331823.42
,"Invoice","17-12-2024","MC06472",,"Unilever Kenya Ltd:Vim","Vim Lemon Fresh 24x500g","Cost of Goods Sold","Vim",,"Accounts Receivable",296267.73,"",103628091.15
,"Invoice","17-12-2024","MC06473",,"Unilever Kenya Ltd:Vim","Vim Scourer Lmn 12X(1Kg+ Vim Lvr 1Kg)","Cost of Goods Sold","Vim",,"Accounts Receivable",36020.65,"",103664111.80
,"Invoice","17-12-2024","MC06478",,"Unilever Kenya Ltd:Vim","Vim Lemon Fresh 24x500g","Cost of Goods Sold","Vim",,"Accounts Receivable",296726.34,"",103960838.14
,"Invoice","18-12-2024","MC06486",,"Unilever Kenya Ltd:Vim","Vim Lemon Fresh 12x1Kg","Cost of Goods Sold","Vim",,"Accounts Receivable",240958.25,"",104201796.39
,"Invoice","18-12-2024","MC06487",,"Unilever Kenya Ltd:Vim","Vim Lavender Fresh 24x500g","Cost of Goods Sold","Vim",,"Accounts Receivable",82297.51,"",104284093.90
,"Build Assembly","18-12-2024","12263",,,"24513","Cost of Goods Sold","Vim","X","-SPLIT-","",312.25,104283781.65
,"Invoice","19-12-2024","MC06489",,"Unilever Kenya Ltd:Vim","Vim Lemon Fresh Pouch 24x500g","Cost of Goods Sold","Vim",,"Accounts Receivable",65944.78,"",104349726.43
,"Invoice","19-12-2024","MC06490",,"Unilever Kenya Ltd:Vim","Vim Lemon Fresh 12x1Kg","Cost of Goods Sold","Vim",,"Accounts Receivable",202208.21,"",104551934.64
,"Invoice","19-12-2024","MC06491",,"Unilever Kenya Ltd:Vim","Vim Scourer Lmn 12X(1Kg+ Vim Lvr 1Kg)","Cost of Goods Sold","Vim",,"Accounts Receivable",56082.22,"",104608016.86
,"Invoice","19-12-2024","MC06492",,"Unilever Kenya Ltd:Vim","Vim Lavender Fresh 12x1Kg","Cost of Goods Sold","Vim",,"Accounts Receivable",177806.77,"",104785823.63
,"Invoice","20-12-2024","MC06493",,"Unilever Kenya Ltd:Vim","Vim Lemon Fresh 24x500g","Cost of Goods Sold","Vim",,"Accounts Receivable",900643.74,"",105686467.37
,"Invoice","20-12-2024","MC06494",,"Unilever Kenya Ltd:Vim","Vim Lavender Fresh 24x500g","Cost of Goods Sold","Vim",,"Accounts Receivable",132737.92,"",105819205.29
,"Invoice","20-12-2024","MC06495",,"Unilever Kenya Ltd:Vim","Vim Lemon Fresh 12x1Kg","Cost of Goods Sold","Vim",,"Accounts Receivable",339175.65,"",106158380.94
,"Invoice","23-12-2024","MC06498",,"Unilever Kenya Ltd:Vim","Vim Lemon Fresh 24x500g","Cost of Goods Sold","Vim",,"Accounts Receivable",404935.56,"",106563316.50
,"Invoice","23-12-2024","MC06503",,"Unilever Kenya Ltd:Vim","Vim Lavender Fresh 24x500g","Cost of Goods Sold","Vim",,"Accounts Receivable",406620.48,"",106969936.98
,"Invoice","23-12-2024","MC06504",,"Unilever Kenya Ltd:Vim","Vim Lemon Fresh 24x500g","Cost of Goods Sold","Vim",,"Accounts Receivable",944845.68,"",107914782.66
,"Invoice","24-12-2024","MC06505",,"Unilever Kenya Ltd:Vim","Vim Lemon Fresh 24x500g","Cost of Goods Sold","Vim",,"Accounts Receivable",330695.99,"",108245478.65
,"Invoice","24-12-2024","MC06506",,"Unilever Kenya Ltd:Vim","Vim Lemon Fresh 12x1Kg","Cost of Goods Sold","Vim",,"Accounts Receivable",133533.72,"",108379012.37
,"Invoice","24-12-2024","MC06507",,"Unilever Kenya Ltd:Vim","Vim Lemon Fresh Pouch 24x500g","Cost of Goods Sold","Vim",,"Accounts Receivable",95437.67,"",108474450.04
,"Invoice","24-12-2024","MC06508",,"Unilever Kenya Ltd:Vim","Vim Lemon Fresh 12x1Kg","Cost of Goods Sold","Vim",,"Accounts Receivable",80120.23,"",108554570.27
,"Invoice","24-12-2024","MC06509",,"Unilever Kenya Ltd:Vim","Vim Lavender Fresh 12x1Kg","Cost of Goods Sold","Vim",,"Accounts Receivable",171275.09,"",108725845.36
,"Invoice","24-12-2024","MC06510",,"Unilever Kenya Ltd:Vim","Vim Scourer Lmn 12X(1Kg+ Vim Lvr 1Kg)","Cost of Goods Sold","Vim",,"Accounts Receivable",168334.81,"",108894180.17
,"Invoice","24-12-2024","MC06511",,"Unilever Kenya Ltd:Vim","Vim Lemon Fresh 12x1Kg","Cost of Goods Sold","Vim",,"Accounts Receivable",267067.44,"",109161247.61
,"Invoice","24-12-2024","MC06512",,"Unilever Kenya Ltd:Vim","Vim Lavender Fresh 12x1Kg","Cost of Goods Sold","Vim",,"Accounts Receivable",130633.54,"",109291881.15
,"Invoice","24-12-2024","MC06514",,"Unilever Kenya Ltd:Vim","Vim Lemon Fresh 24x500g","Cost of Goods Sold","Vim",,"Accounts Receivable",369982.29,"",109661863.44
,"Invoice","24-12-2024","MC06515",,"Unilever Kenya Ltd:Vim","Vim Lemon Fresh 12x1Kg","Cost of Goods Sold","Vim",,"Accounts Receivable",25943.69,"",109687807.13
,"Build Assembly","24-12-2024","12331",,,"24522","Cost of Goods Sold","Vim","X","-SPLIT-",5143.34,"",109692950.47
,"Build Assembly","24-12-2024","12332",,,"24522","Cost of Goods Sold","Vim","X","-SPLIT-",956.02,"",109693906.49
"Total Vim - Other",,,,,,,,,,,110434791.89,740885.40,109693906.49
"Total Vim",,,,,,,,,,,122581540.20,740886.34,121840653.86
"Cost of Goods Sold - Other",,,,,,,,,,,,,""
,"Invoice","31-07-2024","MC05989",,"Clarjos Enterprise","Stretchfilm","Cost of Goods Sold","Cost of Goods Sold",,"Accounts Receivable",7830.00,"",7830.00
,"Credit","30-10-2024","0110164220000001643",,"Mr. Green Trading Africa Kenya Limited","rHDPE white pellets","Cost of Goods Sold","Cost of Goods Sold",,"Accounts Payable","",68008.09,-60178.09
"Total Cost of Goods Sold - Other",,,,,,,,,,,7830.00,68008.09,-60178.09
"Total Cost of Goods Sold",,,,,,,,,,,158963706.05,2682144.18,156281561.87
"Total COGS",,,,,,,,,,,158963706.05,2682144.18,156281561.87
"Gross Profit",,,,,,,,,,,160929203.13,294257293.52,133328090.39
"Expense",,,,,,,,,,,,,""
"Sales and Marketing",,,,,,,,,,,,,""
"Advertising",,,,,,,,,,,,,""
,"Bill","23-02-2024","571",,"JJ Investments Ltd","posters and flyers","Expense","Advertising",,"Accounts Payable",3850.00,"",3850.00
,"Bill","24-07-2024","2591",,"Option Digital Printing Centre","500pc A6 fliers @ 3.5","Expense","Advertising",,"Accounts Payable",1750.00,"",5600.00
,"Bill","29-07-2024","2593",,"Option Digital Printing Centre","500pcs A5 fliers","Expense","Advertising",,"Accounts Payable",3500.00,"",9100.00
,"Bill","18-09-2024","2710",,"Option Digital Printing Centre","500pcs A6 fliers","Expense","Advertising",,"Accounts Payable",1750.00,"",10850.00
,"Bill","29-10-2024","2910",,"Red Pictures Production","Product photo shoot","Expense","Advertising",,"Accounts Payable",15000.00,"",25850.00
,"Bill","06-11-2024","1048615127001759",,"Facebook Inc","Instagram ads","Expense","Advertising",,"Accounts Payable - USD",1201.76,"",27051.76
,"Bill","21-11-2024","GPA33260596823674469",,"TikTok Pte. Ltd","TikTok ad","Expense","Advertising",,"Accounts Payable",770.00,"",27821.76
,"Cheque","22-11-2024","P2421",,"Facebook Inc","Facebook ad","Expense","Advertising",,"MPESA Account",428.65,"",28250.41
,"Bill","18-12-2024",,,"Option Digital Printing Centre","300pcs A6 fliers stickers","Expense","Advertising",,"Accounts Payable",1110.00,"",29360.41
"Total Advertising",,,,,,,,,,,29360.41,0.00,29360.41
"Promotion",,,,,,,,,,,,,""
,"Cheque","01-05-2024","P1994",,,"Sales commission","Expense","Promotion",,"MPESA Account",20000.00,"",20000.00
,"Cheque","05-08-2024","P2191",,,"Sales commission","Expense","Promotion",,"MPESA Account",35000.00,"",55000.00
,"Cheque","03-09-2024","P2264",,,"Sales commission","Expense","Promotion",,"MPESA Account",38318.00,"",93318.00
,"Cheque","01-10-2024","P2318",,,"Sales commission","Expense","Promotion",,"MPESA Account",25000.00,"",118318.00
,"Cheque","01-11-2024","P2371",,,"Sales commission","Expense","Promotion",,"MPESA Account",30600.00,"",148918.00
,"Cheque","01-12-2024","P2439",,,"Sales commission","Expense","Promotion",,"MPESA Account",45000.00,"",193918.00
,"Cheque","25-12-2024","P2505",,,"Sales commission","Expense","Promotion",,"MPESA Account",25000.00,"",218918.00
"Total Promotion",,,,,,,,,,,218918.00,0.00,218918.00
"Market Samples",,,,,,,,,,,,,""
,"Cheque","22-05-2024","22052024",,"Towfiq Shop","competitor bar soap","Expense","Market Samples",,"Cash Account",140.00,"",140.00
"Total Market Samples",,,,,,,,,,,140.00,0.00,140.00
"Marketing",,,,,,,,,,,,,""
,"Cheque","10-01-2024","P1779",,,"fare reimbursement","Expense","Marketing",,"MPESA Account",1790.00,"",1790.00
,"Cheque","10-01-2024","P1780",,,"fare reimbursement","Expense","Marketing",,"MPESA Account",520.00,"",2310.00
,"Cheque","15-01-2024","P1789",,,"fare reimbursement","Expense","Marketing",,"MPESA Account",2100.00,"",4410.00
,"Cheque","22-01-2024","P1802",,,"fare reimbursement","Expense","Marketing",,"MPESA Account",2240.00,"",6650.00
,"Bill","22-01-2024",,,"JJ Investments Ltd","flyers","Expense","Marketing",,"Accounts Payable",3713.22,"",10363.22
,"Cheque","29-01-2024","P1812",,,"fare reimbursement","Expense","Marketing",,"MPESA Account",3717.00,"",14080.22
,"Cheque","31-01-2024","4104",,"Plusline Design","Ad & Artwork Design","Expense","Marketing",,"Cash Account",5000.00,"",19080.22
,"Cheque","09-02-2024","P1831",,,"fare reimbursement","Expense","Marketing",,"MPESA Account",2950.00,"",22030.22
,"Cheque","12-02-2024","P1834",,,"fare reimbursement","Expense","Marketing",,"MPESA Account",3655.00,"",25685.22
,"Cheque","19-02-2024","P1855",,,"fare reimbursement","Expense","Marketing",,"MPESA Account",3645.00,"",29330.22
,"Bill","23-02-2024","BL-GADF-037733",,"Nairobi City County","Outdoor advertisement flyer stamping fee","Expense","Marketing",,"Accounts Payable",4500.00,"",33830.22
,"Cheque","26-02-2024","P1868",,,"fare reimbursement","Expense","Marketing",,"MPESA Account",3430.00,"",37260.22
,"Cheque","28-02-2024","P1873",,,"Van delivery","Expense","Marketing",,"MPESA Account",200.00,"",37460.22
,"Cheque","04-03-2024","P1880",,,"fare reimbursement","Expense","Marketing",,"MPESA Account",3360.00,"",40820.22
,"Cheque","11-03-2024","P1888",,,"fare reimbursement","Expense","Marketing",,"MPESA Account",3650.00,"",44470.22
,"Cheque","18-03-2024","P1895",,,"fare reimbursement","Expense","Marketing",,"MPESA Account",3372.00,"",47842.22
,"Cheque","25-03-2024","P1915",,,"fare reimbursement","Expense","Marketing",,"MPESA Account",3570.00,"",51412.22
,"Cheque","31-03-2024","4106",,"Plusline Design","Ad & Artwork Design & Social Media","Expense","Marketing",,"Cash Account",5000.00,"",56412.22
,"Cheque","02-04-2024","P1936",,,"fare reimbursement","Expense","Marketing",,"MPESA Account",3045.00,"",59457.22
,"Cheque","08-04-2024","P1962",,,"fare reimbursement","Expense","Marketing",,"MPESA Account",4275.00,"",63732.22
,"Cheque","09-04-2024","P1959",,,"fare to Mombasa","Expense","Marketing",,"MPESA Account",4000.00,"",67732.22
,"Cheque","15-04-2024","P1968",,,"fare reimbursement","Expense","Marketing",,"MPESA Account",3955.00,"",71687.22
,"Cheque","24-04-2024","P1981",,,"fare reimbursement","Expense","Marketing",,"MPESA Account",5620.00,"",77307.22
,"Cheque","30-04-2024","4107",,"Plusline Design","Ad & Artwork Design & Social Media","Expense","Marketing",,"Cash Account",9000.00,"",86307.22
,"Cheque","02-05-2024","P1999",,,"fare reimbursement","Expense","Marketing",,"MPESA Account",5255.00,"",91562.22
,"Cheque","06-05-2024","P2005",,,"fare reimbursement","Expense","Marketing",,"MPESA Account",4600.00,"",96162.22
,"Cheque","13-05-2024","P2027",,,"fare reimbursement","Expense","Marketing",,"MPESA Account",4690.00,"",100852.22
,"Cheque","20-05-2024","P2040",,,"fare reimbursement","Expense","Marketing",,"MPESA Account",5650.00,"",106502.22
,"Cheque","27-05-2024","P2057",,,"fare reimbursement","Expense","Marketing",,"MPESA Account",5970.00,"",112472.22
,"Cheque","30-05-2024","P2068",,,"Tender submission for Supply of toiletries and detergents to St. Georges","Expense","Marketing",,"MPESA Account",1000.00,"",113472.22
,"Cheque","03-06-2024","P2074",,,"fare reimbursement","Expense","Marketing",,"MPESA Account",4910.00,"",118382.22
,"Bill","05-06-2024","0010197120000007298",,"Ravs Fashions Ltd","Promotional t-shirts","Expense","Marketing",,"Accounts Payable",11788.79,"",130171.01
,"Bill","05-06-2024","0040809890000056943",,"Robin Packaging Ltd","Carrier Bags","Expense","Marketing",,"Accounts Payable",689.66,"",130860.67
,"Bill","05-06-2024","0190443710000003901",,"Munira Stores","Decor clothe","Expense","Marketing",,"Accounts Payable",3517.24,"",134377.91
,"Bill","05-06-2024","0190443710000003902",,"Munira Stores","Decor clothe","Expense","Marketing",,"Accounts Payable",517.24,"",134895.15
,"Bill","05-06-2024","2578",,"Option Digital Printing Centre","Printing of flyers","Expense","Marketing",,"Accounts Payable",1900.00,"",136795.15
,"Cheque","10-06-2024","P2094",,,"fare reimbursement","Expense","Marketing",,"MPESA Account",8240.00,"",145035.15
,"Cheque","18-06-2024","P2106",,,"fare reimbursement","Expense","Marketing",,"MPESA Account",5720.00,"",150755.15
,"Bill","20-06-2024","0171752780000000138",,"Eminent Brands Limited","T-shirts Branding","Expense","Marketing",,"Accounts Payable",10000.00,"",160755.15
,"Cheque","24-06-2024","P2112",,,"fare reimbursement","Expense","Marketing",,"MPESA Account",5580.00,"",166335.15
,"Cheque","03-07-2024","P2126",,,"fare reimbursement","Expense","Marketing",,"MPESA Account",5050.00,"",171385.15
,"Cheque","03-07-2024","P2127",,,"Machakos parking fee","Expense","Marketing",,"MPESA Account",500.00,"",171885.15
,"Bill","05-07-2024","0171752780000000147",,"Eminent Brands Limited","Branded Zelia Gift sets","Expense","Marketing",,"Accounts Payable",15000.00,"",186885.15
,"Cheque","08-07-2024","P2142",,,"fare reimbursement","Expense","Marketing",,"MPESA Account",6610.00,"",193495.15
,"Cheque","11-07-2024","P2151",,,"Maurine fare to and from Kisii to contact Market study","Expense","Marketing",,"MPESA Account",2900.00,"",196395.15
,"Cheque","15-07-2024","P2155",,,"Duran fare to and from Kisii to contact Market study","Expense","Marketing",,"MPESA Account",1500.00,"",197895.15
,"Cheque","15-07-2024","P2156",,,"fare reimbursement","Expense","Marketing",,"MPESA Account",7490.00,"",205385.15
,"Cheque","22-07-2024","P2164",,,"fare reimbursement","Expense","Marketing",,"MPESA Account",7380.00,"",212765.15
,"Bill","24-07-2024","0040809890000062339",,"Robin Packaging Ltd","Carrier Bags","Expense","Marketing",,"Accounts Payable",689.66,"",213454.81
,"Bill","25-07-2024","0040809890000062404",,"Robin Packaging Ltd","Carrier Bags: 2pkt @ 150 and 1pkt @ 200","Expense","Marketing",,"Accounts Payable",431.03,"",213885.84
,"Cheque","27-07-2024","P2178",,,"Machakos parking fee","Expense","Marketing",,"MPESA Account",500.00,"",214385.84
,"Cheque","29-07-2024","P2185",,,"fare reimbursement","Expense","Marketing",,"MPESA Account",5010.00,"",219395.84
,"Bill","01-08-2024","2594",,"Option Digital Printing Centre","Business cards","Expense","Marketing",,"Accounts Payable",2500.00,"",221895.84
,"Bill","07-08-2024","2590",,"Option Digital Printing Centre","Receipt books","Expense","Marketing",,"Accounts Payable",3500.00,"",225395.84
,"Cheque","08-08-2024","P2204",,,"fare reimbursement","Expense","Marketing",,"MPESA Account",1630.00,"",227025.84
,"Cheque","08-08-2024","P2205",,,"fare reimbursement","Expense","Marketing",,"MPESA Account",8190.00,"",235215.84
,"Cheque","09-08-2024","P2207",,,"Zachaeus Zelia Transport to Kisii","Expense","Marketing",,"MPESA Account",5000.00,"",240215.84
,"Cheque","12-08-2024","P2213",,,"fare reimbursement","Expense","Marketing",,"MPESA Account",3280.00,"",243495.84
,"Cheque","14-08-2024","P2216",,,"fare reimbursement","Expense","Marketing",,"MPESA Account",1120.00,"",244615.84
,"Cheque","19-08-2024","P2224",,,"fare reimbursement","Expense","Marketing",,"MPESA Account",6500.00,"",251115.84
,"Cheque","20-08-2024","SHK7NK522P",,"Nyena Sacco","Maurine fare to Nakuru","Expense","Marketing",,"MPESA Account",500.00,"",251615.84
,"Cheque","20-08-2024","SHK5PHIGF9",,"Mololine Prestige Shuttle 2014 Ltd","Maurine Fare from Nakuru","Expense","Marketing",,"MPESA Account",700.00,"",252315.84
,"Cheque","22-08-2024","P2229",,,"fare reimbursement Maurine","Expense","Marketing",,"MPESA Account",680.00,"",252995.84
,"Cheque","26-08-2024","P2236",,,"fare reimbursement","Expense","Marketing",,"MPESA Account",6520.00,"",259515.84
,"Cheque","30-08-2024","P2248",,,"Kisii transport","Expense","Marketing",,"MPESA Account",5000.00,"",264515.84
,"Cheque","31-08-2024","P2251",,,"Kisii rider","Expense","Marketing",,"MPESA Account",750.00,"",265265.84
,"Cheque","31-08-2024","4111",,"Plusline Design","Ad & Artwork Design & Social Media","Expense","Marketing",,"Cash Account",12500.00,"",277765.84
,"Cheque","02-09-2024","P2252",,,"fare reimbursement","Expense","Marketing",,"MPESA Account",7670.00,"",285435.84
,"Cheque","05-09-2024","P2272",,,"fare to Kisii","Expense","Marketing",,"MPESA Account",1400.00,"",286835.84
,"Cheque","06-09-2024","P2273",,,"fare from Kisii","Expense","Marketing",,"MPESA Account",1400.00,"",288235.84
,"Cheque","09-09-2024","P2276",,,"fare reimbursement","Expense","Marketing",,"MPESA Account",4920.00,"",293155.84
,"Cheque","09-09-2024","P2277",,,"Machakos parking fee","Expense","Marketing",,"MPESA Account",300.00,"",293455.84
,"Cheque","16-09-2024","P2291",,,"fare reimbursement","Expense","Marketing",,"MPESA Account",5290.00,"",298745.84
,"Cheque","19-09-2024","P2300",,,"fare reimbursement","Expense","Marketing",,"MPESA Account",1850.00,"",300595.84
,"Cheque","19-09-2024","P2301",,,"fare reimbursement","Expense","Marketing",,"MPESA Account",500.00,"",301095.84
,"Cheque","23-09-2024","P2305",,,"fare reimbursement","Expense","Marketing",,"MPESA Account",7280.00,"",308375.84
,"Bill","27-09-2024","0190408130000010384",,"Kenya Association of Manufacturers","Changamka Festival SME Expo booth","Expense","Marketing",,"Accounts Payable",10000.00,"",318375.84
,"Cheque","30-09-2024","P2313",,,"fare reimbursement","Expense","Marketing",,"MPESA Account",7280.00,"",325655.84
,"Cheque","30-09-2024","4112",,"Plusline Design","Ad & Artwork Design & Social Media","Expense","Marketing",,"Cash Account",12500.00,"",338155.84
,"Bill","01-10-2024","136",,"Elidah Designers","Kitchen Aprons merc 30 @ 230","Expense","Marketing",,"Accounts Payable",6900.00,"",345055.84
,"Cheque","05-10-2024","P2333",,,"George transport to Machakos to deliver Zelia","Expense","Marketing",,"MPESA Account",3000.00,"",348055.84
,"Cheque","07-10-2024","P2335",,,"fare reimbursement","Expense","Marketing",,"MPESA Account",5826.00,"",353881.84
,"Cheque","14-10-2024","P2344",,,"fare reimbursement","Expense","Marketing",,"MPESA Account",5080.00,"",358961.84
,"Cheque","22-10-2024","P2352",,,"Zachaeus Zelia Transport to Kisii","Expense","Marketing",,"MPESA Account",5000.00,"",363961.84
,"Bill","23-10-2024","0040809890000073392",,"Robin Packaging Ltd","Carrier Bags: 4pkt @ 210 and 4pkt @ 310","Expense","Marketing",,"Accounts Payable",1793.10,"",365754.94
,"Cheque","24-10-2024","P2358",,,"fare reimbursement","Expense","Marketing",,"MPESA Account",5450.00,"",371204.94
,"Bill","28-10-2024","0040809890000073984",,"Robin Packaging Ltd","250M King Nets Roll","Expense","Marketing",,"Accounts Payable",1034.48,"",372239.42
,"Cheque","28-10-2024","P2364",,,"fare reimbursement","Expense","Marketing",,"MPESA Account",5530.00,"",377769.42
,"Cheque","29-10-2024","P2366",,,"fruits as props for photoshoot","Expense","Marketing",,"MPESA Account",520.00,"",378289.42
,"Cheque","02-11-2024","4113",,"Plusline Design","Ad & Artwork Design & Social Media","Expense","Marketing",,"Cash Account",9000.00,"",387289.42
,"Bill","04-11-2024","0090974830000004871",,"Alla International Co. Limited","Non Woven Zelia shopping Bags","Expense","Marketing",,"Accounts Payable",93103.44,"",480392.86
,"Cheque","05-11-2024","P2374",,,"Zelia delivery to KICC","Expense","Marketing",,"MPESA Account",1200.00,"",481592.86
,"Cheque","05-11-2024","P2386",,,"fare reimbursement","Expense","Marketing",,"MPESA Account",5572.00,"",487164.86
,"Cheque","06-11-2024","P2388",,,"fare reimbursement","Expense","Marketing",,"MPESA Account",1960.00,"",489124.86
,"Cheque","11-11-2024","P2396",,,"Zelia delivery from KICC","Expense","Marketing",,"MPESA Account",1200.00,"",490324.86
,"Cheque","12-11-2024","P2398",,,"fare reimbursement","Expense","Marketing",,"MPESA Account",7430.00,"",497754.86
,"Cheque","18-11-2024","P2414",,,"fare reimbursement","Expense","Marketing",,"MPESA Account",5840.00,"",503594.86
,"Cheque","26-11-2024","P2429",,,"fare reimbursement","Expense","Marketing",,"MPESA Account",4970.00,"",508564.86
,"Cheque","27-11-2024","P2431",,,"Nixon Fare to Nakuru","Expense","Marketing",,"MPESA Account",3000.00,"",511564.86
,"Cheque","30-11-2024","P2436",,,"George transport to Machakos to deliver Zelia","Expense","Marketing",,"MPESA Account",3000.00,"",514564.86
,"Cheque","03-12-2024","P2442",,,"fare reimbursement","Expense","Marketing",,"MPESA Account",8132.00,"",522696.86
,"Cheque","09-12-2024","P2464",,,"fare reimbursement","Expense","Marketing",,"MPESA Account",7004.00,"",529700.86
,"Cheque","19-12-2024","P2484",,,"fare reimbursement","Expense","Marketing",,"MPESA Account",6332.00,"",536032.86
"Total Marketing",,,,,,,,,,,536032.86,0.00,536032.86
"Total Sales and Marketing",,,,,,,,,,,784451.27,0.00,784451.27
"Depreciation Expense",,,,,,,,,,,,,""
,"General Journal","01-01-2024","21801",,,"Hoisting Bucket 1 Depreciation","Expense","Depreciation Expense",,"Accumulated Depreciation",148.81,"",148.81
,"General Journal","01-01-2024","21802",,,"Hoisting Bucket 2 Dereciation","Expense","Depreciation Expense",,"Accumulated Depreciation",148.81,"",297.62
,"General Journal","01-01-2024","21808",,,"Lenovo Laptop 2 Depreciation","Expense","Depreciation Expense",,"Accumulated Depreciation",333.33,"",630.95
,"General Journal","01-01-2024","21824",,,"Processing Platform Depreciation","Expense","Depreciation Expense",,"Accumulated Depreciation",4880.95,"",5511.90
,"General Journal","01-01-2024","21827",,,"Security and Computer Sytem UPS Depreciation","Expense","Depreciation Expense",,"Accumulated Depreciation",3584.50,"",9096.40
,"General Journal","01-01-2024","21840",,,"Trophy Shelf 1 Depreciation","Expense","Depreciation Expense",,"Accumulated Depreciation",95.24,"",9191.64
,"General Journal","01-01-2024","21843",,,"Water tank 4 Depreciation","Expense","Depreciation Expense",,"Accumulated Depreciation",453.24,"",9644.88
,"General Journal","02-01-2024","21771",,,"CMPP 1kg Jar Blow Mould 1 Depreciation","Expense","Depreciation Expense",,"Accumulated Depreciation",3364.87,"",13009.75
,"General Journal","02-01-2024","21772",,,"CMPP 1kg Jar Blow Mould 2 Depreciation","Expense","Depreciation Expense",,"Accumulated Depreciation",3364.87,"",16374.62
,"General Journal","02-01-2024","21773",,,"CMPP 500gm Jar Blow Mould 1 Depreciation","Expense","Depreciation Expense",,"Accumulated Depreciation",2643.82,"",19018.44
,"General Journal","02-01-2024","21774",,,"CMPP 500gm Jar Blow Mould 2 Depreciation","Expense","Depreciation Expense",,"Accumulated Depreciation",2643.82,"",21662.26
,"General Journal","02-01-2024","21775",,,"CMPP Blow Moulding Machine 1 Depreciation","Expense","Depreciation Expense",,"Accumulated Depreciation",49344.71,"",71006.97
,"General Journal","02-01-2024","21776",,,"CMPP Blow Moulding Machine 2 Depreciation","Expense","Depreciation Expense",,"Accumulated Depreciation",49344.71,"",120351.68
,"General Journal","02-01-2024","21782",,,"Drum Pump 1 Depreiation","Expense","Depreciation Expense",,"Accumulated Depreciation",123.03,"",120474.71
,"General Journal","02-01-2024","21800",,,"Heat Gun Bosch 1 Depreciation","Expense","Depreciation Expense",,"Accumulated Depreciation",100.57,"",120575.28
,"General Journal","02-01-2024","21803",,,"Hot ProcessWater Storage Tank1  Depreciation","Expense","Depreciation Expense",,"Accumulated Depreciation",73.99,"",120649.27
,"General Journal","02-01-2024","21804","*",,"HP Laptop 4 Depreciation","Expense","Depreciation Expense",,"Accumulated Depreciation",297.62,"",120946.89
,"General Journal","02-01-2024","21805","*",,"HP Laptop 8 Depreciation","Expense","Depreciation Expense",,"Accumulated Depreciation",1200.00,"",122146.89
,"General Journal","02-01-2024","21830",,,"Store Racking 1 depreciation","Expense","Depreciation Expense",,"Accumulated Depreciation",175.60,"",122322.49
,"General Journal","02-01-2024","21831",,,"Store Racking 2 Depreciation","Expense","Depreciation Expense",,"Accumulated Depreciation",175.60,"",122498.09
,"General Journal","02-01-2024","21838",,,"Tank platform Depreciation","Expense","Depreciation Expense",,"Accumulated Depreciation",130.95,"",122629.04
,"General Journal","02-01-2024","21842",,,"Water tank 1 Depreciation","Expense","Depreciation Expense",,"Accumulated Depreciation",120.07,"",122749.11
,"General Journal","02-01-2024","21845",,,"Workshop cabinet depreciation","Expense","Depreciation Expense",,"Accumulated Depreciation",172.02,"",122921.13
,"General Journal","03-01-2024","21751",,,"Alarm System extension","Expense","Depreciation Expense",,"Accumulated Depreciation",602.38,"",123523.51
,"General Journal","03-01-2024","21752",,,"Domestos sewing machine depreciation","Expense","Depreciation Expense",,"Acummulated depreciation",82.10,"",123605.61
,"General Journal","03-01-2024","21753",,,"Bench Grinder 2 Depreciation","Expense","Depreciation Expense",,"Accumulated Depreceiation",100.57,"",123706.18
,"General Journal","03-01-2024","21769",,,"CCTV survellance System extension Depreciation","Expense","Depreciation Expense",,"Accumulated Depreciation",657.14,"",124363.32
,"General Journal","03-01-2024","21784",,,"Electrical Enclosure CCTV Depreciation","Expense","Depreciation Expense",,"Accumulated Depreciation",126.19,"",124489.51
,"General Journal","03-01-2024","21785",,,"Electrical Enclosure Main Depreciation","Expense","Depreciation Expense",,"Accumulated Depreciation",2339.29,"",126828.80
,"General Journal","03-01-2024","21786",,,"Electrical Enclosure P Line Depreciation","Expense","Depreciation Expense",,"Accumulated Depreciation",428.57,"",127257.37
,"General Journal","03-01-2024","21791",,,"Floodlight Depreciation","Expense","Depreciation Expense",,"Accumulated Depreciation",59.52,"",127316.89
,"General Journal","03-01-2024","21812",,,"Office Desk 1 Depreciation","Expense","Depreciation Expense",,"Accumulated Depreciation",225.00,"",127541.89
,"General Journal","03-01-2024","21813",,,"Office Desk 2 Depreciation","Expense","Depreciation Expense",,"Accumulated Depreciation",225.00,"",127766.89
,"General Journal","03-01-2024","21814",,,"Office Desk 3 Depreciation","Expense","Depreciation Expense",,"Accumulated Depreciation",225.00,"",127991.89
,"General Journal","03-01-2024","21828",,,"Signet ESD 1 Depreciation","Expense","Depreciation Expense",,"Accumulated Depreciation",928.57,"",128920.46
,"General Journal","03-01-2024","21829","*",,"Sterling Water Dispenser 1 Depreciation","Expense","Depreciation Expense",,"Accumulated Depreciation",119.05,"",129039.51
,"General Journal","03-01-2024","21833",,,"Table top Weighing Scale 5 Depreciation","Expense","Depreciation Expense",,"Accumulated Depreciation",248.57,"",129288.08
,"General Journal","03-01-2024","21834",,,"Table top Weighing Scale 6 Depreciation","Expense","Depreciation Expense",,"Accumulated Depreciation",248.57,"",129536.65
,"General Journal","03-01-2024","21835",,,"Table top Weighing Scale 7 Depreciation","Expense","Depreciation Expense",,"Accumulated Depreciation",248.57,"",129785.22
,"General Journal","03-01-2024","21836",,,"Table top Weighing Scale 8 Depreciation","Expense","Depreciation Expense",,"Accumulated Depreciation",248.57,"",130033.79
,"General Journal","03-01-2024","21837",,,"Table top Weighing Scale 9 Depreciation","Expense","Depreciation Expense",,"Accumulated Depreciation",248.57,"",130282.36
,"General Journal","04-01-2024","21847",,,"9Kg Powder Fire Extinguisher 1 Depreciation","Expense","Depreciation Expense",,"Accumulated Depreciation",34.52,"",130316.88
,"General Journal","04-01-2024","21848",,,"9Kg Powder Fire Extinguisher 2 Depreciation","Expense","Depreciation Expense",,"Accumulated Depreciation",34.52,"",130351.40
,"General Journal","04-01-2024","21849",,,"9Kg Powder Fire Extinguisher 3 Depreciation","Expense","Depreciation Expense",,"Accumulated Depreciation",34.52,"",130385.92
,"General Journal","04-01-2024","21850",,,"9Kg Powder Fire Extinguisher 5 Depreciation","Expense","Depreciation Expense",,"Accumulated Depreciation",34.52,"",130420.44
,"General Journal","04-01-2024","21851",,,"Chiller 2 Depreciation","Expense","Depreciation Expense",,"Accumulated Depreciation",8035.71,"",138456.15
,"General Journal","04-01-2024","21852",,,"Empty IBC Tank 10 Depreciation","Expense","Depreciation Expense",,"Accumulated Depreciation",41.67,"",138497.82
,"General Journal","04-01-2024","21853",,,"Empty IBC Tank 3 Depreciation","Expense","Depreciation Expense",,"Accumulated Depreciation",65.48,"",138563.30
,"General Journal","04-01-2024","21854",,,"Empty IBC Tank 4 Depreciation","Expense","Depreciation Expense",,"Accumulated Depreciation",65.48,"",138628.78
,"General Journal","04-01-2024","21855",,,"Empty IBC Tank 5 Depreciation","Expense","Depreciation Expense",,"Accumulated Depreciation",65.48,"",138694.26
,"General Journal","04-01-2024","21856",,,"Empty IBC Tank 6 Depreciation","Expense","Depreciation Expense",,"Accumulated Depreciation",65.48,"",138759.74
,"General Journal","04-01-2024","21857",,,"Empty IBC Tank 7 Depreciation","Expense","Depreciation Expense",,"Accumulated Depreciation",41.67,"",138801.41
,"General Journal","04-01-2024","21858",,,"Empty IBC Tank 8 Depreciation","Expense","Depreciation Expense",,"Accumulated Depreiation",41.67,"",138843.08
,"General Journal","04-01-2024","21859",,,"Empty IBC Tank 9 Depreciation","Expense","Depreciation Expense",,"Accumulated Depreciation",41.67,"",138884.75
,"General Journal","04-01-2024","21861",,,"Linx 8900 Coder 1 Depreciation","Expense","Depreciation Expense",,"Accumulated Depreciation",8333.33,"",147218.08
,"General Journal","04-01-2024","21862",,,"Mobile Phone 2 Depreciation","Expense","Depreciation Expense",,"Accumulated Depreciation",46.67,"",147264.75
,"General Journal","04-01-2024","21864",,,"Triple UV water purifier 1 Depreciation","Expense","Depreciation Expense",,"Accumulated Depreciation",296.22,"",147560.97
,"General Journal","05-01-2024","21733",,,"Linx 8900 Coder 2 Depreciation","Expense","Depreciation Expense",,"Accumulated Depreciation",12500.00,"",160060.97
,"General Journal","05-01-2024","21865",,,"1Kg Generic Jar Blow Mould 1 depreciation","Expense","Depreciation Expense",,"Accumulated Depreciation",1500.00,"",161560.97
,"General Journal","05-01-2024","21866",,,"1Kg Generic Jar Blow Mould 2 depreciation","Expense","Depreciation Expense",,"Accumulated Depreciation",1500.00,"",163060.97
,"General Journal","05-01-2024","21867",,,"500gm Generic Jar Blow Mould 1 depreciation","Expense","Depreciation Expense",,"Accumulated Depreciation",1071.43,"",164132.40
,"General Journal","05-01-2024","21868",,,"500gm Generic Jar Blow Mould 2 depreciation","Expense","Depreciation Expense",,"Accumulated Depreciation",1071.43,"",165203.83
,"General Journal","05-01-2024","21869",,,"9Kg Powder Fire Extinguisher 4 Depreciation","Expense","Depreciation Expense",,"Accumulated Depreciation",34.52,"",165238.35
,"General Journal","05-01-2024","21880",,,"Extractor Fan 4 Depreciation","Expense","Depreciation Expense",,"Accumulated Depreciation",726.19,"",165964.54
,"General Journal","05-01-2024","21881",,,"FFS  Machine Installation Elct Depreciation","Expense","Depreciation Expense",,"Accumulated Depreciation",200.60,"",166165.14
,"General Journal","05-01-2024","21882",,,"First Aid Kit Depreciation","Expense","Depreciation Expense",,"Accumulated  Depreciation",77.38,"",166242.52
,"General Journal","05-01-2024","21888",,,"Packing Platform Depreciation","Expense","Depreciation Expense",,"Accumulated Depreciation",5297.62,"",171540.14
,"General Journal","05-01-2024","21895",,,"SS Industrial Turntable Depreciation","Expense","Depreciation Expense",,"Accumulated Depreciation",5238.10,"",176778.24
,"General Journal","05-01-2024","21898",,,"TV Screen 2 Depreciation","Expense","Depreciation Expense",,"Accumulated Depreciation",950.00,"",177728.24
,"General Journal","05-01-2024","21900",,,"Water Purifier 1 Depreciation","Expense","Depreciation Expense",,"Accumulated Depreciation",117.10,"",177845.34
,"General Journal","05-01-2024","21901",,,"Water tank 2 Depreciation","Expense","Depreciation Expense",,"Accumulated Depreciation",23.81,"",177869.15
,"General Journal","06-01-2024","21873",,,"Blower Depreciation","Expense","Depreciation Expense",,"Accumulated Depreciation",59.52,"",177928.67
,"General Journal","06-01-2024","21879",,,"Emergency Washing Point Depreciation","Expense","Depreciation Expense",,"Accumulated Deprecation",160.71,"",178089.38
,"General Journal","06-01-2024","21885","*",,"Infrared Thermometre 1 Depreciation","Expense","Depreciation Expense",,"Accumulated Depreciation",416.67,"",178506.05
,"General Journal","06-01-2024","21886",,,"Material's Trolley Depreciation","Expense","Depreciation Expense",,"Accumulated Depreciation",297.62,"",178803.67
,"General Journal","06-01-2024","21892",,,"Plastic Scrap Grinder Machine Depreciation","Expense","Depreciation Expense",,"Accumulated  Depreciation",3452.38,"",182256.05
,"General Journal","06-01-2024","21894",,,"Ribon Mixer SS depreciation","Expense","Depreciation Expense",,"Accumulated depreciation",4642.86,"",186898.91
,"General Journal","06-01-2024","21896",,,"Telephone Handset Depreciation","Expense","Depreciation Expense",,"Accumulated Depreciation",29.76,"",186928.67
,"General Journal","06-01-2024","21897",,,"Telkom Wifi Router Depreciation","Expense","Depreciation Expense",,"Accumulated Depreciation",71.43,"",187000.10
,"General Journal","06-01-2024","21899",,,"Vacuum Cleaner Depreciation","Expense","Depreciation Expense",,"Accumulated Depreciation",148.81,"",187148.91
,"General Journal","07-01-2024","21870",,,"9Kg Powder Fire Extinguisher 6 Depreciation","Expense","Depreciation Expense",,"Accumulated Depreciation",44.05,"",187192.96
,"General Journal","07-01-2024","21872",,,"Big bag trolley 1 Depreciation","Expense","Depreciation Expense",,"Accumulated Depreciation",344.29,"",187537.25
,"General Journal","07-01-2024","21874",,,"Cartoning table 4 depreciation","Expense","Depreciation Expense",,"Accumulated Depreciation",262.49,"",187799.74
,"General Journal","07-01-2024","21875",,,"Case sealing table depreciation","Expense","Depreciation Expense",,"Accumulated Depreciation",86.67,"",187886.41
,"General Journal","07-01-2024","21876",,,"Chain block 2 depreciation","Expense","Depreciation Expense",,"Accumulated depreciation",398.81,"",188285.22
,"General Journal","07-01-2024","21877",,,"Chain block 3 depreciation","Expense","Depreciation Expense",,"Accumulated depreciation",398.81,"",188684.03
,"General Journal","07-01-2024","21878",,,"Drilling machine Depreciation","Expense","Depreciation Expense",,"Accumulated Depreciation",88.39,"",188772.42
,"General Journal","07-01-2024","21883",,,"Grinder Depreciation","Expense","Depreciation Expense",,"Acccumulated Depreciation",159.82,"",188932.24
,"General Journal","07-01-2024","21889",,,"Packing table 1 depreciation","Expense","Depreciation Expense",,"Accumulated Depreciation",262.49,"",189194.73
,"General Journal","07-01-2024","21890",,,"Packing table 2 depreciation","Expense","Depreciation Expense",,"Accumulated Depreciation",262.49,"",189457.22
,"General Journal","07-01-2024","21891",,,"Packing table 3 depreciation","Expense","Depreciation Expense",,"Accumulated Depreciation",262.49,"",189719.71
,"General Journal","07-01-2024","21893",,,"Quality table depreciation","Expense","Depreciation Expense",,"Accumulated Depreciation",86.67,"",189806.38
,"General Journal","07-01-2024","21902",,,"Welding machine Depreciation","Expense","Depreciation Expense",,"Accumulated Depreciation",178.57,"",189984.95
,"General Journal","08-01-2024","21871",,,"Bench Grinder 350W Depreciation","Expense","Depreciation Expense",,"Accumulated Depreciation",122.13,"",190107.08
,"General Journal","08-01-2024","21884",,,"HP Laptop 6 Depreciation","Expense","Depreciation Expense",,"Accumulated Depreciation",416.67,"",190523.75
,"General Journal","08-01-2024","21887",,,"Mobile Phone 1 Depreciation","Expense","Depreciation Expense",,"Accumulated Depreciation",58.33,"",190582.08
,"General Journal","09-01-2024","21903",,,"Canteen Table 1 Depreciation","Expense","Depreciation Expense",,"Accumulated Depreciation",184.52,"",190766.60
,"General Journal","09-01-2024","21904",,,"Canteen Table 2 Depreciation","Expense","Depreciation Expense",,"Accumulated Depreciation",184.52,"",190951.12
,"General Journal","09-01-2024","21905",,,"Dell Desktop 1 Depreciation","Expense","Depreciation Expense",,"Accumulated Depreciation",178.57,"",191129.69
,"General Journal","09-01-2024","21906",,,"Fire Alarm System Extension'19 Depreciation","Expense","Depreciation Expense",,"Accumulated Depreciation",9857.14,"",200986.83
,"General Journal","09-01-2024","21907",,,"Floor Chair 1 Depreciation","Expense","Depreciation Expense",,"Accumulated Depreciation",26.79,"",201013.62
,"General Journal","09-01-2024","21908",,,"Floor Chair 10 Depreciation","Expense","Depreciation Expense",,"Accumulated Depreciation",53.57,"",201067.19
,"General Journal","09-01-2024","21909",,,"Floor Chair 2 Depreciation","Expense","Depreciation Expense",,"Accumulated Depreciation",26.79,"",201093.98
,"General Journal","09-01-2024","21910",,,"Floor Chair 3 Depreciation","Expense","Depreciation Expense",,"Accumulated Depreciation",26.79,"",201120.77
,"General Journal","09-01-2024","21911",,,"Floor Chair 4 Depreciation","Expense","Depreciation Expense",,"Accumulated Depreciation",26.79,"",201147.56
,"General Journal","09-01-2024","21912",,,"Floor Chair 5 Depreciation","Expense","Depreciation Expense",,"Accumulated Depreciation",26.79,"",201174.35
,"General Journal","09-01-2024","21913",,,"Floor Chair 6 Depreciation","Expense","Depreciation Expense",,"Accumulated Depreciation",53.57,"",201227.92
,"General Journal","09-01-2024","21914",,,"Floor Chair 7 Depreciation","Expense","Depreciation Expense",,"Accumulated Depreciation",53.57,"",201281.49
,"General Journal","09-01-2024","21915",,,"Floor Chair 8 Depreciation","Expense","Depreciation Expense",,"Accumulated Depreciation",53.57,"",201335.06
,"General Journal","09-01-2024","21916",,,"Floor Chair 9 Depreciation","Expense","Depreciation Expense",,"Accumulated Depreciation",53.57,"",201388.63
,"General Journal","09-01-2024","21917",,,"Floor weighing scale Depreciation","Expense","Depreciation Expense",,"Accumulated Depreciation",593.81,"",201982.44
,"General Journal","09-01-2024","21918",,,"Lab Office Chair 1 Depreciation","Expense","Depreciation Expense",,"Accumulated Depreciation",47.62,"",202030.06
,"General Journal","09-01-2024","21919",,,"Lab Office Chair 2 Depreciation","Expense","Depreciation Expense",,"Accumulated Depreciation",47.62,"",202077.68
,"General Journal","09-01-2024","21920",,,"Lab Office Chair 3 Depreciation","Expense","Depreciation Expense",,"Accumulated Depreciation",47.62,"",202125.30
,"General Journal","09-01-2024","21921","*","Unilever Kenya Ltd:Sunlight Washing Pwd","Sunlight Bag Closing Machine 1 Depreciation","Expense","Depreciation Expense",,"Accumulated Depreciation",738.10,"",202863.40
,"General Journal","09-01-2024","21922","*","Unilever Kenya Ltd:Sunlight Washing Pwd","Sunlight Packing Chair 1 Depreciation","Expense","Depreciation Expense",,"Accumulated Depreciation",41.67,"",202905.07
,"General Journal","10-01-2024","21923",,,"5Kg Fire Extinguisher 1 Depreciation","Expense","Depreciation Expense",,"Accumulated Depreciation",65.48,"",202970.55
,"General Journal","10-01-2024","21924",,,"HP Laptop 10 Depreciation","Expense","Depreciation Expense",,"Accumulated Depreciation",1200.00,"",204170.55
,"General Journal","10-01-2024","21925",,,"HP Laptop 9 Depreciation","Expense","Depreciation Expense",,"Accumulated Depreciation",1200.00,"",205370.55
,"General Journal","10-01-2024","21926",,,"Office Seat 1 Depreciation","Expense","Depreciation Expense",,"Accumulated Depreciation",142.86,"",205513.41
,"General Journal","10-01-2024","21927",,,"Office Seat 2 Depreciation","Expense","Depreciation Expense",,"Accumulated Depreciation",71.43,"",205584.84
,"General Journal","10-01-2024","21928",,,"Office Seat 3 Depreciation","Expense","Depreciation Expense",,"Accumulated Depreciation",71.43,"",205656.27
,"General Journal","10-01-2024","21929",,,"Reverse Osmosis Unit 1 Depreciation","Expense","Depreciation Expense",,"Accumulated Depreciation",416.67,"",206072.94
,"General Journal","10-01-2024","21930",,,"Steam Generator SG24 Depreciation","Expense","Depreciation Expense",,"Accumulated Depreciation",3794.53,"",209867.47
,"General Journal","10-01-2024","21931",,,"Toilet Cleaner Mixing Machine Depreciation","Expense","Depreciation Expense",,"Accumulated Depreciation",6333.33,"",216200.80
,"General Journal","11-01-2024","21948",,,"4 GB hard drive for CCTV Depreciation","Expense","Depreciation Expense",,"Accumulated Depreciation",178.57,"",216379.37
,"General Journal","11-01-2024","21949",,,"4TB Hard Disk Depreciation","Expense","Depreciation Expense",,"Accumulated Depreciation",178.57,"",216557.94
,"General Journal","11-01-2024","21950","*","Unilever Kenya Ltd:Sunlight Washing Pwd","Chain block trolley 4 depreciation","Expense","Depreciation Expense",,"Accumulated Depreciation",85.00,"",216642.94
,"General Journal","11-01-2024","21951",,,"Coder Depreciation","Expense","Depreciation Expense",,"Accumulated Depreciation",2261.90,"",218904.84
,"General Journal","11-01-2024","21952",,,"Coder Stand Depreciation","Expense","Depreciation Expense",,"Accumulated Depreciation",59.52,"",218964.36
,"General Journal","11-01-2024","21953",,,"Compressor 1 depreciation","Expense","Depreciation Expense",,"Accumulated depreciation",3750.00,"",222714.36
,"General Journal","11-01-2024","21954",,,"HP Laptop 14 Depreciation","Expense","Depreciation Expense",,"Accumulated Depreciation",1941.67,"",224656.03
,"General Journal","11-01-2024","21955",,,"HP Laptop 15 Depreciation","Expense","Depreciation Expense",,"Accumulated Depreciation",1750.00,"",226406.03
,"General Journal","11-01-2024","21956",,,"Pallet truck 2 depreciation","Expense","Depreciation Expense",,"Accumulated depreciation",440.48,"",226846.51
,"General Journal","11-01-2024","21957","*",,"Steam Label Shrink Tunnel Depreciation","Expense","Depreciation Expense",,"Accumulated  Depreciation",10952.38,"",237798.89
,"General Journal","12-01-2024","21969",,,"Coder Housing Depreciation","Expense","Depreciation Expense",,"Accumulated Depreciation",80.36,"",237879.25
,"General Journal","12-01-2024","21970","*","Unilever Kenya Ltd:Sunlight Washing Pwd","Coder UPS 4 Depreciation","Expense","Depreciation Expense",,"Accumulated Depreciation",158.33,"",238037.58
,"General Journal","12-01-2024","21971",,,"Coding Conveyor Depreciation","Expense","Depreciation Expense",,"Accumulated Depreciation",476.19,"",238513.77
,"General Journal","12-01-2024","21972",,,"Conveyor 2 Depreciation","Expense","Depreciation Expense",,"Accumulated  Depreciation",169.64,"",238683.41
,"General Journal","12-01-2024","21973",,,"Eyewash Station 1 Depreciation","Expense","Depreciation Expense",,"Accumulated Depreciation",904.76,"",239588.17
,"General Journal","12-01-2024","21974",,,"HP Laptop 5 Depreciation","Expense","Depreciation Expense",,"Accumulated Depreciation",416.67,"",240004.84
,"General Journal","12-01-2024","21975",,,"Tea maker Depreciation","Expense","Depreciation Expense",,"Accumulated Depreciation",225.00,"",240229.84
,"General Journal","13-01-2024","21732",,,"Coder UPS 8 Depreciation","Expense","Depreciation Expense",,"Accumulated Depreciation",81.67,"",240311.51
,"General Journal","13-01-2024","21739",,,"Bosch Blower 2 Depreciation","Expense","Depreciation Expense",,"Accumulated Depreciation",136.49,"",240448.00
,"General Journal","13-01-2024","21979",,,"Alarm System Depreciation","Expense","Depreciation Expense",,"Accumulated Depreciation",580.95,"",241028.95
,"General Journal","13-01-2024","22013",,,"Coder UPS 8 Depreciation","Expense","Depreciation Expense",,"Accumulated Depreciation",81.67,"",241110.62
,"General Journal","13-01-2024","22025","*",,"HP Laptop 16 Depreciation","Expense","Depreciation Expense",,"Accumulated Depreciation",1000.00,"",242110.62
,"General Journal","13-01-2024","22029",,,"PIR system extension Depreciation","Expense","Depreciation Expense",,"Accumulated Depreciation",254.67,"",242365.29
,"General Journal","13-01-2024","22030",,,"Process Water Storage Tank Depreciation","Expense","Depreciation Expense",,"Accumulated Depreciation",1065.16,"",243430.45
,"General Journal","13-01-2024","22031","*",,"Store Racking 3 FG Depreciation","Expense","Depreciation Expense",,"Accumulated Depreciation",9791.67,"",253222.12
,"General Journal","13-01-2024","22035",,,"Weighing scale 1","Expense","Depreciation Expense",,"Accumulated Depreciation",559.52,"",253781.64
,"General Journal","14-01-2024","21731",,,"Paste Packing Machine Depreciation","Expense","Depreciation Expense",,"Accumulated Depreciation",4166.67,"",257948.31
,"General Journal","14-01-2024","22012",,,"Coder UPS 5 Depreciation","Expense","Depreciation Expense",,"Accumulated Depreciation",158.33,"",258106.64
,"General Journal","14-01-2024","22027",,,"Motor Vehicle 2 Depreciation","Expense","Depreciation Expense",,"Accumulated Depreciation",10297.62,"",268404.26
,"General Journal","14-01-2024","22032",,,"Table Top Scale 10  SS 15Kg Depreciation","Expense","Depreciation Expense",,"Accumulated Depreciation",297.62,"",268701.88
,"General Journal","15-01-2024","21976",,,"150KVA Enclosed Genset Depreciation","Expense","Depreciation Expense",,"Accumulated Depreciation",24404.76,"",293106.64
,"General Journal","15-01-2024","21977",,,"20Kg Forklift Gas Cylinder 2 Depreciation","Expense","Depreciation Expense",,"Accumulated Depreciation",769.70,"",293876.34
,"General Journal","15-01-2024","21978",,,"2Ton Electric Hoist 1 Depreciation","Expense","Depreciation Expense",,"Accumulated Depreciation",3708.33,"",297584.67
,"General Journal","15-01-2024","21980",,,"Automatic Change Over Switch 1 Depreciation","Expense","Depreciation Expense",,"Accumulated Depreciation",1666.67,"",299251.34
,"General Journal","15-01-2024","21981",,,"Bench top Weighing Scale 1 Depreciation","Expense","Depreciation Expense",,"Accumulated Depreciation",357.14,"",299608.48
,"General Journal","15-01-2024","21982",,,"Bench top Weighing Scale 2 Depreciation","Expense","Depreciation Expense",,"Accumulated Depreciation",357.14,"",299965.62
,"General Journal","15-01-2024","21983",,,"Bench top Weighing Scale 3 Depreciation","Expense","Depreciation Expense",,"Accumulated Depreciation",357.14,"",300322.76
,"General Journal","15-01-2024","21984",,,"Bench top Weighing Scale 4 Depreciation","Expense","Depreciation Expense",,"Accumulated Depreciation",357.14,"",300679.90
,"General Journal","15-01-2024","21985",,,"Board room chair 3 Depreciation","Expense","Depreciation Expense",,"Accumulated Depreciation",59.52,"",300739.42
,"General Journal","15-01-2024","21986",,,"Bosch Blower Depreciation","Expense","Depreciation Expense",,"Accumulated Depreciation",129.31,"",300868.73
,"General Journal","15-01-2024","21987",,,"Canteen Chair 1 Depreciation","Expense","Depreciation Expense",,"Accumulated Depreciation",6.12,"",300874.85
,"General Journal","15-01-2024","21988",,,"Canteen Chair 10 Depreciation","Expense","Depreciation Expense",,"Accumulated Depreciation",6.12,"",300880.97
,"General Journal","15-01-2024","21989",,,"Canteen Chair 11 Depreciation","Expense","Depreciation Expense",,"Accumulated Depreciation",6.12,"",300887.09
,"General Journal","15-01-2024","21990",,,"Canteen Chair 11 Depreciation","Expense","Depreciation Expense",,"Accumulated Depreciation",6.12,"",300893.21
,"General Journal","15-01-2024","21991",,,"Canteen Chair 12 Depreciation","Expense","Depreciation Expense",,"Accumulated Depreciation",6.12,"",300899.33
,"General Journal","15-01-2024","21992",,,"Canteen Chair 13 Depreciation","Expense","Depreciation Expense",,"Accumulated Depreciation",6.12,"",300905.45
,"General Journal","15-01-2024","21993",,,"Canteen Chair 14 Depreciation","Expense","Depreciation Expense",,"Accumulated Depreciation",6.12,"",300911.57
,"General Journal","15-01-2024","21994",,,"Canteen Chair 15 Depreciation","Expense","Depreciation Expense",,"Accumulated Depreciation",6.12,"",300917.69
,"General Journal","15-01-2024","21995",,,"Canteen Chair 16 Depreciation","Expense","Depreciation Expense",,"Accumulated Depreciation",6.12,"",300923.81
,"General Journal","15-01-2024","21996",,,"Canteen Chair 17 Depreciation","Expense","Depreciation Expense",,"Accumulated Depreciation",6.12,"",300929.93
,"General Journal","15-01-2024","21997",,,"Canteen Chair 18 Depreciation","Expense","Depreciation Expense",,"Accumulated Depreciation",6.12,"",300936.05
,"General Journal","15-01-2024","21998",,,"Canteen Chair 19 Depreciation","Expense","Depreciation Expense",,"Accumulated Depreciation",6.12,"",300942.17
,"General Journal","15-01-2024","21999",,,"Canteen Chair 2 Depreciation","Expense","Depreciation Expense",,"Accumulated Depreciation",6.12,"",300948.29
,"General Journal","15-01-2024","22000",,,"Canteen Chair 21 Depreciation","Expense","Depreciation Expense",,"Accumulated Depreciation",6.12,"",300954.41
,"General Journal","15-01-2024","22001",,,"Canteen Chair 22 Depreciation","Expense","Depreciation Expense",,"Accumulated Depreciation",6.12,"",300960.53
,"General Journal","15-01-2024","22002",,,"Canteen Chair 23 Depreciation","Expense","Depreciation Expense",,"Accumulated Depreciation",6.12,"",300966.65
,"General Journal","15-01-2024","22003",,,"Canteen Chair 24 Depreciation","Expense","Depreciation Expense",,"Accumulated Depreciation",6.12,"",300972.77
,"General Journal","15-01-2024","22004",,,"Canteen Chair 25 Depreciation","Expense","Depreciation Expense",,"Accumulated Depreciation",6.12,"",300978.89
,"General Journal","15-01-2024","22005",,,"Canteen Chair 3 Depreciation","Expense","Depreciation Expense",,"Accumulated Depreciation",6.12,"",300985.01
,"General Journal","15-01-2024","22006",,,"Canteen Chair 4 Depreciation","Expense","Depreciation Expense",,"Accumulated Depreciation",6.12,"",300991.13
,"General Journal","15-01-2024","22007",,,"Canteen Chair 5 Depreciation","Expense","Depreciation Expense",,"Accumulated Depreciation",6.12,"",300997.25
,"General Journal","15-01-2024","22008",,,"Canteen Chair 6 Depreciation","Expense","Depreciation Expense",,"Accumulated Depreciation",6.12,"",301003.37
,"General Journal","15-01-2024","22009",,,"Canteen Chair 7 Depreciation","Expense","Depreciation Expense",,"Accumulated Depreciation",6.12,"",301009.49
,"General Journal","15-01-2024","22010",,,"Canteen Chair 8 Depreciation","Expense","Depreciation Expense",,"Accumulated Depreciation",6.12,"",301015.61
,"General Journal","15-01-2024","22011",,,"Canteen Chair 9 Depreciation","Expense","Depreciation Expense",,"Accumulated Depreciation",6.12,"",301021.73
,"General Journal","15-01-2024","22014",,,"EOL Case sealer Outfeed Conveyor Depreciation","Expense","Depreciation Expense",,"Accumulated Depreciation",297.62,"",301319.35
,"General Journal","15-01-2024","22015",,,"Epson L6190 Printer 1 Depreciation","Expense","Depreciation Expense",,"Accumulated Depreciation",654.76,"",301974.11
,"General Journal","15-01-2024","22016",,,"Fire Extinguisher 1 Depreciation","Expense","Depreciation Expense",,"Accumulated Depreciation",77.38,"",302051.49
,"General Journal","15-01-2024","22017",,,"Fire Extinguisher 2 Depreciation","Expense","Depreciation Expense",,"Accumulated Depreciation",77.38,"",302128.87
,"General Journal","15-01-2024","22018",,,"Fire Extinguisher 3 Depreciation","Expense","Depreciation Expense",,"Accumulated Depreciation",77.38,"",302206.25
,"General Journal","15-01-2024","22019",,,"Fire Extinguisher 4 Depreciation","Expense","Depreciation Expense",,"Accumulated Depreciation",77.38,"",302283.63
,"General Journal","15-01-2024","22020",,,"Fire Extinguisher 5 Depreciation","Expense","Depreciation Expense",,"Accumulated Depreciation",77.38,"",302361.01
,"General Journal","15-01-2024","22021",,,"Fire Extinguisher 6 Depreciation","Expense","Depreciation Expense",,"Accumulated Depreciation",77.38,"",302438.39
,"General Journal","15-01-2024","22022",,,"Grinder 2 Depreciation","Expense","Depreciation Expense",,"Accumulated Depreciation",178.57,"",302616.96
,"General Journal","15-01-2024","22023",,,"HP Laptop 11 Depreciation","Expense","Depreciation Expense",,"Accumulated Depreciation",1200.00,"",303816.96
,"General Journal","15-01-2024","22024",,,"HP Laptop 12 Depreciation","Expense","Depreciation Expense",,"Accumulated Depreciation",1200.00,"",305016.96
,"General Journal","15-01-2024","22026",,,"Microwave 2 Depreciation","Expense","Depreciation Expense",,"Accumulated Depreciation",147.27,"",305164.23
,"General Journal","15-01-2024","22028",,,"Movable Ladder 1 Depreciation","Expense","Depreciation Expense",,"Accumulated Depreciation",434.52,"",305598.75
,"General Journal","15-01-2024","22033",,,"UV water purifier 3 Depreciation","Expense","Depreciation Expense",,"Accumulated Depreciation",543.10,"",306141.85
,"General Journal","15-01-2024","22034",,,"Water tank 6 Depreciation","Expense","Depreciation Expense",,"Accumulated Depreciation",71.84,"",306213.69
,"General Journal","16-01-2024","22036",,,"Bosch Grinder 3 Depreciation","Expense","Depreciation Expense",,"Accumulated Depreceiation",86.21,"",306299.90
,"General Journal","16-01-2024","22037",,,"Canteen Chair 20 Depreciation","Expense","Depreciation Expense",,"Accumulated Depreciation",6.12,"",306306.02
,"General Journal","16-01-2024","22038",,,"Chain block 5 depreciation","Expense","Depreciation Expense",,"Accumulated Depreciation",292.49,"",306598.51
,"General Journal","16-01-2024","22039",,,"Chain block 6 depreciation","Expense","Depreciation Expense",,"Accumulated Depreciation",292.49,"",306891.00
,"General Journal","16-01-2024","22040",,,"Heat Gun Total 1 Depreciation","Expense","Depreciation Expense",,"Accumulated Depreciation",64.66,"",306955.66
,"General Journal","16-01-2024","22041",,,"Linx 5900 Coder 1 Depreciation","Expense","Depreciation Expense",,"Accumulated Depreciation",4166.67,"",311122.33
,"General Journal","16-01-2024","22042",,,"Table Top Scale 11 6Kg Depreciation","Expense","Depreciation Expense",,"Accumulated Depreciation",277.09,"",311399.42
,"General Journal","16-01-2024","22043",,,"Washing Machine 1 Depreciation","Expense","Depreciation Expense",,"Accumulated Depreciation",2640.01,"",314039.43
,"General Journal","17-01-2024","22044",,,"2T Mixer Depreciation","Expense","Depreciation Expense",,"Accumulated Depreciation",12633.99,"",326673.42
,"General Journal","17-01-2024","22045",,,"2T Mixer Installation Depreciation","Expense","Depreciation Expense",,"Accumulated Depreciation",29713.15,"",356386.57
,"General Journal","17-01-2024","22046",,,"Coder UPS 6 Depreciation","Expense","Depreciation Expense",,"Accumulated Depreciation",94.83,"",356481.40
,"General Journal","17-01-2024","22047",,,"Coder UPS 7 Depreciation","Expense","Depreciation Expense",,"Accumulated Depreciation",94.83,"",356576.23
,"General Journal","17-01-2024","22048","*",,"Hand Dryer 1 Depreciation","Expense","Depreciation Expense",,"Accumulated Depreciation",46.18,"",356622.41
,"General Journal","17-01-2024","22049","*",,"HP Laptop 3 Depreciation","Expense","Depreciation Expense",,"Accumulated Depreciation",297.62,"",356920.03
,"General Journal","17-01-2024","22050",,,"Office desks  4","Expense","Depreciation Expense",,"Accumulated Depreciation",361.90,"",357281.93
,"General Journal","17-01-2024","22051",,,"Pallet truck 4 Depreciation","Expense","Depreciation Expense",,"Accumulated Depreciation",428.57,"",357710.50
,"General Journal","17-01-2024","22052",,,"Pallet truck 5 Depreciation","Expense","Depreciation Expense",,"Accumulated Depreciation",428.57,"",358139.07
,"General Journal","17-01-2024","22053",,,"Recirculation Pump Depreciation","Expense","Depreciation Expense",,"Accumulated  Depreciation",71.19,"",358210.26
,"General Journal","17-01-2024","22054",,,"Server 1 Depreciation","Expense","Depreciation Expense",,"Accumulated Depreciation",357.14,"",358567.40
,"General Journal","17-01-2024","22055",,,"Server Monitor Depreciation","Expense","Depreciation Expense",,"Accumulated Depreciaion",107.14,"",358674.54
,"General Journal","17-01-2024","22056",,,"Shrink Tunnel Depreciation","Expense","Depreciation Expense",,"Accumulated Depreciation",3750.00,"",362424.54
,"General Journal","17-01-2024","22057","*",,"Soap Dispenser 1 Depreciation","Expense","Depreciation Expense",,"Accumulated Depreciation",15.39,"",362439.93
,"General Journal","17-01-2024","22058","*",,"TP Link 3 Depreciation","Expense","Depreciation Expense",,"Accumulated Depreciation",33.33,"",362473.26
,"General Journal","17-01-2024","22059","*",,"Water Tank 3 Depreciation","Expense","Depreciation Expense",,"Accumulated Depreciation",123.15,"",362596.41
,"General Journal","18-01-2024","22061",,,"Carton Sealer Manual 1 Depreciation","Expense","Depreciation Expense",,"Accumulated Depreciation",14.80,"",362611.21
,"General Journal","18-01-2024","22063",,,"Compressor 3 Depreciation","Expense","Depreciation Expense",,"Accumulated Depreciation",5357.14,"",367968.35
,"General Journal","18-01-2024","22064",,,"Compressor room depreciation","Expense","Depreciation Expense",,"Accumulated depreciation",132.44,"",368100.79
,"General Journal","18-01-2024","22065",,,"Electric Hoist 1 depreciation","Expense","Depreciation Expense",,"Accumulated depreciation",3452.38,"",371553.17
,"General Journal","18-01-2024","22066",,,"Gents changing room Lockers Depreciation","Expense","Depreciation Expense",,"Accumulated Depreciation",386.90,"",371940.07
,"General Journal","18-01-2024","22068",,,"Ladies changing room Lockers Depreciation","Expense","Depreciation Expense",,"Accumulated Depreciation",411.90,"",372351.97
,"General Journal","18-01-2024","22069",,,"Omrom M1 Basic BP Monitor Depreciation","Expense","Depreciation Expense",,"Accumulated Depreciation",58.33,"",372410.30
,"General Journal","18-01-2024","22070",,,"SS Hand Washing Station 1 Depreciation","Expense","Depreciation Expense",,"Accumulated Depreciation",690.48,"",373100.78
,"General Journal","18-01-2024","22071",,,"TP Link 2 Depreciation","Expense","Depreciation Expense",,"Accumulated Depreciation",41.67,"",373142.45
,"General Journal","19-01-2024","22060",,,"3T Gas Forklift 1 Depreciation","Expense","Depreciation Expense",,"Accumulated Depreciation",30952.38,"",404094.83
,"General Journal","19-01-2024","22062",,,"Coding Stamp 3 Depreciation","Expense","Depreciation Expense",,"Accumulated Depreciation",143.68,"",404238.51
,"General Journal","19-01-2024","22067",,,"HP Laptop 2 Depreciation","Expense","Depreciation Expense",,"Accumulated Depreciation",392.86,"",404631.37
,"General Journal","20-01-2024","21736",,,"Bosch Blower 5 Depreciation","Expense","Depreciation Expense",,"Accumulated Depreciation",136.49,"",404767.86
,"General Journal","20-01-2024","21737",,,"Bosch Blower 4 Depreciation","Expense","Depreciation Expense",,"Accumulated Depreciation",136.49,"",404904.35
,"General Journal","20-01-2024","21738",,,"Bosch Blower 3 Depreciation","Expense","Depreciation Expense",,"Accumulated Depreciation",79.02,"",404983.37
,"General Journal","20-01-2024","22084","*","Unilever Kenya Ltd:Sunlight Washing Pwd","Boato Commisioning Depreciation","Expense","Depreciation Expense",,"Accumulated Depreciation",889.88,"",405873.25
,"General Journal","20-01-2024","22086",,,"Conference Office Desk 1 Depreciation","Expense","Depreciation Expense",,"Accumulated Depreciation",416.67,"",406289.92
,"General Journal","20-01-2024","22091",,,"Floor Chair 17 depreciation","Expense","Depreciation Expense",,"Accumulated Depreciation",20.24,"",406310.16
,"General Journal","20-01-2024","22092",,,"Floor Chair 18 depreciation","Expense","Depreciation Expense",,"Accumulated Depreciation",20.24,"",406330.40
,"General Journal","20-01-2024","22093",,,"Floor Chair 19 depreciation","Expense","Depreciation Expense",,"Accumulated Depreciation",20.24,"",406350.64
,"General Journal","20-01-2024","22094",,,"Floor Chair 20 depreciation","Expense","Depreciation Expense",,"Accumulated Depreciation",20.24,"",406370.88
,"General Journal","20-01-2024","22095",,,"Heat Gun CAT Digital 1 Depreciation","Expense","Depreciation Expense",,"Accumulated Depreciation",136.49,"",406507.37
,"General Journal","20-01-2024","22099","*",,"Lumnia 1 Pro Insect Trap Depreciation","Expense","Depreciation Expense",,"Accumulated Depreciation",316.67,"",406824.04
,"General Journal","20-01-2024","22103",,,"PF Correction Unit Depreciation","Expense","Depreciation Expense",,"Accumulated Depreciation",1708.33,"",408532.37
,"General Journal","21-01-2024","22072",,,"5Kg CO2 Fire Extinguisher 2 Depreciation","Expense","Depreciation Expense",,"Accumulated Depreciation",73.81,"",408606.18
,"General Journal","21-01-2024","22075",,,"6Kg Dry Pwd Fire Extinguisher 1 Depreciaiton","Expense","Depreciation Expense",,"Accumulated Depreciation",59.52,"",408665.70
,"General Journal","21-01-2024","22077",,,"Board room chair 1 Depreciation","Expense","Depreciation Expense",,"Accumulated Depreciation",59.52,"",408725.22
,"General Journal","21-01-2024","22078",,,"Board room chair 2 Depreciation","Expense","Depreciation Expense",,"Accumulated Depreciation",59.52,"",408784.74
,"General Journal","21-01-2024","22079",,,"Board room chair 4 Depreciation","Expense","Depreciation Expense",,"Accumulated Depreciation",59.52,"",408844.26
,"General Journal","21-01-2024","22080",,,"Board room chair 5 Depreciation","Expense","Depreciation Expense",,"Accumulated Depreciation",59.52,"",408903.78
,"General Journal","21-01-2024","22081",,,"Board room chair 6 Depreciation","Expense","Depreciation Expense",,"Accumulated Depreciation",59.52,"",408963.30
,"General Journal","21-01-2024","22082",,,"Board room chair 7 Depreciation","Expense","Depreciation Expense",,"Accumulated Depreciation",59.52,"",409022.82
,"General Journal","21-01-2024","22083",,,"Board room chair 8 Depreciation","Expense","Depreciation Expense",,"Accumulated Depreciation",59.52,"",409082.34
,"General Journal","21-01-2024","22085",,,"Coding Stamp 2 Depreciation","Expense","Depreciation Expense",,"Accumulated Depreciation",133.33,"",409215.67
,"General Journal","21-01-2024","22088",,,"IBC Tank 1 Depreciation","Expense","Depreciation Expense",,"Accumulated Depreciation",41.67,"",409257.34
,"General Journal","21-01-2024","22089",,,"Empty IBC Tank 2 Depreciation","Expense","Depreciation Expense",,"Accumulated Depreciation",65.48,"",409322.82
,"General Journal","21-01-2024","22090",,,"FFS Filling Machine 300 1 Depreciation","Expense","Depreciation Expense",,"Accumulated Depreciation",11850.01,"",421172.83
,"General Journal","21-01-2024","22098",,,"Laboratory Oven & Dessicator  Depreciation","Expense","Depreciation Expense",,"Accumulated Depreciation",766.67,"",421939.50
,"General Journal","21-01-2024","22100",,,"Nikon D3500 Camera 1 Depreciation","Expense","Depreciation Expense",,"Accumulated Depreciation",766.67,"",422706.17
,"General Journal","21-01-2024","22106",,,"Tea Urn Depreciation","Expense","Depreciation Expense",,"Accumulated Depreciation",121.67,"",422827.84
,"General Journal","22-01-2024","22073",,,"6Kg Auto Fire Extinguisher 1 Depreciation","Expense","Depreciation Expense",,"Accumulated Depreciation",53.57,"",422881.41
,"General Journal","22-01-2024","22074",,,"6Kg Auto Fire Extinguisher 2 Depreciation","Expense","Depreciation Expense",,"Accumulated Depreciation",53.57,"",422934.98
,"General Journal","22-01-2024","22076","*",,"AVS Voltage Stabilizer Depreciation","Expense","Depreciation Expense",,"Accumulated Depreciation",63.10,"",422998.08
,"General Journal","22-01-2024","22087",,,"Conveyor Belt Green 1 Depreciation","Expense","Depreciation Expense",,"Accumulated Depreciation",82.14,"",423080.22
,"General Journal","22-01-2024","22096",,,"HP Laptop 13 Depreciation","Expense","Depreciation Expense",,"Accumulated Depreciation",1200.00,"",424280.22
,"General Journal","22-01-2024","22097","*",,"HP Laptop 7 Depreciation","Expense","Depreciation Expense",,"Accumulated Depreciation",1200.00,"",425480.22
,"General Journal","22-01-2024","22101",,,"Office Desk 5 Depreciation","Expense","Depreciation Expense",,"Accumulated Depreciation",180.95,"",425661.17
,"General Journal","22-01-2024","22102",,,"Office cabinets depreciation","Expense","Depreciation Expense",,"Accumulated Depreciation",119.05,"",425780.22
,"General Journal","22-01-2024","22104",,,"Platform Scale 2 SS 100Kg Depreciation","Expense","Depreciation Expense",,"Accumulated Depreciation",339.29,"",426119.51
,"General Journal","22-01-2024","22105",,,"Solar Water Heater 300L Depreciation","Expense","Depreciation Expense",,"Accumulated Depreciation",3125.00,"",429244.51
,"General Journal","23-01-2024","22107",,,"Analytical Balance Depreciation","Expense","Depreciation Expense",,"Accumulated Depreciation",2405.58,"",431650.09
,"General Journal","23-01-2024","22108",,,"Auger Filler 1 Depreciation","Expense","Depreciation Expense",,"Accumulated Depreciation",7220.12,"",438870.21
,"General Journal","23-01-2024","22109",,,"Auger Filler 2 Depreciation","Expense","Depreciation Expense",,"Accumulated Depreciation",13258.63,"",452128.84
,"General Journal","23-01-2024","22110",,,"Auger Filler 3 Depreciation","Expense","Depreciation Expense",,"Accumulated Depreciation",11788.69,"",463917.53
,"General Journal","23-01-2024","22111",,,"Bajaj Boxer BM150 UG Depreciation","Expense","Depreciation Expense",,"Accumulated Depreciation",1539.41,"",465456.94
,"General Journal","23-01-2024","22112",,,"Chain block 4 depreciation","Expense","Depreciation Expense",,"Accumulated Depreciation",133.42,"",465590.36
,"General Journal","23-01-2024","22113",,,"Coder UPS Depreciation","Expense","Depreciation Expense",,"Accumulated Depreciation",95.24,"",465685.60
,"General Journal","23-01-2024","22114",,,"Dust Extractor 1 Depreciation","Expense","Depreciation Expense",,"Accumulated Depreciation",446.43,"",466132.03
,"General Journal","23-01-2024","22115",,,"Dust Extractor 2 Depreciation","Expense","Depreciation Expense",,"Accumulated Depreciation",446.43,"",466578.46
,"General Journal","23-01-2024","22116",,,"Filler 1 Geared Motor & Feeding System Depreciation","Expense","Depreciation Expense",,"Accumulated Depreciation",333.33,"",466911.79
,"General Journal","23-01-2024","22117",,,"Filler 2 Geared Motor & Feeding System Depreciation","Expense","Depreciation Expense",,"Accumulated Depreciation",348.72,"",467260.51
,"General Journal","23-01-2024","22118",,,"Filler 3 Geared Motor & Feeding System Depreciation","Expense","Depreciation Expense",,"Accumulated Depreciation",347.52,"",467608.03
,"General Journal","23-01-2024","22119",,,"Hotplate with Stirrer Depreciation","Expense","Depreciation Expense",,"Accumulated Depreciation",1785.71,"",469393.74
,"General Journal","23-01-2024","22120",,,"Makita Hammer Drill Depreciation","Expense","Depreciation Expense",,"Accumulated Depreciation",205.25,"",469598.99
,"General Journal","23-01-2024","22121",,,"Microwave 1 Depreciation","Expense","Depreciation Expense",,"Accumulated Depreciation",217.13,"",469816.12
,"General Journal","23-01-2024","22122",,,"Pallet truck 3 Dep","Expense","Depreciation Expense",,"Accumulated Depreciation",510.95,"",470327.07
,"General Journal","23-01-2024","22123",,,"Pouching Machine Depreciation","Expense","Depreciation Expense",,"Accumulated Depreciation",711.90,"",471038.97
,"General Journal","23-01-2024","22124",,,"Power bank dep","Expense","Depreciation Expense",,"Accumulated Depreciation",119.05,"",471158.02
,"General Journal","23-01-2024","22125",,,"Table Top Scale 11  SS 30Kg Depreciation","Expense","Depreciation Expense",,"Accumulated Depreciation",297.62,"",471455.64
,"General Journal","23-01-2024","22126",,,"Table Top Scale 12  SS 30Kg Depreciation","Expense","Depreciation Expense",,"Accumulated Depreciation",297.62,"",471753.26
,"General Journal","24-01-2024","22127",,,"Access Control Unit & System Depreciation","Expense","Depreciation Expense",,"Accumulated Depreciation",334.76,"",472088.02
,"General Journal","24-01-2024","22128",,,"Electrical Enclosure Compressor Depreciation","Expense","Depreciation Expense",,"Accumulated Depreciation",125.00,"",472213.02
,"General Journal","24-01-2024","22129",,,"ETR Machine Depreciation","Expense","Depreciation Expense",,"Accumulated Depreciation",236.04,"",472449.06
,"General Journal","24-01-2024","22130",,,"Liquid Plant Depreciation","Expense","Depreciation Expense",,"Accumulated Deprecation",15029.76,"",487478.82
,"General Journal","24-01-2024","22131",,,"Paste processing & packing line depreciation","Expense","Depreciation Expense",,"Accumulated Depreciation",17348.21,"",504827.03
,"General Journal","24-01-2024","22132",,,"pH Meter Depreciation","Expense","Depreciation Expense",,"Accumulated Depreciation",741.39,"",505568.42
,"General Journal","25-01-2024","22133",,,"Clamp Meter 1 Depreciation","Expense","Depreciation Expense",,"Accumulated Depreciation",36.90,"",505605.32
,"General Journal","25-01-2024","22134",,,"Fire Alarm Sytstem Depreciation","Expense","Depreciation Expense",,"Accumulated Depreciation",728.57,"",506333.89
,"General Journal","25-01-2024","22135",,,"Floor Chair 11 Depreciation","Expense","Depreciation Expense",,"Accumulated Depreciation",53.57,"",506387.46
,"General Journal","25-01-2024","22136",,,"Floor Chair 12 Depreciation","Expense","Depreciation Expense",,"Accumulated Depreciation",53.57,"",506441.03
,"General Journal","25-01-2024","22137",,,"Floor Chair 13 Depreciation","Expense","Depreciation Expense",,"Accumulated Depreciation",53.57,"",506494.60
,"General Journal","25-01-2024","22138",,,"Floor Chair 14 Depreciation","Expense","Depreciation Expense",,"Accumulated Depreciation",53.57,"",506548.17
,"General Journal","25-01-2024","22139",,,"Floor Chair 15 Depreciation","Expense","Depreciation Expense",,"Accumulated Depreciation",53.57,"",506601.74
,"General Journal","25-01-2024","22140",,,"Floor Chair 16 Depreciation","Expense","Depreciation Expense",,"Accumulated Depreciation",53.57,"",506655.31
,"General Journal","25-01-2024","22141",,,"Liquid Mixer 500Lt Depreciation","Expense","Depreciation Expense",,"Accumulated Depreciation",6172.62,"",512827.93
,"General Journal","25-01-2024","22142",,,"Plastic Resin Mixer Depreciation","Expense","Depreciation Expense",,"Accumulated  Depreciation",1130.95,"",513958.88
,"General Journal","25-01-2024","22143",,,"Plastic Resin Mixer Depreciation","Expense","Depreciation Expense",,"Accumulated  Depreciation",1130.95,"",515089.83
,"General Journal","25-01-2024","25159",,,"Water tank 7 Depreciation","Expense","Depreciation Expense",,"Accumulated Depreciation",71.84,"",515161.67
,"General Journal","26-01-2024","22144",,,"Dell Desktop 2 Depreciation","Expense","Depreciation Expense",,"Accumulated Depreciation",229.17,"",515390.84
,"General Journal","26-01-2024","22145",,,"Dell Desktop 3 Depreciation","Expense","Depreciation Expense",,"Accumulated Depreciation",229.17,"",515620.01
,"General Journal","26-01-2024","22146",,,"Dell Desktop 4 Depreciation","Expense","Depreciation Expense",,"Accumulated Depreciation",229.17,"",515849.18
,"General Journal","26-01-2024","22147",,,"Grease Gun 1 Depreciation","Expense","Depreciation Expense",,"Accumulated Depreciation",73.21,"",515922.39
,"General Journal","26-01-2024","22148",,,"Grease Gun 2 Depreciation","Expense","Depreciation Expense",,"Accumulated Depreciation",63.14,"",515985.53
,"General Journal","26-01-2024","22149",,,"Retort Stand 1 Depreciation","Expense","Depreciation Expense",,"Accumulated Depreciation",10.71,"",515996.24
,"General Journal","26-01-2024","22150",,,"Retort Stand 2 Depreciation","Expense","Depreciation Expense",,"Accumulated Depreciation",10.71,"",516006.95
,"General Journal","27-01-2024","22151",,,"Board room chair 10 Depreciation","Expense","Depreciation Expense",,"Accumulated Depreciation",79.55,"",516086.50
,"General Journal","27-01-2024","22152",,,"Board room chair 11 Depreciation","Expense","Depreciation Expense",,"Accumulated Depreciation",79.55,"",516166.05
,"General Journal","27-01-2024","22153",,,"Board room chair 12 Depreciation","Expense","Depreciation Expense",,"Accumulated Depreciation",79.55,"",516245.60
,"General Journal","27-01-2024","22154",,,"Board room chair 13 Depreciation","Expense","Depreciation Expense",,"Accumulated Depreciation",79.55,"",516325.15
,"General Journal","27-01-2024","22155",,,"Board room chair 14 Depreciation","Expense","Depreciation Expense",,"Accumulated Depreciation",79.55,"",516404.70
,"General Journal","27-01-2024","22156",,,"Board room chair 15 Depreciation","Expense","Depreciation Expense",,"Accumulated Depreciation",79.55,"",516484.25
,"General Journal","27-01-2024","22157",,,"Board room chair 16 Depreciation","Expense","Depreciation Expense",,"Accumulated Depreciation",79.55,"",516563.80
,"General Journal","27-01-2024","22158",,,"Board room chair 17 Depreciation","Expense","Depreciation Expense",,"Accumulated Depreciation",79.55,"",516643.35
,"General Journal","27-01-2024","22159",,,"Board room chair 18 Depreciation","Expense","Depreciation Expense",,"Accumulated Depreciation",79.55,"",516722.90
,"General Journal","27-01-2024","22160",,,"Board room chair 19 Depreciation","Expense","Depreciation Expense",,"Accumulated Depreciation",79.55,"",516802.45
,"General Journal","27-01-2024","22161",,,"Board room chair 9 Depreciation","Expense","Depreciation Expense",,"Accumulated Depreciation",79.55,"",516882.00
,"General Journal","27-01-2024","22162",,,"Canvas Stretcher Depreciation","Expense","Depreciation Expense",,"Accumulated Depreciation",133.33,"",517015.33
,"General Journal","27-01-2024","22164",,,"Passenger Lift 1000kg Depreciation","Expense","Depreciation Expense",,"Accumulated Depreciation",44484.68,"",561500.01
,"General Journal","27-01-2024","22165",,,"Printer Depreciation","Expense","Depreciation Expense",,"Accumulated Depreciation",205.25,"",561705.26
,"General Journal","31-01-2024","22166",,,"500gm Jar Blow Mould 3 depreciation","Expense","Depreciation Expense",,"Accumulated Depreciation",1026.79,"",562732.05
,"General Journal","31-01-2024","22167",,,"500gm Jar Blow Mould 4 depreciation","Expense","Depreciation Expense",,"Accumulated Depreciation",1026.79,"",563758.84
,"General Journal","31-01-2024","22168",,,"Air cooled chiller depeciation","Expense","Depreciation Expense",,"Accumulated  Depreciation",8916.67,"",572675.51
,"General Journal","31-01-2024","22169","*","Unilever Kenya Ltd:Sunlight Washing Pwd","Boato Installation Depreciation","Expense","Depreciation Expense",,"Accumulated Depreciation",65114.38,"",637789.89
,"General Journal","31-01-2024","22170","*",,"Canister Platform Depreciation","Expense","Depreciation Expense",,"Accumulated Depreciation",59246.67,"",697036.56
,"General Journal","31-01-2024","22171",,,"CCTV DRV & System Depreciation","Expense","Depreciation Expense",,"Accumulated Depreciation",1295.33,"",698331.89
,"General Journal","31-01-2024","22172",,,"Colour Pressure tank Depreciation","Expense","Depreciation Expense",,"Accumulated Depreciation",232.14,"",698564.03
,"General Journal","31-01-2024","22173",,,"Compressed air gun Depreciation","Expense","Depreciation Expense",,"Accumulated Depreciation",47.62,"",698611.65
,"General Journal","31-01-2024","22174",,,"Drum Pump 2 Depreciation","Expense","Depreciation Expense",,"Accumulated Depreciation",123.15,"",698734.80
,"General Journal","31-01-2024","22175",,,"Extractor Fan down Depreciation","Expense","Depreciation Expense",,"Accumulated Depreciation",150.12,"",698884.92
,"General Journal","31-01-2024","22176",,,"Extractor Fan Hoisting Depreciation","Expense","Depreciation Expense",,"Accumulated Depreciation",176.67,"",699061.59
,"General Journal","31-01-2024","22177",,,"Extractor Fan Packaging Depreciation","Expense","Depreciation Expense",,"Accumulated Depreciation",150.12,"",699211.71
,"General Journal","31-01-2024","22178",,,"Incotex Type C Control Unit Depreciation","Expense","Depreciation Expense",,"Accumulated Depreciation",1939.66,"",701151.37
,"General Journal","31-01-2024","22179",,,"Lamination Machine 1 Depreciation","Expense","Depreciation Expense",,"Accumulated Depreciation",84.78,"",701236.15
,"General Journal","31-01-2024","22180",,,"Office Cabinet 5 Depreciation","Expense","Depreciation Expense",,"Accumulated Depreciation",58.33,"",701294.48
,"General Journal","31-01-2024","22181",,,"Office Desk 6 Depreciation","Expense","Depreciation Expense",,"Accumulated Depreciation",90.48,"",701384.96
,"General Journal","31-01-2024","22182",,,"Office Desk 7 Depreciation","Expense","Depreciation Expense",,"Accumulated Depreciation",90.48,"",701475.44
,"General Journal","31-01-2024","22183",,,"Office Desk 8 Depreciation","Expense","Depreciation Expense",,"Accumulated Depreciation",83.33,"",701558.77
,"General Journal","31-01-2024","22184",,,"Platform Scale 4 tons 1 Depreciation","Expense","Depreciation Expense",,"Accumulated Depreciation",10782.43,"",712341.20
,"General Journal","31-01-2024","22185",,,"Process Water Filtration System Depreciation","Expense","Depreciation Expense",,"Accumulated Depreciation",1785.71,"",714126.91
,"General Journal","31-01-2024","22186",,,"Sulphonic Acid pressure tank Depreciation","Expense","Depreciation Expense",,"Accumulated Depreciation",110.48,"",714237.39
,"General Journal","31-01-2024","22187",,,"Test Sieves 100 & 200 microns Depreciation","Expense","Depreciation Expense",,"Accumulated Depreciation",450.00,"",714687.39
,"General Journal","31-01-2024","22188",,,"Wall mounted cabinet 1 Dep","Expense","Depreciation Expense",,"Accumulated Depreciation",107.14,"",714794.53
,"General Journal","31-01-2024","22189",,,"Water tank 5 Depreciation","Expense","Depreciation Expense",,"Accumulated Depreciation",137.79,"",714932.32
,"General Journal","01-02-2024","22190",,,"Hoisting Bucket 1 Depreciation","Expense","Depreciation Expense",,"Accumulated Depreciation",148.81,"",715081.13
,"General Journal","01-02-2024","22191",,,"Hoisting Bucket 2 Dereciation","Expense","Depreciation Expense",,"Accumulated Depreciation",148.81,"",715229.94
,"General Journal","01-02-2024","22192",,,"Lenovo Laptop 2 Depreciation","Expense","Depreciation Expense",,"Accumulated Depreciation",333.33,"",715563.27
,"General Journal","01-02-2024","22193",,,"Processing Platform Depreciation","Expense","Depreciation Expense",,"Accumulated Depreciation",4880.95,"",720444.22
,"General Journal","01-02-2024","22194",,,"Security and Computer Sytem UPS Depreciation","Expense","Depreciation Expense",,"Accumulated Depreciation",3584.50,"",724028.72
,"General Journal","01-02-2024","22195",,,"Trophy Shelf 1 Depreciation","Expense","Depreciation Expense",,"Accumulated Depreciation",95.24,"",724123.96
,"General Journal","01-02-2024","22196",,,"Water tank 4 Depreciation","Expense","Depreciation Expense",,"Accumulated Depreciation",453.24,"",724577.20
,"General Journal","02-02-2024","22197",,,"CMPP 1kg Jar Blow Mould 1 Depreciation","Expense","Depreciation Expense",,"Accumulated Depreciation",3364.87,"",727942.07
,"General Journal","02-02-2024","22198",,,"CMPP 1kg Jar Blow Mould 2 Depreciation","Expense","Depreciation Expense",,"Accumulated Depreciation",3364.87,"",731306.94
,"General Journal","02-02-2024","22199",,,"CMPP 500gm Jar Blow Mould 1 Depreciation","Expense","Depreciation Expense",,"Accumulated Depreciation",2643.82,"",733950.76
,"General Journal","02-02-2024","22200",,,"CMPP 500gm Jar Blow Mould 2 Depreciation","Expense","Depreciation Expense",,"Accumulated Depreciation",2643.82,"",736594.58
,"General Journal","02-02-2024","22201",,,"CMPP Blow Moulding Machine 1 Depreciation","Expense","Depreciation Expense",,"Accumulated Depreciation",49344.71,"",785939.29
,"General Journal","02-02-2024","22202",,,"CMPP Blow Moulding Machine 2 Depreciation","Expense","Depreciation Expense",,"Accumulated Depreciation",49344.71,"",835284.00
,"General Journal","02-02-2024","22203",,,"Drum Pump 1 Depreiation","Expense","Depreciation Expense",,"Accumulated Depreciation",123.03,"",835407.03
,"General Journal","02-02-2024","22204",,,"Heat Gun Bosch 1 Depreciation","Expense","Depreciation Expense",,"Accumulated Depreciation",100.57,"",835507.60
,"General Journal","02-02-2024","22205",,,"Hot ProcessWater Storage Tank1  Depreciation","Expense","Depreciation Expense",,"Accumulated Depreciation",73.99,"",835581.59
,"General Journal","02-02-2024","22206","*",,"HP Laptop 4 Depreciation","Expense","Depreciation Expense",,"Accumulated Depreciation",297.62,"",835879.21
,"General Journal","02-02-2024","22207","*",,"HP Laptop 8 Depreciation","Expense","Depreciation Expense",,"Accumulated Depreciation",1200.00,"",837079.21
,"General Journal","02-02-2024","22208",,,"Store Racking 1 depreciation","Expense","Depreciation Expense",,"Accumulated Depreciation",175.60,"",837254.81
,"General Journal","02-02-2024","22209",,,"Store Racking 2 Depreciation","Expense","Depreciation Expense",,"Accumulated Depreciation",175.60,"",837430.41
,"General Journal","02-02-2024","22210",,,"Tank platform Depreciation","Expense","Depreciation Expense",,"Accumulated Depreciation",130.95,"",837561.36
,"General Journal","02-02-2024","22211",,,"Water tank 1 Depreciation","Expense","Depreciation Expense",,"Accumulated Depreciation",120.07,"",837681.43
,"General Journal","02-02-2024","22212",,,"Workshop cabinet depreciation","Expense","Depreciation Expense",,"Accumulated Depreciation",172.02,"",837853.45
,"General Journal","03-02-2024","22222",,,"Alarm System extension","Expense","Depreciation Expense",,"Accumulated Depreciation",602.38,"",838455.83
,"General Journal","03-02-2024","22223",,,"Domestos sewing machine depreciation","Expense","Depreciation Expense",,"Acummulated depreciation",82.10,"",838537.93
,"General Journal","03-02-2024","22224",,,"Bench Grinder 2 Depreciation","Expense","Depreciation Expense",,"Accumulated Depreceiation",100.57,"",838638.50
,"General Journal","03-02-2024","22225",,,"CCTV survellance System extension Depreciation","Expense","Depreciation Expense",,"Accumulated Depreciation",657.14,"",839295.64
,"General Journal","03-02-2024","22227",,,"Electrical Enclosure CCTV Depreciation","Expense","Depreciation Expense",,"Accumulated Depreciation",126.19,"",839421.83
,"General Journal","03-02-2024","22228",,,"Electrical Enclosure Main Depreciation","Expense","Depreciation Expense",,"Accumulated Depreciation",2339.29,"",841761.12
,"General Journal","03-02-2024","22229",,,"Electrical Enclosure P Line Depreciation","Expense","Depreciation Expense",,"Accumulated Depreciation",428.57,"",842189.69
,"General Journal","03-02-2024","22242",,,"Floodlight Depreciation","Expense","Depreciation Expense",,"Accumulated Depreciation",59.52,"",842249.21
,"General Journal","03-02-2024","22247",,,"Office Desk 1 Depreciation","Expense","Depreciation Expense",,"Accumulated Depreciation",225.00,"",842474.21
,"General Journal","03-02-2024","22248",,,"Office Desk 2 Depreciation","Expense","Depreciation Expense",,"Accumulated Depreciation",225.00,"",842699.21
,"General Journal","03-02-2024","22249",,,"Office Desk 3 Depreciation","Expense","Depreciation Expense",,"Accumulated Depreciation",225.00,"",842924.21
,"General Journal","03-02-2024","22251",,,"Signet ESD 1 Depreciation","Expense","Depreciation Expense",,"Accumulated Depreciation",928.57,"",843852.78
,"General Journal","03-02-2024","22253","*",,"Sterling Water Dispenser 1 Depreciation","Expense","Depreciation Expense",,"Accumulated Depreciation",119.05,"",843971.83
,"General Journal","03-02-2024","22254",,,"Table top Weighing Scale 5 Depreciation","Expense","Depreciation Expense",,"Accumulated Depreciation",248.57,"",844220.40
,"General Journal","03-02-2024","22255",,,"Table top Weighing Scale 6 Depreciation","Expense","Depreciation Expense",,"Accumulated Depreciation",248.57,"",844468.97
,"General Journal","03-02-2024","22256",,,"Table top Weighing Scale 7 Depreciation","Expense","Depreciation Expense",,"Accumulated Depreciation",248.57,"",844717.54
,"General Journal","03-02-2024","22257",,,"Table top Weighing Scale 8 Depreciation","Expense","Depreciation Expense",,"Accumulated Depreciation",248.57,"",844966.11
,"General Journal","03-02-2024","22258",,,"Table top Weighing Scale 9 Depreciation","Expense","Depreciation Expense",,"Accumulated Depreciation",248.57,"",845214.68
,"General Journal","04-02-2024","22217",,,"9Kg Powder Fire Extinguisher 1 Depreciation","Expense","Depreciation Expense",,"Accumulated Depreciation",34.52,"",845249.20
,"General Journal","04-02-2024","22218",,,"9Kg Powder Fire Extinguisher 2 Depreciation","Expense","Depreciation Expense",,"Accumulated Depreciation",34.52,"",845283.72
,"General Journal","04-02-2024","22219",,,"9Kg Powder Fire Extinguisher 3 Depreciation","Expense","Depreciation Expense",,"Accumulated Depreciation",34.52,"",845318.24
,"General Journal","04-02-2024","22221",,,"9Kg Powder Fire Extinguisher 5 Depreciation","Expense","Depreciation Expense",,"Accumulated Depreciation",34.52,"",845352.76
,"General Journal","04-02-2024","22226",,,"Chiller 2 Depreciation","Expense","Depreciation Expense",,"Accumulated Depreciation",8035.71,"",853388.47
,"General Journal","04-02-2024","22230",,,"Empty IBC Tank 10 Depreciation","Expense","Depreciation Expense",,"Accumulated Depreciation",41.67,"",853430.14
,"General Journal","04-02-2024","22231",,,"Empty IBC Tank 3 Depreciation","Expense","Depreciation Expense",,"Accumulated Depreciation",65.48,"",853495.62
,"General Journal","04-02-2024","22232",,,"Empty IBC Tank 4 Depreciation","Expense","Depreciation Expense",,"Accumulated Depreciation",65.48,"",853561.10
,"General Journal","04-02-2024","22233",,,"Empty IBC Tank 5 Depreciation","Expense","Depreciation Expense",,"Accumulated Depreciation",65.48,"",853626.58
,"General Journal","04-02-2024","22234",,,"Empty IBC Tank 6 Depreciation","Expense","Depreciation Expense",,"Accumulated Depreciation",65.48,"",853692.06
,"General Journal","04-02-2024","22235",,,"Empty IBC Tank 7 Depreciation","Expense","Depreciation Expense",,"Accumulated Depreciation",41.67,"",853733.73
,"General Journal","04-02-2024","22236",,,"Empty IBC Tank 8 Depreciation","Expense","Depreciation Expense",,"Accumulated Depreiation",41.67,"",853775.40
,"General Journal","04-02-2024","22237",,,"Empty IBC Tank 9 Depreciation","Expense","Depreciation Expense",,"Accumulated Depreciation",41.67,"",853817.07
,"General Journal","04-02-2024","22243",,,"Linx 8900 Coder 1 Depreciation","Expense","Depreciation Expense",,"Accumulated Depreciation",8333.33,"",862150.40
,"General Journal","04-02-2024","22245",,,"Mobile Phone 2 Depreciation","Expense","Depreciation Expense",,"Accumulated Depreciation",46.67,"",862197.07
,"General Journal","04-02-2024","22259",,,"Triple UV water purifier 1 Depreciation","Expense","Depreciation Expense",,"Accumulated Depreciation",296.22,"",862493.29
,"General Journal","05-02-2024","22213",,,"1Kg Generic Jar Blow Mould 1 depreciation","Expense","Depreciation Expense",,"Accumulated Depreciation",1500.00,"",863993.29
,"General Journal","05-02-2024","22214",,,"1Kg Generic Jar Blow Mould 2 depreciation","Expense","Depreciation Expense",,"Accumulated Depreciation",1500.00,"",865493.29
,"General Journal","05-02-2024","22215",,,"500gm Generic Jar Blow Mould 1 depreciation","Expense","Depreciation Expense",,"Accumulated Depreciation",1071.43,"",866564.72
,"General Journal","05-02-2024","22216",,,"500gm Generic Jar Blow Mould 2 depreciation","Expense","Depreciation Expense",,"Accumulated Depreciation",1071.43,"",867636.15
,"General Journal","05-02-2024","22220",,,"9Kg Powder Fire Extinguisher 4 Depreciation","Expense","Depreciation Expense",,"Accumulated Depreciation",34.52,"",867670.67
,"General Journal","05-02-2024","22238",,,"Extractor Fan 4 Depreciation","Expense","Depreciation Expense",,"Accumulated Depreciation",726.19,"",868396.86
,"General Journal","05-02-2024","22239",,,"FFS  Machine Installation Elct Depreciation","Expense","Depreciation Expense",,"Accumulated Depreciation",200.60,"",868597.46
,"General Journal","05-02-2024","22241",,,"First Aid Kit Depreciation","Expense","Depreciation Expense",,"Accumulated  Depreciation",77.38,"",868674.84
,"General Journal","05-02-2024","22244",,,"Linx 8900 Coder 2 Depreciation","Expense","Depreciation Expense",,"Accumulated Depreciation",12500.00,"",881174.84
,"General Journal","05-02-2024","22250",,,"Packing Platform Depreciation","Expense","Depreciation Expense",,"Accumulated Depreciation",5297.62,"",886472.46
,"General Journal","05-02-2024","22252",,,"SS Industrial Turntable Depreciation","Expense","Depreciation Expense",,"Accumulated Depreciation",5238.10,"",891710.56
,"General Journal","05-02-2024","22260",,,"TV Screen 2 Depreciation","Expense","Depreciation Expense",,"Accumulated Depreciation",950.00,"",892660.56
,"General Journal","05-02-2024","22261",,,"Water Purifier 1 Depreciation","Expense","Depreciation Expense",,"Accumulated Depreciation",117.10,"",892777.66
,"General Journal","05-02-2024","22262",,,"Water tank 2 Depreciation","Expense","Depreciation Expense",,"Accumulated Depreciation",23.81,"",892801.47
,"General Journal","06-02-2024","22263",,,"Blower Depreciation","Expense","Depreciation Expense",,"Accumulated Depreciation",59.52,"",892860.99
,"General Journal","06-02-2024","22264",,,"Emergency Washing Point Depreciation","Expense","Depreciation Expense",,"Accumulated Deprecation",160.71,"",893021.70
,"General Journal","06-02-2024","22265","*",,"Infrared Thermometre 1 Depreciation","Expense","Depreciation Expense",,"Accumulated Depreciation",416.67,"",893438.37
,"General Journal","06-02-2024","22266",,,"Material's Trolley Depreciation","Expense","Depreciation Expense",,"Accumulated Depreciation",297.62,"",893735.99
,"General Journal","06-02-2024","22267",,,"Plastic Scrap Grinder Machine Depreciation","Expense","Depreciation Expense",,"Accumulated  Depreciation",3452.38,"",897188.37
,"General Journal","06-02-2024","22268",,,"Ribon Mixer SS depreciation","Expense","Depreciation Expense",,"Accumulated depreciation",4642.86,"",901831.23
,"General Journal","06-02-2024","22269",,,"Telephone Handset Depreciation","Expense","Depreciation Expense",,"Accumulated Depreciation",29.76,"",901860.99
,"General Journal","06-02-2024","22270",,,"Telkom Wifi Router Depreciation","Expense","Depreciation Expense",,"Accumulated Depreciation",71.43,"",901932.42
,"General Journal","06-02-2024","22271",,,"Vacuum Cleaner Depreciation","Expense","Depreciation Expense",,"Accumulated Depreciation",148.81,"",902081.23
,"General Journal","07-02-2024","22272",,,"9Kg Powder Fire Extinguisher 6 Depreciation","Expense","Depreciation Expense",,"Accumulated Depreciation",44.05,"",902125.28
,"General Journal","07-02-2024","22273",,,"Big bag trolley 1 Depreciation","Expense","Depreciation Expense",,"Accumulated Depreciation",344.29,"",902469.57
,"General Journal","07-02-2024","22274",,,"Cartoning table 4 depreciation","Expense","Depreciation Expense",,"Accumulated Depreciation",262.49,"",902732.06
,"General Journal","07-02-2024","22275",,,"Case sealing table depreciation","Expense","Depreciation Expense",,"Accumulated Depreciation",86.67,"",902818.73
,"General Journal","07-02-2024","22276",,,"Chain block 2 depreciation","Expense","Depreciation Expense",,"Accumulated depreciation",398.81,"",903217.54
,"General Journal","07-02-2024","22277",,,"Chain block 3 depreciation","Expense","Depreciation Expense",,"Accumulated depreciation",398.81,"",903616.35
,"General Journal","07-02-2024","22278",,,"Drilling machine Depreciation","Expense","Depreciation Expense",,"Accumulated Depreciation",88.39,"",903704.74
,"General Journal","07-02-2024","22279",,,"Grinder Depreciation","Expense","Depreciation Expense",,"Acccumulated Depreciation",159.82,"",903864.56
,"General Journal","07-02-2024","22280",,,"Packing table 1 depreciation","Expense","Depreciation Expense",,"Accumulated Depreciation",262.49,"",904127.05
,"General Journal","07-02-2024","22281",,,"Packing table 2 depreciation","Expense","Depreciation Expense",,"Accumulated Depreciation",262.49,"",904389.54
,"General Journal","07-02-2024","22282",,,"Packing table 3 depreciation","Expense","Depreciation Expense",,"Accumulated Depreciation",262.49,"",904652.03
,"General Journal","07-02-2024","22283",,,"Quality table depreciation","Expense","Depreciation Expense",,"Accumulated Depreciation",86.67,"",904738.70
,"General Journal","07-02-2024","22284",,,"Welding machine Depreciation","Expense","Depreciation Expense",,"Accumulated Depreciation",178.57,"",904917.27
,"General Journal","08-02-2024","22285",,,"Bench Grinder 350W Depreciation","Expense","Depreciation Expense",,"Accumulated Depreciation",122.13,"",905039.40
,"General Journal","08-02-2024","22286",,,"HP Laptop 6 Depreciation","Expense","Depreciation Expense",,"Accumulated Depreciation",416.67,"",905456.07
,"General Journal","08-02-2024","22287",,,"Mobile Phone 1 Depreciation","Expense","Depreciation Expense",,"Accumulated Depreciation",58.33,"",905514.40
,"General Journal","09-02-2024","22288",,,"Canteen Table 1 Depreciation","Expense","Depreciation Expense",,"Accumulated Depreciation",184.52,"",905698.92
,"General Journal","09-02-2024","22289",,,"Canteen Table 2 Depreciation","Expense","Depreciation Expense",,"Accumulated Depreciation",184.52,"",905883.44
,"General Journal","09-02-2024","22290",,,"Dell Desktop 1 Depreciation","Expense","Depreciation Expense",,"Accumulated Depreciation",178.57,"",906062.01
,"General Journal","09-02-2024","22291",,,"Fire Alarm System Extension'19 Depreciation","Expense","Depreciation Expense",,"Accumulated Depreciation",9857.14,"",915919.15
,"General Journal","09-02-2024","22292",,,"Floor Chair 1 Depreciation","Expense","Depreciation Expense",,"Accumulated Depreciation",26.79,"",915945.94
,"General Journal","09-02-2024","22293",,,"Floor Chair 10 Depreciation","Expense","Depreciation Expense",,"Accumulated Depreciation",53.57,"",915999.51
,"General Journal","09-02-2024","22294",,,"Floor Chair 2 Depreciation","Expense","Depreciation Expense",,"Accumulated Depreciation",26.79,"",916026.30
,"General Journal","09-02-2024","22295",,,"Floor Chair 3 Depreciation","Expense","Depreciation Expense",,"Accumulated Depreciation",26.79,"",916053.09
,"General Journal","09-02-2024","22296",,,"Floor Chair 4 Depreciation","Expense","Depreciation Expense",,"Accumulated Depreciation",26.79,"",916079.88
,"General Journal","09-02-2024","22297",,,"Floor Chair 5 Depreciation","Expense","Depreciation Expense",,"Accumulated Depreciation",26.79,"",916106.67
,"General Journal","09-02-2024","22298",,,"Floor Chair 6 Depreciation","Expense","Depreciation Expense",,"Accumulated Depreciation",53.57,"",916160.24
,"General Journal","09-02-2024","22299",,,"Floor Chair 7 Depreciation","Expense","Depreciation Expense",,"Accumulated Depreciation",53.57,"",916213.81
,"General Journal","09-02-2024","22300",,,"Floor Chair 8 Depreciation","Expense","Depreciation Expense",,"Accumulated Depreciation",53.57,"",916267.38
,"General Journal","09-02-2024","22301",,,"Floor Chair 9 Depreciation","Expense","Depreciation Expense",,"Accumulated Depreciation",53.57,"",916320.95
,"General Journal","09-02-2024","22302",,,"Floor weighing scale Depreciation","Expense","Depreciation Expense",,"Accumulated Depreciation",593.81,"",916914.76
,"General Journal","09-02-2024","22303",,,"Lab Office Chair 1 Depreciation","Expense","Depreciation Expense",,"Accumulated Depreciation",47.62,"",916962.38
,"General Journal","09-02-2024","22304",,,"Lab Office Chair 2 Depreciation","Expense","Depreciation Expense",,"Accumulated Depreciation",47.62,"",917010.00
,"General Journal","09-02-2024","22305",,,"Lab Office Chair 3 Depreciation","Expense","Depreciation Expense",,"Accumulated Depreciation",47.62,"",917057.62
,"General Journal","09-02-2024","22306","*","Unilever Kenya Ltd:Sunlight Washing Pwd","Sunlight Bag Closing Machine 1 Depreciation","Expense","Depreciation Expense",,"Accumulated Depreciation",738.10,"",917795.72
,"General Journal","09-02-2024","22307","*","Unilever Kenya Ltd:Sunlight Washing Pwd","Sunlight Packing Chair 1 Depreciation","Expense","Depreciation Expense",,"Accumulated Depreciation",41.67,"",917837.39
,"General Journal","10-02-2024","22309",,,"5Kg Fire Extinguisher 1 Depreciation","Expense","Depreciation Expense",,"Accumulated Depreciation",65.48,"",917902.87
,"General Journal","10-02-2024","22310",,,"HP Laptop 10 Depreciation","Expense","Depreciation Expense",,"Accumulated Depreciation",1200.00,"",919102.87
,"General Journal","10-02-2024","22311",,,"HP Laptop 9 Depreciation","Expense","Depreciation Expense",,"Accumulated Depreciation",1200.00,"",920302.87
,"General Journal","10-02-2024","22312",,,"Office Seat 1 Depreciation","Expense","Depreciation Expense",,"Accumulated Depreciation",142.86,"",920445.73
,"General Journal","10-02-2024","22313",,,"Office Seat 2 Depreciation","Expense","Depreciation Expense",,"Accumulated Depreciation",71.43,"",920517.16
,"General Journal","10-02-2024","22314",,,"Office Seat 3 Depreciation","Expense","Depreciation Expense",,"Accumulated Depreciation",71.43,"",920588.59
,"General Journal","10-02-2024","22315",,,"Reverse Osmosis Unit 1 Depreciation","Expense","Depreciation Expense",,"Accumulated Depreciation",416.67,"",921005.26
,"General Journal","10-02-2024","22316",,,"Steam Generator SG24 Depreciation","Expense","Depreciation Expense",,"Accumulated Depreciation",3794.53,"",924799.79
,"General Journal","10-02-2024","22317",,,"Toilet Cleaner Mixing Machine Depreciation","Expense","Depreciation Expense",,"Accumulated Depreciation",6333.33,"",931133.12
,"General Journal","11-02-2024","22318",,,"4 GB hard drive for CCTV Depreciation","Expense","Depreciation Expense",,"Accumulated Depreciation",178.57,"",931311.69
,"General Journal","11-02-2024","22319",,,"4TB Hard Disk Depreciation","Expense","Depreciation Expense",,"Accumulated Depreciation",178.57,"",931490.26
,"General Journal","11-02-2024","22321","*","Unilever Kenya Ltd:Sunlight Washing Pwd","Chain block trolley 4 depreciation","Expense","Depreciation Expense",,"Accumulated Depreciation",85.00,"",931575.26
,"General Journal","11-02-2024","22322",,,"Coder Depreciation","Expense","Depreciation Expense",,"Accumulated Depreciation",2261.90,"",933837.16
,"General Journal","11-02-2024","22324",,,"Coder Stand Depreciation","Expense","Depreciation Expense",,"Accumulated Depreciation",59.52,"",933896.68
,"General Journal","11-02-2024","22327",,,"Compressor 1 depreciation","Expense","Depreciation Expense",,"Accumulated depreciation",3750.00,"",937646.68
,"General Journal","11-02-2024","22330",,,"HP Laptop 14 Depreciation","Expense","Depreciation Expense",,"Accumulated Depreciation",1941.67,"",939588.35
,"General Journal","11-02-2024","22331",,,"HP Laptop 15 Depreciation","Expense","Depreciation Expense",,"Accumulated Depreciation",1750.00,"",941338.35
,"General Journal","11-02-2024","22333",,,"Pallet truck 2 depreciation","Expense","Depreciation Expense",,"Accumulated depreciation",440.48,"",941778.83
,"General Journal","11-02-2024","22334","*",,"Steam Label Shrink Tunnel Depreciation","Expense","Depreciation Expense",,"Accumulated  Depreciation",10952.38,"",952731.21
,"General Journal","12-02-2024","22320",,,"Board room chair 3 Depreciation","Expense","Depreciation Expense",,"Accumulated Depreciation",59.52,"",952790.73
,"General Journal","12-02-2024","22323",,,"Coder Housing Depreciation","Expense","Depreciation Expense",,"Accumulated Depreciation",80.36,"",952871.09
,"General Journal","12-02-2024","22325","*","Unilever Kenya Ltd:Sunlight Washing Pwd","Coder UPS 4 Depreciation","Expense","Depreciation Expense",,"Accumulated Depreciation",158.33,"",953029.42
,"General Journal","12-02-2024","22326",,,"Coding Conveyor Depreciation","Expense","Depreciation Expense",,"Accumulated Depreciation",476.19,"",953505.61
,"General Journal","12-02-2024","22328",,,"Conveyor 2 Depreciation","Expense","Depreciation Expense",,"Accumulated  Depreciation",169.64,"",953675.25
,"General Journal","12-02-2024","22329",,,"Eyewash Station 1 Depreciation","Expense","Depreciation Expense",,"Accumulated Depreciation",904.76,"",954580.01
,"General Journal","12-02-2024","22332",,,"HP Laptop 5 Depreciation","Expense","Depreciation Expense",,"Accumulated Depreciation",416.67,"",954996.68
,"General Journal","12-02-2024","22335",,,"Tea maker Depreciation","Expense","Depreciation Expense",,"Accumulated Depreciation",225.00,"",955221.68
,"General Journal","13-02-2024","22336",,,"Alarm System Depreciation","Expense","Depreciation Expense",,"Accumulated Depreciation",580.95,"",955802.63
,"General Journal","13-02-2024","22337",,,"Bosch Blower 2 Depreciation","Expense","Depreciation Expense",,"Accumulated Depreciation",136.49,"",955939.12
,"General Journal","13-02-2024","22338",,,"Canteen Chair 20 Depreciation","Expense","Depreciation Expense",,"Accumulated Depreciation",6.12,"",955945.24
,"General Journal","13-02-2024","22339",,,"Coder UPS 8 Depreciation","Expense","Depreciation Expense",,"Accumulated Depreciation",81.67,"",956026.91
,"General Journal","13-02-2024","22340","*",,"HP Laptop 16 Depreciation","Expense","Depreciation Expense",,"Accumulated Depreciation",1000.00,"",957026.91
,"General Journal","13-02-2024","22341",,,"PIR system extension Depreciation","Expense","Depreciation Expense",,"Accumulated Depreciation",254.67,"",957281.58
,"General Journal","13-02-2024","22342",,,"Process Water Storage Tank Depreciation","Expense","Depreciation Expense",,"Accumulated Depreciation",1065.16,"",958346.74
,"General Journal","13-02-2024","22343","*",,"Store Racking 3 FG Depreciation","Expense","Depreciation Expense",,"Accumulated Depreciation",9791.67,"",968138.41
,"General Journal","13-02-2024","22344",,,"Weighing scale 1","Expense","Depreciation Expense",,"Accumulated Depreciation",559.52,"",968697.93
,"General Journal","14-02-2024","22346",,,"Coder UPS 5 Depreciation","Expense","Depreciation Expense",,"Accumulated Depreciation",158.33,"",968856.26
,"General Journal","14-02-2024","22347",,,"Motor Vehicle 2 Depreciation","Expense","Depreciation Expense",,"Accumulated Depreciation",10297.62,"",979153.88
,"General Journal","14-02-2024","22348",,,"Paste Packing Machine Depreciation","Expense","Depreciation Expense",,"Accumulated Depreciation",4166.67,"",983320.55
,"General Journal","14-02-2024","22349",,,"Table Top Scale 10  SS 15Kg Depreciation","Expense","Depreciation Expense",,"Accumulated Depreciation",297.62,"",983618.17
,"General Journal","15-02-2024","22350",,,"150KVA Enclosed Genset Depreciation","Expense","Depreciation Expense",,"Accumulated Depreciation",24404.76,"",1008022.93
,"General Journal","15-02-2024","22351",,,"20Kg Forklift Gas Cylinder 2 Depreciation","Expense","Depreciation Expense",,"Accumulated Depreciation",769.70,"",1008792.63
,"General Journal","15-02-2024","22352",,,"2Ton Electric Hoist 1 Depreciation","Expense","Depreciation Expense",,"Accumulated Depreciation",3708.33,"",1012500.96
,"General Journal","15-02-2024","22353",,,"Automatic Change Over Switch 1 Depreciation","Expense","Depreciation Expense",,"Accumulated Depreciation",1666.67,"",1014167.63
,"General Journal","15-02-2024","22354",,,"Bench top Weighing Scale 1 Depreciation","Expense","Depreciation Expense",,"Accumulated Depreciation",357.14,"",1014524.77
,"General Journal","15-02-2024","22355",,,"Bench top Weighing Scale 2 Depreciation","Expense","Depreciation Expense",,"Accumulated Depreciation",357.14,"",1014881.91
,"General Journal","15-02-2024","22356",,,"Bench top Weighing Scale 3 Depreciation","Expense","Depreciation Expense",,"Accumulated Depreciation",357.14,"",1015239.05
,"General Journal","15-02-2024","22357",,,"Bench top Weighing Scale 4 Depreciation","Expense","Depreciation Expense",,"Accumulated Depreciation",357.14,"",1015596.19
,"General Journal","15-02-2024","22358",,,"Bosch Blower Depreciation","Expense","Depreciation Expense",,"Accumulated Depreciation",129.31,"",1015725.50
,"General Journal","15-02-2024","22359",,,"Canteen Chair 1 Depreciation","Expense","Depreciation Expense",,"Accumulated Depreciation",6.12,"",1015731.62
,"General Journal","15-02-2024","22360",,,"Canteen Chair 10 Depreciation","Expense","Depreciation Expense",,"Accumulated Depreciation",6.12,"",1015737.74
,"General Journal","15-02-2024","22361",,,"Canteen Chair 11 Depreciation","Expense","Depreciation Expense",,"Accumulated Depreciation",6.12,"",1015743.86
,"General Journal","15-02-2024","22362",,,"Canteen Chair 11 Depreciation","Expense","Depreciation Expense",,"Accumulated Depreciation",6.12,"",1015749.98
,"General Journal","15-02-2024","22363",,,"Canteen Chair 12 Depreciation","Expense","Depreciation Expense",,"Accumulated Depreciation",6.12,"",1015756.10
,"General Journal","15-02-2024","22364",,,"Canteen Chair 13 Depreciation","Expense","Depreciation Expense",,"Accumulated Depreciation",6.12,"",1015762.22
,"General Journal","15-02-2024","22365",,,"Canteen Chair 14 Depreciation","Expense","Depreciation Expense",,"Accumulated Depreciation",6.12,"",1015768.34
,"General Journal","15-02-2024","22366",,,"Canteen Chair 15 Depreciation","Expense","Depreciation Expense",,"Accumulated Depreciation",6.12,"",1015774.46
,"General Journal","15-02-2024","22367",,,"Canteen Chair 16 Depreciation","Expense","Depreciation Expense",,"Accumulated Depreciation",6.12,"",1015780.58
,"General Journal","15-02-2024","22368",,,"Canteen Chair 17 Depreciation","Expense","Depreciation Expense",,"Accumulated Depreciation",6.12,"",1015786.70
,"General Journal","15-02-2024","22369",,,"Canteen Chair 18 Depreciation","Expense","Depreciation Expense",,"Accumulated Depreciation",6.12,"",1015792.82
,"General Journal","15-02-2024","22370",,,"Canteen Chair 19 Depreciation","Expense","Depreciation Expense",,"Accumulated Depreciation",6.12,"",1015798.94
,"General Journal","15-02-2024","22371",,,"Canteen Chair 2 Depreciation","Expense","Depreciation Expense",,"Accumulated Depreciation",6.12,"",1015805.06
,"General Journal","15-02-2024","22372",,,"Canteen Chair 21 Depreciation","Expense","Depreciation Expense",,"Accumulated Depreciation",6.12,"",1015811.18
,"General Journal","15-02-2024","22373",,,"Canteen Chair 22 Depreciation","Expense","Depreciation Expense",,"Accumulated Depreciation",6.12,"",1015817.30
,"General Journal","15-02-2024","22374",,,"Canteen Chair 23 Depreciation","Expense","Depreciation Expense",,"Accumulated Depreciation",6.12,"",1015823.42
,"General Journal","15-02-2024","22375",,,"Canteen Chair 24 Depreciation","Expense","Depreciation Expense",,"Accumulated Depreciation",6.12,"",1015829.54
,"General Journal","15-02-2024","22376",,,"Canteen Chair 25 Depreciation","Expense","Depreciation Expense",,"Accumulated Depreciation",6.12,"",1015835.66
,"General Journal","15-02-2024","22377",,,"Canteen Chair 3 Depreciation","Expense","Depreciation Expense",,"Accumulated Depreciation",6.12,"",1015841.78
,"General Journal","15-02-2024","22378",,,"Canteen Chair 4 Depreciation","Expense","Depreciation Expense",,"Accumulated Depreciation",6.12,"",1015847.90
,"General Journal","15-02-2024","22379",,,"Canteen Chair 5 Depreciation","Expense","Depreciation Expense",,"Accumulated Depreciation",6.12,"",1015854.02
,"General Journal","15-02-2024","22380",,,"Canteen Chair 6 Depreciation","Expense","Depreciation Expense",,"Accumulated Depreciation",6.12,"",1015860.14
,"General Journal","15-02-2024","22381",,,"Canteen Chair 7 Depreciation","Expense","Depreciation Expense",,"Accumulated Depreciation",6.12,"",1015866.26
,"General Journal","15-02-2024","22382",,,"Canteen Chair 8 Depreciation","Expense","Depreciation Expense",,"Accumulated Depreciation",6.12,"",1015872.38
,"General Journal","15-02-2024","22383",,,"Canteen Chair 9 Depreciation","Expense","Depreciation Expense",,"Accumulated Depreciation",6.12,"",1015878.50
,"General Journal","15-02-2024","22384",,,"EOL Case sealer Outfeed Conveyor Depreciation","Expense","Depreciation Expense",,"Accumulated Depreciation",297.62,"",1016176.12
,"General Journal","15-02-2024","22385",,,"Epson L6190 Printer 1 Depreciation","Expense","Depreciation Expense",,"Accumulated Depreciation",654.76,"",1016830.88
,"General Journal","15-02-2024","22386",,,"Fire Extinguisher 1 Depreciation","Expense","Depreciation Expense",,"Accumulated Depreciation",77.38,"",1016908.26
,"General Journal","15-02-2024","22387",,,"Fire Extinguisher 2 Depreciation","Expense","Depreciation Expense",,"Accumulated Depreciation",77.38,"",1016985.64
,"General Journal","15-02-2024","22388",,,"Fire Extinguisher 3 Depreciation","Expense","Depreciation Expense",,"Accumulated Depreciation",77.38,"",1017063.02
,"General Journal","15-02-2024","22389",,,"Fire Extinguisher 4 Depreciation","Expense","Depreciation Expense",,"Accumulated Depreciation",77.38,"",1017140.40
,"General Journal","15-02-2024","22390",,,"Fire Extinguisher 5 Depreciation","Expense","Depreciation Expense",,"Accumulated Depreciation",77.38,"",1017217.78
,"General Journal","15-02-2024","22391",,,"Fire Extinguisher 6 Depreciation","Expense","Depreciation Expense",,"Accumulated Depreciation",77.38,"",1017295.16
,"General Journal","15-02-2024","22392",,,"Grinder 2 Depreciation","Expense","Depreciation Expense",,"Accumulated Depreciation",178.57,"",1017473.73
,"General Journal","15-02-2024","22393",,,"HP Laptop 11 Depreciation","Expense","Depreciation Expense",,"Accumulated Depreciation",1200.00,"",1018673.73
,"General Journal","15-02-2024","22394",,,"HP Laptop 12 Depreciation","Expense","Depreciation Expense",,"Accumulated Depreciation",1200.00,"",1019873.73
,"General Journal","15-02-2024","22395",,,"Microwave 2 Depreciation","Expense","Depreciation Expense",,"Accumulated Depreciation",147.27,"",1020021.00
,"General Journal","15-02-2024","22396",,,"Movable Ladder 1 Depreciation","Expense","Depreciation Expense",,"Accumulated Depreciation",434.52,"",1020455.52
,"General Journal","15-02-2024","22397",,,"UV water purifier 3 Depreciation","Expense","Depreciation Expense",,"Accumulated Depreciation",543.10,"",1020998.62
,"General Journal","15-02-2024","22398",,,"Water tank 6 Depreciation","Expense","Depreciation Expense",,"Accumulated Depreciation",71.84,"",1021070.46
,"General Journal","16-02-2024","22410",,,"Bosch Grinder 3 Depreciation","Expense","Depreciation Expense",,"Accumulated Depreceiation",86.21,"",1021156.67
,"General Journal","16-02-2024","22411",,,"Chain block 5 depreciation","Expense","Depreciation Expense",,"Accumulated Depreciation",292.49,"",1021449.16
,"General Journal","16-02-2024","22412",,,"Chain block 6 depreciation","Expense","Depreciation Expense",,"Accumulated Depreciation",292.49,"",1021741.65
,"General Journal","16-02-2024","22413",,,"Heat Gun Total 1 Depreciation","Expense","Depreciation Expense",,"Accumulated Depreciation",64.66,"",1021806.31
,"General Journal","16-02-2024","22414",,,"Linx 5900 Coder 1 Depreciation","Expense","Depreciation Expense",,"Accumulated Depreciation",4166.67,"",1025972.98
,"General Journal","16-02-2024","22415",,,"Table Top Scale 11 6Kg Depreciation","Expense","Depreciation Expense",,"Accumulated Depreciation",277.09,"",1026250.07
,"General Journal","16-02-2024","22416",,,"Washing Machine 1 Depreciation","Expense","Depreciation Expense",,"Accumulated Depreciation",2640.01,"",1028890.08
,"General Journal","17-02-2024","22423",,,"2T Mixer Depreciation","Expense","Depreciation Expense",,"Accumulated Depreciation",12633.99,"",1041524.07
,"General Journal","17-02-2024","22424",,,"2T Mixer Installation Depreciation","Expense","Depreciation Expense",,"Accumulated Depreciation",29713.15,"",1071237.22
,"General Journal","17-02-2024","22427",,,"Coder UPS 6 Depreciation","Expense","Depreciation Expense",,"Accumulated Depreciation",94.83,"",1071332.05
,"General Journal","17-02-2024","22428",,,"Coder UPS 7 Depreciation","Expense","Depreciation Expense",,"Accumulated Depreciation",94.83,"",1071426.88
,"General Journal","17-02-2024","22434","*",,"Hand Dryer 1 Depreciation","Expense","Depreciation Expense",,"Accumulated Depreciation",46.18,"",1071473.06
,"General Journal","17-02-2024","22435","*",,"HP Laptop 3 Depreciation","Expense","Depreciation Expense",,"Accumulated Depreciation",297.62,"",1071770.68
,"General Journal","17-02-2024","22437",,,"Office desks  4","Expense","Depreciation Expense",,"Accumulated Depreciation",361.90,"",1072132.58
,"General Journal","17-02-2024","22439",,,"Pallet truck 4 Depreciation","Expense","Depreciation Expense",,"Accumulated Depreciation",428.57,"",1072561.15
,"General Journal","17-02-2024","22440",,,"Pallet truck 5 Depreciation","Expense","Depreciation Expense",,"Accumulated Depreciation",428.57,"",1072989.72
,"General Journal","17-02-2024","22441",,,"Recirculation Pump Depreciation","Expense","Depreciation Expense",,"Accumulated  Depreciation",71.19,"",1073060.91
,"General Journal","17-02-2024","22442",,,"Server 1 Depreciation","Expense","Depreciation Expense",,"Accumulated Depreciation",357.14,"",1073418.05
,"General Journal","17-02-2024","22443",,,"Server Monitor Depreciation","Expense","Depreciation Expense",,"Accumulated Depreciaion",107.14,"",1073525.19
,"General Journal","17-02-2024","22444",,,"Shrink Tunnel Depreciation","Expense","Depreciation Expense",,"Accumulated Depreciation",3750.00,"",1077275.19
,"General Journal","17-02-2024","22445","*",,"Soap Dispenser 1 Depreciation","Expense","Depreciation Expense",,"Accumulated Depreciation",15.39,"",1077290.58
,"General Journal","17-02-2024","22448","*",,"TP Link 3 Depreciation","Expense","Depreciation Expense",,"Accumulated Depreciation",33.33,"",1077323.91
,"General Journal","17-02-2024","22449","*",,"Water Tank 3 Depreciation","Expense","Depreciation Expense",,"Accumulated Depreciation",123.15,"",1077447.06
,"General Journal","18-02-2024","22417",,,"TV Screen 3 Depreciation","Expense","Depreciation Expense",,"Accumulated Depreciation",316.67,"",1077763.73
,"General Journal","18-02-2024","22418",,,"TV Screen 4 Depreciation","Expense","Depreciation Expense",,"Accumulated Depreciation",1550.00,"",1079313.73
,"General Journal","18-02-2024","22420",,,"HP Mini Desktop 1 Depreciation","Expense","Depreciation Expense",,"Accumulated Depreciation",733.33,"",1080047.06
,"General Journal","18-02-2024","22421",,,"HP Mini Desktop 2 Depreciation","Expense","Depreciation Expense",,"Accumulated Depreciation",733.33,"",1080780.39
,"General Journal","18-02-2024","22422",,,"HP Mini Desktop 3 Depreciation","Expense","Depreciation Expense",,"Accumulated Depreciation",733.33,"",1081513.72
,"General Journal","18-02-2024","22426",,,"Carton Sealer Manual 1 Depreciation","Expense","Depreciation Expense",,"Accumulated Depreciation",14.80,"",1081528.52
,"General Journal","18-02-2024","22430",,,"Compressor 3 Depreciation","Expense","Depreciation Expense",,"Accumulated Depreciation",5357.14,"",1086885.66
,"General Journal","18-02-2024","22431",,,"Compressor room depreciation","Expense","Depreciation Expense",,"Accumulated depreciation",132.44,"",1087018.10
,"General Journal","18-02-2024","22432",,,"Electric Hoist 1 depreciation","Expense","Depreciation Expense",,"Accumulated depreciation",3452.38,"",1090470.48
,"General Journal","18-02-2024","22433",,,"Gents changing room Lockers Depreciation","Expense","Depreciation Expense",,"Accumulated Depreciation",386.90,"",1090857.38
,"General Journal","18-02-2024","22436",,,"Ladies changing room Lockers Depreciation","Expense","Depreciation Expense",,"Accumulated Depreciation",411.90,"",1091269.28
,"General Journal","18-02-2024","22438",,,"Omrom M1 Basic BP Monitor Depreciation","Expense","Depreciation Expense",,"Accumulated Depreciation",58.33,"",1091327.61
,"General Journal","18-02-2024","22446",,,"SS Hand Washing Station 1 Depreciation","Expense","Depreciation Expense",,"Accumulated Depreciation",690.48,"",1092018.09
,"General Journal","18-02-2024","22447",,,"TP Link 2 Depreciation","Expense","Depreciation Expense",,"Accumulated Depreciation",41.67,"",1092059.76
,"General Journal","19-02-2024","22425",,,"3T Gas Forklift 1 Depreciation","Expense","Depreciation Expense",,"Accumulated Depreciation",30952.38,"",1123012.14
,"General Journal","19-02-2024","22429",,,"Coding Stamp 3 Depreciation","Expense","Depreciation Expense",,"Accumulated Depreciation",143.68,"",1123155.82
,"General Journal","20-02-2024","22450","*","Unilever Kenya Ltd:Sunlight Washing Pwd","Boato Commisioning Depreciation","Expense","Depreciation Expense",,"Accumulated Depreciation",889.88,"",1124045.70
,"General Journal","20-02-2024","22451",,,"Bosch Blower 3 Depreciation","Expense","Depreciation Expense",,"Accumulated Depreciation",79.02,"",1124124.72
,"General Journal","20-02-2024","22452",,,"Bosch Blower 4 Depreciation","Expense","Depreciation Expense",,"Accumulated Depreciation",136.49,"",1124261.21
,"General Journal","20-02-2024","22453",,,"Bosch Blower 5 Depreciation","Expense","Depreciation Expense",,"Accumulated Depreciation",136.49,"",1124397.70
,"General Journal","20-02-2024","22454",,,"Conference Office Desk 1 Depreciation","Expense","Depreciation Expense",,"Accumulated Depreciation",416.67,"",1124814.37
,"General Journal","20-02-2024","22455",,,"Floor Chair 17 depreciation","Expense","Depreciation Expense",,"Accumulated Depreciation",20.24,"",1124834.61
,"General Journal","20-02-2024","22456",,,"Floor Chair 18 depreciation","Expense","Depreciation Expense",,"Accumulated Depreciation",20.24,"",1124854.85
,"General Journal","20-02-2024","22457",,,"Floor Chair 19 depreciation","Expense","Depreciation Expense",,"Accumulated Depreciation",20.24,"",1124875.09
,"General Journal","20-02-2024","22458",,,"Floor Chair 20 depreciation","Expense","Depreciation Expense",,"Accumulated Depreciation",20.24,"",1124895.33
,"General Journal","20-02-2024","22459",,,"Heat Gun CAT Digital 1 Depreciation","Expense","Depreciation Expense",,"Accumulated Depreciation",136.49,"",1125031.82
,"General Journal","20-02-2024","22460","*",,"Lumnia 1 Pro Insect Trap Depreciation","Expense","Depreciation Expense",,"Accumulated Depreciation",316.67,"",1125348.49
,"General Journal","20-02-2024","22461",,,"PF Correction Unit Depreciation","Expense","Depreciation Expense",,"Accumulated Depreciation",1708.33,"",1127056.82
,"General Journal","21-02-2024","22462",,,"5Kg CO2 Fire Extinguisher 2 Depreciation","Expense","Depreciation Expense",,"Accumulated Depreciation",73.81,"",1127130.63
,"General Journal","21-02-2024","22463",,,"6Kg Dry Pwd Fire Extinguisher 1 Depreciaiton","Expense","Depreciation Expense",,"Accumulated Depreciation",59.52,"",1127190.15
,"General Journal","21-02-2024","22464",,,"Board room chair 1 Depreciation","Expense","Depreciation Expense",,"Accumulated Depreciation",59.52,"",1127249.67
,"General Journal","21-02-2024","22465",,,"Board room chair 2 Depreciation","Expense","Depreciation Expense",,"Accumulated Depreciation",59.52,"",1127309.19
,"General Journal","21-02-2024","22466",,,"Board room chair 4 Depreciation","Expense","Depreciation Expense",,"Accumulated Depreciation",59.52,"",1127368.71
,"General Journal","21-02-2024","22467",,,"Board room chair 5 Depreciation","Expense","Depreciation Expense",,"Accumulated Depreciation",59.52,"",1127428.23
,"General Journal","21-02-2024","22468",,,"Board room chair 6 Depreciation","Expense","Depreciation Expense",,"Accumulated Depreciation",59.52,"",1127487.75
,"General Journal","21-02-2024","22469",,,"Board room chair 7 Depreciation","Expense","Depreciation Expense",,"Accumulated Depreciation",59.52,"",1127547.27
,"General Journal","21-02-2024","22470",,,"Board room chair 8 Depreciation","Expense","Depreciation Expense",,"Accumulated Depreciation",59.52,"",1127606.79
,"General Journal","21-02-2024","22471",,,"Coding Stamp 2 Depreciation","Expense","Depreciation Expense",,"Accumulated Depreciation",133.33,"",1127740.12
,"General Journal","21-02-2024","22472",,,"IBC Tank 1 Depreciation","Expense","Depreciation Expense",,"Accumulated Depreciation",41.67,"",1127781.79
,"General Journal","21-02-2024","22473",,,"Empty IBC Tank 2 Depreciation","Expense","Depreciation Expense",,"Accumulated Depreciation",65.48,"",1127847.27
,"General Journal","21-02-2024","22474",,,"FFS Filling Machine 300 1 Depreciation","Expense","Depreciation Expense",,"Accumulated Depreciation",11850.01,"",1139697.28
,"General Journal","21-02-2024","22475",,,"Laboratory Oven & Dessicator  Depreciation","Expense","Depreciation Expense",,"Accumulated Depreciation",766.67,"",1140463.95
,"General Journal","21-02-2024","22476",,,"Nikon D3500 Camera 1 Depreciation","Expense","Depreciation Expense",,"Accumulated Depreciation",766.67,"",1141230.62
,"General Journal","21-02-2024","22477",,,"Tea Urn Depreciation","Expense","Depreciation Expense",,"Accumulated Depreciation",121.67,"",1141352.29
,"General Journal","22-02-2024","22478",,,"6Kg Auto Fire Extinguisher 1 Depreciation","Expense","Depreciation Expense",,"Accumulated Depreciation",53.57,"",1141405.86
,"General Journal","22-02-2024","22479",,,"6Kg Auto Fire Extinguisher 2 Depreciation","Expense","Depreciation Expense",,"Accumulated Depreciation",53.57,"",1141459.43
,"General Journal","22-02-2024","22480","*",,"AVS Voltage Stabilizer Depreciation","Expense","Depreciation Expense",,"Accumulated Depreciation",63.10,"",1141522.53
,"General Journal","22-02-2024","22481",,,"Conveyor Belt Green 1 Depreciation","Expense","Depreciation Expense",,"Accumulated Depreciation",82.14,"",1141604.67
,"General Journal","22-02-2024","22482",,,"HP Laptop 13 Depreciation","Expense","Depreciation Expense",,"Accumulated Depreciation",1200.00,"",1142804.67
,"General Journal","22-02-2024","22483","*",,"HP Laptop 7 Depreciation","Expense","Depreciation Expense",,"Accumulated Depreciation",1200.00,"",1144004.67
,"General Journal","22-02-2024","22484",,,"Office Desk 5 Depreciation","Expense","Depreciation Expense",,"Accumulated Depreciation",180.95,"",1144185.62
,"General Journal","22-02-2024","22485",,,"Office cabinets depreciation","Expense","Depreciation Expense",,"Accumulated Depreciation",119.05,"",1144304.67
,"General Journal","22-02-2024","22486",,,"Platform Scale 2 SS 100Kg Depreciation","Expense","Depreciation Expense",,"Accumulated Depreciation",339.29,"",1144643.96
,"General Journal","22-02-2024","22487",,,"Solar Water Heater 300L Depreciation","Expense","Depreciation Expense",,"Accumulated Depreciation",3125.00,"",1147768.96
,"General Journal","23-02-2024","22488",,,"Analytical Balance Depreciation","Expense","Depreciation Expense",,"Accumulated Depreciation",2405.58,"",1150174.54
,"General Journal","23-02-2024","22489",,,"Auger Filler 1 Depreciation","Expense","Depreciation Expense",,"Accumulated Depreciation",7220.12,"",1157394.66
,"General Journal","23-02-2024","22490",,,"Auger Filler 2 Depreciation","Expense","Depreciation Expense",,"Accumulated Depreciation",13258.63,"",1170653.29
,"General Journal","23-02-2024","22491",,,"Auger Filler 3 Depreciation","Expense","Depreciation Expense",,"Accumulated Depreciation",11788.69,"",1182441.98
,"General Journal","23-02-2024","22492",,,"Bajaj Boxer BM150 UG Depreciation","Expense","Depreciation Expense",,"Accumulated Depreciation",1539.41,"",1183981.39
,"General Journal","23-02-2024","22493",,,"Chain block 4 depreciation","Expense","Depreciation Expense",,"Accumulated Depreciation",133.42,"",1184114.81
,"General Journal","23-02-2024","22494",,,"Coder UPS Depreciation","Expense","Depreciation Expense",,"Accumulated Depreciation",95.24,"",1184210.05
,"General Journal","23-02-2024","22495",,,"Dust Extractor 1 Depreciation","Expense","Depreciation Expense",,"Accumulated Depreciation",446.43,"",1184656.48
,"General Journal","23-02-2024","22496",,,"Dust Extractor 2 Depreciation","Expense","Depreciation Expense",,"Accumulated Depreciation",446.43,"",1185102.91
,"General Journal","23-02-2024","22497",,,"Filler 1 Geared Motor & Feeding System Depreciation","Expense","Depreciation Expense",,"Accumulated Depreciation",333.33,"",1185436.24
,"General Journal","23-02-2024","22498",,,"Filler 2 Geared Motor & Feeding System Depreciation","Expense","Depreciation Expense",,"Accumulated Depreciation",348.72,"",1185784.96
,"General Journal","23-02-2024","22499",,,"Filler 3 Geared Motor & Feeding System Depreciation","Expense","Depreciation Expense",,"Accumulated Depreciation",347.52,"",1186132.48
,"General Journal","23-02-2024","22500",,,"Hotplate with Stirrer Depreciation","Expense","Depreciation Expense",,"Accumulated Depreciation",1785.71,"",1187918.19
,"General Journal","23-02-2024","22501",,,"Makita Hammer Drill Depreciation","Expense","Depreciation Expense",,"Accumulated Depreciation",205.25,"",1188123.44
,"General Journal","23-02-2024","22502",,,"Microwave 1 Depreciation","Expense","Depreciation Expense",,"Accumulated Depreciation",217.13,"",1188340.57
,"General Journal","23-02-2024","22503",,,"Pallet truck 3 Dep","Expense","Depreciation Expense",,"Accumulated Depreciation",510.95,"",1188851.52
,"General Journal","23-02-2024","22504",,,"Pouching Machine Depreciation","Expense","Depreciation Expense",,"Accumulated Depreciation",711.90,"",1189563.42
,"General Journal","23-02-2024","22505",,,"Power bank dep","Expense","Depreciation Expense",,"Accumulated Depreciation",119.05,"",1189682.47
,"General Journal","23-02-2024","22506",,,"Table Top Scale 11  SS 30Kg Depreciation","Expense","Depreciation Expense",,"Accumulated Depreciation",297.62,"",1189980.09
,"General Journal","23-02-2024","22507",,,"Table Top Scale 12  SS 30Kg Depreciation","Expense","Depreciation Expense",,"Accumulated Depreciation",297.62,"",1190277.71
,"General Journal","24-02-2024","22508",,,"Access Control Unit & System Depreciation","Expense","Depreciation Expense",,"Accumulated Depreciation",334.76,"",1190612.47
,"General Journal","24-02-2024","22513",,,"Electrical Enclosure Compressor Depreciation","Expense","Depreciation Expense",,"Accumulated Depreciation",125.00,"",1190737.47
,"General Journal","24-02-2024","22514",,,"ETR Machine Depreciation","Expense","Depreciation Expense",,"Accumulated Depreciation",236.04,"",1190973.51
,"General Journal","24-02-2024","22525",,,"Liquid Plant Depreciation","Expense","Depreciation Expense",,"Accumulated Deprecation",15029.76,"",1206003.27
,"General Journal","24-02-2024","22526",,,"Paste processing & packing line depreciation","Expense","Depreciation Expense",,"Accumulated Depreciation",17348.21,"",1223351.48
,"General Journal","24-02-2024","22527",,,"pH Meter Depreciation","Expense","Depreciation Expense",,"Accumulated Depreciation",741.39,"",1224092.87
,"General Journal","25-02-2024","22509",,,"Clamp Meter 1 Depreciation","Expense","Depreciation Expense",,"Accumulated Depreciation",36.90,"",1224129.77
,"General Journal","25-02-2024","22515",,,"Fire Alarm Sytstem Depreciation","Expense","Depreciation Expense",,"Accumulated Depreciation",728.57,"",1224858.34
,"General Journal","25-02-2024","22516",,,"Floor Chair 11 Depreciation","Expense","Depreciation Expense",,"Accumulated Depreciation",53.57,"",1224911.91
,"General Journal","25-02-2024","22517",,,"Floor Chair 12 Depreciation","Expense","Depreciation Expense",,"Accumulated Depreciation",53.57,"",1224965.48
,"General Journal","25-02-2024","22518",,,"Floor Chair 13 Depreciation","Expense","Depreciation Expense",,"Accumulated Depreciation",53.57,"",1225019.05
,"General Journal","25-02-2024","22519",,,"Floor Chair 14 Depreciation","Expense","Depreciation Expense",,"Accumulated Depreciation",53.57,"",1225072.62
,"General Journal","25-02-2024","22520",,,"Floor Chair 15 Depreciation","Expense","Depreciation Expense",,"Accumulated Depreciation",53.57,"",1225126.19
,"General Journal","25-02-2024","22521",,,"Floor Chair 16 Depreciation","Expense","Depreciation Expense",,"Accumulated Depreciation",53.57,"",1225179.76
,"General Journal","25-02-2024","22524",,,"Liquid Mixer 500Lt Depreciation","Expense","Depreciation Expense",,"Accumulated Depreciation",6172.62,"",1231352.38
,"General Journal","25-02-2024","22528",,,"Plastic Resin Mixer Depreciation","Expense","Depreciation Expense",,"Accumulated  Depreciation",1130.95,"",1232483.33
,"General Journal","25-02-2024","22529",,,"Plastic Resin Mixer Depreciation","Expense","Depreciation Expense",,"Accumulated  Depreciation",1130.95,"",1233614.28
,"General Journal","25-02-2024","25184",,,"Water tank 7 Depreciation","Expense","Depreciation Expense",,"Accumulated Depreciation",71.84,"",1233686.12
,"General Journal","26-02-2024","22510",,,"Dell Desktop 2 Depreciation","Expense","Depreciation Expense",,"Accumulated Depreciation",229.17,"",1233915.29
,"General Journal","26-02-2024","22511",,,"Dell Desktop 3 Depreciation","Expense","Depreciation Expense",,"Accumulated Depreciation",229.17,"",1234144.46
,"General Journal","26-02-2024","22512",,,"Dell Desktop 4 Depreciation","Expense","Depreciation Expense",,"Accumulated Depreciation",229.17,"",1234373.63
,"General Journal","26-02-2024","22522",,,"Grease Gun 1 Depreciation","Expense","Depreciation Expense",,"Accumulated Depreciation",73.21,"",1234446.84
,"General Journal","26-02-2024","22523",,,"Grease Gun 2 Depreciation","Expense","Depreciation Expense",,"Accumulated Depreciation",63.14,"",1234509.98
,"General Journal","26-02-2024","22530",,,"Retort Stand 1 Depreciation","Expense","Depreciation Expense",,"Accumulated Depreciation",10.71,"",1234520.69
,"General Journal","26-02-2024","22531",,,"Retort Stand 2 Depreciation","Expense","Depreciation Expense",,"Accumulated Depreciation",10.71,"",1234531.40
,"General Journal","27-02-2024","22532",,,"Board room chair 10 Depreciation","Expense","Depreciation Expense",,"Accumulated Depreciation",79.55,"",1234610.95
,"General Journal","27-02-2024","22533",,,"Board room chair 11 Depreciation","Expense","Depreciation Expense",,"Accumulated Depreciation",79.55,"",1234690.50
,"General Journal","27-02-2024","22534",,,"Board room chair 12 Depreciation","Expense","Depreciation Expense",,"Accumulated Depreciation",79.55,"",1234770.05
,"General Journal","27-02-2024","22535",,,"Board room chair 13 Depreciation","Expense","Depreciation Expense",,"Accumulated Depreciation",79.55,"",1234849.60
,"General Journal","27-02-2024","22536",,,"Board room chair 14 Depreciation","Expense","Depreciation Expense",,"Accumulated Depreciation",79.55,"",1234929.15
,"General Journal","27-02-2024","22537",,,"Board room chair 15 Depreciation","Expense","Depreciation Expense",,"Accumulated Depreciation",79.55,"",1235008.70
,"General Journal","27-02-2024","22538",,,"Board room chair 16 Depreciation","Expense","Depreciation Expense",,"Accumulated Depreciation",79.55,"",1235088.25
,"General Journal","27-02-2024","22539",,,"Board room chair 17 Depreciation","Expense","Depreciation Expense",,"Accumulated Depreciation",79.55,"",1235167.80
,"General Journal","27-02-2024","22540",,,"Board room chair 18 Depreciation","Expense","Depreciation Expense",,"Accumulated Depreciation",79.55,"",1235247.35
,"General Journal","27-02-2024","22541",,,"Board room chair 19 Depreciation","Expense","Depreciation Expense",,"Accumulated Depreciation",79.55,"",1235326.90
,"General Journal","27-02-2024","22542",,,"Board room chair 9 Depreciation","Expense","Depreciation Expense",,"Accumulated Depreciation",79.55,"",1235406.45
,"General Journal","27-02-2024","22543",,,"Canvas Stretcher Depreciation","Expense","Depreciation Expense",,"Accumulated Depreciation",133.33,"",1235539.78
,"General Journal","27-02-2024","22544",,,"Passenger Lift 1000kg Depreciation","Expense","Depreciation Expense",,"Accumulated Depreciation",44484.68,"",1280024.46
,"General Journal","27-02-2024","22545",,,"Printer Depreciation","Expense","Depreciation Expense",,"Accumulated Depreciation",205.25,"",1280229.71
,"General Journal","28-02-2024","25155",,,"Heat Gun Bosch 2 Accumulated depreciation","Expense","Depreciation Expense",,"Accumulated Depreciation",75.43,"",1280305.14
,"General Journal","28-02-2024","25156",,,"Heat Gun Bosch 3 Accumulated depreciation","Expense","Depreciation Expense",,"Accumulated Depreciation",75.43,"",1280380.57
,"General Journal","29-02-2024","22546",,,"500gm Jar Blow Mould 3 depreciation","Expense","Depreciation Expense",,"Accumulated Depreciation",1026.79,"",1281407.36
,"General Journal","29-02-2024","22547",,,"500gm Jar Blow Mould 4 depreciation","Expense","Depreciation Expense",,"Accumulated Depreciation",1026.79,"",1282434.15
,"General Journal","29-02-2024","22548",,,"Air cooled chiller depeciation","Expense","Depreciation Expense",,"Accumulated  Depreciation",8916.67,"",1291350.82
,"General Journal","29-02-2024","22549","*","Unilever Kenya Ltd:Sunlight Washing Pwd","Boato Installation Depreciation","Expense","Depreciation Expense",,"Accumulated Depreciation",65114.38,"",1356465.20
,"General Journal","29-02-2024","22550","*",,"Canister Platform Depreciation","Expense","Depreciation Expense",,"Accumulated Depreciation",59246.67,"",1415711.87
,"General Journal","29-02-2024","22551",,,"CCTV DRV & System Depreciation","Expense","Depreciation Expense",,"Accumulated Depreciation",1295.33,"",1417007.20
,"General Journal","29-02-2024","22552",,,"Colour Pressure tank Depreciation","Expense","Depreciation Expense",,"Accumulated Depreciation",232.14,"",1417239.34
,"General Journal","29-02-2024","22553",,,"Compressed air gun Depreciation","Expense","Depreciation Expense",,"Accumulated Depreciation",47.62,"",1417286.96
,"General Journal","29-02-2024","22554",,,"Drum Pump 2 Depreciation","Expense","Depreciation Expense",,"Accumulated Depreciation",123.15,"",1417410.11
,"General Journal","29-02-2024","22555",,,"Extractor Fan down Depreciation","Expense","Depreciation Expense",,"Accumulated Depreciation",150.12,"",1417560.23
,"General Journal","29-02-2024","22556",,,"Extractor Fan Hoisting Depreciation","Expense","Depreciation Expense",,"Accumulated Depreciation",176.67,"",1417736.90
,"General Journal","29-02-2024","22557",,,"Extractor Fan Packaging Depreciation","Expense","Depreciation Expense",,"Accumulated Depreciation",150.12,"",1417887.02
,"General Journal","29-02-2024","22558",,,"Incotex Type C Control Unit Depreciation","Expense","Depreciation Expense",,"Accumulated Depreciation",1939.66,"",1419826.68
,"General Journal","29-02-2024","22559",,,"Lamination Machine 1 Depreciation","Expense","Depreciation Expense",,"Accumulated Depreciation",84.78,"",1419911.46
,"General Journal","29-02-2024","22560",,,"Office Cabinet 5 Depreciation","Expense","Depreciation Expense",,"Accumulated Depreciation",58.33,"",1419969.79
,"General Journal","29-02-2024","22561",,,"Office Desk 6 Depreciation","Expense","Depreciation Expense",,"Accumulated Depreciation",90.48,"",1420060.27
,"General Journal","29-02-2024","22562",,,"Office Desk 7 Depreciation","Expense","Depreciation Expense",,"Accumulated Depreciation",90.48,"",1420150.75
,"General Journal","29-02-2024","22563",,,"Office Desk 8 Depreciation","Expense","Depreciation Expense",,"Accumulated Depreciation",83.33,"",1420234.08
,"General Journal","29-02-2024","22564",,,"Platform Scale 4 tons 1 Depreciation","Expense","Depreciation Expense",,"Accumulated Depreciation",10782.43,"",1431016.51
,"General Journal","29-02-2024","22565",,,"Process Water Filtration System Depreciation","Expense","Depreciation Expense",,"Accumulated Depreciation",1785.71,"",1432802.22
,"General Journal","29-02-2024","22566",,,"Sulphonic Acid pressure tank Depreciation","Expense","Depreciation Expense",,"Accumulated Depreciation",110.48,"",1432912.70
,"General Journal","29-02-2024","22567",,,"Test Sieves 100 & 200 microns Depreciation","Expense","Depreciation Expense",,"Accumulated Depreciation",450.00,"",1433362.70
,"General Journal","29-02-2024","22568",,,"Wall mounted cabinet 1 Dep","Expense","Depreciation Expense",,"Accumulated Depreciation",107.14,"",1433469.84
,"General Journal","29-02-2024","22569",,,"Water tank 5 Depreciation","Expense","Depreciation Expense",,"Accumulated Depreciation",137.79,"",1433607.63
,"General Journal","01-03-2024","22570",,,"Hoisting Bucket 1 Depreciation","Expense","Depreciation Expense",,"Accumulated Depreciation",148.81,"",1433756.44
,"General Journal","01-03-2024","22571",,,"Hoisting Bucket 2 Dereciation","Expense","Depreciation Expense",,"Accumulated Depreciation",148.81,"",1433905.25
,"General Journal","01-03-2024","22572",,,"Lenovo Laptop 2 Depreciation","Expense","Depreciation Expense",,"Accumulated Depreciation",333.33,"",1434238.58
,"General Journal","01-03-2024","22573",,,"Processing Platform Depreciation","Expense","Depreciation Expense",,"Accumulated Depreciation",4880.95,"",1439119.53
,"General Journal","01-03-2024","22574",,,"Security and Computer Sytem UPS Depreciation","Expense","Depreciation Expense",,"Accumulated Depreciation",3584.50,"",1442704.03
,"General Journal","01-03-2024","22575",,,"Trophy Shelf 1 Depreciation","Expense","Depreciation Expense",,"Accumulated Depreciation",95.24,"",1442799.27
,"General Journal","01-03-2024","22576",,,"Water tank 4 Depreciation","Expense","Depreciation Expense",,"Accumulated Depreciation",453.24,"",1443252.51
,"General Journal","02-03-2024","22586",,,"CMPP 1kg Jar Blow Mould 1 Depreciation","Expense","Depreciation Expense",,"Accumulated Depreciation",3364.87,"",1446617.38
,"General Journal","02-03-2024","22587",,,"CMPP 1kg Jar Blow Mould 2 Depreciation","Expense","Depreciation Expense",,"Accumulated Depreciation",3364.87,"",1449982.25
,"General Journal","02-03-2024","22588",,,"CMPP 500gm Jar Blow Mould 1 Depreciation","Expense","Depreciation Expense",,"Accumulated Depreciation",2643.82,"",1452626.07
,"General Journal","02-03-2024","22589",,,"CMPP 500gm Jar Blow Mould 2 Depreciation","Expense","Depreciation Expense",,"Accumulated Depreciation",2643.82,"",1455269.89
,"General Journal","02-03-2024","22590",,,"CMPP Blow Moulding Machine 1 Depreciation","Expense","Depreciation Expense",,"Accumulated Depreciation",49344.71,"",1504614.60
,"General Journal","02-03-2024","22591",,,"CMPP Blow Moulding Machine 2 Depreciation","Expense","Depreciation Expense",,"Accumulated Depreciation",49344.71,"",1553959.31
,"General Journal","02-03-2024","22592",,,"Drum Pump 1 Depreiation","Expense","Depreciation Expense",,"Accumulated Depreciation",123.03,"",1554082.34
,"General Journal","02-03-2024","22606",,,"Heat Gun Bosch 1 Depreciation","Expense","Depreciation Expense",,"Accumulated Depreciation",100.57,"",1554182.91
,"General Journal","02-03-2024","22607",,,"Hot ProcessWater Storage Tank1  Depreciation","Expense","Depreciation Expense",,"Accumulated Depreciation",73.99,"",1554256.90
,"General Journal","02-03-2024","22608","*",,"HP Laptop 4 Depreciation","Expense","Depreciation Expense",,"Accumulated Depreciation",297.62,"",1554554.52
,"General Journal","02-03-2024","22609","*",,"HP Laptop 8 Depreciation","Expense","Depreciation Expense",,"Accumulated Depreciation",1200.00,"",1555754.52
,"General Journal","02-03-2024","22618",,,"Store Racking 1 depreciation","Expense","Depreciation Expense",,"Accumulated Depreciation",175.60,"",1555930.12
,"General Journal","02-03-2024","22619",,,"Store Racking 2 Depreciation","Expense","Depreciation Expense",,"Accumulated Depreciation",175.60,"",1556105.72
,"General Journal","02-03-2024","22625",,,"Tank platform Depreciation","Expense","Depreciation Expense",,"Accumulated Depreciation",130.95,"",1556236.67
,"General Journal","02-03-2024","22627",,,"Water tank 1 Depreciation","Expense","Depreciation Expense",,"Accumulated Depreciation",120.07,"",1556356.74
,"General Journal","02-03-2024","22628",,,"Workshop cabinet depreciation","Expense","Depreciation Expense",,"Accumulated Depreciation",172.02,"",1556528.76
,"General Journal","03-03-2024","22581",,,"Alarm System extension","Expense","Depreciation Expense",,"Accumulated Depreciation",602.38,"",1557131.14
,"General Journal","03-03-2024","22582",,,"Domestos sewing machine depreciation","Expense","Depreciation Expense",,"Acummulated depreciation",82.10,"",1557213.24
,"General Journal","03-03-2024","22583",,,"Bench Grinder 2 Depreciation","Expense","Depreciation Expense",,"Accumulated Depreceiation",100.57,"",1557313.81
,"General Journal","03-03-2024","22584",,,"CCTV survellance System extension Depreciation","Expense","Depreciation Expense",,"Accumulated Depreciation",657.14,"",1557970.95
,"General Journal","03-03-2024","22593",,,"Electrical Enclosure CCTV Depreciation","Expense","Depreciation Expense",,"Accumulated Depreciation",126.19,"",1558097.14
,"General Journal","03-03-2024","22594",,,"Electrical Enclosure Main Depreciation","Expense","Depreciation Expense",,"Accumulated Depreciation",2339.29,"",1560436.43
,"General Journal","03-03-2024","22595",,,"Electrical Enclosure P Line Depreciation","Expense","Depreciation Expense",,"Accumulated Depreciation",428.57,"",1560865.00
,"General Journal","03-03-2024","22605",,,"Floodlight Depreciation","Expense","Depreciation Expense",,"Accumulated Depreciation",59.52,"",1560924.52
,"General Journal","03-03-2024","22613",,,"Office Desk 1 Depreciation","Expense","Depreciation Expense",,"Accumulated Depreciation",225.00,"",1561149.52
,"General Journal","03-03-2024","22614",,,"Office Desk 2 Depreciation","Expense","Depreciation Expense",,"Accumulated Depreciation",225.00,"",1561374.52
,"General Journal","03-03-2024","22615",,,"Office Desk 3 Depreciation","Expense","Depreciation Expense",,"Accumulated Depreciation",225.00,"",1561599.52
,"General Journal","03-03-2024","22616",,,"Signet ESD 1 Depreciation","Expense","Depreciation Expense",,"Accumulated Depreciation",928.57,"",1562528.09
,"General Journal","03-03-2024","22617","*",,"Sterling Water Dispenser 1 Depreciation","Expense","Depreciation Expense",,"Accumulated Depreciation",119.05,"",1562647.14
,"General Journal","03-03-2024","22620",,,"Table top Weighing Scale 5 Depreciation","Expense","Depreciation Expense",,"Accumulated Depreciation",248.57,"",1562895.71
,"General Journal","03-03-2024","22621",,,"Table top Weighing Scale 6 Depreciation","Expense","Depreciation Expense",,"Accumulated Depreciation",248.57,"",1563144.28
,"General Journal","03-03-2024","22622",,,"Table top Weighing Scale 7 Depreciation","Expense","Depreciation Expense",,"Accumulated Depreciation",248.57,"",1563392.85
,"General Journal","03-03-2024","22623",,,"Table top Weighing Scale 8 Depreciation","Expense","Depreciation Expense",,"Accumulated Depreciation",248.57,"",1563641.42
,"General Journal","03-03-2024","22624",,,"Table top Weighing Scale 9 Depreciation","Expense","Depreciation Expense",,"Accumulated Depreciation",248.57,"",1563889.99
,"General Journal","04-03-2024","22577",,,"9Kg Powder Fire Extinguisher 1 Depreciation","Expense","Depreciation Expense",,"Accumulated Depreciation",34.52,"",1563924.51
,"General Journal","04-03-2024","22578",,,"9Kg Powder Fire Extinguisher 2 Depreciation","Expense","Depreciation Expense",,"Accumulated Depreciation",34.52,"",1563959.03
,"General Journal","04-03-2024","22579",,,"9Kg Powder Fire Extinguisher 3 Depreciation","Expense","Depreciation Expense",,"Accumulated Depreciation",34.52,"",1563993.55
,"General Journal","04-03-2024","22580",,,"9Kg Powder Fire Extinguisher 5 Depreciation","Expense","Depreciation Expense",,"Accumulated Depreciation",34.52,"",1564028.07
,"General Journal","04-03-2024","22585",,,"Chiller 2 Depreciation","Expense","Depreciation Expense",,"Accumulated Depreciation",8035.71,"",1572063.78
,"General Journal","04-03-2024","22596",,,"Empty IBC Tank 10 Depreciation","Expense","Depreciation Expense",,"Accumulated Depreciation",41.67,"",1572105.45
,"General Journal","04-03-2024","22597",,,"Empty IBC Tank 3 Depreciation","Expense","Depreciation Expense",,"Accumulated Depreciation",65.48,"",1572170.93
,"General Journal","04-03-2024","22598",,,"Empty IBC Tank 4 Depreciation","Expense","Depreciation Expense",,"Accumulated Depreciation",65.48,"",1572236.41
,"General Journal","04-03-2024","22599",,,"Empty IBC Tank 5 Depreciation","Expense","Depreciation Expense",,"Accumulated Depreciation",65.48,"",1572301.89
,"General Journal","04-03-2024","22600",,,"Empty IBC Tank 6 Depreciation","Expense","Depreciation Expense",,"Accumulated Depreciation",65.48,"",1572367.37
,"General Journal","04-03-2024","22601",,,"Empty IBC Tank 7 Depreciation","Expense","Depreciation Expense",,"Accumulated Depreciation",41.67,"",1572409.04
,"General Journal","04-03-2024","22602",,,"Empty IBC Tank 8 Depreciation","Expense","Depreciation Expense",,"Accumulated Depreiation",41.67,"",1572450.71
,"General Journal","04-03-2024","22603",,,"Empty IBC Tank 9 Depreciation","Expense","Depreciation Expense",,"Accumulated Depreciation",41.67,"",1572492.38
,"General Journal","04-03-2024","22610",,,"Linx 8900 Coder 1 Depreciation","Expense","Depreciation Expense",,"Accumulated Depreciation",8333.33,"",1580825.71
,"General Journal","04-03-2024","22611",,,"Mobile Phone 2 Depreciation","Expense","Depreciation Expense",,"Accumulated Depreciation",46.67,"",1580872.38
,"General Journal","04-03-2024","22626",,,"Triple UV water purifier 1 Depreciation","Expense","Depreciation Expense",,"Accumulated Depreciation",296.22,"",1581168.60
,"General Journal","05-03-2024","22630",,,"1Kg Generic Jar Blow Mould 1 depreciation","Expense","Depreciation Expense",,"Accumulated Depreciation",1500.00,"",1582668.60
,"General Journal","05-03-2024","22631",,,"1Kg Generic Jar Blow Mould 2 depreciation","Expense","Depreciation Expense",,"Accumulated Depreciation",1500.00,"",1584168.60
,"General Journal","05-03-2024","22632",,,"500gm Generic Jar Blow Mould 1 depreciation","Expense","Depreciation Expense",,"Accumulated Depreciation",1071.43,"",1585240.03
,"General Journal","05-03-2024","22633",,,"500gm Generic Jar Blow Mould 2 depreciation","Expense","Depreciation Expense",,"Accumulated Depreciation",1071.43,"",1586311.46
,"General Journal","05-03-2024","22634",,,"9Kg Powder Fire Extinguisher 4 Depreciation","Expense","Depreciation Expense",,"Accumulated Depreciation",34.52,"",1586345.98
,"General Journal","05-03-2024","22635",,,"Extractor Fan 4 Depreciation","Expense","Depreciation Expense",,"Accumulated Depreciation",726.19,"",1587072.17
,"General Journal","05-03-2024","22636",,,"FFS  Machine Installation Elct Depreciation","Expense","Depreciation Expense",,"Accumulated Depreciation",200.60,"",1587272.77
,"General Journal","05-03-2024","22637",,,"First Aid Kit Depreciation","Expense","Depreciation Expense",,"Accumulated  Depreciation",77.38,"",1587350.15
,"General Journal","05-03-2024","22638",,,"Linx 8900 Coder 2 Depreciation","Expense","Depreciation Expense",,"Accumulated Depreciation",12500.00,"",1599850.15
,"General Journal","05-03-2024","22639",,,"Packing Platform Depreciation","Expense","Depreciation Expense",,"Accumulated Depreciation",5297.62,"",1605147.77
,"General Journal","05-03-2024","22640",,,"SS Industrial Turntable Depreciation","Expense","Depreciation Expense",,"Accumulated Depreciation",5238.10,"",1610385.87
,"General Journal","05-03-2024","22641",,,"TV Screen 2 Depreciation","Expense","Depreciation Expense",,"Accumulated Depreciation",950.00,"",1611335.87
,"General Journal","05-03-2024","22642",,,"Water Purifier 1 Depreciation","Expense","Depreciation Expense",,"Accumulated Depreciation",117.10,"",1611452.97
,"General Journal","05-03-2024","22643",,,"Water tank 2 Depreciation","Expense","Depreciation Expense",,"Accumulated Depreciation",23.81,"",1611476.78
,"General Journal","06-03-2024","22644",,,"Blower Depreciation","Expense","Depreciation Expense",,"Accumulated Depreciation",59.52,"",1611536.30
,"General Journal","06-03-2024","22645",,,"Emergency Washing Point Depreciation","Expense","Depreciation Expense",,"Accumulated Deprecation",160.71,"",1611697.01
,"General Journal","06-03-2024","22646","*",,"Infrared Thermometre 1 Depreciation","Expense","Depreciation Expense",,"Accumulated Depreciation",416.67,"",1612113.68
,"General Journal","06-03-2024","22647",,,"Material's Trolley Depreciation","Expense","Depreciation Expense",,"Accumulated Depreciation",297.62,"",1612411.30
,"General Journal","06-03-2024","22648",,,"Plastic Scrap Grinder Machine Depreciation","Expense","Depreciation Expense",,"Accumulated  Depreciation",3452.38,"",1615863.68
,"General Journal","06-03-2024","22649",,,"Ribon Mixer SS depreciation","Expense","Depreciation Expense",,"Accumulated depreciation",4642.86,"",1620506.54
,"General Journal","06-03-2024","22650",,,"Telephone Handset Depreciation","Expense","Depreciation Expense",,"Accumulated Depreciation",29.76,"",1620536.30
,"General Journal","06-03-2024","22651",,,"Telkom Wifi Router Depreciation","Expense","Depreciation Expense",,"Accumulated Depreciation",71.43,"",1620607.73
,"General Journal","06-03-2024","22652",,,"Vacuum Cleaner Depreciation","Expense","Depreciation Expense",,"Accumulated Depreciation",148.81,"",1620756.54
,"General Journal","07-03-2024","22658",,,"9Kg Powder Fire Extinguisher 6 Depreciation","Expense","Depreciation Expense",,"Accumulated Depreciation",44.05,"",1620800.59
,"General Journal","07-03-2024","22659",,,"Big bag trolley 1 Depreciation","Expense","Depreciation Expense",,"Accumulated Depreciation",344.29,"",1621144.88
,"General Journal","07-03-2024","22660",,,"Cartoning table 4 depreciation","Expense","Depreciation Expense",,"Accumulated Depreciation",262.49,"",1621407.37
,"General Journal","07-03-2024","22661",,,"Case sealing table depreciation","Expense","Depreciation Expense",,"Accumulated Depreciation",86.67,"",1621494.04
,"General Journal","07-03-2024","22662",,,"Chain block 2 depreciation","Expense","Depreciation Expense",,"Accumulated depreciation",398.81,"",1621892.85
,"General Journal","07-03-2024","22663",,,"Chain block 3 depreciation","Expense","Depreciation Expense",,"Accumulated depreciation",398.81,"",1622291.66
,"General Journal","07-03-2024","22664",,,"Drilling machine Depreciation","Expense","Depreciation Expense",,"Accumulated Depreciation",88.39,"",1622380.05
,"General Journal","07-03-2024","22665",,,"Grinder Depreciation","Expense","Depreciation Expense",,"Acccumulated Depreciation",159.82,"",1622539.87
,"General Journal","07-03-2024","22666",,,"Packing table 1 depreciation","Expense","Depreciation Expense",,"Accumulated Depreciation",262.49,"",1622802.36
,"General Journal","07-03-2024","22667",,,"Packing table 2 depreciation","Expense","Depreciation Expense",,"Accumulated Depreciation",262.49,"",1623064.85
,"General Journal","07-03-2024","22668",,,"Packing table 3 depreciation","Expense","Depreciation Expense",,"Accumulated Depreciation",262.49,"",1623327.34
,"General Journal","07-03-2024","22669",,,"Quality table depreciation","Expense","Depreciation Expense",,"Accumulated Depreciation",86.67,"",1623414.01
,"General Journal","07-03-2024","22670",,,"Welding machine Depreciation","Expense","Depreciation Expense",,"Accumulated Depreciation",178.57,"",1623592.58
,"General Journal","08-03-2024","22671",,,"Bench Grinder 350W Depreciation","Expense","Depreciation Expense",,"Accumulated Depreciation",122.13,"",1623714.71
,"General Journal","08-03-2024","22672",,,"HP Laptop 6 Depreciation","Expense","Depreciation Expense",,"Accumulated Depreciation",416.67,"",1624131.38
,"General Journal","08-03-2024","22673",,,"Mobile Phone 1 Depreciation","Expense","Depreciation Expense",,"Accumulated Depreciation",58.33,"",1624189.71
,"General Journal","09-03-2024","22680",,,"Canteen Table 1 Depreciation","Expense","Depreciation Expense",,"Accumulated Depreciation",184.52,"",1624374.23
,"General Journal","09-03-2024","22681",,,"Canteen Table 2 Depreciation","Expense","Depreciation Expense",,"Accumulated Depreciation",184.52,"",1624558.75
,"General Journal","09-03-2024","22686",,,"Dell Desktop 1 Depreciation","Expense","Depreciation Expense",,"Accumulated Depreciation",178.57,"",1624737.32
,"General Journal","09-03-2024","22687",,,"Fire Alarm System Extension'19 Depreciation","Expense","Depreciation Expense",,"Accumulated Depreciation",9857.14,"",1634594.46
,"General Journal","09-03-2024","22688",,,"Floor Chair 1 Depreciation","Expense","Depreciation Expense",,"Accumulated Depreciation",26.79,"",1634621.25
,"General Journal","09-03-2024","22689",,,"Floor Chair 10 Depreciation","Expense","Depreciation Expense",,"Accumulated Depreciation",53.57,"",1634674.82
,"General Journal","09-03-2024","22690",,,"Floor Chair 2 Depreciation","Expense","Depreciation Expense",,"Accumulated Depreciation",26.79,"",1634701.61
,"General Journal","09-03-2024","22691",,,"Floor Chair 3 Depreciation","Expense","Depreciation Expense",,"Accumulated Depreciation",26.79,"",1634728.40
,"General Journal","09-03-2024","22692",,,"Floor Chair 4 Depreciation","Expense","Depreciation Expense",,"Accumulated Depreciation",26.79,"",1634755.19
,"General Journal","09-03-2024","22693",,,"Floor Chair 5 Depreciation","Expense","Depreciation Expense",,"Accumulated Depreciation",26.79,"",1634781.98
,"General Journal","09-03-2024","22694",,,"Floor Chair 6 Depreciation","Expense","Depreciation Expense",,"Accumulated Depreciation",53.57,"",1634835.55
,"General Journal","09-03-2024","22695",,,"Floor Chair 7 Depreciation","Expense","Depreciation Expense",,"Accumulated Depreciation",53.57,"",1634889.12
,"General Journal","09-03-2024","22696",,,"Floor Chair 8 Depreciation","Expense","Depreciation Expense",,"Accumulated Depreciation",53.57,"",1634942.69
,"General Journal","09-03-2024","22697",,,"Floor Chair 9 Depreciation","Expense","Depreciation Expense",,"Accumulated Depreciation",53.57,"",1634996.26
,"General Journal","09-03-2024","22698",,,"Floor weighing scale Depreciation","Expense","Depreciation Expense",,"Accumulated Depreciation",593.81,"",1635590.07
,"General Journal","09-03-2024","22703",,,"Lab Office Chair 1 Depreciation","Expense","Depreciation Expense",,"Accumulated Depreciation",47.62,"",1635637.69
,"General Journal","09-03-2024","22704",,,"Lab Office Chair 2 Depreciation","Expense","Depreciation Expense",,"Accumulated Depreciation",47.62,"",1635685.31
,"General Journal","09-03-2024","22705",,,"Lab Office Chair 3 Depreciation","Expense","Depreciation Expense",,"Accumulated Depreciation",47.62,"",1635732.93
,"General Journal","09-03-2024","22713","*","Unilever Kenya Ltd:Sunlight Washing Pwd","Sunlight Bag Closing Machine 1 Depreciation","Expense","Depreciation Expense",,"Accumulated Depreciation",738.10,"",1636471.03
,"General Journal","09-03-2024","22714","*","Unilever Kenya Ltd:Sunlight Washing Pwd","Sunlight Packing Chair 1 Depreciation","Expense","Depreciation Expense",,"Accumulated Depreciation",41.67,"",1636512.70
,"General Journal","10-03-2024","22678",,,"5Kg Fire Extinguisher 1 Depreciation","Expense","Depreciation Expense",,"Accumulated Depreciation",65.48,"",1636578.18
,"General Journal","10-03-2024","22699",,,"HP Laptop 10 Depreciation","Expense","Depreciation Expense",,"Accumulated Depreciation",1200.00,"",1637778.18
,"General Journal","10-03-2024","22702",,,"HP Laptop 9 Depreciation","Expense","Depreciation Expense",,"Accumulated Depreciation",1200.00,"",1638978.18
,"General Journal","10-03-2024","22706",,,"Office Seat 1 Depreciation","Expense","Depreciation Expense",,"Accumulated Depreciation",142.86,"",1639121.04
,"General Journal","10-03-2024","22707",,,"Office Seat 2 Depreciation","Expense","Depreciation Expense",,"Accumulated Depreciation",71.43,"",1639192.47
,"General Journal","10-03-2024","22708",,,"Office Seat 3 Depreciation","Expense","Depreciation Expense",,"Accumulated Depreciation",71.43,"",1639263.90
,"General Journal","10-03-2024","22710",,,"Reverse Osmosis Unit 1 Depreciation","Expense","Depreciation Expense",,"Accumulated Depreciation",416.67,"",1639680.57
,"General Journal","10-03-2024","22711",,,"Steam Generator SG24 Depreciation","Expense","Depreciation Expense",,"Accumulated Depreciation",3794.53,"",1643475.10
,"General Journal","10-03-2024","22715",,,"Toilet Cleaner Mixing Machine Depreciation","Expense","Depreciation Expense",,"Accumulated Depreciation",6333.33,"",1649808.43
,"General Journal","11-03-2024","22676",,,"4 GB hard drive for CCTV Depreciation","Expense","Depreciation Expense",,"Accumulated Depreciation",178.57,"",1649987.00
,"General Journal","11-03-2024","22677",,,"4TB Hard Disk Depreciation","Expense","Depreciation Expense",,"Accumulated Depreciation",178.57,"",1650165.57
,"General Journal","11-03-2024","22679",,,"Board room chair 3 Depreciation","Expense","Depreciation Expense",,"Accumulated Depreciation",59.52,"",1650225.09
,"General Journal","11-03-2024","22682","*","Unilever Kenya Ltd:Sunlight Washing Pwd","Chain block trolley 4 depreciation","Expense","Depreciation Expense",,"Accumulated Depreciation",85.00,"",1650310.09
,"General Journal","11-03-2024","22683",,,"Coder Depreciation","Expense","Depreciation Expense",,"Accumulated Depreciation",2261.90,"",1652571.99
,"General Journal","11-03-2024","22684",,,"Coder Stand Depreciation","Expense","Depreciation Expense",,"Accumulated Depreciation",59.52,"",1652631.51
,"General Journal","11-03-2024","22685",,,"Compressor 1 depreciation","Expense","Depreciation Expense",,"Accumulated depreciation",3750.00,"",1656381.51
,"General Journal","11-03-2024","22700",,,"HP Laptop 14 Depreciation","Expense","Depreciation Expense",,"Accumulated Depreciation",1941.67,"",1658323.18
,"General Journal","11-03-2024","22701",,,"HP Laptop 15 Depreciation","Expense","Depreciation Expense",,"Accumulated Depreciation",1750.00,"",1660073.18
,"General Journal","11-03-2024","22709",,,"Pallet truck 2 depreciation","Expense","Depreciation Expense",,"Accumulated depreciation",440.48,"",1660513.66
,"General Journal","11-03-2024","22712","*",,"Steam Label Shrink Tunnel Depreciation","Expense","Depreciation Expense",,"Accumulated  Depreciation",10952.38,"",1671466.04
,"General Journal","12-03-2024","22716",,,"Canteen Chair 20 Depreciation","Expense","Depreciation Expense",,"Accumulated Depreciation",6.12,"",1671472.16
,"General Journal","12-03-2024","22717",,,"Coder Housing Depreciation","Expense","Depreciation Expense",,"Accumulated Depreciation",80.36,"",1671552.52
,"General Journal","12-03-2024","22718","*","Unilever Kenya Ltd:Sunlight Washing Pwd","Coder UPS 4 Depreciation","Expense","Depreciation Expense",,"Accumulated Depreciation",158.33,"",1671710.85
,"General Journal","12-03-2024","22719",,,"Coding Conveyor Depreciation","Expense","Depreciation Expense",,"Accumulated Depreciation",476.19,"",1672187.04
,"General Journal","12-03-2024","22720",,,"Conveyor 2 Depreciation","Expense","Depreciation Expense",,"Accumulated  Depreciation",169.64,"",1672356.68
,"General Journal","12-03-2024","22721",,,"Eyewash Station 1 Depreciation","Expense","Depreciation Expense",,"Accumulated Depreciation",904.76,"",1673261.44
,"General Journal","12-03-2024","22722",,,"HP Laptop 5 Depreciation","Expense","Depreciation Expense",,"Accumulated Depreciation",416.67,"",1673678.11
,"General Journal","12-03-2024","22723",,,"Tea maker Depreciation","Expense","Depreciation Expense",,"Accumulated Depreciation",225.00,"",1673903.11
,"General Journal","13-03-2024","22724",,,"Alarm System Depreciation","Expense","Depreciation Expense",,"Accumulated Depreciation",580.95,"",1674484.06
,"General Journal","13-03-2024","22725",,,"Bosch Blower 2 Depreciation","Expense","Depreciation Expense",,"Accumulated Depreciation",136.49,"",1674620.55
,"General Journal","13-03-2024","22726",,,"Coder UPS 8 Depreciation","Expense","Depreciation Expense",,"Accumulated Depreciation",81.67,"",1674702.22
,"General Journal","13-03-2024","22727","*",,"HP Laptop 16 Depreciation","Expense","Depreciation Expense",,"Accumulated Depreciation",1000.00,"",1675702.22
,"General Journal","13-03-2024","22728",,,"PIR system extension Depreciation","Expense","Depreciation Expense",,"Accumulated Depreciation",254.67,"",1675956.89
,"General Journal","13-03-2024","22729",,,"Process Water Storage Tank Depreciation","Expense","Depreciation Expense",,"Accumulated Depreciation",1065.16,"",1677022.05
,"General Journal","13-03-2024","22730","*",,"Store Racking 3 FG Depreciation","Expense","Depreciation Expense",,"Accumulated Depreciation",9791.67,"",1686813.72
,"General Journal","13-03-2024","22731",,,"Weighing scale 1","Expense","Depreciation Expense",,"Accumulated Depreciation",559.52,"",1687373.24
,"General Journal","14-03-2024","22732",,,"Coder UPS 5 Depreciation","Expense","Depreciation Expense",,"Accumulated Depreciation",158.33,"",1687531.57
,"General Journal","14-03-2024","22733",,,"Motor Vehicle 2 Depreciation","Expense","Depreciation Expense",,"Accumulated Depreciation",10297.62,"",1697829.19
,"General Journal","14-03-2024","22734",,,"Paste Packing Machine Depreciation","Expense","Depreciation Expense",,"Accumulated Depreciation",4166.67,"",1701995.86
,"General Journal","14-03-2024","22735",,,"Table Top Scale 10  SS 15Kg Depreciation","Expense","Depreciation Expense",,"Accumulated Depreciation",297.62,"",1702293.48
,"General Journal","15-03-2024","22419",,,"Mobile phone 3 Depreciation","Expense","Depreciation Expense",,"Accumulated Depreciation",41.67,"",1702335.15
,"General Journal","15-03-2024","22736",,,"150KVA Enclosed Genset Depreciation","Expense","Depreciation Expense",,"Accumulated Depreciation",24404.76,"",1726739.91
,"General Journal","15-03-2024","22737",,,"20Kg Forklift Gas Cylinder 2 Depreciation","Expense","Depreciation Expense",,"Accumulated Depreciation",769.70,"",1727509.61
,"General Journal","15-03-2024","22738",,,"2Ton Electric Hoist 1 Depreciation","Expense","Depreciation Expense",,"Accumulated Depreciation",3708.33,"",1731217.94
,"General Journal","15-03-2024","22739",,,"Automatic Change Over Switch 1 Depreciation","Expense","Depreciation Expense",,"Accumulated Depreciation",1666.67,"",1732884.61
,"General Journal","15-03-2024","22740",,,"Bench top Weighing Scale 1 Depreciation","Expense","Depreciation Expense",,"Accumulated Depreciation",357.14,"",1733241.75
,"General Journal","15-03-2024","22741",,,"Bench top Weighing Scale 2 Depreciation","Expense","Depreciation Expense",,"Accumulated Depreciation",357.14,"",1733598.89
,"General Journal","15-03-2024","22742",,,"Bench top Weighing Scale 3 Depreciation","Expense","Depreciation Expense",,"Accumulated Depreciation",357.14,"",1733956.03
,"General Journal","15-03-2024","22743",,,"Bench top Weighing Scale 4 Depreciation","Expense","Depreciation Expense",,"Accumulated Depreciation",357.14,"",1734313.17
,"General Journal","15-03-2024","22744",,,"Bosch Blower Depreciation","Expense","Depreciation Expense",,"Accumulated Depreciation",129.31,"",1734442.48
,"General Journal","15-03-2024","22745",,,"Canteen Chair 1 Depreciation","Expense","Depreciation Expense",,"Accumulated Depreciation",6.12,"",1734448.60
,"General Journal","15-03-2024","22746",,,"Canteen Chair 10 Depreciation","Expense","Depreciation Expense",,"Accumulated Depreciation",6.12,"",1734454.72
,"General Journal","15-03-2024","22747",,,"Canteen Chair 11 Depreciation","Expense","Depreciation Expense",,"Accumulated Depreciation",6.12,"",1734460.84
,"General Journal","15-03-2024","22748",,,"Canteen Chair 11 Depreciation","Expense","Depreciation Expense",,"Accumulated Depreciation",6.12,"",1734466.96
,"General Journal","15-03-2024","22749",,,"Canteen Chair 12 Depreciation","Expense","Depreciation Expense",,"Accumulated Depreciation",6.12,"",1734473.08
,"General Journal","15-03-2024","22750",,,"Canteen Chair 13 Depreciation","Expense","Depreciation Expense",,"Accumulated Depreciation",6.12,"",1734479.20
,"General Journal","15-03-2024","22751",,,"Canteen Chair 14 Depreciation","Expense","Depreciation Expense",,"Accumulated Depreciation",6.12,"",1734485.32
,"General Journal","15-03-2024","22752",,,"Canteen Chair 15 Depreciation","Expense","Depreciation Expense",,"Accumulated Depreciation",6.12,"",1734491.44
,"General Journal","15-03-2024","22753",,,"Canteen Chair 16 Depreciation","Expense","Depreciation Expense",,"Accumulated Depreciation",6.12,"",1734497.56
,"General Journal","15-03-2024","22754",,,"Canteen Chair 17 Depreciation","Expense","Depreciation Expense",,"Accumulated Depreciation",6.12,"",1734503.68
,"General Journal","15-03-2024","22755",,,"Canteen Chair 18 Depreciation","Expense","Depreciation Expense",,"Accumulated Depreciation",6.12,"",1734509.80
,"General Journal","15-03-2024","22756",,,"Canteen Chair 19 Depreciation","Expense","Depreciation Expense",,"Accumulated Depreciation",6.12,"",1734515.92
,"General Journal","15-03-2024","22757",,,"Canteen Chair 2 Depreciation","Expense","Depreciation Expense",,"Accumulated Depreciation",6.12,"",1734522.04
,"General Journal","15-03-2024","22758",,,"Canteen Chair 21 Depreciation","Expense","Depreciation Expense",,"Accumulated Depreciation",6.12,"",1734528.16
,"General Journal","15-03-2024","22759",,,"Canteen Chair 22 Depreciation","Expense","Depreciation Expense",,"Accumulated Depreciation",6.12,"",1734534.28
,"General Journal","15-03-2024","22760",,,"Canteen Chair 23 Depreciation","Expense","Depreciation Expense",,"Accumulated Depreciation",6.12,"",1734540.40
,"General Journal","15-03-2024","22761",,,"Canteen Chair 24 Depreciation","Expense","Depreciation Expense",,"Accumulated Depreciation",6.12,"",1734546.52
,"General Journal","15-03-2024","22762",,,"Canteen Chair 25 Depreciation","Expense","Depreciation Expense",,"Accumulated Depreciation",6.12,"",1734552.64
,"General Journal","15-03-2024","22763",,,"Canteen Chair 3 Depreciation","Expense","Depreciation Expense",,"Accumulated Depreciation",6.12,"",1734558.76
,"General Journal","15-03-2024","22764",,,"Canteen Chair 4 Depreciation","Expense","Depreciation Expense",,"Accumulated Depreciation",6.12,"",1734564.88
,"General Journal","15-03-2024","22765",,,"Canteen Chair 5 Depreciation","Expense","Depreciation Expense",,"Accumulated Depreciation",6.12,"",1734571.00
,"General Journal","15-03-2024","22766",,,"Canteen Chair 6 Depreciation","Expense","Depreciation Expense",,"Accumulated Depreciation",6.12,"",1734577.12
,"General Journal","15-03-2024","22767",,,"Canteen Chair 7 Depreciation","Expense","Depreciation Expense",,"Accumulated Depreciation",6.12,"",1734583.24
,"General Journal","15-03-2024","22768",,,"Canteen Chair 8 Depreciation","Expense","Depreciation Expense",,"Accumulated Depreciation",6.12,"",1734589.36
,"General Journal","15-03-2024","22769",,,"Canteen Chair 9 Depreciation","Expense","Depreciation Expense",,"Accumulated Depreciation",6.12,"",1734595.48
,"General Journal","15-03-2024","22770",,,"EOL Case sealer Outfeed Conveyor Depreciation","Expense","Depreciation Expense",,"Accumulated Depreciation",297.62,"",1734893.10
,"General Journal","15-03-2024","22771",,,"Epson L6190 Printer 1 Depreciation","Expense","Depreciation Expense",,"Accumulated Depreciation",654.76,"",1735547.86
,"General Journal","15-03-2024","22772",,,"Fire Extinguisher 1 Depreciation","Expense","Depreciation Expense",,"Accumulated Depreciation",77.38,"",1735625.24
,"General Journal","15-03-2024","22773",,,"Fire Extinguisher 2 Depreciation","Expense","Depreciation Expense",,"Accumulated Depreciation",77.38,"",1735702.62
,"General Journal","15-03-2024","22774",,,"Fire Extinguisher 3 Depreciation","Expense","Depreciation Expense",,"Accumulated Depreciation",77.38,"",1735780.00
,"General Journal","15-03-2024","22775",,,"Fire Extinguisher 4 Depreciation","Expense","Depreciation Expense",,"Accumulated Depreciation",77.38,"",1735857.38
,"General Journal","15-03-2024","22776",,,"Fire Extinguisher 5 Depreciation","Expense","Depreciation Expense",,"Accumulated Depreciation",77.38,"",1735934.76
,"General Journal","15-03-2024","22777",,,"Fire Extinguisher 6 Depreciation","Expense","Depreciation Expense",,"Accumulated Depreciation",77.38,"",1736012.14
,"General Journal","15-03-2024","22778",,,"Grinder 2 Depreciation","Expense","Depreciation Expense",,"Accumulated Depreciation",178.57,"",1736190.71
,"General Journal","15-03-2024","22779",,,"HP Laptop 11 Depreciation","Expense","Depreciation Expense",,"Accumulated Depreciation",1200.00,"",1737390.71
,"General Journal","15-03-2024","22780",,,"HP Laptop 12 Depreciation","Expense","Depreciation Expense",,"Accumulated Depreciation",1200.00,"",1738590.71
,"General Journal","15-03-2024","22781",,,"Microwave 2 Depreciation","Expense","Depreciation Expense",,"Accumulated Depreciation",147.27,"",1738737.98
,"General Journal","15-03-2024","22782",,,"Movable Ladder 1 Depreciation","Expense","Depreciation Expense",,"Accumulated Depreciation",434.52,"",1739172.50
,"General Journal","15-03-2024","22783",,,"UV water purifier 3 Depreciation","Expense","Depreciation Expense",,"Accumulated Depreciation",543.10,"",1739715.60
,"General Journal","15-03-2024","22784",,,"Water tank 6 Depreciation","Expense","Depreciation Expense",,"Accumulated Depreciation",71.84,"",1739787.44
,"General Journal","16-03-2024","22787",,,"Bosch Grinder 3 Depreciation","Expense","Depreciation Expense",,"Accumulated Depreceiation",86.21,"",1739873.65
,"General Journal","16-03-2024","22788",,,"Chain block 5 depreciation","Expense","Depreciation Expense",,"Accumulated Depreciation",292.49,"",1740166.14
,"General Journal","16-03-2024","22789",,,"Chain block 6 depreciation","Expense","Depreciation Expense",,"Accumulated Depreciation",292.49,"",1740458.63
,"General Journal","16-03-2024","22793",,,"Heat Gun Total 1 Depreciation","Expense","Depreciation Expense",,"Accumulated Depreciation",64.66,"",1740523.29
,"General Journal","16-03-2024","22795",,,"Linx 5900 Coder 1 Depreciation","Expense","Depreciation Expense",,"Accumulated Depreciation",4166.67,"",1744689.96
,"General Journal","16-03-2024","22804",,,"Table Top Scale 11 6Kg Depreciation","Expense","Depreciation Expense",,"Accumulated Depreciation",277.09,"",1744967.05
,"General Journal","16-03-2024","22806",,,"Washing Machine 1 Depreciation","Expense","Depreciation Expense",,"Accumulated Depreciation",2640.01,"",1747607.06
,"General Journal","17-03-2024","22785",,,"2T Mixer Depreciation","Expense","Depreciation Expense",,"Accumulated Depreciation",12633.99,"",1760241.05
,"General Journal","17-03-2024","22786",,,"2T Mixer Installation Depreciation","Expense","Depreciation Expense",,"Accumulated Depreciation",29713.15,"",1789954.20
,"General Journal","17-03-2024","22790",,,"Coder UPS 6 Depreciation","Expense","Depreciation Expense",,"Accumulated Depreciation",94.83,"",1790049.03
,"General Journal","17-03-2024","22791",,,"Coder UPS 7 Depreciation","Expense","Depreciation Expense",,"Accumulated Depreciation",94.83,"",1790143.86
,"General Journal","17-03-2024","22792","*",,"Hand Dryer 1 Depreciation","Expense","Depreciation Expense",,"Accumulated Depreciation",46.18,"",1790190.04
,"General Journal","17-03-2024","22794","*",,"HP Laptop 3 Depreciation","Expense","Depreciation Expense",,"Accumulated Depreciation",297.62,"",1790487.66
,"General Journal","17-03-2024","22796",,,"Office desks  4","Expense","Depreciation Expense",,"Accumulated Depreciation",361.90,"",1790849.56
,"General Journal","17-03-2024","22797",,,"Pallet truck 4 Depreciation","Expense","Depreciation Expense",,"Accumulated Depreciation",428.57,"",1791278.13
,"General Journal","17-03-2024","22798",,,"Pallet truck 5 Depreciation","Expense","Depreciation Expense",,"Accumulated Depreciation",428.57,"",1791706.70
,"General Journal","17-03-2024","22799",,,"Recirculation Pump Depreciation","Expense","Depreciation Expense",,"Accumulated  Depreciation",71.19,"",1791777.89
,"General Journal","17-03-2024","22800",,,"Server 1 Depreciation","Expense","Depreciation Expense",,"Accumulated Depreciation",357.14,"",1792135.03
,"General Journal","17-03-2024","22801",,,"Server Monitor Depreciation","Expense","Depreciation Expense",,"Accumulated Depreciaion",107.14,"",1792242.17
,"General Journal","17-03-2024","22802",,,"Shrink Tunnel Depreciation","Expense","Depreciation Expense",,"Accumulated Depreciation",3750.00,"",1795992.17
,"General Journal","17-03-2024","22803","*",,"Soap Dispenser 1 Depreciation","Expense","Depreciation Expense",,"Accumulated Depreciation",15.39,"",1796007.56
,"General Journal","17-03-2024","22805","*",,"TP Link 3 Depreciation","Expense","Depreciation Expense",,"Accumulated Depreciation",33.33,"",1796040.89
,"General Journal","17-03-2024","22807","*",,"Water Tank 3 Depreciation","Expense","Depreciation Expense",,"Accumulated Depreciation",123.15,"",1796164.04
,"General Journal","18-03-2024","22808",,,"Carton Sealer Manual 1 Depreciation","Expense","Depreciation Expense",,"Accumulated Depreciation",14.80,"",1796178.84
,"General Journal","18-03-2024","22809",,,"Compressor 3 Depreciation","Expense","Depreciation Expense",,"Accumulated Depreciation",5357.14,"",1801535.98
,"General Journal","18-03-2024","22810",,,"Compressor room depreciation","Expense","Depreciation Expense",,"Accumulated depreciation",132.44,"",1801668.42
,"General Journal","18-03-2024","22811",,,"Electric Hoist 1 depreciation","Expense","Depreciation Expense",,"Accumulated depreciation",3452.38,"",1805120.80
,"General Journal","18-03-2024","22812",,,"Gents changing room Lockers Depreciation","Expense","Depreciation Expense",,"Accumulated Depreciation",386.90,"",1805507.70
,"General Journal","18-03-2024","22813",,,"HP Mini Desktop 1 Depreciation","Expense","Depreciation Expense",,"Accumulated Depreciation",733.33,"",1806241.03
,"General Journal","18-03-2024","22814",,,"HP Mini Desktop 2 Depreciation","Expense","Depreciation Expense",,"Accumulated Depreciation",733.33,"",1806974.36
,"General Journal","18-03-2024","22815",,,"HP Mini Desktop 3 Depreciation","Expense","Depreciation Expense",,"Accumulated Depreciation",733.33,"",1807707.69
,"General Journal","18-03-2024","22816",,,"Ladies changing room Lockers Depreciation","Expense","Depreciation Expense",,"Accumulated Depreciation",411.90,"",1808119.59
,"General Journal","18-03-2024","22817",,,"Omrom M1 Basic BP Monitor Depreciation","Expense","Depreciation Expense",,"Accumulated Depreciation",58.33,"",1808177.92
,"General Journal","18-03-2024","22818",,,"SS Hand Washing Station 1 Depreciation","Expense","Depreciation Expense",,"Accumulated Depreciation",690.48,"",1808868.40
,"General Journal","18-03-2024","22819",,,"TP Link 2 Depreciation","Expense","Depreciation Expense",,"Accumulated Depreciation",41.67,"",1808910.07
,"General Journal","18-03-2024","22820",,,"TV Screen 3 Depreciation","Expense","Depreciation Expense",,"Accumulated Depreciation",316.67,"",1809226.74
,"General Journal","18-03-2024","22821",,,"TV Screen 4 Depreciation","Expense","Depreciation Expense",,"Accumulated Depreciation",1550.00,"",1810776.74
,"General Journal","19-03-2024","22822",,,"3T Gas Forklift 1 Depreciation","Expense","Depreciation Expense",,"Accumulated Depreciation",30952.38,"",1841729.12
,"General Journal","19-03-2024","22823",,,"Coding Stamp 3 Depreciation","Expense","Depreciation Expense",,"Accumulated Depreciation",143.68,"",1841872.80
,"General Journal","20-03-2024","22824","*","Unilever Kenya Ltd:Sunlight Washing Pwd","Boato Commisioning Depreciation","Expense","Depreciation Expense",,"Accumulated Depreciation",889.88,"",1842762.68
,"General Journal","20-03-2024","22825",,,"Bosch Blower 3 Depreciation","Expense","Depreciation Expense",,"Accumulated Depreciation",79.02,"",1842841.70
,"General Journal","20-03-2024","22826",,,"Bosch Blower 4 Depreciation","Expense","Depreciation Expense",,"Accumulated Depreciation",136.49,"",1842978.19
,"General Journal","20-03-2024","22827",,,"Bosch Blower 5 Depreciation","Expense","Depreciation Expense",,"Accumulated Depreciation",136.49,"",1843114.68
,"General Journal","20-03-2024","22828",,,"Conference Office Desk 1 Depreciation","Expense","Depreciation Expense",,"Accumulated Depreciation",416.67,"",1843531.35
,"General Journal","20-03-2024","22829",,,"Floor Chair 17 depreciation","Expense","Depreciation Expense",,"Accumulated Depreciation",20.24,"",1843551.59
,"General Journal","20-03-2024","22830",,,"Floor Chair 18 depreciation","Expense","Depreciation Expense",,"Accumulated Depreciation",20.24,"",1843571.83
,"General Journal","20-03-2024","22831",,,"Floor Chair 19 depreciation","Expense","Depreciation Expense",,"Accumulated Depreciation",20.24,"",1843592.07
,"General Journal","20-03-2024","22832",,,"Floor Chair 20 depreciation","Expense","Depreciation Expense",,"Accumulated Depreciation",20.24,"",1843612.31
,"General Journal","20-03-2024","22833",,,"Heat Gun CAT Digital 1 Depreciation","Expense","Depreciation Expense",,"Accumulated Depreciation",136.49,"",1843748.80
,"General Journal","20-03-2024","22834","*",,"Lumnia 1 Pro Insect Trap Depreciation","Expense","Depreciation Expense",,"Accumulated Depreciation",316.67,"",1844065.47
,"General Journal","20-03-2024","22835",,,"PF Correction Unit Depreciation","Expense","Depreciation Expense",,"Accumulated Depreciation",1708.33,"",1845773.80
,"General Journal","21-03-2024","22836",,,"5Kg CO2 Fire Extinguisher 2 Depreciation","Expense","Depreciation Expense",,"Accumulated Depreciation",73.81,"",1845847.61
,"General Journal","21-03-2024","22837",,,"6Kg Dry Pwd Fire Extinguisher 1 Depreciaiton","Expense","Depreciation Expense",,"Accumulated Depreciation",59.52,"",1845907.13
,"General Journal","21-03-2024","22838",,,"Board room chair 1 Depreciation","Expense","Depreciation Expense",,"Accumulated Depreciation",59.52,"",1845966.65
,"General Journal","21-03-2024","22839",,,"Board room chair 2 Depreciation","Expense","Depreciation Expense",,"Accumulated Depreciation",59.52,"",1846026.17
,"General Journal","21-03-2024","22840",,,"Board room chair 4 Depreciation","Expense","Depreciation Expense",,"Accumulated Depreciation",59.52,"",1846085.69
,"General Journal","21-03-2024","22841",,,"Board room chair 5 Depreciation","Expense","Depreciation Expense",,"Accumulated Depreciation",59.52,"",1846145.21
,"General Journal","21-03-2024","22842",,,"Board room chair 6 Depreciation","Expense","Depreciation Expense",,"Accumulated Depreciation",59.52,"",1846204.73
,"General Journal","21-03-2024","22843",,,"Board room chair 7 Depreciation","Expense","Depreciation Expense",,"Accumulated Depreciation",59.52,"",1846264.25
,"General Journal","21-03-2024","22844",,,"Board room chair 8 Depreciation","Expense","Depreciation Expense",,"Accumulated Depreciation",59.52,"",1846323.77
,"General Journal","21-03-2024","22845",,,"Coding Stamp 2 Depreciation","Expense","Depreciation Expense",,"Accumulated Depreciation",133.33,"",1846457.10
,"General Journal","21-03-2024","22846",,,"IBC Tank 1 Depreciation","Expense","Depreciation Expense",,"Accumulated Depreciation",41.67,"",1846498.77
,"General Journal","21-03-2024","22847",,,"Empty IBC Tank 2 Depreciation","Expense","Depreciation Expense",,"Accumulated Depreciation",65.48,"",1846564.25
,"General Journal","21-03-2024","22848",,,"FFS Filling Machine 300 1 Depreciation","Expense","Depreciation Expense",,"Accumulated Depreciation",11850.01,"",1858414.26
,"General Journal","21-03-2024","22849",,,"Laboratory Oven & Dessicator  Depreciation","Expense","Depreciation Expense",,"Accumulated Depreciation",766.67,"",1859180.93
,"General Journal","21-03-2024","22850",,,"Nikon D3500 Camera 1 Depreciation","Expense","Depreciation Expense",,"Accumulated Depreciation",766.67,"",1859947.60
,"General Journal","21-03-2024","22851",,,"Tea Urn Depreciation","Expense","Depreciation Expense",,"Accumulated Depreciation",121.67,"",1860069.27
,"General Journal","22-03-2024","22852",,,"6Kg Auto Fire Extinguisher 1 Depreciation","Expense","Depreciation Expense",,"Accumulated Depreciation",53.57,"",1860122.84
,"General Journal","22-03-2024","22853",,,"6Kg Auto Fire Extinguisher 2 Depreciation","Expense","Depreciation Expense",,"Accumulated Depreciation",53.57,"",1860176.41
,"General Journal","22-03-2024","22854","*",,"AVS Voltage Stabilizer Depreciation","Expense","Depreciation Expense",,"Accumulated Depreciation",63.10,"",1860239.51
,"General Journal","22-03-2024","22855",,,"Conveyor Belt Green 1 Depreciation","Expense","Depreciation Expense",,"Accumulated Depreciation",82.14,"",1860321.65
,"General Journal","22-03-2024","22856",,,"HP Laptop 13 Depreciation","Expense","Depreciation Expense",,"Accumulated Depreciation",1200.00,"",1861521.65
,"General Journal","22-03-2024","22857","*",,"HP Laptop 7 Depreciation","Expense","Depreciation Expense",,"Accumulated Depreciation",1200.00,"",1862721.65
,"General Journal","22-03-2024","22858",,,"Office Desk 5 Depreciation","Expense","Depreciation Expense",,"Accumulated Depreciation",180.95,"",1862902.60
,"General Journal","22-03-2024","22859",,,"Office cabinets depreciation","Expense","Depreciation Expense",,"Accumulated Depreciation",119.05,"",1863021.65
,"General Journal","22-03-2024","22860",,,"Platform Scale 2 SS 100Kg Depreciation","Expense","Depreciation Expense",,"Accumulated Depreciation",339.29,"",1863360.94
,"General Journal","22-03-2024","22861",,,"Solar Water Heater 300L Depreciation","Expense","Depreciation Expense",,"Accumulated Depreciation",3125.00,"",1866485.94
,"General Journal","23-03-2024","22862",,,"Analytical Balance Depreciation","Expense","Depreciation Expense",,"Accumulated Depreciation",2405.58,"",1868891.52
,"General Journal","23-03-2024","22863",,,"Auger Filler 1 Depreciation","Expense","Depreciation Expense",,"Accumulated Depreciation",7220.12,"",1876111.64
,"General Journal","23-03-2024","22864",,,"Auger Filler 2 Depreciation","Expense","Depreciation Expense",,"Accumulated Depreciation",13258.63,"",1889370.27
,"General Journal","23-03-2024","22865",,,"Auger Filler 3 Depreciation","Expense","Depreciation Expense",,"Accumulated Depreciation",11788.69,"",1901158.96
,"General Journal","23-03-2024","22866",,,"Bajaj Boxer BM150 UG Depreciation","Expense","Depreciation Expense",,"Accumulated Depreciation",1539.41,"",1902698.37
,"General Journal","23-03-2024","22867",,,"Chain block 4 depreciation","Expense","Depreciation Expense",,"Accumulated Depreciation",133.42,"",1902831.79
,"General Journal","23-03-2024","22868",,,"Coder UPS Depreciation","Expense","Depreciation Expense",,"Accumulated Depreciation",95.24,"",1902927.03
,"General Journal","23-03-2024","22869",,,"Dust Extractor 1 Depreciation","Expense","Depreciation Expense",,"Accumulated Depreciation",446.43,"",1903373.46
,"General Journal","23-03-2024","22870",,,"Dust Extractor 2 Depreciation","Expense","Depreciation Expense",,"Accumulated Depreciation",446.43,"",1903819.89
,"General Journal","23-03-2024","22871",,,"Filler 1 Geared Motor & Feeding System Depreciation","Expense","Depreciation Expense",,"Accumulated Depreciation",333.33,"",1904153.22
,"General Journal","23-03-2024","22872",,,"Filler 2 Geared Motor & Feeding System Depreciation","Expense","Depreciation Expense",,"Accumulated Depreciation",348.72,"",1904501.94
,"General Journal","23-03-2024","22873",,,"Filler 3 Geared Motor & Feeding System Depreciation","Expense","Depreciation Expense",,"Accumulated Depreciation",347.52,"",1904849.46
,"General Journal","23-03-2024","22874",,,"Hotplate with Stirrer Depreciation","Expense","Depreciation Expense",,"Accumulated Depreciation",1785.71,"",1906635.17
,"General Journal","23-03-2024","22875",,,"Makita Hammer Drill Depreciation","Expense","Depreciation Expense",,"Accumulated Depreciation",205.25,"",1906840.42
,"General Journal","23-03-2024","22876",,,"Microwave 1 Depreciation","Expense","Depreciation Expense",,"Accumulated Depreciation",217.13,"",1907057.55
,"General Journal","23-03-2024","22877",,,"Pallet truck 3 Dep","Expense","Depreciation Expense",,"Accumulated Depreciation",510.95,"",1907568.50
,"General Journal","23-03-2024","22878",,,"Pouching Machine Depreciation","Expense","Depreciation Expense",,"Accumulated Depreciation",711.90,"",1908280.40
,"General Journal","23-03-2024","22879",,,"Power bank dep","Expense","Depreciation Expense",,"Accumulated Depreciation",119.05,"",1908399.45
,"General Journal","23-03-2024","22880",,,"Table Top Scale 11  SS 30Kg Depreciation","Expense","Depreciation Expense",,"Accumulated Depreciation",297.62,"",1908697.07
,"General Journal","23-03-2024","22881",,,"Table Top Scale 12  SS 30Kg Depreciation","Expense","Depreciation Expense",,"Accumulated Depreciation",297.62,"",1908994.69
,"General Journal","24-03-2024","22882",,,"Access Control Unit & System Depreciation","Expense","Depreciation Expense",,"Accumulated Depreciation",334.76,"",1909329.45
,"General Journal","24-03-2024","22884",,,"Electrical Enclosure Compressor Depreciation","Expense","Depreciation Expense",,"Accumulated Depreciation",125.00,"",1909454.45
,"General Journal","24-03-2024","22885",,,"ETR Machine Depreciation","Expense","Depreciation Expense",,"Accumulated Depreciation",236.04,"",1909690.49
,"General Journal","24-03-2024","22894",,,"Liquid Plant Depreciation","Expense","Depreciation Expense",,"Accumulated Deprecation",15029.76,"",1924720.25
,"General Journal","24-03-2024","22895",,,"Paste processing & packing line depreciation","Expense","Depreciation Expense",,"Accumulated Depreciation",17348.21,"",1942068.46
,"General Journal","24-03-2024","22896",,,"pH Meter Depreciation","Expense","Depreciation Expense",,"Accumulated Depreciation",741.39,"",1942809.85
,"General Journal","25-03-2024","22883",,,"Clamp Meter 1 Depreciation","Expense","Depreciation Expense",,"Accumulated Depreciation",36.90,"",1942846.75
,"General Journal","25-03-2024","22886",,,"Fire Alarm Sytstem Depreciation","Expense","Depreciation Expense",,"Accumulated Depreciation",728.57,"",1943575.32
,"General Journal","25-03-2024","22887",,,"Floor Chair 11 Depreciation","Expense","Depreciation Expense",,"Accumulated Depreciation",53.57,"",1943628.89
,"General Journal","25-03-2024","22888",,,"Floor Chair 12 Depreciation","Expense","Depreciation Expense",,"Accumulated Depreciation",53.57,"",1943682.46
,"General Journal","25-03-2024","22889",,,"Floor Chair 13 Depreciation","Expense","Depreciation Expense",,"Accumulated Depreciation",53.57,"",1943736.03
,"General Journal","25-03-2024","22890",,,"Floor Chair 14 Depreciation","Expense","Depreciation Expense",,"Accumulated Depreciation",53.57,"",1943789.60
,"General Journal","25-03-2024","22891",,,"Floor Chair 15 Depreciation","Expense","Depreciation Expense",,"Accumulated Depreciation",53.57,"",1943843.17
,"General Journal","25-03-2024","22892",,,"Floor Chair 16 Depreciation","Expense","Depreciation Expense",,"Accumulated Depreciation",53.57,"",1943896.74
,"General Journal","25-03-2024","22893",,,"Liquid Mixer 500Lt Depreciation","Expense","Depreciation Expense",,"Accumulated Depreciation",6172.62,"",1950069.36
,"General Journal","25-03-2024","22897",,,"Plastic Resin Mixer Depreciation","Expense","Depreciation Expense",,"Accumulated  Depreciation",1130.95,"",1951200.31
,"General Journal","25-03-2024","22898",,,"Plastic Resin Mixer Depreciation","Expense","Depreciation Expense",,"Accumulated  Depreciation",1130.95,"",1952331.26
,"General Journal","25-03-2024","25185",,,"Water tank 7 Depreciation","Expense","Depreciation Expense",,"Accumulated Depreciation",71.84,"",1952403.10
,"General Journal","26-03-2024","22899",,,"Dell Desktop 2 Depreciation","Expense","Depreciation Expense",,"Accumulated Depreciation",229.17,"",1952632.27
,"General Journal","26-03-2024","22900",,,"Dell Desktop 3 Depreciation","Expense","Depreciation Expense",,"Accumulated Depreciation",229.17,"",1952861.44
,"General Journal","26-03-2024","22901",,,"Dell Desktop 4 Depreciation","Expense","Depreciation Expense",,"Accumulated Depreciation",229.17,"",1953090.61
,"General Journal","26-03-2024","22902",,,"Grease Gun 1 Depreciation","Expense","Depreciation Expense",,"Accumulated Depreciation",73.21,"",1953163.82
,"General Journal","26-03-2024","22903",,,"Grease Gun 2 Depreciation","Expense","Depreciation Expense",,"Accumulated Depreciation",63.14,"",1953226.96
,"General Journal","26-03-2024","22904",,,"Retort Stand 1 Depreciation","Expense","Depreciation Expense",,"Accumulated Depreciation",10.71,"",1953237.67
,"General Journal","26-03-2024","22905",,,"Retort Stand 2 Depreciation","Expense","Depreciation Expense",,"Accumulated Depreciation",10.71,"",1953248.38
,"General Journal","27-03-2024","22906",,,"Board room chair 10 Depreciation","Expense","Depreciation Expense",,"Accumulated Depreciation",79.55,"",1953327.93
,"General Journal","27-03-2024","22907",,,"Board room chair 11 Depreciation","Expense","Depreciation Expense",,"Accumulated Depreciation",79.55,"",1953407.48
,"General Journal","27-03-2024","22908",,,"Board room chair 12 Depreciation","Expense","Depreciation Expense",,"Accumulated Depreciation",79.55,"",1953487.03
,"General Journal","27-03-2024","22909",,,"Board room chair 13 Depreciation","Expense","Depreciation Expense",,"Accumulated Depreciation",79.55,"",1953566.58
,"General Journal","27-03-2024","22910",,,"Board room chair 14 Depreciation","Expense","Depreciation Expense",,"Accumulated Depreciation",79.55,"",1953646.13
,"General Journal","27-03-2024","22911",,,"Board room chair 15 Depreciation","Expense","Depreciation Expense",,"Accumulated Depreciation",79.55,"",1953725.68
,"General Journal","27-03-2024","22912",,,"Board room chair 16 Depreciation","Expense","Depreciation Expense",,"Accumulated Depreciation",79.55,"",1953805.23
,"General Journal","27-03-2024","22913",,,"Board room chair 17 Depreciation","Expense","Depreciation Expense",,"Accumulated Depreciation",79.55,"",1953884.78
,"General Journal","27-03-2024","22914",,,"Board room chair 18 Depreciation","Expense","Depreciation Expense",,"Accumulated Depreciation",79.55,"",1953964.33
,"General Journal","27-03-2024","22915",,,"Board room chair 19 Depreciation","Expense","Depreciation Expense",,"Accumulated Depreciation",79.55,"",1954043.88
,"General Journal","27-03-2024","22916",,,"Board room chair 9 Depreciation","Expense","Depreciation Expense",,"Accumulated Depreciation",79.55,"",1954123.43
,"General Journal","27-03-2024","22917",,,"Canvas Stretcher Depreciation","Expense","Depreciation Expense",,"Accumulated Depreciation",133.33,"",1954256.76
,"General Journal","27-03-2024","22918",,,"Passenger Lift 1000kg Depreciation","Expense","Depreciation Expense",,"Accumulated Depreciation",44484.68,"",1998741.44
,"General Journal","27-03-2024","22919",,,"Printer Depreciation","Expense","Depreciation Expense",,"Accumulated Depreciation",205.25,"",1998946.69
,"General Journal","28-03-2024","25161",,,"Heat Gun Bosch 2 Accumulated depreciation","Expense","Depreciation Expense",,"Accumulated Depreciation",75.43,"",1999022.12
,"General Journal","28-03-2024","25167",,,"Heat Gun Bosch 3 Accumulated depreciation","Expense","Depreciation Expense",,"Accumulated Depreciation",75.43,"",1999097.55
,"General Journal","31-03-2024","22920",,,"500gm Jar Blow Mould 3 depreciation","Expense","Depreciation Expense",,"Accumulated Depreciation",1026.79,"",2000124.34
,"General Journal","31-03-2024","22921",,,"500gm Jar Blow Mould 4 depreciation","Expense","Depreciation Expense",,"Accumulated Depreciation",1026.79,"",2001151.13
,"General Journal","31-03-2024","22922",,,"Air cooled chiller depeciation","Expense","Depreciation Expense",,"Accumulated  Depreciation",8916.67,"",2010067.80
,"General Journal","31-03-2024","22923","*","Unilever Kenya Ltd:Sunlight Washing Pwd","Boato Installation Depreciation","Expense","Depreciation Expense",,"Accumulated Depreciation",65114.38,"",2075182.18
,"General Journal","31-03-2024","22924","*",,"Canister Platform Depreciation","Expense","Depreciation Expense",,"Accumulated Depreciation",59246.67,"",2134428.85
,"General Journal","31-03-2024","22925",,,"CCTV DRV & System Depreciation","Expense","Depreciation Expense",,"Accumulated Depreciation",1295.33,"",2135724.18
,"General Journal","31-03-2024","22932",,,"Colour Pressure tank Depreciation","Expense","Depreciation Expense",,"Accumulated Depreciation",232.14,"",2135956.32
,"General Journal","31-03-2024","22933",,,"Compressed air gun Depreciation","Expense","Depreciation Expense",,"Accumulated Depreciation",47.62,"",2136003.94
,"General Journal","31-03-2024","22935",,,"Drum Pump 2 Depreciation","Expense","Depreciation Expense",,"Accumulated Depreciation",123.15,"",2136127.09
,"General Journal","31-03-2024","22936",,,"Extractor Fan down Depreciation","Expense","Depreciation Expense",,"Accumulated Depreciation",150.12,"",2136277.21
,"General Journal","31-03-2024","22937",,,"Extractor Fan Hoisting Depreciation","Expense","Depreciation Expense",,"Accumulated Depreciation",176.67,"",2136453.88
,"General Journal","31-03-2024","22938",,,"Extractor Fan Packaging Depreciation","Expense","Depreciation Expense",,"Accumulated Depreciation",150.12,"",2136604.00
,"General Journal","31-03-2024","22945",,,"Incotex Type C Control Unit Depreciation","Expense","Depreciation Expense",,"Accumulated Depreciation",1939.66,"",2138543.66
,"General Journal","31-03-2024","22946",,,"Lamination Machine 1 Depreciation","Expense","Depreciation Expense",,"Accumulated Depreciation",84.78,"",2138628.44
,"General Journal","31-03-2024","22948",,,"Office Cabinet 5 Depreciation","Expense","Depreciation Expense",,"Accumulated Depreciation",58.33,"",2138686.77
,"General Journal","31-03-2024","22949",,,"Office Desk 6 Depreciation","Expense","Depreciation Expense",,"Accumulated Depreciation",90.48,"",2138777.25
,"General Journal","31-03-2024","22950",,,"Office Desk 7 Depreciation","Expense","Depreciation Expense",,"Accumulated Depreciation",90.48,"",2138867.73
,"General Journal","31-03-2024","22951",,,"Office Desk 8 Depreciation","Expense","Depreciation Expense",,"Accumulated Depreciation",83.33,"",2138951.06
,"General Journal","31-03-2024","22952",,,"Platform Scale 4 tons 1 Depreciation","Expense","Depreciation Expense",,"Accumulated Depreciation",10782.43,"",2149733.49
,"General Journal","31-03-2024","22953",,,"Process Water Filtration System Depreciation","Expense","Depreciation Expense",,"Accumulated Depreciation",1785.71,"",2151519.20
,"General Journal","31-03-2024","22958",,,"Sulphonic Acid pressure tank Depreciation","Expense","Depreciation Expense",,"Accumulated Depreciation",110.48,"",2151629.68
,"General Journal","31-03-2024","22960",,,"Test Sieves 100 & 200 microns Depreciation","Expense","Depreciation Expense",,"Accumulated Depreciation",450.00,"",2152079.68
,"General Journal","31-03-2024","22962",,,"Wall mounted cabinet 1 Dep","Expense","Depreciation Expense",,"Accumulated Depreciation",107.14,"",2152186.82
,"General Journal","31-03-2024","22965",,,"Water tank 5 Depreciation","Expense","Depreciation Expense",,"Accumulated Depreciation",137.79,"",2152324.61
,"General Journal","01-04-2024","22940",,,"Hoisting Bucket 1 Depreciation","Expense","Depreciation Expense",,"Accumulated Depreciation",148.81,"",2152473.42
,"General Journal","01-04-2024","22941",,,"Hoisting Bucket 2 Dereciation","Expense","Depreciation Expense",,"Accumulated Depreciation",148.81,"",2152622.23
,"General Journal","01-04-2024","22947",,,"Lenovo Laptop 2 Depreciation","Expense","Depreciation Expense",,"Accumulated Depreciation",333.33,"",2152955.56
,"General Journal","01-04-2024","22954",,,"Processing Platform Depreciation","Expense","Depreciation Expense",,"Accumulated Depreciation",4880.95,"",2157836.51
,"General Journal","01-04-2024","22955",,,"Security and Computer Sytem UPS Depreciation","Expense","Depreciation Expense",,"Accumulated Depreciation",3584.50,"",2161421.01
,"General Journal","01-04-2024","22961",,,"Trophy Shelf 1 Depreciation","Expense","Depreciation Expense",,"Accumulated Depreciation",95.24,"",2161516.25
,"General Journal","01-04-2024","22964",,,"Water tank 4 Depreciation","Expense","Depreciation Expense",,"Accumulated Depreciation",453.24,"",2161969.49
,"General Journal","02-04-2024","22926",,,"CMPP 1kg Jar Blow Mould 1 Depreciation","Expense","Depreciation Expense",,"Accumulated Depreciation",3364.87,"",2165334.36
,"General Journal","02-04-2024","22927",,,"CMPP 1kg Jar Blow Mould 2 Depreciation","Expense","Depreciation Expense",,"Accumulated Depreciation",3364.87,"",2168699.23
,"General Journal","02-04-2024","22928",,,"CMPP 500gm Jar Blow Mould 1 Depreciation","Expense","Depreciation Expense",,"Accumulated Depreciation",2643.82,"",2171343.05
,"General Journal","02-04-2024","22929",,,"CMPP 500gm Jar Blow Mould 2 Depreciation","Expense","Depreciation Expense",,"Accumulated Depreciation",2643.82,"",2173986.87
,"General Journal","02-04-2024","22930",,,"CMPP Blow Moulding Machine 1 Depreciation","Expense","Depreciation Expense",,"Accumulated Depreciation",49344.71,"",2223331.58
,"General Journal","02-04-2024","22931",,,"CMPP Blow Moulding Machine 2 Depreciation","Expense","Depreciation Expense",,"Accumulated Depreciation",49344.71,"",2272676.29
,"General Journal","02-04-2024","22934",,,"Drum Pump 1 Depreiation","Expense","Depreciation Expense",,"Accumulated Depreciation",123.03,"",2272799.32
,"General Journal","02-04-2024","22939",,,"Heat Gun Bosch 1 Depreciation","Expense","Depreciation Expense",,"Accumulated Depreciation",100.57,"",2272899.89
,"General Journal","02-04-2024","22942",,,"Hot ProcessWater Storage Tank1  Depreciation","Expense","Depreciation Expense",,"Accumulated Depreciation",73.99,"",2272973.88
,"General Journal","02-04-2024","22943","*",,"HP Laptop 4 Depreciation","Expense","Depreciation Expense",,"Accumulated Depreciation",297.62,"",2273271.50
,"General Journal","02-04-2024","22944","*",,"HP Laptop 8 Depreciation","Expense","Depreciation Expense",,"Accumulated Depreciation",1200.00,"",2274471.50
,"General Journal","02-04-2024","22956",,,"Store Racking 1 depreciation","Expense","Depreciation Expense",,"Accumulated Depreciation",175.60,"",2274647.10
,"General Journal","02-04-2024","22957",,,"Store Racking 2 Depreciation","Expense","Depreciation Expense",,"Accumulated Depreciation",175.60,"",2274822.70
,"General Journal","02-04-2024","22959",,,"Tank platform Depreciation","Expense","Depreciation Expense",,"Accumulated Depreciation",130.95,"",2274953.65
,"General Journal","02-04-2024","22963",,,"Water tank 1 Depreciation","Expense","Depreciation Expense",,"Accumulated Depreciation",120.07,"",2275073.72
,"General Journal","02-04-2024","22966",,,"Workshop cabinet depreciation","Expense","Depreciation Expense",,"Accumulated Depreciation",172.02,"",2275245.74
,"General Journal","03-04-2024","22967",,,"Alarm System extension","Expense","Depreciation Expense",,"Accumulated Depreciation",602.38,"",2275848.12
,"General Journal","03-04-2024","22968",,,"Domestos sewing machine depreciation","Expense","Depreciation Expense",,"Acummulated depreciation",82.10,"",2275930.22
,"General Journal","03-04-2024","22969",,,"Bench Grinder 2 Depreciation","Expense","Depreciation Expense",,"Accumulated Depreceiation",100.57,"",2276030.79
,"General Journal","03-04-2024","22970",,,"CCTV survellance System extension Depreciation","Expense","Depreciation Expense",,"Accumulated Depreciation",657.14,"",2276687.93
,"General Journal","03-04-2024","22971",,,"Electrical Enclosure CCTV Depreciation","Expense","Depreciation Expense",,"Accumulated Depreciation",126.19,"",2276814.12
,"General Journal","03-04-2024","22972",,,"Electrical Enclosure Main Depreciation","Expense","Depreciation Expense",,"Accumulated Depreciation",2339.29,"",2279153.41
,"General Journal","03-04-2024","22973",,,"Electrical Enclosure P Line Depreciation","Expense","Depreciation Expense",,"Accumulated Depreciation",428.57,"",2279581.98
,"General Journal","03-04-2024","22974",,,"Floodlight Depreciation","Expense","Depreciation Expense",,"Accumulated Depreciation",59.52,"",2279641.50
,"General Journal","03-04-2024","22975",,,"Office Desk 1 Depreciation","Expense","Depreciation Expense",,"Accumulated Depreciation",225.00,"",2279866.50
,"General Journal","03-04-2024","22976",,,"Office Desk 2 Depreciation","Expense","Depreciation Expense",,"Accumulated Depreciation",225.00,"",2280091.50
,"General Journal","03-04-2024","22977",,,"Office Desk 3 Depreciation","Expense","Depreciation Expense",,"Accumulated Depreciation",225.00,"",2280316.50
,"General Journal","03-04-2024","22978",,,"Signet ESD 1 Depreciation","Expense","Depreciation Expense",,"Accumulated Depreciation",928.57,"",2281245.07
,"General Journal","03-04-2024","22979","*",,"Sterling Water Dispenser 1 Depreciation","Expense","Depreciation Expense",,"Accumulated Depreciation",119.05,"",2281364.12
,"General Journal","03-04-2024","22980",,,"Table top Weighing Scale 5 Depreciation","Expense","Depreciation Expense",,"Accumulated Depreciation",248.57,"",2281612.69
,"General Journal","03-04-2024","22981",,,"Table top Weighing Scale 6 Depreciation","Expense","Depreciation Expense",,"Accumulated Depreciation",248.57,"",2281861.26
,"General Journal","03-04-2024","22982",,,"Table top Weighing Scale 7 Depreciation","Expense","Depreciation Expense",,"Accumulated Depreciation",248.57,"",2282109.83
,"General Journal","03-04-2024","22983",,,"Table top Weighing Scale 8 Depreciation","Expense","Depreciation Expense",,"Accumulated Depreciation",248.57,"",2282358.40
,"General Journal","03-04-2024","22984",,,"Table top Weighing Scale 9 Depreciation","Expense","Depreciation Expense",,"Accumulated Depreciation",248.57,"",2282606.97
,"General Journal","04-04-2024","22985",,,"9Kg Powder Fire Extinguisher 1 Depreciation","Expense","Depreciation Expense",,"Accumulated Depreciation",34.52,"",2282641.49
,"General Journal","04-04-2024","22986",,,"9Kg Powder Fire Extinguisher 2 Depreciation","Expense","Depreciation Expense",,"Accumulated Depreciation",34.52,"",2282676.01
,"General Journal","04-04-2024","22987",,,"9Kg Powder Fire Extinguisher 3 Depreciation","Expense","Depreciation Expense",,"Accumulated Depreciation",34.52,"",2282710.53
,"General Journal","04-04-2024","22988",,,"9Kg Powder Fire Extinguisher 5 Depreciation","Expense","Depreciation Expense",,"Accumulated Depreciation",34.52,"",2282745.05
,"General Journal","04-04-2024","22989",,,"Chiller 2 Depreciation","Expense","Depreciation Expense",,"Accumulated Depreciation",8035.71,"",2290780.76
,"General Journal","04-04-2024","22990",,,"Empty IBC Tank 10 Depreciation","Expense","Depreciation Expense",,"Accumulated Depreciation",41.67,"",2290822.43
,"General Journal","04-04-2024","22991",,,"Empty IBC Tank 3 Depreciation","Expense","Depreciation Expense",,"Accumulated Depreciation",65.48,"",2290887.91
,"General Journal","04-04-2024","22992",,,"Empty IBC Tank 4 Depreciation","Expense","Depreciation Expense",,"Accumulated Depreciation",65.48,"",2290953.39
,"General Journal","04-04-2024","22993",,,"Empty IBC Tank 5 Depreciation","Expense","Depreciation Expense",,"Accumulated Depreciation",65.48,"",2291018.87
,"General Journal","04-04-2024","22994",,,"Empty IBC Tank 6 Depreciation","Expense","Depreciation Expense",,"Accumulated Depreciation",65.48,"",2291084.35
,"General Journal","04-04-2024","22995",,,"Empty IBC Tank 7 Depreciation","Expense","Depreciation Expense",,"Accumulated Depreciation",41.67,"",2291126.02
,"General Journal","04-04-2024","22996",,,"Empty IBC Tank 8 Depreciation","Expense","Depreciation Expense",,"Accumulated Depreiation",41.67,"",2291167.69
,"General Journal","04-04-2024","22997",,,"Empty IBC Tank 9 Depreciation","Expense","Depreciation Expense",,"Accumulated Depreciation",41.67,"",2291209.36
,"General Journal","04-04-2024","22999",,,"Linx 8900 Coder 1 Depreciation","Expense","Depreciation Expense",,"Accumulated Depreciation",8333.33,"",2299542.69
,"General Journal","04-04-2024","23000",,,"Mobile Phone 2 Depreciation","Expense","Depreciation Expense",,"Accumulated Depreciation",46.67,"",2299589.36
,"General Journal","04-04-2024","23001",,,"Triple UV water purifier 1 Depreciation","Expense","Depreciation Expense",,"Accumulated Depreciation",296.22,"",2299885.58
,"General Journal","05-04-2024","23002",,,"1Kg Generic Jar Blow Mould 1 depreciation","Expense","Depreciation Expense",,"Accumulated Depreciation",1500.00,"",2301385.58
,"General Journal","05-04-2024","23003",,,"1Kg Generic Jar Blow Mould 2 depreciation","Expense","Depreciation Expense",,"Accumulated Depreciation",1500.00,"",2302885.58
,"General Journal","05-04-2024","23004",,,"500gm Generic Jar Blow Mould 1 depreciation","Expense","Depreciation Expense",,"Accumulated Depreciation",1071.43,"",2303957.01
,"General Journal","05-04-2024","23005",,,"500gm Generic Jar Blow Mould 2 depreciation","Expense","Depreciation Expense",,"Accumulated Depreciation",1071.43,"",2305028.44
,"General Journal","05-04-2024","23006",,,"9Kg Powder Fire Extinguisher 4 Depreciation","Expense","Depreciation Expense",,"Accumulated Depreciation",34.52,"",2305062.96
,"General Journal","05-04-2024","23007",,,"Extractor Fan 4 Depreciation","Expense","Depreciation Expense",,"Accumulated Depreciation",726.19,"",2305789.15
,"General Journal","05-04-2024","23008",,,"FFS  Machine Installation Elct Depreciation","Expense","Depreciation Expense",,"Accumulated Depreciation",200.60,"",2305989.75
,"General Journal","05-04-2024","23009",,,"First Aid Kit Depreciation","Expense","Depreciation Expense",,"Accumulated  Depreciation",77.38,"",2306067.13
,"General Journal","05-04-2024","23010",,,"Linx 8900 Coder 2 Depreciation","Expense","Depreciation Expense",,"Accumulated Depreciation",12500.00,"",2318567.13
,"General Journal","05-04-2024","23011",,,"Packing Platform Depreciation","Expense","Depreciation Expense",,"Accumulated Depreciation",5297.62,"",2323864.75
,"General Journal","05-04-2024","23012",,,"SS Industrial Turntable Depreciation","Expense","Depreciation Expense",,"Accumulated Depreciation",5238.10,"",2329102.85
,"General Journal","05-04-2024","23013",,,"TV Screen 2 Depreciation","Expense","Depreciation Expense",,"Accumulated Depreciation",950.00,"",2330052.85
,"General Journal","05-04-2024","23014",,,"Water Purifier 1 Depreciation","Expense","Depreciation Expense",,"Accumulated Depreciation",117.10,"",2330169.95
,"General Journal","05-04-2024","23015",,,"Water tank 2 Depreciation","Expense","Depreciation Expense",,"Accumulated Depreciation",23.81,"",2330193.76
,"General Journal","06-04-2024","23018",,,"Blower Depreciation","Expense","Depreciation Expense",,"Accumulated Depreciation",59.52,"",2330253.28
,"General Journal","06-04-2024","23025",,,"Emergency Washing Point Depreciation","Expense","Depreciation Expense",,"Accumulated Deprecation",160.71,"",2330413.99
,"General Journal","06-04-2024","23028","*",,"Infrared Thermometre 1 Depreciation","Expense","Depreciation Expense",,"Accumulated Depreciation",416.67,"",2330830.66
,"General Journal","06-04-2024","23029",,,"Material's Trolley Depreciation","Expense","Depreciation Expense",,"Accumulated Depreciation",297.62,"",2331128.28
,"General Journal","06-04-2024","23034",,,"Plastic Scrap Grinder Machine Depreciation","Expense","Depreciation Expense",,"Accumulated  Depreciation",3452.38,"",2334580.66
,"General Journal","06-04-2024","23036",,,"Ribon Mixer SS depreciation","Expense","Depreciation Expense",,"Accumulated depreciation",4642.86,"",2339223.52
,"General Journal","06-04-2024","23037",,,"Telephone Handset Depreciation","Expense","Depreciation Expense",,"Accumulated Depreciation",29.76,"",2339253.28
,"General Journal","06-04-2024","23038",,,"Telkom Wifi Router Depreciation","Expense","Depreciation Expense",,"Accumulated Depreciation",71.43,"",2339324.71
,"General Journal","06-04-2024","23039",,,"Vacuum Cleaner Depreciation","Expense","Depreciation Expense",,"Accumulated Depreciation",148.81,"",2339473.52
,"General Journal","07-04-2024","23016",,,"9Kg Powder Fire Extinguisher 6 Depreciation","Expense","Depreciation Expense",,"Accumulated Depreciation",44.05,"",2339517.57
,"General Journal","07-04-2024","23020",,,"Cartoning table 4 depreciation","Expense","Depreciation Expense",,"Accumulated Depreciation",262.49,"",2339780.06
,"General Journal","07-04-2024","23021",,,"Case sealing table depreciation","Expense","Depreciation Expense",,"Accumulated Depreciation",86.67,"",2339866.73
,"General Journal","07-04-2024","23022",,,"Chain block 2 depreciation","Expense","Depreciation Expense",,"Accumulated depreciation",398.81,"",2340265.54
,"General Journal","07-04-2024","23023",,,"Chain block 3 depreciation","Expense","Depreciation Expense",,"Accumulated depreciation",398.81,"",2340664.35
,"General Journal","07-04-2024","23024",,,"Drilling machine Depreciation","Expense","Depreciation Expense",,"Accumulated Depreciation",88.39,"",2340752.74
,"General Journal","07-04-2024","23026",,,"Grinder Depreciation","Expense","Depreciation Expense",,"Acccumulated Depreciation",159.82,"",2340912.56
,"General Journal","07-04-2024","23031",,,"Packing table 1 depreciation","Expense","Depreciation Expense",,"Accumulated Depreciation",262.49,"",2341175.05
,"General Journal","07-04-2024","23032",,,"Packing table 2 depreciation","Expense","Depreciation Expense",,"Accumulated Depreciation",262.49,"",2341437.54
,"General Journal","07-04-2024","23033",,,"Packing table 3 depreciation","Expense","Depreciation Expense",,"Accumulated Depreciation",262.49,"",2341700.03
,"General Journal","07-04-2024","23035",,,"Quality table depreciation","Expense","Depreciation Expense",,"Accumulated Depreciation",86.67,"",2341786.70
,"General Journal","07-04-2024","23040",,,"Welding machine Depreciation","Expense","Depreciation Expense",,"Accumulated Depreciation",178.57,"",2341965.27
,"General Journal","08-04-2024","23017",,,"Bench Grinder 350W Depreciation","Expense","Depreciation Expense",,"Accumulated Depreciation",122.13,"",2342087.40
,"General Journal","08-04-2024","23019",,,"Board room chair 3 Depreciation","Expense","Depreciation Expense",,"Accumulated Depreciation",59.52,"",2342146.92
,"General Journal","08-04-2024","23027",,,"HP Laptop 6 Depreciation","Expense","Depreciation Expense",,"Accumulated Depreciation",416.67,"",2342563.59
,"General Journal","08-04-2024","23030",,,"Mobile Phone 1 Depreciation","Expense","Depreciation Expense",,"Accumulated Depreciation",58.33,"",2342621.92
,"General Journal","08-04-2024","25160",,,"Six step steel ladder 1 Depreciation","Expense","Depreciation Expense",,"Accumulated Depreciation",113.51,"",2342735.43
,"General Journal","09-04-2024","23041",,,"Canteen Chair 20 Depreciation","Expense","Depreciation Expense",,"Accumulated Depreciation",6.12,"",2342741.55
,"General Journal","09-04-2024","23042",,,"Canteen Table 1 Depreciation","Expense","Depreciation Expense",,"Accumulated Depreciation",184.52,"",2342926.07
,"General Journal","09-04-2024","23043",,,"Canteen Table 2 Depreciation","Expense","Depreciation Expense",,"Accumulated Depreciation",184.52,"",2343110.59
,"General Journal","09-04-2024","23044",,,"Dell Desktop 1 Depreciation","Expense","Depreciation Expense",,"Accumulated Depreciation",178.57,"",2343289.16
,"General Journal","09-04-2024","23045",,,"Fire Alarm System Extension'19 Depreciation","Expense","Depreciation Expense",,"Accumulated Depreciation",9857.14,"",2353146.30
,"General Journal","09-04-2024","23046",,,"Floor Chair 1 Depreciation","Expense","Depreciation Expense",,"Accumulated Depreciation",26.79,"",2353173.09
,"General Journal","09-04-2024","23047",,,"Floor Chair 10 Depreciation","Expense","Depreciation Expense",,"Accumulated Depreciation",53.57,"",2353226.66
,"General Journal","09-04-2024","23048",,,"Floor Chair 2 Depreciation","Expense","Depreciation Expense",,"Accumulated Depreciation",26.79,"",2353253.45
,"General Journal","09-04-2024","23049",,,"Floor Chair 3 Depreciation","Expense","Depreciation Expense",,"Accumulated Depreciation",26.79,"",2353280.24
,"General Journal","09-04-2024","23050",,,"Floor Chair 4 Depreciation","Expense","Depreciation Expense",,"Accumulated Depreciation",26.79,"",2353307.03
,"General Journal","09-04-2024","23051",,,"Floor Chair 5 Depreciation","Expense","Depreciation Expense",,"Accumulated Depreciation",26.79,"",2353333.82
,"General Journal","09-04-2024","23052",,,"Floor Chair 6 Depreciation","Expense","Depreciation Expense",,"Accumulated Depreciation",53.57,"",2353387.39
,"General Journal","09-04-2024","23053",,,"Floor Chair 7 Depreciation","Expense","Depreciation Expense",,"Accumulated Depreciation",53.57,"",2353440.96
,"General Journal","09-04-2024","23054",,,"Floor Chair 8 Depreciation","Expense","Depreciation Expense",,"Accumulated Depreciation",53.57,"",2353494.53
,"General Journal","09-04-2024","23055",,,"Floor Chair 9 Depreciation","Expense","Depreciation Expense",,"Accumulated Depreciation",53.57,"",2353548.10
,"General Journal","09-04-2024","23056",,,"Floor weighing scale Depreciation","Expense","Depreciation Expense",,"Accumulated Depreciation",593.81,"",2354141.91
,"General Journal","09-04-2024","23057",,,"Lab Office Chair 1 Depreciation","Expense","Depreciation Expense",,"Accumulated Depreciation",47.62,"",2354189.53
,"General Journal","09-04-2024","23058",,,"Lab Office Chair 2 Depreciation","Expense","Depreciation Expense",,"Accumulated Depreciation",47.62,"",2354237.15
,"General Journal","09-04-2024","23059",,,"Lab Office Chair 3 Depreciation","Expense","Depreciation Expense",,"Accumulated Depreciation",47.62,"",2354284.77
,"General Journal","09-04-2024","23060","*","Unilever Kenya Ltd:Sunlight Washing Pwd","Sunlight Bag Closing Machine 1 Depreciation","Expense","Depreciation Expense",,"Accumulated Depreciation",738.10,"",2355022.87
,"General Journal","09-04-2024","23061","*","Unilever Kenya Ltd:Sunlight Washing Pwd","Sunlight Packing Chair 1 Depreciation","Expense","Depreciation Expense",,"Accumulated Depreciation",41.67,"",2355064.54
,"General Journal","10-04-2024","23064",,,"5Kg Fire Extinguisher 1 Depreciation","Expense","Depreciation Expense",,"Accumulated Depreciation",65.48,"",2355130.02
,"General Journal","10-04-2024","23069",,,"HP Laptop 10 Depreciation","Expense","Depreciation Expense",,"Accumulated Depreciation",1200.00,"",2356330.02
,"General Journal","10-04-2024","23072",,,"HP Laptop 9 Depreciation","Expense","Depreciation Expense",,"Accumulated Depreciation",1200.00,"",2357530.02
,"General Journal","10-04-2024","23073",,,"Office Seat 1 Depreciation","Expense","Depreciation Expense",,"Accumulated Depreciation",142.86,"",2357672.88
,"General Journal","10-04-2024","23074",,,"Office Seat 2 Depreciation","Expense","Depreciation Expense",,"Accumulated Depreciation",71.43,"",2357744.31
,"General Journal","10-04-2024","23075",,,"Office Seat 3 Depreciation","Expense","Depreciation Expense",,"Accumulated Depreciation",71.43,"",2357815.74
,"General Journal","10-04-2024","23077",,,"Reverse Osmosis Unit 1 Depreciation","Expense","Depreciation Expense",,"Accumulated Depreciation",416.67,"",2358232.41
,"General Journal","10-04-2024","23078",,,"Steam Generator SG24 Depreciation","Expense","Depreciation Expense",,"Accumulated Depreciation",3794.53,"",2362026.94
,"General Journal","10-04-2024","23080",,,"Toilet Cleaner Mixing Machine Depreciation","Expense","Depreciation Expense",,"Accumulated Depreciation",6333.33,"",2368360.27
,"General Journal","11-04-2024","23062",,,"4 GB hard drive for CCTV Depreciation","Expense","Depreciation Expense",,"Accumulated Depreciation",178.57,"",2368538.84
,"General Journal","11-04-2024","23063",,,"4TB Hard Disk Depreciation","Expense","Depreciation Expense",,"Accumulated Depreciation",178.57,"",2368717.41
,"General Journal","11-04-2024","23065","*","Unilever Kenya Ltd:Sunlight Washing Pwd","Chain block trolley 4 depreciation","Expense","Depreciation Expense",,"Accumulated Depreciation",85.00,"",2368802.41
,"General Journal","11-04-2024","23066",,,"Coder Depreciation","Expense","Depreciation Expense",,"Accumulated Depreciation",2261.90,"",2371064.31
,"General Journal","11-04-2024","23067",,,"Coder Stand Depreciation","Expense","Depreciation Expense",,"Accumulated Depreciation",59.52,"",2371123.83
,"General Journal","11-04-2024","23068",,,"Compressor 1 depreciation","Expense","Depreciation Expense",,"Accumulated depreciation",3750.00,"",2374873.83
,"General Journal","11-04-2024","23070",,,"HP Laptop 14 Depreciation","Expense","Depreciation Expense",,"Accumulated Depreciation",1941.67,"",2376815.50
,"General Journal","11-04-2024","23071",,,"HP Laptop 15 Depreciation","Expense","Depreciation Expense",,"Accumulated Depreciation",1750.00,"",2378565.50
,"General Journal","11-04-2024","23076",,,"Pallet truck 2 depreciation","Expense","Depreciation Expense",,"Accumulated depreciation",440.48,"",2379005.98
,"General Journal","11-04-2024","23079","*",,"Steam Label Shrink Tunnel Depreciation","Expense","Depreciation Expense",,"Accumulated  Depreciation",10952.38,"",2389958.36
,"General Journal","12-04-2024","23081",,,"Coder Housing Depreciation","Expense","Depreciation Expense",,"Accumulated Depreciation",80.36,"",2390038.72
,"General Journal","12-04-2024","23082","*","Unilever Kenya Ltd:Sunlight Washing Pwd","Coder UPS 4 Depreciation","Expense","Depreciation Expense",,"Accumulated Depreciation",158.33,"",2390197.05
,"General Journal","12-04-2024","23083",,,"Coding Conveyor Depreciation","Expense","Depreciation Expense",,"Accumulated Depreciation",476.19,"",2390673.24
,"General Journal","12-04-2024","23084",,,"Conveyor 2 Depreciation","Expense","Depreciation Expense",,"Accumulated  Depreciation",169.64,"",2390842.88
,"General Journal","12-04-2024","23085",,,"Eyewash Station 1 Depreciation","Expense","Depreciation Expense",,"Accumulated Depreciation",904.76,"",2391747.64
,"General Journal","12-04-2024","23086",,,"HP Laptop 5 Depreciation","Expense","Depreciation Expense",,"Accumulated Depreciation",416.67,"",2392164.31
,"General Journal","12-04-2024","23087",,,"Tea maker Depreciation","Expense","Depreciation Expense",,"Accumulated Depreciation",225.00,"",2392389.31
,"General Journal","13-04-2024","23091",,,"Alarm System Depreciation","Expense","Depreciation Expense",,"Accumulated Depreciation",580.95,"",2392970.26
,"General Journal","13-04-2024","23097",,,"Bosch Blower 2 Depreciation","Expense","Depreciation Expense",,"Accumulated Depreciation",136.49,"",2393106.75
,"General Journal","13-04-2024","23125",,,"Coder UPS 8 Depreciation","Expense","Depreciation Expense",,"Accumulated Depreciation",81.67,"",2393188.42
,"General Journal","13-04-2024","23137","*",,"HP Laptop 16 Depreciation","Expense","Depreciation Expense",,"Accumulated Depreciation",1000.00,"",2394188.42
,"General Journal","13-04-2024","23143",,,"PIR system extension Depreciation","Expense","Depreciation Expense",,"Accumulated Depreciation",254.67,"",2394443.09
,"General Journal","13-04-2024","23144",,,"Process Water Storage Tank Depreciation","Expense","Depreciation Expense",,"Accumulated Depreciation",1065.16,"",2395508.25
,"General Journal","13-04-2024","23145","*",,"Store Racking 3 FG Depreciation","Expense","Depreciation Expense",,"Accumulated Depreciation",9791.67,"",2405299.92
,"General Journal","13-04-2024","23149",,,"Weighing scale 1","Expense","Depreciation Expense",,"Accumulated Depreciation",559.52,"",2405859.44
,"General Journal","13-04-2024","25158",,,"HP Mini Desktop 4 Depreciation","Expense","Depreciation Expense",,"Accumulated Depreciation",466.67,"",2406326.11
,"General Journal","14-04-2024","23124",,,"Coder UPS 5 Depreciation","Expense","Depreciation Expense",,"Accumulated Depreciation",158.33,"",2406484.44
,"General Journal","14-04-2024","23140",,,"Motor Vehicle 2 Depreciation","Expense","Depreciation Expense",,"Accumulated Depreciation",10297.62,"",2416782.06
,"General Journal","14-04-2024","23142",,,"Paste Packing Machine Depreciation","Expense","Depreciation Expense",,"Accumulated Depreciation",4166.67,"",2420948.73
,"General Journal","14-04-2024","23146",,,"Table Top Scale 10  SS 15Kg Depreciation","Expense","Depreciation Expense",,"Accumulated Depreciation",297.62,"",2421246.35
,"General Journal","15-04-2024","23088",,,"150KVA Enclosed Genset Depreciation","Expense","Depreciation Expense",,"Accumulated Depreciation",24404.76,"",2445651.11
,"General Journal","15-04-2024","23089",,,"20Kg Forklift Gas Cylinder 2 Depreciation","Expense","Depreciation Expense",,"Accumulated Depreciation",769.70,"",2446420.81
,"General Journal","15-04-2024","23090",,,"2Ton Electric Hoist 1 Depreciation","Expense","Depreciation Expense",,"Accumulated Depreciation",3708.33,"",2450129.14
,"General Journal","15-04-2024","23092",,,"Automatic Change Over Switch 1 Depreciation","Expense","Depreciation Expense",,"Accumulated Depreciation",1666.67,"",2451795.81
,"General Journal","15-04-2024","23093",,,"Bench top Weighing Scale 1 Depreciation","Expense","Depreciation Expense",,"Accumulated Depreciation",357.14,"",2452152.95
,"General Journal","15-04-2024","23094",,,"Bench top Weighing Scale 2 Depreciation","Expense","Depreciation Expense",,"Accumulated Depreciation",357.14,"",2452510.09
,"General Journal","15-04-2024","23095",,,"Bench top Weighing Scale 3 Depreciation","Expense","Depreciation Expense",,"Accumulated Depreciation",357.14,"",2452867.23
,"General Journal","15-04-2024","23096",,,"Bench top Weighing Scale 4 Depreciation","Expense","Depreciation Expense",,"Accumulated Depreciation",357.14,"",2453224.37
,"General Journal","15-04-2024","23098",,,"Bosch Blower Depreciation","Expense","Depreciation Expense",,"Accumulated Depreciation",129.31,"",2453353.68
,"General Journal","15-04-2024","23099",,,"Canteen Chair 1 Depreciation","Expense","Depreciation Expense",,"Accumulated Depreciation",6.12,"",2453359.80
,"General Journal","15-04-2024","23100",,,"Canteen Chair 10 Depreciation","Expense","Depreciation Expense",,"Accumulated Depreciation",6.12,"",2453365.92
,"General Journal","15-04-2024","23101",,,"Canteen Chair 11 Depreciation","Expense","Depreciation Expense",,"Accumulated Depreciation",6.12,"",2453372.04
,"General Journal","15-04-2024","23102",,,"Canteen Chair 11 Depreciation","Expense","Depreciation Expense",,"Accumulated Depreciation",6.12,"",2453378.16
,"General Journal","15-04-2024","23103",,,"Canteen Chair 12 Depreciation","Expense","Depreciation Expense",,"Accumulated Depreciation",6.12,"",2453384.28
,"General Journal","15-04-2024","23104",,,"Canteen Chair 13 Depreciation","Expense","Depreciation Expense",,"Accumulated Depreciation",6.12,"",2453390.40
,"General Journal","15-04-2024","23105",,,"Canteen Chair 14 Depreciation","Expense","Depreciation Expense",,"Accumulated Depreciation",6.12,"",2453396.52
,"General Journal","15-04-2024","23106",,,"Canteen Chair 15 Depreciation","Expense","Depreciation Expense",,"Accumulated Depreciation",6.12,"",2453402.64
,"General Journal","15-04-2024","23107",,,"Canteen Chair 16 Depreciation","Expense","Depreciation Expense",,"Accumulated Depreciation",6.12,"",2453408.76
,"General Journal","15-04-2024","23108",,,"Canteen Chair 17 Depreciation","Expense","Depreciation Expense",,"Accumulated Depreciation",6.12,"",2453414.88
,"General Journal","15-04-2024","23109",,,"Canteen Chair 18 Depreciation","Expense","Depreciation Expense",,"Accumulated Depreciation",6.12,"",2453421.00
,"General Journal","15-04-2024","23110",,,"Canteen Chair 19 Depreciation","Expense","Depreciation Expense",,"Accumulated Depreciation",6.12,"",2453427.12
,"General Journal","15-04-2024","23111",,,"Canteen Chair 2 Depreciation","Expense","Depreciation Expense",,"Accumulated Depreciation",6.12,"",2453433.24
,"General Journal","15-04-2024","23112",,,"Canteen Chair 21 Depreciation","Expense","Depreciation Expense",,"Accumulated Depreciation",6.12,"",2453439.36
,"General Journal","15-04-2024","23113",,,"Canteen Chair 22 Depreciation","Expense","Depreciation Expense",,"Accumulated Depreciation",6.12,"",2453445.48
,"General Journal","15-04-2024","23114",,,"Canteen Chair 23 Depreciation","Expense","Depreciation Expense",,"Accumulated Depreciation",6.12,"",2453451.60
,"General Journal","15-04-2024","23115",,,"Canteen Chair 24 Depreciation","Expense","Depreciation Expense",,"Accumulated Depreciation",6.12,"",2453457.72
,"General Journal","15-04-2024","23116",,,"Canteen Chair 25 Depreciation","Expense","Depreciation Expense",,"Accumulated Depreciation",6.12,"",2453463.84
,"General Journal","15-04-2024","23117",,,"Canteen Chair 3 Depreciation","Expense","Depreciation Expense",,"Accumulated Depreciation",6.12,"",2453469.96
,"General Journal","15-04-2024","23118",,,"Canteen Chair 4 Depreciation","Expense","Depreciation Expense",,"Accumulated Depreciation",6.12,"",2453476.08
,"General Journal","15-04-2024","23119",,,"Canteen Chair 5 Depreciation","Expense","Depreciation Expense",,"Accumulated Depreciation",6.12,"",2453482.20
,"General Journal","15-04-2024","23120",,,"Canteen Chair 6 Depreciation","Expense","Depreciation Expense",,"Accumulated Depreciation",6.12,"",2453488.32
,"General Journal","15-04-2024","23121",,,"Canteen Chair 7 Depreciation","Expense","Depreciation Expense",,"Accumulated Depreciation",6.12,"",2453494.44
,"General Journal","15-04-2024","23122",,,"Canteen Chair 8 Depreciation","Expense","Depreciation Expense",,"Accumulated Depreciation",6.12,"",2453500.56
,"General Journal","15-04-2024","23123",,,"Canteen Chair 9 Depreciation","Expense","Depreciation Expense",,"Accumulated Depreciation",6.12,"",2453506.68
,"General Journal","15-04-2024","23126",,,"EOL Case sealer Outfeed Conveyor Depreciation","Expense","Depreciation Expense",,"Accumulated Depreciation",297.62,"",2453804.30
,"General Journal","15-04-2024","23127",,,"Epson L6190 Printer 1 Depreciation","Expense","Depreciation Expense",,"Accumulated Depreciation",654.76,"",2454459.06
,"General Journal","15-04-2024","23128",,,"Fire Extinguisher 1 Depreciation","Expense","Depreciation Expense",,"Accumulated Depreciation",77.38,"",2454536.44
,"General Journal","15-04-2024","23129",,,"Fire Extinguisher 2 Depreciation","Expense","Depreciation Expense",,"Accumulated Depreciation",77.38,"",2454613.82
,"General Journal","15-04-2024","23130",,,"Fire Extinguisher 3 Depreciation","Expense","Depreciation Expense",,"Accumulated Depreciation",77.38,"",2454691.20
,"General Journal","15-04-2024","23131",,,"Fire Extinguisher 4 Depreciation","Expense","Depreciation Expense",,"Accumulated Depreciation",77.38,"",2454768.58
,"General Journal","15-04-2024","23132",,,"Fire Extinguisher 5 Depreciation","Expense","Depreciation Expense",,"Accumulated Depreciation",77.38,"",2454845.96
,"General Journal","15-04-2024","23133",,,"Fire Extinguisher 6 Depreciation","Expense","Depreciation Expense",,"Accumulated Depreciation",77.38,"",2454923.34
,"General Journal","15-04-2024","23134",,,"Grinder 2 Depreciation","Expense","Depreciation Expense",,"Accumulated Depreciation",178.57,"",2455101.91
,"General Journal","15-04-2024","23135",,,"HP Laptop 11 Depreciation","Expense","Depreciation Expense",,"Accumulated Depreciation",1200.00,"",2456301.91
,"General Journal","15-04-2024","23136",,,"HP Laptop 12 Depreciation","Expense","Depreciation Expense",,"Accumulated Depreciation",1200.00,"",2457501.91
,"General Journal","15-04-2024","23138",,,"Microwave 2 Depreciation","Expense","Depreciation Expense",,"Accumulated Depreciation",147.27,"",2457649.18
,"General Journal","15-04-2024","23139",,,"Mobile phone 3 Depreciation","Expense","Depreciation Expense",,"Accumulated Depreciation",41.67,"",2457690.85
,"General Journal","15-04-2024","23141",,,"Movable Ladder 1 Depreciation","Expense","Depreciation Expense",,"Accumulated Depreciation",434.52,"",2458125.37
,"General Journal","15-04-2024","23147",,,"UV water purifier 3 Depreciation","Expense","Depreciation Expense",,"Accumulated Depreciation",543.10,"",2458668.47
,"General Journal","15-04-2024","23148",,,"Water tank 6 Depreciation","Expense","Depreciation Expense",,"Accumulated Depreciation",71.84,"",2458740.31
,"General Journal","16-04-2024","23150",,,"Bosch Grinder 3 Depreciation","Expense","Depreciation Expense",,"Accumulated Depreceiation",86.21,"",2458826.52
,"General Journal","16-04-2024","23151",,,"Chain block 5 depreciation","Expense","Depreciation Expense",,"Accumulated Depreciation",292.49,"",2459119.01
,"General Journal","16-04-2024","23152",,,"Chain block 6 depreciation","Expense","Depreciation Expense",,"Accumulated Depreciation",292.49,"",2459411.50
,"General Journal","16-04-2024","23153",,,"Heat Gun Total 1 Depreciation","Expense","Depreciation Expense",,"Accumulated Depreciation",64.66,"",2459476.16
,"General Journal","16-04-2024","23154",,,"Linx 5900 Coder 1 Depreciation","Expense","Depreciation Expense",,"Accumulated Depreciation",4166.67,"",2463642.83
,"General Journal","16-04-2024","23155",,,"Table Top Scale 11 6Kg Depreciation","Expense","Depreciation Expense",,"Accumulated Depreciation",277.09,"",2463919.92
,"General Journal","16-04-2024","23156",,,"Washing Machine 1 Depreciation","Expense","Depreciation Expense",,"Accumulated Depreciation",2640.01,"",2466559.93
,"General Journal","17-04-2024","23158",,,"2T Mixer Depreciation","Expense","Depreciation Expense",,"Accumulated Depreciation",12633.99,"",2479193.92
,"General Journal","17-04-2024","23159",,,"2T Mixer Installation Depreciation","Expense","Depreciation Expense",,"Accumulated Depreciation",29713.15,"",2508907.07
,"General Journal","17-04-2024","23160",,,"Coder UPS 6 Depreciation","Expense","Depreciation Expense",,"Accumulated Depreciation",94.83,"",2509001.90
,"General Journal","17-04-2024","23161",,,"Coder UPS 7 Depreciation","Expense","Depreciation Expense",,"Accumulated Depreciation",94.83,"",2509096.73
,"General Journal","17-04-2024","23162","*",,"Hand Dryer 1 Depreciation","Expense","Depreciation Expense",,"Accumulated Depreciation",46.18,"",2509142.91
,"General Journal","17-04-2024","23163","*",,"HP Laptop 3 Depreciation","Expense","Depreciation Expense",,"Accumulated Depreciation",297.62,"",2509440.53
,"General Journal","17-04-2024","23164",,,"Office desks  4","Expense","Depreciation Expense",,"Accumulated Depreciation",361.90,"",2509802.43
,"General Journal","17-04-2024","23165",,,"Pallet truck 4 Depreciation","Expense","Depreciation Expense",,"Accumulated Depreciation",428.57,"",2510231.00
,"General Journal","17-04-2024","23166",,,"Pallet truck 5 Depreciation","Expense","Depreciation Expense",,"Accumulated Depreciation",428.57,"",2510659.57
,"General Journal","17-04-2024","23167",,,"Recirculation Pump Depreciation","Expense","Depreciation Expense",,"Accumulated  Depreciation",71.19,"",2510730.76
,"General Journal","17-04-2024","23168",,,"Server 1 Depreciation","Expense","Depreciation Expense",,"Accumulated Depreciation",357.14,"",2511087.90
,"General Journal","17-04-2024","23169",,,"Server Monitor Depreciation","Expense","Depreciation Expense",,"Accumulated Depreciaion",107.14,"",2511195.04
,"General Journal","17-04-2024","23170",,,"Shrink Tunnel Depreciation","Expense","Depreciation Expense",,"Accumulated Depreciation",3750.00,"",2514945.04
,"General Journal","17-04-2024","23171","*",,"Soap Dispenser 1 Depreciation","Expense","Depreciation Expense",,"Accumulated Depreciation",15.39,"",2514960.43
,"General Journal","17-04-2024","23172","*",,"TP Link 3 Depreciation","Expense","Depreciation Expense",,"Accumulated Depreciation",33.33,"",2514993.76
,"General Journal","17-04-2024","23173","*",,"Water Tank 3 Depreciation","Expense","Depreciation Expense",,"Accumulated Depreciation",123.15,"",2515116.91
,"General Journal","18-04-2024","23174",,,"Carton Sealer Manual 1 Depreciation","Expense","Depreciation Expense",,"Accumulated Depreciation",14.80,"",2515131.71
,"General Journal","18-04-2024","23175",,,"Compressor 3 Depreciation","Expense","Depreciation Expense",,"Accumulated Depreciation",5357.14,"",2520488.85
,"General Journal","18-04-2024","23176",,,"Compressor room depreciation","Expense","Depreciation Expense",,"Accumulated depreciation",132.44,"",2520621.29
,"General Journal","18-04-2024","23177",,,"Electric Hoist 1 depreciation","Expense","Depreciation Expense",,"Accumulated depreciation",3452.38,"",2524073.67
,"General Journal","18-04-2024","23178",,,"Gents changing room Lockers Depreciation","Expense","Depreciation Expense",,"Accumulated Depreciation",386.90,"",2524460.57
,"General Journal","18-04-2024","23179",,,"HP Mini Desktop 1 Depreciation","Expense","Depreciation Expense",,"Accumulated Depreciation",733.33,"",2525193.90
,"General Journal","18-04-2024","23180",,,"HP Mini Desktop 2 Depreciation","Expense","Depreciation Expense",,"Accumulated Depreciation",733.33,"",2525927.23
,"General Journal","18-04-2024","23181",,,"HP Mini Desktop 3 Depreciation","Expense","Depreciation Expense",,"Accumulated Depreciation",733.33,"",2526660.56
,"General Journal","18-04-2024","23182",,,"Ladies changing room Lockers Depreciation","Expense","Depreciation Expense",,"Accumulated Depreciation",411.90,"",2527072.46
,"General Journal","18-04-2024","23183",,,"Omrom M1 Basic BP Monitor Depreciation","Expense","Depreciation Expense",,"Accumulated Depreciation",58.33,"",2527130.79
,"General Journal","18-04-2024","23184",,,"SS Hand Washing Station 1 Depreciation","Expense","Depreciation Expense",,"Accumulated Depreciation",690.48,"",2527821.27
,"General Journal","18-04-2024","23185",,,"TP Link 2 Depreciation","Expense","Depreciation Expense",,"Accumulated Depreciation",41.67,"",2527862.94
,"General Journal","18-04-2024","23186",,,"TV Screen 3 Depreciation","Expense","Depreciation Expense",,"Accumulated Depreciation",316.67,"",2528179.61
,"General Journal","18-04-2024","23187",,,"TV Screen 4 Depreciation","Expense","Depreciation Expense",,"Accumulated Depreciation",1550.00,"",2529729.61
,"General Journal","19-04-2024","23188",,,"3T Gas Forklift 1 Depreciation","Expense","Depreciation Expense",,"Accumulated Depreciation",30952.38,"",2560681.99
,"General Journal","19-04-2024","23189",,,"Coding Stamp 3 Depreciation","Expense","Depreciation Expense",,"Accumulated Depreciation",143.68,"",2560825.67
,"General Journal","19-04-2024","25191",,,"Office Stamp 2 Depreciation","Expense","Depreciation Expense",,"Accumulated Depreciaion",30.83,"",2560856.50
,"General Journal","19-04-2024","25193",,,"Office Stamp 2 Depreciation","Expense","Depreciation Expense",,"Accumulated Depreciaion",30.83,"",2560887.33
,"General Journal","20-04-2024","23196","*","Unilever Kenya Ltd:Sunlight Washing Pwd","Boato Commisioning Depreciation","Expense","Depreciation Expense",,"Accumulated Depreciation",889.88,"",2561777.21
,"General Journal","20-04-2024","23197",,,"Bosch Blower 3 Depreciation","Expense","Depreciation Expense",,"Accumulated Depreciation",79.02,"",2561856.23
,"General Journal","20-04-2024","23198",,,"Bosch Blower 4 Depreciation","Expense","Depreciation Expense",,"Accumulated Depreciation",136.49,"",2561992.72
,"General Journal","20-04-2024","23199",,,"Bosch Blower 5 Depreciation","Expense","Depreciation Expense",,"Accumulated Depreciation",136.49,"",2562129.21
,"General Journal","20-04-2024","23200",,,"Conference Office Desk 1 Depreciation","Expense","Depreciation Expense",,"Accumulated Depreciation",416.67,"",2562545.88
,"General Journal","20-04-2024","23201",,,"Floor Chair 17 depreciation","Expense","Depreciation Expense",,"Accumulated Depreciation",20.24,"",2562566.12
,"General Journal","20-04-2024","23202",,,"Floor Chair 18 depreciation","Expense","Depreciation Expense",,"Accumulated Depreciation",20.24,"",2562586.36
,"General Journal","20-04-2024","23203",,,"Floor Chair 19 depreciation","Expense","Depreciation Expense",,"Accumulated Depreciation",20.24,"",2562606.60
,"General Journal","20-04-2024","23204",,,"Floor Chair 20 depreciation","Expense","Depreciation Expense",,"Accumulated Depreciation",20.24,"",2562626.84
,"General Journal","20-04-2024","23205",,,"Heat Gun CAT Digital 1 Depreciation","Expense","Depreciation Expense",,"Accumulated Depreciation",136.49,"",2562763.33
,"General Journal","20-04-2024","23206","*",,"Lumnia 1 Pro Insect Trap Depreciation","Expense","Depreciation Expense",,"Accumulated Depreciation",316.67,"",2563080.00
,"General Journal","20-04-2024","23207",,,"PF Correction Unit Depreciation","Expense","Depreciation Expense",,"Accumulated Depreciation",1708.33,"",2564788.33
,"General Journal","21-04-2024","23208",,,"5Kg CO2 Fire Extinguisher 2 Depreciation","Expense","Depreciation Expense",,"Accumulated Depreciation",73.81,"",2564862.14
,"General Journal","21-04-2024","23211",,,"6Kg Dry Pwd Fire Extinguisher 1 Depreciaiton","Expense","Depreciation Expense",,"Accumulated Depreciation",59.52,"",2564921.66
,"General Journal","21-04-2024","23218",,,"Board room chair 1 Depreciation","Expense","Depreciation Expense",,"Accumulated Depreciation",59.52,"",2564981.18
,"General Journal","21-04-2024","23219",,,"Board room chair 2 Depreciation","Expense","Depreciation Expense",,"Accumulated Depreciation",59.52,"",2565040.70
,"General Journal","21-04-2024","23220",,,"Board room chair 4 Depreciation","Expense","Depreciation Expense",,"Accumulated Depreciation",59.52,"",2565100.22
,"General Journal","21-04-2024","23221",,,"Board room chair 5 Depreciation","Expense","Depreciation Expense",,"Accumulated Depreciation",59.52,"",2565159.74
,"General Journal","21-04-2024","23222",,,"Board room chair 6 Depreciation","Expense","Depreciation Expense",,"Accumulated Depreciation",59.52,"",2565219.26
,"General Journal","21-04-2024","23223",,,"Board room chair 7 Depreciation","Expense","Depreciation Expense",,"Accumulated Depreciation",59.52,"",2565278.78
,"General Journal","21-04-2024","23224",,,"Board room chair 8 Depreciation","Expense","Depreciation Expense",,"Accumulated Depreciation",59.52,"",2565338.30
,"General Journal","21-04-2024","23227",,,"Coding Stamp 2 Depreciation","Expense","Depreciation Expense",,"Accumulated Depreciation",133.33,"",2565471.63
,"General Journal","21-04-2024","23231",,,"IBC Tank 1 Depreciation","Expense","Depreciation Expense",,"Accumulated Depreciation",41.67,"",2565513.30
,"General Journal","21-04-2024","23232",,,"Empty IBC Tank 2 Depreciation","Expense","Depreciation Expense",,"Accumulated Depreciation",65.48,"",2565578.78
,"General Journal","21-04-2024","23233",,,"FFS Filling Machine 300 1 Depreciation","Expense","Depreciation Expense",,"Accumulated Depreciation",11850.01,"",2577428.79
,"General Journal","21-04-2024","23240",,,"Laboratory Oven & Dessicator  Depreciation","Expense","Depreciation Expense",,"Accumulated Depreciation",766.67,"",2578195.46
,"General Journal","21-04-2024","23243",,,"Nikon D3500 Camera 1 Depreciation","Expense","Depreciation Expense",,"Accumulated Depreciation",766.67,"",2578962.13
,"General Journal","21-04-2024","23253",,,"Tea Urn Depreciation","Expense","Depreciation Expense",,"Accumulated Depreciation",121.67,"",2579083.80
,"General Journal","22-04-2024","23209",,,"6Kg Auto Fire Extinguisher 1 Depreciation","Expense","Depreciation Expense",,"Accumulated Depreciation",53.57,"",2579137.37
,"General Journal","22-04-2024","23210",,,"6Kg Auto Fire Extinguisher 2 Depreciation","Expense","Depreciation Expense",,"Accumulated Depreciation",53.57,"",2579190.94
,"General Journal","22-04-2024","23216","*",,"AVS Voltage Stabilizer Depreciation","Expense","Depreciation Expense",,"Accumulated Depreciation",63.10,"",2579254.04
,"General Journal","22-04-2024","23228",,,"Conveyor Belt Green 1 Depreciation","Expense","Depreciation Expense",,"Accumulated Depreciation",82.14,"",2579336.18
,"General Journal","22-04-2024","23238",,,"HP Laptop 13 Depreciation","Expense","Depreciation Expense",,"Accumulated Depreciation",1200.00,"",2580536.18
,"General Journal","22-04-2024","23239","*",,"HP Laptop 7 Depreciation","Expense","Depreciation Expense",,"Accumulated Depreciation",1200.00,"",2581736.18
,"General Journal","22-04-2024","23244",,,"Office Desk 5 Depreciation","Expense","Depreciation Expense",,"Accumulated Depreciation",180.95,"",2581917.13
,"General Journal","22-04-2024","23245",,,"Office cabinets depreciation","Expense","Depreciation Expense",,"Accumulated Depreciation",119.05,"",2582036.18
,"General Journal","22-04-2024","23247",,,"Platform Scale 2 SS 100Kg Depreciation","Expense","Depreciation Expense",,"Accumulated Depreciation",339.29,"",2582375.47
,"General Journal","22-04-2024","23250",,,"Solar Water Heater 300L Depreciation","Expense","Depreciation Expense",,"Accumulated Depreciation",3125.00,"",2585500.47
,"General Journal","23-04-2024","23212",,,"Analytical Balance Depreciation","Expense","Depreciation Expense",,"Accumulated Depreciation",2405.58,"",2587906.05
,"General Journal","23-04-2024","23213",,,"Auger Filler 1 Depreciation","Expense","Depreciation Expense",,"Accumulated Depreciation",7220.12,"",2595126.17
,"General Journal","23-04-2024","23214",,,"Auger Filler 2 Depreciation","Expense","Depreciation Expense",,"Accumulated Depreciation",13258.63,"",2608384.80
,"General Journal","23-04-2024","23215",,,"Auger Filler 3 Depreciation","Expense","Depreciation Expense",,"Accumulated Depreciation",11788.69,"",2620173.49
,"General Journal","23-04-2024","23217",,,"Bajaj Boxer BM150 UG Depreciation","Expense","Depreciation Expense",,"Accumulated Depreciation",1539.41,"",2621712.90
,"General Journal","23-04-2024","23225",,,"Chain block 4 depreciation","Expense","Depreciation Expense",,"Accumulated Depreciation",133.42,"",2621846.32
,"General Journal","23-04-2024","23226",,,"Coder UPS Depreciation","Expense","Depreciation Expense",,"Accumulated Depreciation",95.24,"",2621941.56
,"General Journal","23-04-2024","23229",,,"Dust Extractor 1 Depreciation","Expense","Depreciation Expense",,"Accumulated Depreciation",446.43,"",2622387.99
,"General Journal","23-04-2024","23230",,,"Dust Extractor 2 Depreciation","Expense","Depreciation Expense",,"Accumulated Depreciation",446.43,"",2622834.42
,"General Journal","23-04-2024","23234",,,"Filler 1 Geared Motor & Feeding System Depreciation","Expense","Depreciation Expense",,"Accumulated Depreciation",333.33,"",2623167.75
,"General Journal","23-04-2024","23235",,,"Filler 2 Geared Motor & Feeding System Depreciation","Expense","Depreciation Expense",,"Accumulated Depreciation",348.72,"",2623516.47
,"General Journal","23-04-2024","23236",,,"Filler 3 Geared Motor & Feeding System Depreciation","Expense","Depreciation Expense",,"Accumulated Depreciation",347.52,"",2623863.99
,"General Journal","23-04-2024","23237",,,"Hotplate with Stirrer Depreciation","Expense","Depreciation Expense",,"Accumulated Depreciation",1785.71,"",2625649.70
,"General Journal","23-04-2024","23241",,,"Makita Hammer Drill Depreciation","Expense","Depreciation Expense",,"Accumulated Depreciation",205.25,"",2625854.95
,"General Journal","23-04-2024","23242",,,"Microwave 1 Depreciation","Expense","Depreciation Expense",,"Accumulated Depreciation",217.13,"",2626072.08
,"General Journal","23-04-2024","23246",,,"Pallet truck 3 Dep","Expense","Depreciation Expense",,"Accumulated Depreciation",510.95,"",2626583.03
,"General Journal","23-04-2024","23248",,,"Pouching Machine Depreciation","Expense","Depreciation Expense",,"Accumulated Depreciation",711.90,"",2627294.93
,"General Journal","23-04-2024","23249",,,"Power bank dep","Expense","Depreciation Expense",,"Accumulated Depreciation",119.05,"",2627413.98
,"General Journal","23-04-2024","23251",,,"Table Top Scale 11  SS 30Kg Depreciation","Expense","Depreciation Expense",,"Accumulated Depreciation",297.62,"",2627711.60
,"General Journal","23-04-2024","23252",,,"Table Top Scale 12  SS 30Kg Depreciation","Expense","Depreciation Expense",,"Accumulated Depreciation",297.62,"",2628009.22
,"General Journal","24-04-2024","23255",,,"Access Control Unit & System Depreciation","Expense","Depreciation Expense",,"Accumulated Depreciation",334.76,"",2628343.98
,"General Journal","24-04-2024","23256",,,"Electrical Enclosure Compressor Depreciation","Expense","Depreciation Expense",,"Accumulated Depreciation",125.00,"",2628468.98
,"General Journal","24-04-2024","23257",,,"ETR Machine Depreciation","Expense","Depreciation Expense",,"Accumulated Depreciation",236.04,"",2628705.02
,"General Journal","24-04-2024","23258",,,"Liquid Plant Depreciation","Expense","Depreciation Expense",,"Accumulated Deprecation",15029.76,"",2643734.78
,"General Journal","24-04-2024","23259",,,"Paste processing & packing line depreciation","Expense","Depreciation Expense",,"Accumulated Depreciation",17348.21,"",2661082.99
,"General Journal","24-04-2024","23260",,,"pH Meter Depreciation","Expense","Depreciation Expense",,"Accumulated Depreciation",741.39,"",2661824.38
,"General Journal","25-04-2024","23263",,,"Clamp Meter 1 Depreciation","Expense","Depreciation Expense",,"Accumulated Depreciation",36.90,"",2661861.28
,"General Journal","25-04-2024","23264",,,"Fire Alarm Sytstem Depreciation","Expense","Depreciation Expense",,"Accumulated Depreciation",728.57,"",2662589.85
,"General Journal","25-04-2024","23265",,,"Floor Chair 11 Depreciation","Expense","Depreciation Expense",,"Accumulated Depreciation",53.57,"",2662643.42
,"General Journal","25-04-2024","23266",,,"Floor Chair 12 Depreciation","Expense","Depreciation Expense",,"Accumulated Depreciation",53.57,"",2662696.99
,"General Journal","25-04-2024","23267",,,"Floor Chair 13 Depreciation","Expense","Depreciation Expense",,"Accumulated Depreciation",53.57,"",2662750.56
,"General Journal","25-04-2024","23268",,,"Floor Chair 14 Depreciation","Expense","Depreciation Expense",,"Accumulated Depreciation",53.57,"",2662804.13
,"General Journal","25-04-2024","23269",,,"Floor Chair 15 Depreciation","Expense","Depreciation Expense",,"Accumulated Depreciation",53.57,"",2662857.70
,"General Journal","25-04-2024","23270",,,"Floor Chair 16 Depreciation","Expense","Depreciation Expense",,"Accumulated Depreciation",53.57,"",2662911.27
,"General Journal","25-04-2024","23271",,,"Liquid Mixer 500Lt Depreciation","Expense","Depreciation Expense",,"Accumulated Depreciation",6172.62,"",2669083.89
,"General Journal","25-04-2024","23272",,,"Plastic Resin Mixer Depreciation","Expense","Depreciation Expense",,"Accumulated  Depreciation",1130.95,"",2670214.84
,"General Journal","25-04-2024","23273",,,"Plastic Resin Mixer Depreciation","Expense","Depreciation Expense",,"Accumulated  Depreciation",1130.95,"",2671345.79
,"General Journal","25-04-2024","25186",,,"Water tank 7 Depreciation","Expense","Depreciation Expense",,"Accumulated Depreciation",71.84,"",2671417.63
,"General Journal","26-04-2024","23274",,,"Dell Desktop 2 Depreciation","Expense","Depreciation Expense",,"Accumulated Depreciation",229.17,"",2671646.80
,"General Journal","26-04-2024","23275",,,"Dell Desktop 3 Depreciation","Expense","Depreciation Expense",,"Accumulated Depreciation",229.17,"",2671875.97
,"General Journal","26-04-2024","23276",,,"Dell Desktop 4 Depreciation","Expense","Depreciation Expense",,"Accumulated Depreciation",229.17,"",2672105.14
,"General Journal","26-04-2024","23277",,,"Grease Gun 1 Depreciation","Expense","Depreciation Expense",,"Accumulated Depreciation",73.21,"",2672178.35
,"General Journal","26-04-2024","23278",,,"Grease Gun 2 Depreciation","Expense","Depreciation Expense",,"Accumulated Depreciation",63.14,"",2672241.49
,"General Journal","26-04-2024","23279",,,"Retort Stand 1 Depreciation","Expense","Depreciation Expense",,"Accumulated Depreciation",10.71,"",2672252.20
,"General Journal","26-04-2024","23280",,,"Retort Stand 2 Depreciation","Expense","Depreciation Expense",,"Accumulated Depreciation",10.71,"",2672262.91
,"General Journal","27-04-2024","23283",,,"Board room chair 10 Depreciation","Expense","Depreciation Expense",,"Accumulated Depreciation",79.55,"",2672342.46
,"General Journal","27-04-2024","23284",,,"Board room chair 11 Depreciation","Expense","Depreciation Expense",,"Accumulated Depreciation",79.55,"",2672422.01
,"General Journal","27-04-2024","23285",,,"Board room chair 12 Depreciation","Expense","Depreciation Expense",,"Accumulated Depreciation",79.55,"",2672501.56
,"General Journal","27-04-2024","23286",,,"Board room chair 13 Depreciation","Expense","Depreciation Expense",,"Accumulated Depreciation",79.55,"",2672581.11
,"General Journal","27-04-2024","23287",,,"Board room chair 14 Depreciation","Expense","Depreciation Expense",,"Accumulated Depreciation",79.55,"",2672660.66
,"General Journal","27-04-2024","23288",,,"Board room chair 15 Depreciation","Expense","Depreciation Expense",,"Accumulated Depreciation",79.55,"",2672740.21
,"General Journal","27-04-2024","23289",,,"Board room chair 16 Depreciation","Expense","Depreciation Expense",,"Accumulated Depreciation",79.55,"",2672819.76
,"General Journal","27-04-2024","23290",,,"Board room chair 17 Depreciation","Expense","Depreciation Expense",,"Accumulated Depreciation",79.55,"",2672899.31
,"General Journal","27-04-2024","23291",,,"Board room chair 18 Depreciation","Expense","Depreciation Expense",,"Accumulated Depreciation",79.55,"",2672978.86
,"General Journal","27-04-2024","23292",,,"Board room chair 19 Depreciation","Expense","Depreciation Expense",,"Accumulated Depreciation",79.55,"",2673058.41
,"General Journal","27-04-2024","23293",,,"Board room chair 9 Depreciation","Expense","Depreciation Expense",,"Accumulated Depreciation",79.55,"",2673137.96
,"General Journal","27-04-2024","23294",,,"Canvas Stretcher Depreciation","Expense","Depreciation Expense",,"Accumulated Depreciation",133.33,"",2673271.29
,"General Journal","27-04-2024","23295",,,"Passenger Lift 1000kg Depreciation","Expense","Depreciation Expense",,"Accumulated Depreciation",44484.68,"",2717755.97
,"General Journal","27-04-2024","23296",,,"Printer Depreciation","Expense","Depreciation Expense",,"Accumulated Depreciation",205.25,"",2717961.22
,"General Journal","28-04-2024","25162",,,"Heat Gun Bosch 2 Accumulated depreciation","Expense","Depreciation Expense",,"Accumulated Depreciation",75.43,"",2718036.65
,"General Journal","28-04-2024","25168",,,"Heat Gun Bosch 3 Accumulated depreciation","Expense","Depreciation Expense",,"Accumulated Depreciation",75.43,"",2718112.08
,"General Journal","30-04-2024","23312",,,"500gm Jar Blow Mould 3 depreciation","Expense","Depreciation Expense",,"Accumulated Depreciation",1026.79,"",2719138.87
,"General Journal","30-04-2024","23313",,,"500gm Jar Blow Mould 4 depreciation","Expense","Depreciation Expense",,"Accumulated Depreciation",1026.79,"",2720165.66
,"General Journal","30-04-2024","23314",,,"Air cooled chiller depeciation","Expense","Depreciation Expense",,"Accumulated  Depreciation",8916.67,"",2729082.33
,"General Journal","30-04-2024","23315","*","Unilever Kenya Ltd:Sunlight Washing Pwd","Boato Installation Depreciation","Expense","Depreciation Expense",,"Accumulated Depreciation",65114.38,"",2794196.71
,"General Journal","30-04-2024","23316","*",,"Canister Platform Depreciation","Expense","Depreciation Expense",,"Accumulated Depreciation",59246.67,"",2853443.38
,"General Journal","30-04-2024","23317",,,"CCTV DRV & System Depreciation","Expense","Depreciation Expense",,"Accumulated Depreciation",1295.33,"",2854738.71
,"General Journal","30-04-2024","23324",,,"Colour Pressure tank Depreciation","Expense","Depreciation Expense",,"Accumulated Depreciation",232.14,"",2854970.85
,"General Journal","30-04-2024","23325",,,"Compressed air gun Depreciation","Expense","Depreciation Expense",,"Accumulated Depreciation",47.62,"",2855018.47
,"General Journal","30-04-2024","23327",,,"Drum Pump 2 Depreciation","Expense","Depreciation Expense",,"Accumulated Depreciation",123.15,"",2855141.62
,"General Journal","30-04-2024","23328",,,"Extractor Fan down Depreciation","Expense","Depreciation Expense",,"Accumulated Depreciation",150.12,"",2855291.74
,"General Journal","30-04-2024","23329",,,"Extractor Fan Hoisting Depreciation","Expense","Depreciation Expense",,"Accumulated Depreciation",176.67,"",2855468.41
,"General Journal","30-04-2024","23330",,,"Extractor Fan Packaging Depreciation","Expense","Depreciation Expense",,"Accumulated Depreciation",150.12,"",2855618.53
,"General Journal","30-04-2024","23337",,,"Incotex Type C Control Unit Depreciation","Expense","Depreciation Expense",,"Accumulated Depreciation",1939.66,"",2857558.19
,"General Journal","30-04-2024","23338",,,"Lamination Machine 1 Depreciation","Expense","Depreciation Expense",,"Accumulated Depreciation",84.78,"",2857642.97
,"General Journal","30-04-2024","23340",,,"Office Cabinet 5 Depreciation","Expense","Depreciation Expense",,"Accumulated Depreciation",58.33,"",2857701.30
,"General Journal","30-04-2024","23341",,,"Office Desk 6 Depreciation","Expense","Depreciation Expense",,"Accumulated Depreciation",90.48,"",2857791.78
,"General Journal","30-04-2024","23342",,,"Office Desk 7 Depreciation","Expense","Depreciation Expense",,"Accumulated Depreciation",90.48,"",2857882.26
,"General Journal","30-04-2024","23343",,,"Office Desk 8 Depreciation","Expense","Depreciation Expense",,"Accumulated Depreciation",83.33,"",2857965.59
,"General Journal","30-04-2024","23344",,,"Platform Scale 4 tons 1 Depreciation","Expense","Depreciation Expense",,"Accumulated Depreciation",10782.43,"",2868748.02
,"General Journal","30-04-2024","23345",,,"Process Water Filtration System Depreciation","Expense","Depreciation Expense",,"Accumulated Depreciation",1785.71,"",2870533.73
,"General Journal","30-04-2024","23350",,,"Sulphonic Acid pressure tank Depreciation","Expense","Depreciation Expense",,"Accumulated Depreciation",110.48,"",2870644.21
,"General Journal","30-04-2024","23352",,,"Test Sieves 100 & 200 microns Depreciation","Expense","Depreciation Expense",,"Accumulated Depreciation",450.00,"",2871094.21
,"General Journal","30-04-2024","23354",,,"Wall mounted cabinet 1 Dep","Expense","Depreciation Expense",,"Accumulated Depreciation",107.14,"",2871201.35
,"General Journal","30-04-2024","23357",,,"Water tank 5 Depreciation","Expense","Depreciation Expense",,"Accumulated Depreciation",137.79,"",2871339.14
,"General Journal","01-05-2024","23332",,,"Hoisting Bucket 1 Depreciation","Expense","Depreciation Expense",,"Accumulated Depreciation",148.81,"",2871487.95
,"General Journal","01-05-2024","23333",,,"Hoisting Bucket 2 Dereciation","Expense","Depreciation Expense",,"Accumulated Depreciation",148.81,"",2871636.76
,"General Journal","01-05-2024","23339",,,"Lenovo Laptop 2 Depreciation","Expense","Depreciation Expense",,"Accumulated Depreciation",333.33,"",2871970.09
,"General Journal","01-05-2024","23346",,,"Processing Platform Depreciation","Expense","Depreciation Expense",,"Accumulated Depreciation",4880.95,"",2876851.04
,"General Journal","01-05-2024","23347",,,"Security and Computer Sytem UPS Depreciation","Expense","Depreciation Expense",,"Accumulated Depreciation",3584.50,"",2880435.54
,"General Journal","01-05-2024","23353",,,"Trophy Shelf 1 Depreciation","Expense","Depreciation Expense",,"Accumulated Depreciation",95.24,"",2880530.78
,"General Journal","01-05-2024","23356",,,"Water tank 4 Depreciation","Expense","Depreciation Expense",,"Accumulated Depreciation",453.24,"",2880984.02
,"General Journal","02-05-2024","23318",,,"CMPP 1kg Jar Blow Mould 1 Depreciation","Expense","Depreciation Expense",,"Accumulated Depreciation",3364.87,"",2884348.89
,"General Journal","02-05-2024","23319",,,"CMPP 1kg Jar Blow Mould 2 Depreciation","Expense","Depreciation Expense",,"Accumulated Depreciation",3364.87,"",2887713.76
,"General Journal","02-05-2024","23320",,,"CMPP 500gm Jar Blow Mould 1 Depreciation","Expense","Depreciation Expense",,"Accumulated Depreciation",2643.82,"",2890357.58
,"General Journal","02-05-2024","23321",,,"CMPP 500gm Jar Blow Mould 2 Depreciation","Expense","Depreciation Expense",,"Accumulated Depreciation",2643.82,"",2893001.40
,"General Journal","02-05-2024","23322",,,"CMPP Blow Moulding Machine 1 Depreciation","Expense","Depreciation Expense",,"Accumulated Depreciation",49344.71,"",2942346.11
,"General Journal","02-05-2024","23323",,,"CMPP Blow Moulding Machine 2 Depreciation","Expense","Depreciation Expense",,"Accumulated Depreciation",49344.71,"",2991690.82
,"General Journal","02-05-2024","23326",,,"Drum Pump 1 Depreiation","Expense","Depreciation Expense",,"Accumulated Depreciation",123.03,"",2991813.85
,"General Journal","02-05-2024","23331",,,"Heat Gun Bosch 1 Depreciation","Expense","Depreciation Expense",,"Accumulated Depreciation",100.57,"",2991914.42
,"General Journal","02-05-2024","23334",,,"Hot ProcessWater Storage Tank1  Depreciation","Expense","Depreciation Expense",,"Accumulated Depreciation",73.99,"",2991988.41
,"General Journal","02-05-2024","23335","*",,"HP Laptop 4 Depreciation","Expense","Depreciation Expense",,"Accumulated Depreciation",297.62,"",2992286.03
,"General Journal","02-05-2024","23336","*",,"HP Laptop 8 Depreciation","Expense","Depreciation Expense",,"Accumulated Depreciation",1200.00,"",2993486.03
,"General Journal","02-05-2024","23348",,,"Store Racking 1 depreciation","Expense","Depreciation Expense",,"Accumulated Depreciation",175.60,"",2993661.63
,"General Journal","02-05-2024","23349",,,"Store Racking 2 Depreciation","Expense","Depreciation Expense",,"Accumulated Depreciation",175.60,"",2993837.23
,"General Journal","02-05-2024","23351",,,"Tank platform Depreciation","Expense","Depreciation Expense",,"Accumulated Depreciation",130.95,"",2993968.18
,"General Journal","02-05-2024","23355",,,"Water tank 1 Depreciation","Expense","Depreciation Expense",,"Accumulated Depreciation",120.07,"",2994088.25
,"General Journal","02-05-2024","23358",,,"Workshop cabinet depreciation","Expense","Depreciation Expense",,"Accumulated Depreciation",172.02,"",2994260.27
,"General Journal","03-05-2024","23368",,,"Alarm System extension","Expense","Depreciation Expense",,"Accumulated Depreciation",602.38,"",2994862.65
,"General Journal","03-05-2024","23369",,,"Domestos sewing machine depreciation","Expense","Depreciation Expense",,"Acummulated depreciation",82.10,"",2994944.75
,"General Journal","03-05-2024","23370",,,"Bench Grinder 2 Depreciation","Expense","Depreciation Expense",,"Accumulated Depreceiation",100.57,"",2995045.32
,"General Journal","03-05-2024","23373",,,"CCTV survellance System extension Depreciation","Expense","Depreciation Expense",,"Accumulated Depreciation",657.14,"",2995702.46
,"General Journal","03-05-2024","23375",,,"Electrical Enclosure CCTV Depreciation","Expense","Depreciation Expense",,"Accumulated Depreciation",126.19,"",2995828.65
,"General Journal","03-05-2024","23376",,,"Electrical Enclosure Main Depreciation","Expense","Depreciation Expense",,"Accumulated Depreciation",2339.29,"",2998167.94
,"General Journal","03-05-2024","23377",,,"Electrical Enclosure P Line Depreciation","Expense","Depreciation Expense",,"Accumulated Depreciation",428.57,"",2998596.51
,"General Journal","03-05-2024","23391",,,"Floodlight Depreciation","Expense","Depreciation Expense",,"Accumulated Depreciation",59.52,"",2998656.03
,"General Journal","03-05-2024","23397",,,"Office Desk 1 Depreciation","Expense","Depreciation Expense",,"Accumulated Depreciation",225.00,"",2998881.03
,"General Journal","03-05-2024","23398",,,"Office Desk 2 Depreciation","Expense","Depreciation Expense",,"Accumulated Depreciation",225.00,"",2999106.03
,"General Journal","03-05-2024","23399",,,"Office Desk 3 Depreciation","Expense","Depreciation Expense",,"Accumulated Depreciation",225.00,"",2999331.03
,"General Journal","03-05-2024","23403",,,"Signet ESD 1 Depreciation","Expense","Depreciation Expense",,"Accumulated Depreciation",928.57,"",3000259.60
,"General Journal","03-05-2024","23405","*",,"Sterling Water Dispenser 1 Depreciation","Expense","Depreciation Expense",,"Accumulated Depreciation",119.05,"",3000378.65
,"General Journal","03-05-2024","23406",,,"Table top Weighing Scale 5 Depreciation","Expense","Depreciation Expense",,"Accumulated Depreciation",248.57,"",3000627.22
,"General Journal","03-05-2024","23407",,,"Table top Weighing Scale 6 Depreciation","Expense","Depreciation Expense",,"Accumulated Depreciation",248.57,"",3000875.79
,"General Journal","03-05-2024","23408",,,"Table top Weighing Scale 7 Depreciation","Expense","Depreciation Expense",,"Accumulated Depreciation",248.57,"",3001124.36
,"General Journal","03-05-2024","23409",,,"Table top Weighing Scale 8 Depreciation","Expense","Depreciation Expense",,"Accumulated Depreciation",248.57,"",3001372.93
,"General Journal","03-05-2024","23410",,,"Table top Weighing Scale 9 Depreciation","Expense","Depreciation Expense",,"Accumulated Depreciation",248.57,"",3001621.50
,"General Journal","04-05-2024","23363",,,"9Kg Powder Fire Extinguisher 1 Depreciation","Expense","Depreciation Expense",,"Accumulated Depreciation",34.52,"",3001656.02
,"General Journal","04-05-2024","23364",,,"9Kg Powder Fire Extinguisher 2 Depreciation","Expense","Depreciation Expense",,"Accumulated Depreciation",34.52,"",3001690.54
,"General Journal","04-05-2024","23365",,,"9Kg Powder Fire Extinguisher 3 Depreciation","Expense","Depreciation Expense",,"Accumulated Depreciation",34.52,"",3001725.06
,"General Journal","04-05-2024","23367",,,"9Kg Powder Fire Extinguisher 5 Depreciation","Expense","Depreciation Expense",,"Accumulated Depreciation",34.52,"",3001759.58
,"General Journal","04-05-2024","23374",,,"Chiller 2 Depreciation","Expense","Depreciation Expense",,"Accumulated Depreciation",8035.71,"",3009795.29
,"General Journal","04-05-2024","23379",,,"Empty IBC Tank 10 Depreciation","Expense","Depreciation Expense",,"Accumulated Depreciation",41.67,"",3009836.96
,"General Journal","04-05-2024","23380",,,"Empty IBC Tank 3 Depreciation","Expense","Depreciation Expense",,"Accumulated Depreciation",65.48,"",3009902.44
,"General Journal","04-05-2024","23381",,,"Empty IBC Tank 4 Depreciation","Expense","Depreciation Expense",,"Accumulated Depreciation",65.48,"",3009967.92
,"General Journal","04-05-2024","23382",,,"Empty IBC Tank 5 Depreciation","Expense","Depreciation Expense",,"Accumulated Depreciation",65.48,"",3010033.40
,"General Journal","04-05-2024","23383",,,"Empty IBC Tank 6 Depreciation","Expense","Depreciation Expense",,"Accumulated Depreciation",65.48,"",3010098.88
,"General Journal","04-05-2024","23384",,,"Empty IBC Tank 7 Depreciation","Expense","Depreciation Expense",,"Accumulated Depreciation",41.67,"",3010140.55
,"General Journal","04-05-2024","23385",,,"Empty IBC Tank 8 Depreciation","Expense","Depreciation Expense",,"Accumulated Depreiation",41.67,"",3010182.22
,"General Journal","04-05-2024","23386",,,"Empty IBC Tank 9 Depreciation","Expense","Depreciation Expense",,"Accumulated Depreciation",41.67,"",3010223.89
,"General Journal","04-05-2024","23393",,,"Linx 8900 Coder 1 Depreciation","Expense","Depreciation Expense",,"Accumulated Depreciation",8333.33,"",3018557.22
,"General Journal","04-05-2024","23396",,,"Mobile Phone 2 Depreciation","Expense","Depreciation Expense",,"Accumulated Depreciation",46.67,"",3018603.89
,"General Journal","04-05-2024","23413",,,"Triple UV water purifier 1 Depreciation","Expense","Depreciation Expense",,"Accumulated Depreciation",296.22,"",3018900.11
,"General Journal","05-05-2024","23359",,,"1Kg Generic Jar Blow Mould 1 depreciation","Expense","Depreciation Expense",,"Accumulated Depreciation",1500.00,"",3020400.11
,"General Journal","05-05-2024","23360",,,"1Kg Generic Jar Blow Mould 2 depreciation","Expense","Depreciation Expense",,"Accumulated Depreciation",1500.00,"",3021900.11
,"General Journal","05-05-2024","23361",,,"500gm Generic Jar Blow Mould 1 depreciation","Expense","Depreciation Expense",,"Accumulated Depreciation",1071.43,"",3022971.54
,"General Journal","05-05-2024","23362",,,"500gm Generic Jar Blow Mould 2 depreciation","Expense","Depreciation Expense",,"Accumulated Depreciation",1071.43,"",3024042.97
,"General Journal","05-05-2024","23366",,,"9Kg Powder Fire Extinguisher 4 Depreciation","Expense","Depreciation Expense",,"Accumulated Depreciation",34.52,"",3024077.49
,"General Journal","05-05-2024","23387",,,"Extractor Fan 4 Depreciation","Expense","Depreciation Expense",,"Accumulated Depreciation",726.19,"",3024803.68
,"General Journal","05-05-2024","23388",,,"FFS  Machine Installation Elct Depreciation","Expense","Depreciation Expense",,"Accumulated Depreciation",200.60,"",3025004.28
,"General Journal","05-05-2024","23390",,,"First Aid Kit Depreciation","Expense","Depreciation Expense",,"Accumulated  Depreciation",77.38,"",3025081.66
,"General Journal","05-05-2024","23394",,,"Linx 8900 Coder 2 Depreciation","Expense","Depreciation Expense",,"Accumulated Depreciation",12500.00,"",3037581.66
,"General Journal","05-05-2024","23400",,,"Packing Platform Depreciation","Expense","Depreciation Expense",,"Accumulated Depreciation",5297.62,"",3042879.28
,"General Journal","05-05-2024","23404",,,"SS Industrial Turntable Depreciation","Expense","Depreciation Expense",,"Accumulated Depreciation",5238.10,"",3048117.38
,"General Journal","05-05-2024","23414",,,"TV Screen 2 Depreciation","Expense","Depreciation Expense",,"Accumulated Depreciation",950.00,"",3049067.38
,"General Journal","05-05-2024","23416",,,"Water Purifier 1 Depreciation","Expense","Depreciation Expense",,"Accumulated Depreciation",117.10,"",3049184.48
,"General Journal","05-05-2024","23417",,,"Water tank 2 Depreciation","Expense","Depreciation Expense",,"Accumulated Depreciation",23.81,"",3049208.29
,"General Journal","06-05-2024","23371",,,"Blower Depreciation","Expense","Depreciation Expense",,"Accumulated Depreciation",59.52,"",3049267.81
,"General Journal","06-05-2024","23372",,,"Board room chair 3 Depreciation","Expense","Depreciation Expense",,"Accumulated Depreciation",59.52,"",3049327.33
,"General Journal","06-05-2024","23378",,,"Emergency Washing Point Depreciation","Expense","Depreciation Expense",,"Accumulated Deprecation",160.71,"",3049488.04
,"General Journal","06-05-2024","23392","*",,"Infrared Thermometre 1 Depreciation","Expense","Depreciation Expense",,"Accumulated Depreciation",416.67,"",3049904.71
,"General Journal","06-05-2024","23395",,,"Material's Trolley Depreciation","Expense","Depreciation Expense",,"Accumulated Depreciation",297.62,"",3050202.33
,"General Journal","06-05-2024","23401",,,"Plastic Scrap Grinder Machine Depreciation","Expense","Depreciation Expense",,"Accumulated  Depreciation",3452.38,"",3053654.71
,"General Journal","06-05-2024","23402",,,"Ribon Mixer SS depreciation","Expense","Depreciation Expense",,"Accumulated depreciation",4642.86,"",3058297.57
,"General Journal","06-05-2024","23411",,,"Telephone Handset Depreciation","Expense","Depreciation Expense",,"Accumulated Depreciation",29.76,"",3058327.33
,"General Journal","06-05-2024","23412",,,"Telkom Wifi Router Depreciation","Expense","Depreciation Expense",,"Accumulated Depreciation",71.43,"",3058398.76
,"General Journal","06-05-2024","23415",,,"Vacuum Cleaner Depreciation","Expense","Depreciation Expense",,"Accumulated Depreciation",148.81,"",3058547.57
,"General Journal","07-05-2024","23418",,,"9Kg Powder Fire Extinguisher 6 Depreciation","Expense","Depreciation Expense",,"Accumulated Depreciation",44.05,"",3058591.62
,"General Journal","07-05-2024","23419",,,"Canteen Chair 20 Depreciation","Expense","Depreciation Expense",,"Accumulated Depreciation",6.12,"",3058597.74
,"General Journal","07-05-2024","23420",,,"Cartoning table 4 depreciation","Expense","Depreciation Expense",,"Accumulated Depreciation",262.49,"",3058860.23
,"General Journal","07-05-2024","23421",,,"Case sealing table depreciation","Expense","Depreciation Expense",,"Accumulated Depreciation",86.67,"",3058946.90
,"General Journal","07-05-2024","23422",,,"Chain block 2 depreciation","Expense","Depreciation Expense",,"Accumulated depreciation",398.81,"",3059345.71
,"General Journal","07-05-2024","23423",,,"Chain block 3 depreciation","Expense","Depreciation Expense",,"Accumulated depreciation",398.81,"",3059744.52
,"General Journal","07-05-2024","23424",,,"Drilling machine Depreciation","Expense","Depreciation Expense",,"Accumulated Depreciation",88.39,"",3059832.91
,"General Journal","07-05-2024","23425",,,"Grinder Depreciation","Expense","Depreciation Expense",,"Acccumulated Depreciation",159.82,"",3059992.73
,"General Journal","07-05-2024","23426",,,"Packing table 1 depreciation","Expense","Depreciation Expense",,"Accumulated Depreciation",262.49,"",3060255.22
,"General Journal","07-05-2024","23427",,,"Packing table 2 depreciation","Expense","Depreciation Expense",,"Accumulated Depreciation",262.49,"",3060517.71
,"General Journal","07-05-2024","23428",,,"Packing table 3 depreciation","Expense","Depreciation Expense",,"Accumulated Depreciation",262.49,"",3060780.20
,"General Journal","07-05-2024","23429",,,"Quality table depreciation","Expense","Depreciation Expense",,"Accumulated Depreciation",86.67,"",3060866.87
,"General Journal","07-05-2024","23430",,,"Welding machine Depreciation","Expense","Depreciation Expense",,"Accumulated Depreciation",178.57,"",3061045.44
,"General Journal","08-05-2024","23433",,,"Bench Grinder 350W Depreciation","Expense","Depreciation Expense",,"Accumulated Depreciation",122.13,"",3061167.57
,"General Journal","08-05-2024","23434",,,"HP Laptop 6 Depreciation","Expense","Depreciation Expense",,"Accumulated Depreciation",416.67,"",3061584.24
,"General Journal","08-05-2024","23435",,,"Mobile Phone 1 Depreciation","Expense","Depreciation Expense",,"Accumulated Depreciation",58.33,"",3061642.57
,"General Journal","08-05-2024","25179",,,"Six step steel ladder 1 Depreciation","Expense","Depreciation Expense",,"Accumulated Depreciation",113.51,"",3061756.08
,"General Journal","09-05-2024","23437",,,"Canteen Table 1 Depreciation","Expense","Depreciation Expense",,"Accumulated Depreciation",184.52,"",3061940.60
,"General Journal","09-05-2024","23438",,,"Canteen Table 2 Depreciation","Expense","Depreciation Expense",,"Accumulated Depreciation",184.52,"",3062125.12
,"General Journal","09-05-2024","23439",,,"Dell Desktop 1 Depreciation","Expense","Depreciation Expense",,"Accumulated Depreciation",178.57,"",3062303.69
,"General Journal","09-05-2024","23440",,,"Fire Alarm System Extension'19 Depreciation","Expense","Depreciation Expense",,"Accumulated Depreciation",9857.14,"",3072160.83
,"General Journal","09-05-2024","23441",,,"Floor Chair 1 Depreciation","Expense","Depreciation Expense",,"Accumulated Depreciation",26.79,"",3072187.62
,"General Journal","09-05-2024","23442",,,"Floor Chair 10 Depreciation","Expense","Depreciation Expense",,"Accumulated Depreciation",53.57,"",3072241.19
,"General Journal","09-05-2024","23443",,,"Floor Chair 2 Depreciation","Expense","Depreciation Expense",,"Accumulated Depreciation",26.79,"",3072267.98
,"General Journal","09-05-2024","23444",,,"Floor Chair 3 Depreciation","Expense","Depreciation Expense",,"Accumulated Depreciation",26.79,"",3072294.77
,"General Journal","09-05-2024","23445",,,"Floor Chair 4 Depreciation","Expense","Depreciation Expense",,"Accumulated Depreciation",26.79,"",3072321.56
,"General Journal","09-05-2024","23446",,,"Floor Chair 5 Depreciation","Expense","Depreciation Expense",,"Accumulated Depreciation",26.79,"",3072348.35
,"General Journal","09-05-2024","23447",,,"Floor Chair 6 Depreciation","Expense","Depreciation Expense",,"Accumulated Depreciation",53.57,"",3072401.92
,"General Journal","09-05-2024","23448",,,"Floor Chair 7 Depreciation","Expense","Depreciation Expense",,"Accumulated Depreciation",53.57,"",3072455.49
,"General Journal","09-05-2024","23449",,,"Floor Chair 8 Depreciation","Expense","Depreciation Expense",,"Accumulated Depreciation",53.57,"",3072509.06
,"General Journal","09-05-2024","23450",,,"Floor Chair 9 Depreciation","Expense","Depreciation Expense",,"Accumulated Depreciation",53.57,"",3072562.63
,"General Journal","09-05-2024","23451",,,"Floor weighing scale Depreciation","Expense","Depreciation Expense",,"Accumulated Depreciation",593.81,"",3073156.44
,"General Journal","09-05-2024","23452",,,"Lab Office Chair 1 Depreciation","Expense","Depreciation Expense",,"Accumulated Depreciation",47.62,"",3073204.06
,"General Journal","09-05-2024","23453",,,"Lab Office Chair 2 Depreciation","Expense","Depreciation Expense",,"Accumulated Depreciation",47.62,"",3073251.68
,"General Journal","09-05-2024","23454",,,"Lab Office Chair 3 Depreciation","Expense","Depreciation Expense",,"Accumulated Depreciation",47.62,"",3073299.30
,"General Journal","09-05-2024","23455","*","Unilever Kenya Ltd:Sunlight Washing Pwd","Sunlight Bag Closing Machine 1 Depreciation","Expense","Depreciation Expense",,"Accumulated Depreciation",738.10,"",3074037.40
,"General Journal","09-05-2024","23456","*","Unilever Kenya Ltd:Sunlight Washing Pwd","Sunlight Packing Chair 1 Depreciation","Expense","Depreciation Expense",,"Accumulated Depreciation",41.67,"",3074079.07
,"General Journal","10-05-2024","23457",,,"5Kg Fire Extinguisher 1 Depreciation","Expense","Depreciation Expense",,"Accumulated Depreciation",65.48,"",3074144.55
,"General Journal","10-05-2024","23458",,,"HP Laptop 10 Depreciation","Expense","Depreciation Expense",,"Accumulated Depreciation",1200.00,"",3075344.55
,"General Journal","10-05-2024","23459",,,"HP Laptop 9 Depreciation","Expense","Depreciation Expense",,"Accumulated Depreciation",1200.00,"",3076544.55
,"General Journal","10-05-2024","23460",,,"Office Seat 1 Depreciation","Expense","Depreciation Expense",,"Accumulated Depreciation",142.86,"",3076687.41
,"General Journal","10-05-2024","23461",,,"Office Seat 2 Depreciation","Expense","Depreciation Expense",,"Accumulated Depreciation",71.43,"",3076758.84
,"General Journal","10-05-2024","23462",,,"Office Seat 3 Depreciation","Expense","Depreciation Expense",,"Accumulated Depreciation",71.43,"",3076830.27
,"General Journal","10-05-2024","23463",,,"Reverse Osmosis Unit 1 Depreciation","Expense","Depreciation Expense",,"Accumulated Depreciation",416.67,"",3077246.94
,"General Journal","10-05-2024","23464",,,"Steam Generator SG24 Depreciation","Expense","Depreciation Expense",,"Accumulated Depreciation",3794.53,"",3081041.47
,"General Journal","10-05-2024","23465",,,"Toilet Cleaner Mixing Machine Depreciation","Expense","Depreciation Expense",,"Accumulated Depreciation",6333.33,"",3087374.80
,"General Journal","11-05-2024","23466",,,"4 GB hard drive for CCTV Depreciation","Expense","Depreciation Expense",,"Accumulated Depreciation",178.57,"",3087553.37
,"General Journal","11-05-2024","23467",,,"4TB Hard Disk Depreciation","Expense","Depreciation Expense",,"Accumulated Depreciation",178.57,"",3087731.94
,"General Journal","11-05-2024","23470","*","Unilever Kenya Ltd:Sunlight Washing Pwd","Chain block trolley 4 depreciation","Expense","Depreciation Expense",,"Accumulated Depreciation",85.00,"",3087816.94
,"General Journal","11-05-2024","23471",,,"Coder Depreciation","Expense","Depreciation Expense",,"Accumulated Depreciation",2261.90,"",3090078.84
,"General Journal","11-05-2024","23473",,,"Coder Stand Depreciation","Expense","Depreciation Expense",,"Accumulated Depreciation",59.52,"",3090138.36
,"General Journal","11-05-2024","23477",,,"Compressor 1 depreciation","Expense","Depreciation Expense",,"Accumulated depreciation",3750.00,"",3093888.36
,"General Journal","11-05-2024","23480",,,"HP Laptop 14 Depreciation","Expense","Depreciation Expense",,"Accumulated Depreciation",1941.67,"",3095830.03
,"General Journal","11-05-2024","23481",,,"HP Laptop 15 Depreciation","Expense","Depreciation Expense",,"Accumulated Depreciation",1750.00,"",3097580.03
,"General Journal","11-05-2024","23484",,,"Pallet truck 2 depreciation","Expense","Depreciation Expense",,"Accumulated depreciation",440.48,"",3098020.51
,"General Journal","11-05-2024","23487","*",,"Steam Label Shrink Tunnel Depreciation","Expense","Depreciation Expense",,"Accumulated  Depreciation",10952.38,"",3108972.89
,"General Journal","12-05-2024","23472",,,"Coder Housing Depreciation","Expense","Depreciation Expense",,"Accumulated Depreciation",80.36,"",3109053.25
,"General Journal","12-05-2024","23474","*","Unilever Kenya Ltd:Sunlight Washing Pwd","Coder UPS 4 Depreciation","Expense","Depreciation Expense",,"Accumulated Depreciation",158.33,"",3109211.58
,"General Journal","12-05-2024","23476",,,"Coding Conveyor Depreciation","Expense","Depreciation Expense",,"Accumulated Depreciation",476.19,"",3109687.77
,"General Journal","12-05-2024","23478",,,"Conveyor 2 Depreciation","Expense","Depreciation Expense",,"Accumulated  Depreciation",169.64,"",3109857.41
,"General Journal","12-05-2024","23479",,,"Eyewash Station 1 Depreciation","Expense","Depreciation Expense",,"Accumulated Depreciation",904.76,"",3110762.17
,"General Journal","12-05-2024","23483",,,"HP Laptop 5 Depreciation","Expense","Depreciation Expense",,"Accumulated Depreciation",416.67,"",3111178.84
,"General Journal","12-05-2024","23489",,,"Tea maker Depreciation","Expense","Depreciation Expense",,"Accumulated Depreciation",225.00,"",3111403.84
,"General Journal","13-05-2024","23468",,,"Alarm System Depreciation","Expense","Depreciation Expense",,"Accumulated Depreciation",580.95,"",3111984.79
,"General Journal","13-05-2024","23469",,,"Bosch Blower 2 Depreciation","Expense","Depreciation Expense",,"Accumulated Depreciation",136.49,"",3112121.28
,"General Journal","13-05-2024","23475",,,"Coder UPS 8 Depreciation","Expense","Depreciation Expense",,"Accumulated Depreciation",81.67,"",3112202.95
,"General Journal","13-05-2024","23482","*",,"HP Laptop 16 Depreciation","Expense","Depreciation Expense",,"Accumulated Depreciation",1000.00,"",3113202.95
,"General Journal","13-05-2024","23485",,,"PIR system extension Depreciation","Expense","Depreciation Expense",,"Accumulated Depreciation",254.67,"",3113457.62
,"General Journal","13-05-2024","23486",,,"Process Water Storage Tank Depreciation","Expense","Depreciation Expense",,"Accumulated Depreciation",1065.16,"",3114522.78
,"General Journal","13-05-2024","23488","*",,"Store Racking 3 FG Depreciation","Expense","Depreciation Expense",,"Accumulated Depreciation",9791.67,"",3124314.45
,"General Journal","13-05-2024","23490",,,"Weighing scale 1","Expense","Depreciation Expense",,"Accumulated Depreciation",559.52,"",3124873.97
,"General Journal","13-05-2024","25173",,,"HP Mini Desktop 4 Depreciation","Expense","Depreciation Expense",,"Accumulated Depreciation",466.67,"",3125340.64
,"General Journal","14-05-2024","23495",,,"Coder UPS 5 Depreciation","Expense","Depreciation Expense",,"Accumulated Depreciation",158.33,"",3125498.97
,"General Journal","14-05-2024","23496",,,"Motor Vehicle 2 Depreciation","Expense","Depreciation Expense",,"Accumulated Depreciation",10297.62,"",3135796.59
,"General Journal","14-05-2024","23497",,,"Paste Packing Machine Depreciation","Expense","Depreciation Expense",,"Accumulated Depreciation",4166.67,"",3139963.26
,"General Journal","14-05-2024","23498",,,"Table Top Scale 10  SS 15Kg Depreciation","Expense","Depreciation Expense",,"Accumulated Depreciation",297.62,"",3140260.88
,"General Journal","15-05-2024","23499",,,"150KVA Enclosed Genset Depreciation","Expense","Depreciation Expense",,"Accumulated Depreciation",24404.76,"",3164665.64
,"General Journal","15-05-2024","23500",,,"20Kg Forklift Gas Cylinder 2 Depreciation","Expense","Depreciation Expense",,"Accumulated Depreciation",769.70,"",3165435.34
,"General Journal","15-05-2024","23501",,,"2Ton Electric Hoist 1 Depreciation","Expense","Depreciation Expense",,"Accumulated Depreciation",3708.33,"",3169143.67
,"General Journal","15-05-2024","23502",,,"Automatic Change Over Switch 1 Depreciation","Expense","Depreciation Expense",,"Accumulated Depreciation",1666.67,"",3170810.34
,"General Journal","15-05-2024","23503",,,"Bench top Weighing Scale 1 Depreciation","Expense","Depreciation Expense",,"Accumulated Depreciation",357.14,"",3171167.48
,"General Journal","15-05-2024","23504",,,"Bench top Weighing Scale 2 Depreciation","Expense","Depreciation Expense",,"Accumulated Depreciation",357.14,"",3171524.62
,"General Journal","15-05-2024","23505",,,"Bench top Weighing Scale 3 Depreciation","Expense","Depreciation Expense",,"Accumulated Depreciation",357.14,"",3171881.76
,"General Journal","15-05-2024","23506",,,"Bench top Weighing Scale 4 Depreciation","Expense","Depreciation Expense",,"Accumulated Depreciation",357.14,"",3172238.90
,"General Journal","15-05-2024","23507",,,"Bosch Blower Depreciation","Expense","Depreciation Expense",,"Accumulated Depreciation",129.31,"",3172368.21
,"General Journal","15-05-2024","23508",,,"Canteen Chair 1 Depreciation","Expense","Depreciation Expense",,"Accumulated Depreciation",6.12,"",3172374.33
,"General Journal","15-05-2024","23509",,,"Canteen Chair 10 Depreciation","Expense","Depreciation Expense",,"Accumulated Depreciation",6.12,"",3172380.45
,"General Journal","15-05-2024","23510",,,"Canteen Chair 11 Depreciation","Expense","Depreciation Expense",,"Accumulated Depreciation",6.12,"",3172386.57
,"General Journal","15-05-2024","23511",,,"Canteen Chair 11 Depreciation","Expense","Depreciation Expense",,"Accumulated Depreciation",6.12,"",3172392.69
,"General Journal","15-05-2024","23512",,,"Canteen Chair 12 Depreciation","Expense","Depreciation Expense",,"Accumulated Depreciation",6.12,"",3172398.81
,"General Journal","15-05-2024","23513",,,"Canteen Chair 13 Depreciation","Expense","Depreciation Expense",,"Accumulated Depreciation",6.12,"",3172404.93
,"General Journal","15-05-2024","23514",,,"Canteen Chair 14 Depreciation","Expense","Depreciation Expense",,"Accumulated Depreciation",6.12,"",3172411.05
,"General Journal","15-05-2024","23515",,,"Canteen Chair 15 Depreciation","Expense","Depreciation Expense",,"Accumulated Depreciation",6.12,"",3172417.17
,"General Journal","15-05-2024","23516",,,"Canteen Chair 16 Depreciation","Expense","Depreciation Expense",,"Accumulated Depreciation",6.12,"",3172423.29
,"General Journal","15-05-2024","23517",,,"Canteen Chair 17 Depreciation","Expense","Depreciation Expense",,"Accumulated Depreciation",6.12,"",3172429.41
,"General Journal","15-05-2024","23518",,,"Canteen Chair 18 Depreciation","Expense","Depreciation Expense",,"Accumulated Depreciation",6.12,"",3172435.53
,"General Journal","15-05-2024","23519",,,"Canteen Chair 19 Depreciation","Expense","Depreciation Expense",,"Accumulated Depreciation",6.12,"",3172441.65
,"General Journal","15-05-2024","23520",,,"Canteen Chair 2 Depreciation","Expense","Depreciation Expense",,"Accumulated Depreciation",6.12,"",3172447.77
,"General Journal","15-05-2024","23521",,,"Canteen Chair 21 Depreciation","Expense","Depreciation Expense",,"Accumulated Depreciation",6.12,"",3172453.89
,"General Journal","15-05-2024","23522",,,"Canteen Chair 22 Depreciation","Expense","Depreciation Expense",,"Accumulated Depreciation",6.12,"",3172460.01
,"General Journal","15-05-2024","23523",,,"Canteen Chair 23 Depreciation","Expense","Depreciation Expense",,"Accumulated Depreciation",6.12,"",3172466.13
,"General Journal","15-05-2024","23524",,,"Canteen Chair 24 Depreciation","Expense","Depreciation Expense",,"Accumulated Depreciation",6.12,"",3172472.25
,"General Journal","15-05-2024","23525",,,"Canteen Chair 25 Depreciation","Expense","Depreciation Expense",,"Accumulated Depreciation",6.12,"",3172478.37
,"General Journal","15-05-2024","23526",,,"Canteen Chair 3 Depreciation","Expense","Depreciation Expense",,"Accumulated Depreciation",6.12,"",3172484.49
,"General Journal","15-05-2024","23527",,,"Canteen Chair 4 Depreciation","Expense","Depreciation Expense",,"Accumulated Depreciation",6.12,"",3172490.61
,"General Journal","15-05-2024","23528",,,"Canteen Chair 5 Depreciation","Expense","Depreciation Expense",,"Accumulated Depreciation",6.12,"",3172496.73
,"General Journal","15-05-2024","23529",,,"Canteen Chair 6 Depreciation","Expense","Depreciation Expense",,"Accumulated Depreciation",6.12,"",3172502.85
,"General Journal","15-05-2024","23530",,,"Canteen Chair 7 Depreciation","Expense","Depreciation Expense",,"Accumulated Depreciation",6.12,"",3172508.97
,"General Journal","15-05-2024","23531",,,"Canteen Chair 8 Depreciation","Expense","Depreciation Expense",,"Accumulated Depreciation",6.12,"",3172515.09
,"General Journal","15-05-2024","23532",,,"Canteen Chair 9 Depreciation","Expense","Depreciation Expense",,"Accumulated Depreciation",6.12,"",3172521.21
,"General Journal","15-05-2024","23533",,,"EOL Case sealer Outfeed Conveyor Depreciation","Expense","Depreciation Expense",,"Accumulated Depreciation",297.62,"",3172818.83
,"General Journal","15-05-2024","23534",,,"Epson L6190 Printer 1 Depreciation","Expense","Depreciation Expense",,"Accumulated Depreciation",654.76,"",3173473.59
,"General Journal","15-05-2024","23535",,,"Fire Extinguisher 1 Depreciation","Expense","Depreciation Expense",,"Accumulated Depreciation",77.38,"",3173550.97
,"General Journal","15-05-2024","23536",,,"Fire Extinguisher 2 Depreciation","Expense","Depreciation Expense",,"Accumulated Depreciation",77.38,"",3173628.35
,"General Journal","15-05-2024","23537",,,"Fire Extinguisher 3 Depreciation","Expense","Depreciation Expense",,"Accumulated Depreciation",77.38,"",3173705.73
,"General Journal","15-05-2024","23538",,,"Fire Extinguisher 4 Depreciation","Expense","Depreciation Expense",,"Accumulated Depreciation",77.38,"",3173783.11
,"General Journal","15-05-2024","23539",,,"Fire Extinguisher 5 Depreciation","Expense","Depreciation Expense",,"Accumulated Depreciation",77.38,"",3173860.49
,"General Journal","15-05-2024","23540",,,"Fire Extinguisher 6 Depreciation","Expense","Depreciation Expense",,"Accumulated Depreciation",77.38,"",3173937.87
,"General Journal","15-05-2024","23541",,,"Grinder 2 Depreciation","Expense","Depreciation Expense",,"Accumulated Depreciation",178.57,"",3174116.44
,"General Journal","15-05-2024","23542",,,"HP Laptop 11 Depreciation","Expense","Depreciation Expense",,"Accumulated Depreciation",1200.00,"",3175316.44
,"General Journal","15-05-2024","23543",,,"HP Laptop 12 Depreciation","Expense","Depreciation Expense",,"Accumulated Depreciation",1200.00,"",3176516.44
,"General Journal","15-05-2024","23544",,,"Microwave 2 Depreciation","Expense","Depreciation Expense",,"Accumulated Depreciation",147.27,"",3176663.71
,"General Journal","15-05-2024","23545",,,"Mobile phone 3 Depreciation","Expense","Depreciation Expense",,"Accumulated Depreciation",41.67,"",3176705.38
,"General Journal","15-05-2024","23546",,,"Movable Ladder 1 Depreciation","Expense","Depreciation Expense",,"Accumulated Depreciation",434.52,"",3177139.90
,"General Journal","15-05-2024","23547",,,"UV water purifier 3 Depreciation","Expense","Depreciation Expense",,"Accumulated Depreciation",543.10,"",3177683.00
,"General Journal","15-05-2024","23548",,,"Water tank 6 Depreciation","Expense","Depreciation Expense",,"Accumulated Depreciation",71.84,"",3177754.84
,"General Journal","16-05-2024","23550",,,"Bosch Grinder 3 Depreciation","Expense","Depreciation Expense",,"Accumulated Depreceiation",86.21,"",3177841.05
,"General Journal","16-05-2024","23551",,,"Chain block 5 depreciation","Expense","Depreciation Expense",,"Accumulated Depreciation",292.49,"",3178133.54
,"General Journal","16-05-2024","23552",,,"Chain block 6 depreciation","Expense","Depreciation Expense",,"Accumulated Depreciation",292.49,"",3178426.03
,"General Journal","16-05-2024","23553",,,"Heat Gun Total 1 Depreciation","Expense","Depreciation Expense",,"Accumulated Depreciation",64.66,"",3178490.69
,"General Journal","16-05-2024","23554",,,"Linx 5900 Coder 1 Depreciation","Expense","Depreciation Expense",,"Accumulated Depreciation",4166.67,"",3182657.36
,"General Journal","16-05-2024","23555",,,"Table Top Scale 11 6Kg Depreciation","Expense","Depreciation Expense",,"Accumulated Depreciation",277.09,"",3182934.45
,"General Journal","16-05-2024","23556",,,"Washing Machine 1 Depreciation","Expense","Depreciation Expense",,"Accumulated Depreciation",2640.01,"",3185574.46
,"General Journal","17-05-2024","23557",,,"2T Mixer Depreciation","Expense","Depreciation Expense",,"Accumulated Depreciation",12633.99,"",3198208.45
,"General Journal","17-05-2024","23558",,,"2T Mixer Installation Depreciation","Expense","Depreciation Expense",,"Accumulated Depreciation",29713.15,"",3227921.60
,"General Journal","17-05-2024","23559",,,"Coder UPS 6 Depreciation","Expense","Depreciation Expense",,"Accumulated Depreciation",94.83,"",3228016.43
,"General Journal","17-05-2024","23560",,,"Coder UPS 7 Depreciation","Expense","Depreciation Expense",,"Accumulated Depreciation",94.83,"",3228111.26
,"General Journal","17-05-2024","23561","*",,"Hand Dryer 1 Depreciation","Expense","Depreciation Expense",,"Accumulated Depreciation",46.18,"",3228157.44
,"General Journal","17-05-2024","23562","*",,"HP Laptop 3 Depreciation","Expense","Depreciation Expense",,"Accumulated Depreciation",297.62,"",3228455.06
,"General Journal","17-05-2024","23563",,,"Office desks  4","Expense","Depreciation Expense",,"Accumulated Depreciation",361.90,"",3228816.96
,"General Journal","17-05-2024","23564",,,"Pallet truck 4 Depreciation","Expense","Depreciation Expense",,"Accumulated Depreciation",428.57,"",3229245.53
,"General Journal","17-05-2024","23565",,,"Pallet truck 5 Depreciation","Expense","Depreciation Expense",,"Accumulated Depreciation",428.57,"",3229674.10
,"General Journal","17-05-2024","23566",,,"Recirculation Pump Depreciation","Expense","Depreciation Expense",,"Accumulated  Depreciation",71.19,"",3229745.29
,"General Journal","17-05-2024","23567",,,"Server 1 Depreciation","Expense","Depreciation Expense",,"Accumulated Depreciation",357.14,"",3230102.43
,"General Journal","17-05-2024","23568",,,"Server Monitor Depreciation","Expense","Depreciation Expense",,"Accumulated Depreciaion",107.14,"",3230209.57
,"General Journal","17-05-2024","23569",,,"Shrink Tunnel Depreciation","Expense","Depreciation Expense",,"Accumulated Depreciation",3750.00,"",3233959.57
,"General Journal","17-05-2024","23570","*",,"Soap Dispenser 1 Depreciation","Expense","Depreciation Expense",,"Accumulated Depreciation",15.39,"",3233974.96
,"General Journal","17-05-2024","23571","*",,"TP Link 3 Depreciation","Expense","Depreciation Expense",,"Accumulated Depreciation",33.33,"",3234008.29
,"General Journal","17-05-2024","23572","*",,"Water Tank 3 Depreciation","Expense","Depreciation Expense",,"Accumulated Depreciation",123.15,"",3234131.44
,"General Journal","18-05-2024","23590",,,"Carton Sealer Manual 1 Depreciation","Expense","Depreciation Expense",,"Accumulated Depreciation",14.80,"",3234146.24
,"General Journal","18-05-2024","23592",,,"Compressor 3 Depreciation","Expense","Depreciation Expense",,"Accumulated Depreciation",5357.14,"",3239503.38
,"General Journal","18-05-2024","23593",,,"Compressor room depreciation","Expense","Depreciation Expense",,"Accumulated depreciation",132.44,"",3239635.82
,"General Journal","18-05-2024","23595",,,"Electric Hoist 1 depreciation","Expense","Depreciation Expense",,"Accumulated depreciation",3452.38,"",3243088.20
,"General Journal","18-05-2024","23600",,,"Gents changing room Lockers Depreciation","Expense","Depreciation Expense",,"Accumulated Depreciation",386.90,"",3243475.10
,"General Journal","18-05-2024","23602",,,"HP Mini Desktop 1 Depreciation","Expense","Depreciation Expense",,"Accumulated Depreciation",733.33,"",3244208.43
,"General Journal","18-05-2024","23603",,,"HP Mini Desktop 2 Depreciation","Expense","Depreciation Expense",,"Accumulated Depreciation",733.33,"",3244941.76
,"General Journal","18-05-2024","23604",,,"HP Mini Desktop 3 Depreciation","Expense","Depreciation Expense",,"Accumulated Depreciation",733.33,"",3245675.09
,"General Journal","18-05-2024","23605",,,"Ladies changing room Lockers Depreciation","Expense","Depreciation Expense",,"Accumulated Depreciation",411.90,"",3246086.99
,"General Journal","18-05-2024","23607",,,"Omrom M1 Basic BP Monitor Depreciation","Expense","Depreciation Expense",,"Accumulated Depreciation",58.33,"",3246145.32
,"General Journal","18-05-2024","23609",,,"SS Hand Washing Station 1 Depreciation","Expense","Depreciation Expense",,"Accumulated Depreciation",690.48,"",3246835.80
,"General Journal","18-05-2024","23610",,,"TP Link 2 Depreciation","Expense","Depreciation Expense",,"Accumulated Depreciation",41.67,"",3246877.47
,"General Journal","18-05-2024","23611",,,"TV Screen 3 Depreciation","Expense","Depreciation Expense",,"Accumulated Depreciation",316.67,"",3247194.14
,"General Journal","18-05-2024","23612",,,"TV Screen 4 Depreciation","Expense","Depreciation Expense",,"Accumulated Depreciation",1550.00,"",3248744.14
,"General Journal","19-05-2024","23585",,,"3T Gas Forklift 1 Depreciation","Expense","Depreciation Expense",,"Accumulated Depreciation",30952.38,"",3279696.52
,"General Journal","19-05-2024","23591",,,"Coding Stamp 3 Depreciation","Expense","Depreciation Expense",,"Accumulated Depreciation",143.68,"",3279840.20
,"General Journal","19-05-2024","25194",,,"Office Stamp 2 Depreciation","Expense","Depreciation Expense",,"Accumulated Depreciaion",30.83,"",3279871.03
,"General Journal","20-05-2024","23586","*","Unilever Kenya Ltd:Sunlight Washing Pwd","Boato Commisioning Depreciation","Expense","Depreciation Expense",,"Accumulated Depreciation",889.88,"",3280760.91
,"General Journal","20-05-2024","23587",,,"Bosch Blower 3 Depreciation","Expense","Depreciation Expense",,"Accumulated Depreciation",79.02,"",3280839.93
,"General Journal","20-05-2024","23588",,,"Bosch Blower 4 Depreciation","Expense","Depreciation Expense",,"Accumulated Depreciation",136.49,"",3280976.42
,"General Journal","20-05-2024","23589",,,"Bosch Blower 5 Depreciation","Expense","Depreciation Expense",,"Accumulated Depreciation",136.49,"",3281112.91
,"General Journal","20-05-2024","23594",,,"Conference Office Desk 1 Depreciation","Expense","Depreciation Expense",,"Accumulated Depreciation",416.67,"",3281529.58
,"General Journal","20-05-2024","23596",,,"Floor Chair 17 depreciation","Expense","Depreciation Expense",,"Accumulated Depreciation",20.24,"",3281549.82
,"General Journal","20-05-2024","23597",,,"Floor Chair 18 depreciation","Expense","Depreciation Expense",,"Accumulated Depreciation",20.24,"",3281570.06
,"General Journal","20-05-2024","23598",,,"Floor Chair 19 depreciation","Expense","Depreciation Expense",,"Accumulated Depreciation",20.24,"",3281590.30
,"General Journal","20-05-2024","23599",,,"Floor Chair 20 depreciation","Expense","Depreciation Expense",,"Accumulated Depreciation",20.24,"",3281610.54
,"General Journal","20-05-2024","23601",,,"Heat Gun CAT Digital 1 Depreciation","Expense","Depreciation Expense",,"Accumulated Depreciation",136.49,"",3281747.03
,"General Journal","20-05-2024","23606","*",,"Lumnia 1 Pro Insect Trap Depreciation","Expense","Depreciation Expense",,"Accumulated Depreciation",316.67,"",3282063.70
,"General Journal","20-05-2024","23608",,,"PF Correction Unit Depreciation","Expense","Depreciation Expense",,"Accumulated Depreciation",1708.33,"",3283772.03
,"General Journal","21-05-2024","23615",,,"5Kg CO2 Fire Extinguisher 2 Depreciation","Expense","Depreciation Expense",,"Accumulated Depreciation",73.81,"",3283845.84
,"General Journal","21-05-2024","23616",,,"6Kg Dry Pwd Fire Extinguisher 1 Depreciaiton","Expense","Depreciation Expense",,"Accumulated Depreciation",59.52,"",3283905.36
,"General Journal","21-05-2024","23617",,,"Board room chair 1 Depreciation","Expense","Depreciation Expense",,"Accumulated Depreciation",59.52,"",3283964.88
,"General Journal","21-05-2024","23618",,,"Board room chair 2 Depreciation","Expense","Depreciation Expense",,"Accumulated Depreciation",59.52,"",3284024.40
,"General Journal","21-05-2024","23619",,,"Board room chair 4 Depreciation","Expense","Depreciation Expense",,"Accumulated Depreciation",59.52,"",3284083.92
,"General Journal","21-05-2024","23620",,,"Board room chair 5 Depreciation","Expense","Depreciation Expense",,"Accumulated Depreciation",59.52,"",3284143.44
,"General Journal","21-05-2024","23621",,,"Board room chair 6 Depreciation","Expense","Depreciation Expense",,"Accumulated Depreciation",59.52,"",3284202.96
,"General Journal","21-05-2024","23622",,,"Board room chair 7 Depreciation","Expense","Depreciation Expense",,"Accumulated Depreciation",59.52,"",3284262.48
,"General Journal","21-05-2024","23623",,,"Board room chair 8 Depreciation","Expense","Depreciation Expense",,"Accumulated Depreciation",59.52,"",3284322.00
,"General Journal","21-05-2024","23624",,,"Coding Stamp 2 Depreciation","Expense","Depreciation Expense",,"Accumulated Depreciation",133.33,"",3284455.33
,"General Journal","21-05-2024","23625",,,"IBC Tank 1 Depreciation","Expense","Depreciation Expense",,"Accumulated Depreciation",41.67,"",3284497.00
,"General Journal","21-05-2024","23626",,,"Empty IBC Tank 2 Depreciation","Expense","Depreciation Expense",,"Accumulated Depreciation",65.48,"",3284562.48
,"General Journal","21-05-2024","23627",,,"FFS Filling Machine 300 1 Depreciation","Expense","Depreciation Expense",,"Accumulated Depreciation",11850.01,"",3296412.49
,"General Journal","21-05-2024","23628",,,"Laboratory Oven & Dessicator  Depreciation","Expense","Depreciation Expense",,"Accumulated Depreciation",766.67,"",3297179.16
,"General Journal","21-05-2024","23629",,,"Nikon D3500 Camera 1 Depreciation","Expense","Depreciation Expense",,"Accumulated Depreciation",766.67,"",3297945.83
,"General Journal","21-05-2024","23630",,,"Tea Urn Depreciation","Expense","Depreciation Expense",,"Accumulated Depreciation",121.67,"",3298067.50
,"General Journal","22-05-2024","23637",,,"6Kg Auto Fire Extinguisher 1 Depreciation","Expense","Depreciation Expense",,"Accumulated Depreciation",53.57,"",3298121.07
,"General Journal","22-05-2024","23638",,,"6Kg Auto Fire Extinguisher 2 Depreciation","Expense","Depreciation Expense",,"Accumulated Depreciation",53.57,"",3298174.64
,"General Journal","22-05-2024","23639","*",,"AVS Voltage Stabilizer Depreciation","Expense","Depreciation Expense",,"Accumulated Depreciation",63.10,"",3298237.74
,"General Journal","22-05-2024","23640",,,"Conveyor Belt Green 1 Depreciation","Expense","Depreciation Expense",,"Accumulated Depreciation",82.14,"",3298319.88
,"General Journal","22-05-2024","23641",,,"HP Laptop 13 Depreciation","Expense","Depreciation Expense",,"Accumulated Depreciation",1200.00,"",3299519.88
,"General Journal","22-05-2024","23642","*",,"HP Laptop 7 Depreciation","Expense","Depreciation Expense",,"Accumulated Depreciation",1200.00,"",3300719.88
,"General Journal","22-05-2024","23643",,,"Office Desk 5 Depreciation","Expense","Depreciation Expense",,"Accumulated Depreciation",180.95,"",3300900.83
,"General Journal","22-05-2024","23644",,,"Office cabinets depreciation","Expense","Depreciation Expense",,"Accumulated Depreciation",119.05,"",3301019.88
,"General Journal","22-05-2024","23645",,,"Platform Scale 2 SS 100Kg Depreciation","Expense","Depreciation Expense",,"Accumulated Depreciation",339.29,"",3301359.17
,"General Journal","22-05-2024","23646",,,"Solar Water Heater 300L Depreciation","Expense","Depreciation Expense",,"Accumulated Depreciation",3125.00,"",3304484.17
,"General Journal","23-05-2024","23648",,,"Analytical Balance Depreciation","Expense","Depreciation Expense",,"Accumulated Depreciation",2405.58,"",3306889.75
,"General Journal","23-05-2024","23649",,,"Auger Filler 1 Depreciation","Expense","Depreciation Expense",,"Accumulated Depreciation",7220.12,"",3314109.87
,"General Journal","23-05-2024","23650",,,"Auger Filler 2 Depreciation","Expense","Depreciation Expense",,"Accumulated Depreciation",13258.63,"",3327368.50
,"General Journal","23-05-2024","23651",,,"Auger Filler 3 Depreciation","Expense","Depreciation Expense",,"Accumulated Depreciation",11788.69,"",3339157.19
,"General Journal","23-05-2024","23652",,,"Bajaj Boxer BM150 UG Depreciation","Expense","Depreciation Expense",,"Accumulated Depreciation",1539.41,"",3340696.60
,"General Journal","23-05-2024","23653",,,"Chain block 4 depreciation","Expense","Depreciation Expense",,"Accumulated Depreciation",133.42,"",3340830.02
,"General Journal","23-05-2024","23654",,,"Coder UPS Depreciation","Expense","Depreciation Expense",,"Accumulated Depreciation",95.24,"",3340925.26
,"General Journal","23-05-2024","23655",,,"Dust Extractor 1 Depreciation","Expense","Depreciation Expense",,"Accumulated Depreciation",446.43,"",3341371.69
,"General Journal","23-05-2024","23656",,,"Dust Extractor 2 Depreciation","Expense","Depreciation Expense",,"Accumulated Depreciation",446.43,"",3341818.12
,"General Journal","23-05-2024","23657",,,"Filler 1 Geared Motor & Feeding System Depreciation","Expense","Depreciation Expense",,"Accumulated Depreciation",333.33,"",3342151.45
,"General Journal","23-05-2024","23658",,,"Filler 2 Geared Motor & Feeding System Depreciation","Expense","Depreciation Expense",,"Accumulated Depreciation",348.72,"",3342500.17
,"General Journal","23-05-2024","23659",,,"Filler 3 Geared Motor & Feeding System Depreciation","Expense","Depreciation Expense",,"Accumulated Depreciation",347.52,"",3342847.69
,"General Journal","23-05-2024","23660",,,"Hotplate with Stirrer Depreciation","Expense","Depreciation Expense",,"Accumulated Depreciation",1785.71,"",3344633.40
,"General Journal","23-05-2024","23661",,,"Makita Hammer Drill Depreciation","Expense","Depreciation Expense",,"Accumulated Depreciation",205.25,"",3344838.65
,"General Journal","23-05-2024","23662",,,"Microwave 1 Depreciation","Expense","Depreciation Expense",,"Accumulated Depreciation",217.13,"",3345055.78
,"General Journal","23-05-2024","23663",,,"Pallet truck 3 Dep","Expense","Depreciation Expense",,"Accumulated Depreciation",510.95,"",3345566.73
,"General Journal","23-05-2024","23664",,,"Pouching Machine Depreciation","Expense","Depreciation Expense",,"Accumulated Depreciation",711.90,"",3346278.63
,"General Journal","23-05-2024","23665",,,"Power bank dep","Expense","Depreciation Expense",,"Accumulated Depreciation",119.05,"",3346397.68
,"General Journal","23-05-2024","23666",,,"Table Top Scale 11  SS 30Kg Depreciation","Expense","Depreciation Expense",,"Accumulated Depreciation",297.62,"",3346695.30
,"General Journal","23-05-2024","23667",,,"Table Top Scale 12  SS 30Kg Depreciation","Expense","Depreciation Expense",,"Accumulated Depreciation",297.62,"",3346992.92
,"General Journal","24-05-2024","23669",,,"Access Control Unit & System Depreciation","Expense","Depreciation Expense",,"Accumulated Depreciation",334.76,"",3347327.68
,"General Journal","24-05-2024","23670",,,"Electrical Enclosure Compressor Depreciation","Expense","Depreciation Expense",,"Accumulated Depreciation",125.00,"",3347452.68
,"General Journal","24-05-2024","23671",,,"ETR Machine Depreciation","Expense","Depreciation Expense",,"Accumulated Depreciation",236.04,"",3347688.72
,"General Journal","24-05-2024","23672",,,"Liquid Plant Depreciation","Expense","Depreciation Expense",,"Accumulated Deprecation",15029.76,"",3362718.48
,"General Journal","24-05-2024","23673",,,"Paste processing & packing line depreciation","Expense","Depreciation Expense",,"Accumulated Depreciation",17348.21,"",3380066.69
,"General Journal","24-05-2024","23674",,,"pH Meter Depreciation","Expense","Depreciation Expense",,"Accumulated Depreciation",741.39,"",3380808.08
,"General Journal","25-05-2024","23687",,,"Clamp Meter 1 Depreciation","Expense","Depreciation Expense",,"Accumulated Depreciation",36.90,"",3380844.98
,"General Journal","25-05-2024","23691",,,"Fire Alarm Sytstem Depreciation","Expense","Depreciation Expense",,"Accumulated Depreciation",728.57,"",3381573.55
,"General Journal","25-05-2024","23692",,,"Floor Chair 11 Depreciation","Expense","Depreciation Expense",,"Accumulated Depreciation",53.57,"",3381627.12
,"General Journal","25-05-2024","23693",,,"Floor Chair 12 Depreciation","Expense","Depreciation Expense",,"Accumulated Depreciation",53.57,"",3381680.69
,"General Journal","25-05-2024","23694",,,"Floor Chair 13 Depreciation","Expense","Depreciation Expense",,"Accumulated Depreciation",53.57,"",3381734.26
,"General Journal","25-05-2024","23695",,,"Floor Chair 14 Depreciation","Expense","Depreciation Expense",,"Accumulated Depreciation",53.57,"",3381787.83
,"General Journal","25-05-2024","23696",,,"Floor Chair 15 Depreciation","Expense","Depreciation Expense",,"Accumulated Depreciation",53.57,"",3381841.40
,"General Journal","25-05-2024","23697",,,"Floor Chair 16 Depreciation","Expense","Depreciation Expense",,"Accumulated Depreciation",53.57,"",3381894.97
,"General Journal","25-05-2024","23700",,,"Liquid Mixer 500Lt Depreciation","Expense","Depreciation Expense",,"Accumulated Depreciation",6172.62,"",3388067.59
,"General Journal","25-05-2024","23702",,,"Plastic Resin Mixer Depreciation","Expense","Depreciation Expense",,"Accumulated  Depreciation",1130.95,"",3389198.54
,"General Journal","25-05-2024","23703",,,"Plastic Resin Mixer Depreciation","Expense","Depreciation Expense",,"Accumulated  Depreciation",1130.95,"",3390329.49
,"General Journal","25-05-2024","25187",,,"Water tank 7 Depreciation","Expense","Depreciation Expense",,"Accumulated Depreciation",71.84,"",3390401.33
,"General Journal","26-05-2024","23688",,,"Dell Desktop 2 Depreciation","Expense","Depreciation Expense",,"Accumulated Depreciation",229.17,"",3390630.50
,"General Journal","26-05-2024","23689",,,"Dell Desktop 3 Depreciation","Expense","Depreciation Expense",,"Accumulated Depreciation",229.17,"",3390859.67
,"General Journal","26-05-2024","23690",,,"Dell Desktop 4 Depreciation","Expense","Depreciation Expense",,"Accumulated Depreciation",229.17,"",3391088.84
,"General Journal","26-05-2024","23698",,,"Grease Gun 1 Depreciation","Expense","Depreciation Expense",,"Accumulated Depreciation",73.21,"",3391162.05
,"General Journal","26-05-2024","23699",,,"Grease Gun 2 Depreciation","Expense","Depreciation Expense",,"Accumulated Depreciation",63.14,"",3391225.19
,"General Journal","26-05-2024","23704",,,"Retort Stand 1 Depreciation","Expense","Depreciation Expense",,"Accumulated Depreciation",10.71,"",3391235.90
,"General Journal","26-05-2024","23705",,,"Retort Stand 2 Depreciation","Expense","Depreciation Expense",,"Accumulated Depreciation",10.71,"",3391246.61
,"General Journal","27-05-2024","23675",,,"Board room chair 10 Depreciation","Expense","Depreciation Expense",,"Accumulated Depreciation",79.55,"",3391326.16
,"General Journal","27-05-2024","23676",,,"Board room chair 11 Depreciation","Expense","Depreciation Expense",,"Accumulated Depreciation",79.55,"",3391405.71
,"General Journal","27-05-2024","23677",,,"Board room chair 12 Depreciation","Expense","Depreciation Expense",,"Accumulated Depreciation",79.55,"",3391485.26
,"General Journal","27-05-2024","23678",,,"Board room chair 13 Depreciation","Expense","Depreciation Expense",,"Accumulated Depreciation",79.55,"",3391564.81
,"General Journal","27-05-2024","23679",,,"Board room chair 14 Depreciation","Expense","Depreciation Expense",,"Accumulated Depreciation",79.55,"",3391644.36
,"General Journal","27-05-2024","23680",,,"Board room chair 15 Depreciation","Expense","Depreciation Expense",,"Accumulated Depreciation",79.55,"",3391723.91
,"General Journal","27-05-2024","23681",,,"Board room chair 16 Depreciation","Expense","Depreciation Expense",,"Accumulated Depreciation",79.55,"",3391803.46
,"General Journal","27-05-2024","23682",,,"Board room chair 17 Depreciation","Expense","Depreciation Expense",,"Accumulated Depreciation",79.55,"",3391883.01
,"General Journal","27-05-2024","23683",,,"Board room chair 18 Depreciation","Expense","Depreciation Expense",,"Accumulated Depreciation",79.55,"",3391962.56
,"General Journal","27-05-2024","23684",,,"Board room chair 19 Depreciation","Expense","Depreciation Expense",,"Accumulated Depreciation",79.55,"",3392042.11
,"General Journal","27-05-2024","23685",,,"Board room chair 9 Depreciation","Expense","Depreciation Expense",,"Accumulated Depreciation",79.55,"",3392121.66
,"General Journal","27-05-2024","23686",,,"Canvas Stretcher Depreciation","Expense","Depreciation Expense",,"Accumulated Depreciation",133.33,"",3392254.99
,"General Journal","27-05-2024","23701",,,"Passenger Lift 1000kg Depreciation","Expense","Depreciation Expense",,"Accumulated Depreciation",44484.68,"",3436739.67
,"General Journal","28-05-2024","25163",,,"Heat Gun Bosch 2 Accumulated depreciation","Expense","Depreciation Expense",,"Accumulated Depreciation",75.43,"",3436815.10
,"General Journal","28-05-2024","25169",,,"Heat Gun Bosch 3 Accumulated depreciation","Expense","Depreciation Expense",,"Accumulated Depreciation",75.43,"",3436890.53
,"General Journal","31-05-2024","23706",,,"500gm Jar Blow Mould 3 depreciation","Expense","Depreciation Expense",,"Accumulated Depreciation",1026.79,"",3437917.32
,"General Journal","31-05-2024","23707",,,"500gm Jar Blow Mould 4 depreciation","Expense","Depreciation Expense",,"Accumulated Depreciation",1026.79,"",3438944.11
,"General Journal","31-05-2024","23708",,,"Air cooled chiller depeciation","Expense","Depreciation Expense",,"Accumulated  Depreciation",8916.67,"",3447860.78
,"General Journal","31-05-2024","23709","*","Unilever Kenya Ltd:Sunlight Washing Pwd","Boato Installation Depreciation","Expense","Depreciation Expense",,"Accumulated Depreciation",65114.38,"",3512975.16
,"General Journal","31-05-2024","23710","*",,"Canister Platform Depreciation","Expense","Depreciation Expense",,"Accumulated Depreciation",59246.67,"",3572221.83
,"General Journal","31-05-2024","23711",,,"CCTV DRV & System Depreciation","Expense","Depreciation Expense",,"Accumulated Depreciation",1295.33,"",3573517.16
,"General Journal","31-05-2024","23712",,,"Colour Pressure tank Depreciation","Expense","Depreciation Expense",,"Accumulated Depreciation",232.14,"",3573749.30
,"General Journal","31-05-2024","23713",,,"Compressed air gun Depreciation","Expense","Depreciation Expense",,"Accumulated Depreciation",47.62,"",3573796.92
,"General Journal","31-05-2024","23714",,,"Drum Pump 2 Depreciation","Expense","Depreciation Expense",,"Accumulated Depreciation",123.15,"",3573920.07
,"General Journal","31-05-2024","23715",,,"Extractor Fan down Depreciation","Expense","Depreciation Expense",,"Accumulated Depreciation",150.12,"",3574070.19
,"General Journal","31-05-2024","23716",,,"Extractor Fan Hoisting Depreciation","Expense","Depreciation Expense",,"Accumulated Depreciation",176.67,"",3574246.86
,"General Journal","31-05-2024","23717",,,"Extractor Fan Packaging Depreciation","Expense","Depreciation Expense",,"Accumulated Depreciation",150.12,"",3574396.98
,"General Journal","31-05-2024","23718",,,"Incotex Type C Control Unit Depreciation","Expense","Depreciation Expense",,"Accumulated Depreciation",1939.66,"",3576336.64
,"General Journal","31-05-2024","23719",,,"Lamination Machine 1 Depreciation","Expense","Depreciation Expense",,"Accumulated Depreciation",84.78,"",3576421.42
,"General Journal","31-05-2024","23720",,,"Office Cabinet 5 Depreciation","Expense","Depreciation Expense",,"Accumulated Depreciation",58.33,"",3576479.75
,"General Journal","31-05-2024","23721",,,"Office Desk 6 Depreciation","Expense","Depreciation Expense",,"Accumulated Depreciation",90.48,"",3576570.23
,"General Journal","31-05-2024","23722",,,"Office Desk 7 Depreciation","Expense","Depreciation Expense",,"Accumulated Depreciation",90.48,"",3576660.71
,"General Journal","31-05-2024","23723",,,"Office Desk 8 Depreciation","Expense","Depreciation Expense",,"Accumulated Depreciation",83.33,"",3576744.04
,"General Journal","31-05-2024","23724",,,"Platform Scale 4 tons 1 Depreciation","Expense","Depreciation Expense",,"Accumulated Depreciation",10782.43,"",3587526.47
,"General Journal","31-05-2024","23725",,,"Process Water Filtration System Depreciation","Expense","Depreciation Expense",,"Accumulated Depreciation",1785.71,"",3589312.18
,"General Journal","31-05-2024","23726",,,"Sulphonic Acid pressure tank Depreciation","Expense","Depreciation Expense",,"Accumulated Depreciation",110.48,"",3589422.66
,"General Journal","31-05-2024","23727",,,"Test Sieves 100 & 200 microns Depreciation","Expense","Depreciation Expense",,"Accumulated Depreciation",450.00,"",3589872.66
,"General Journal","31-05-2024","23728",,,"Wall mounted cabinet 1 Dep","Expense","Depreciation Expense",,"Accumulated Depreciation",107.14,"",3589979.80
,"General Journal","31-05-2024","23729",,,"Water tank 5 Depreciation","Expense","Depreciation Expense",,"Accumulated Depreciation",137.79,"",3590117.59
,"General Journal","01-06-2024","23747",,,"Hoisting Bucket 1 Depreciation","Expense","Depreciation Expense",,"Accumulated Depreciation",148.81,"",3590266.40
,"General Journal","01-06-2024","23748",,,"Hoisting Bucket 2 Dereciation","Expense","Depreciation Expense",,"Accumulated Depreciation",148.81,"",3590415.21
,"General Journal","01-06-2024","23752",,,"Lenovo Laptop 2 Depreciation","Expense","Depreciation Expense",,"Accumulated Depreciation",333.33,"",3590748.54
,"General Journal","01-06-2024","23756",,,"Processing Platform Depreciation","Expense","Depreciation Expense",,"Accumulated Depreciation",4880.95,"",3595629.49
,"General Journal","01-06-2024","23757",,,"Security and Computer Sytem UPS Depreciation","Expense","Depreciation Expense",,"Accumulated Depreciation",3584.50,"",3599213.99
,"General Journal","01-06-2024","23768",,,"Trophy Shelf 1 Depreciation","Expense","Depreciation Expense",,"Accumulated Depreciation",95.24,"",3599309.23
,"General Journal","01-06-2024","23770",,,"Water tank 4 Depreciation","Expense","Depreciation Expense",,"Accumulated Depreciation",453.24,"",3599762.47
,"General Journal","02-06-2024","23735",,,"CMPP 1kg Jar Blow Mould 1 Depreciation","Expense","Depreciation Expense",,"Accumulated Depreciation",3364.87,"",3603127.34
,"General Journal","02-06-2024","23736",,,"CMPP 1kg Jar Blow Mould 2 Depreciation","Expense","Depreciation Expense",,"Accumulated Depreciation",3364.87,"",3606492.21
,"General Journal","02-06-2024","23737",,,"CMPP 500gm Jar Blow Mould 1 Depreciation","Expense","Depreciation Expense",,"Accumulated Depreciation",2643.82,"",3609136.03
,"General Journal","02-06-2024","23738",,,"CMPP 500gm Jar Blow Mould 2 Depreciation","Expense","Depreciation Expense",,"Accumulated Depreciation",2643.82,"",3611779.85
,"General Journal","02-06-2024","23739",,,"CMPP Blow Moulding Machine 1 Depreciation","Expense","Depreciation Expense",,"Accumulated Depreciation",49344.71,"",3661124.56
,"General Journal","02-06-2024","23740",,,"CMPP Blow Moulding Machine 2 Depreciation","Expense","Depreciation Expense",,"Accumulated Depreciation",49344.71,"",3710469.27
,"General Journal","02-06-2024","23741",,,"Drum Pump 1 Depreiation","Expense","Depreciation Expense",,"Accumulated Depreciation",123.03,"",3710592.30
,"General Journal","02-06-2024","23746",,,"Heat Gun Bosch 1 Depreciation","Expense","Depreciation Expense",,"Accumulated Depreciation",100.57,"",3710692.87
,"General Journal","02-06-2024","23749",,,"Hot ProcessWater Storage Tank1  Depreciation","Expense","Depreciation Expense",,"Accumulated Depreciation",73.99,"",3710766.86
,"General Journal","02-06-2024","23750","*",,"HP Laptop 4 Depreciation","Expense","Depreciation Expense",,"Accumulated Depreciation",297.62,"",3711064.48
,"General Journal","02-06-2024","23751","*",,"HP Laptop 8 Depreciation","Expense","Depreciation Expense",,"Accumulated Depreciation",1200.00,"",3712264.48
,"General Journal","02-06-2024","23760",,,"Store Racking 1 depreciation","Expense","Depreciation Expense",,"Accumulated Depreciation",175.60,"",3712440.08
,"General Journal","02-06-2024","23761",,,"Store Racking 2 Depreciation","Expense","Depreciation Expense",,"Accumulated Depreciation",175.60,"",3712615.68
,"General Journal","02-06-2024","23767",,,"Tank platform Depreciation","Expense","Depreciation Expense",,"Accumulated Depreciation",130.95,"",3712746.63
,"General Journal","02-06-2024","23769",,,"Water tank 1 Depreciation","Expense","Depreciation Expense",,"Accumulated Depreciation",120.07,"",3712866.70
,"General Journal","02-06-2024","23771",,,"Workshop cabinet depreciation","Expense","Depreciation Expense",,"Accumulated Depreciation",172.02,"",3713038.72
,"General Journal","03-06-2024","23730",,,"Alarm System extension","Expense","Depreciation Expense",,"Accumulated Depreciation",602.38,"",3713641.10
,"General Journal","03-06-2024","23731",,,"Domestos sewing machine depreciation","Expense","Depreciation Expense",,"Acummulated depreciation",82.10,"",3713723.20
,"General Journal","03-06-2024","23732",,,"Bench Grinder 2 Depreciation","Expense","Depreciation Expense",,"Accumulated Depreceiation",100.57,"",3713823.77
,"General Journal","03-06-2024","23733",,,"Board room chair 3 Depreciation","Expense","Depreciation Expense",,"Accumulated Depreciation",59.52,"",3713883.29
,"General Journal","03-06-2024","23734",,,"CCTV survellance System extension Depreciation","Expense","Depreciation Expense",,"Accumulated Depreciation",657.14,"",3714540.43
,"General Journal","03-06-2024","23742",,,"Electrical Enclosure CCTV Depreciation","Expense","Depreciation Expense",,"Accumulated Depreciation",126.19,"",3714666.62
,"General Journal","03-06-2024","23743",,,"Electrical Enclosure Main Depreciation","Expense","Depreciation Expense",,"Accumulated Depreciation",2339.29,"",3717005.91
,"General Journal","03-06-2024","23744",,,"Electrical Enclosure P Line Depreciation","Expense","Depreciation Expense",,"Accumulated Depreciation",428.57,"",3717434.48
,"General Journal","03-06-2024","23745",,,"Floodlight Depreciation","Expense","Depreciation Expense",,"Accumulated Depreciation",59.52,"",3717494.00
,"General Journal","03-06-2024","23753",,,"Office Desk 1 Depreciation","Expense","Depreciation Expense",,"Accumulated Depreciation",225.00,"",3717719.00
,"General Journal","03-06-2024","23754",,,"Office Desk 2 Depreciation","Expense","Depreciation Expense",,"Accumulated Depreciation",225.00,"",3717944.00
,"General Journal","03-06-2024","23755",,,"Office Desk 3 Depreciation","Expense","Depreciation Expense",,"Accumulated Depreciation",225.00,"",3718169.00
,"General Journal","03-06-2024","23758",,,"Signet ESD 1 Depreciation","Expense","Depreciation Expense",,"Accumulated Depreciation",928.57,"",3719097.57
,"General Journal","03-06-2024","23759","*",,"Sterling Water Dispenser 1 Depreciation","Expense","Depreciation Expense",,"Accumulated Depreciation",119.05,"",3719216.62
,"General Journal","03-06-2024","23762",,,"Table top Weighing Scale 5 Depreciation","Expense","Depreciation Expense",,"Accumulated Depreciation",248.57,"",3719465.19
,"General Journal","03-06-2024","23763",,,"Table top Weighing Scale 6 Depreciation","Expense","Depreciation Expense",,"Accumulated Depreciation",248.57,"",3719713.76
,"General Journal","03-06-2024","23764",,,"Table top Weighing Scale 7 Depreciation","Expense","Depreciation Expense",,"Accumulated Depreciation",248.57,"",3719962.33
,"General Journal","03-06-2024","23765",,,"Table top Weighing Scale 8 Depreciation","Expense","Depreciation Expense",,"Accumulated Depreciation",248.57,"",3720210.90
,"General Journal","03-06-2024","23766",,,"Table top Weighing Scale 9 Depreciation","Expense","Depreciation Expense",,"Accumulated Depreciation",248.57,"",3720459.47
,"General Journal","04-06-2024","23787",,,"9Kg Powder Fire Extinguisher 1 Depreciation","Expense","Depreciation Expense",,"Accumulated Depreciation",34.52,"",3720493.99
,"General Journal","04-06-2024","23788",,,"9Kg Powder Fire Extinguisher 2 Depreciation","Expense","Depreciation Expense",,"Accumulated Depreciation",34.52,"",3720528.51
,"General Journal","04-06-2024","23789",,,"9Kg Powder Fire Extinguisher 3 Depreciation","Expense","Depreciation Expense",,"Accumulated Depreciation",34.52,"",3720563.03
,"General Journal","04-06-2024","23790",,,"9Kg Powder Fire Extinguisher 5 Depreciation","Expense","Depreciation Expense",,"Accumulated Depreciation",34.52,"",3720597.55
,"General Journal","04-06-2024","23791",,,"Canteen Chair 20 Depreciation","Expense","Depreciation Expense",,"Accumulated Depreciation",6.12,"",3720603.67
,"General Journal","04-06-2024","23792",,,"Chiller 2 Depreciation","Expense","Depreciation Expense",,"Accumulated Depreciation",8035.71,"",3728639.38
,"General Journal","04-06-2024","23793",,,"Empty IBC Tank 10 Depreciation","Expense","Depreciation Expense",,"Accumulated Depreciation",41.67,"",3728681.05
,"General Journal","04-06-2024","23794",,,"Empty IBC Tank 3 Depreciation","Expense","Depreciation Expense",,"Accumulated Depreciation",65.48,"",3728746.53
,"General Journal","04-06-2024","23795",,,"Empty IBC Tank 4 Depreciation","Expense","Depreciation Expense",,"Accumulated Depreciation",65.48,"",3728812.01
,"General Journal","04-06-2024","23796",,,"Empty IBC Tank 5 Depreciation","Expense","Depreciation Expense",,"Accumulated Depreciation",65.48,"",3728877.49
,"General Journal","04-06-2024","23797",,,"Empty IBC Tank 6 Depreciation","Expense","Depreciation Expense",,"Accumulated Depreciation",65.48,"",3728942.97
,"General Journal","04-06-2024","23798",,,"Empty IBC Tank 7 Depreciation","Expense","Depreciation Expense",,"Accumulated Depreciation",41.67,"",3728984.64
,"General Journal","04-06-2024","23799",,,"Empty IBC Tank 8 Depreciation","Expense","Depreciation Expense",,"Accumulated Depreiation",41.67,"",3729026.31
,"General Journal","04-06-2024","23800",,,"Empty IBC Tank 9 Depreciation","Expense","Depreciation Expense",,"Accumulated Depreciation",41.67,"",3729067.98
,"General Journal","04-06-2024","23801",,,"Linx 8900 Coder 1 Depreciation","Expense","Depreciation Expense",,"Accumulated Depreciation",8333.33,"",3737401.31
,"General Journal","04-06-2024","23802",,,"Mobile Phone 2 Depreciation","Expense","Depreciation Expense",,"Accumulated Depreciation",46.67,"",3737447.98
,"General Journal","04-06-2024","23803",,,"Triple UV water purifier 1 Depreciation","Expense","Depreciation Expense",,"Accumulated Depreciation",296.22,"",3737744.20
,"General Journal","05-06-2024","23804",,,"1Kg Generic Jar Blow Mould 1 depreciation","Expense","Depreciation Expense",,"Accumulated Depreciation",1500.00,"",3739244.20
,"General Journal","05-06-2024","23805",,,"1Kg Generic Jar Blow Mould 2 depreciation","Expense","Depreciation Expense",,"Accumulated Depreciation",1500.00,"",3740744.20
,"General Journal","05-06-2024","23806",,,"500gm Generic Jar Blow Mould 1 depreciation","Expense","Depreciation Expense",,"Accumulated Depreciation",1071.43,"",3741815.63
,"General Journal","05-06-2024","23807",,,"500gm Generic Jar Blow Mould 2 depreciation","Expense","Depreciation Expense",,"Accumulated Depreciation",1071.43,"",3742887.06
,"General Journal","05-06-2024","23808",,,"9Kg Powder Fire Extinguisher 4 Depreciation","Expense","Depreciation Expense",,"Accumulated Depreciation",34.52,"",3742921.58
,"General Journal","05-06-2024","23809",,,"Extractor Fan 4 Depreciation","Expense","Depreciation Expense",,"Accumulated Depreciation",726.19,"",3743647.77
,"General Journal","05-06-2024","23810",,,"FFS  Machine Installation Elct Depreciation","Expense","Depreciation Expense",,"Accumulated Depreciation",200.60,"",3743848.37
,"General Journal","05-06-2024","23811",,,"First Aid Kit Depreciation","Expense","Depreciation Expense",,"Accumulated  Depreciation",77.38,"",3743925.75
,"General Journal","05-06-2024","23812",,,"Linx 8900 Coder 2 Depreciation","Expense","Depreciation Expense",,"Accumulated Depreciation",12500.00,"",3756425.75
,"General Journal","05-06-2024","23813",,,"Packing Platform Depreciation","Expense","Depreciation Expense",,"Accumulated Depreciation",5297.62,"",3761723.37
,"General Journal","05-06-2024","23814",,,"SS Industrial Turntable Depreciation","Expense","Depreciation Expense",,"Accumulated Depreciation",5238.10,"",3766961.47
,"General Journal","05-06-2024","23815",,,"TV Screen 2 Depreciation","Expense","Depreciation Expense",,"Accumulated Depreciation",950.00,"",3767911.47
,"General Journal","05-06-2024","23816",,,"Water Purifier 1 Depreciation","Expense","Depreciation Expense",,"Accumulated Depreciation",117.10,"",3768028.57
,"General Journal","06-06-2024","23818",,,"Blower Depreciation","Expense","Depreciation Expense",,"Accumulated Depreciation",59.52,"",3768088.09
,"General Journal","06-06-2024","23819",,,"Emergency Washing Point Depreciation","Expense","Depreciation Expense",,"Accumulated Deprecation",160.71,"",3768248.80
,"General Journal","06-06-2024","23820","*",,"Infrared Thermometre 1 Depreciation","Expense","Depreciation Expense",,"Accumulated Depreciation",416.67,"",3768665.47
,"General Journal","06-06-2024","23821",,,"Material's Trolley Depreciation","Expense","Depreciation Expense",,"Accumulated Depreciation",297.62,"",3768963.09
,"General Journal","06-06-2024","23822",,,"Plastic Scrap Grinder Machine Depreciation","Expense","Depreciation Expense",,"Accumulated  Depreciation",3452.38,"",3772415.47
,"General Journal","06-06-2024","23823",,,"Ribon Mixer SS depreciation","Expense","Depreciation Expense",,"Accumulated depreciation",4642.86,"",3777058.33
,"General Journal","06-06-2024","23824",,,"Telephone Handset Depreciation","Expense","Depreciation Expense",,"Accumulated Depreciation",29.76,"",3777088.09
,"General Journal","06-06-2024","23825",,,"Telkom Wifi Router Depreciation","Expense","Depreciation Expense",,"Accumulated Depreciation",71.43,"",3777159.52
,"General Journal","06-06-2024","23826",,,"Vacuum Cleaner Depreciation","Expense","Depreciation Expense",,"Accumulated Depreciation",148.81,"",3777308.33
,"General Journal","07-06-2024","23829",,,"9Kg Powder Fire Extinguisher 6 Depreciation","Expense","Depreciation Expense",,"Accumulated Depreciation",44.05,"",3777352.38
,"General Journal","07-06-2024","23830",,,"Cartoning table 4 depreciation","Expense","Depreciation Expense",,"Accumulated Depreciation",262.49,"",3777614.87
,"General Journal","07-06-2024","23831",,,"Case sealing table depreciation","Expense","Depreciation Expense",,"Accumulated Depreciation",86.67,"",3777701.54
,"General Journal","07-06-2024","23832",,,"Chain block 2 depreciation","Expense","Depreciation Expense",,"Accumulated depreciation",398.81,"",3778100.35
,"General Journal","07-06-2024","23833",,,"Chain block 3 depreciation","Expense","Depreciation Expense",,"Accumulated depreciation",398.81,"",3778499.16
,"General Journal","07-06-2024","23834",,,"Drilling machine Depreciation","Expense","Depreciation Expense",,"Accumulated Depreciation",88.39,"",3778587.55
,"General Journal","07-06-2024","23835",,,"Grinder Depreciation","Expense","Depreciation Expense",,"Acccumulated Depreciation",159.82,"",3778747.37
,"General Journal","07-06-2024","23836",,,"Packing table 1 depreciation","Expense","Depreciation Expense",,"Accumulated Depreciation",262.49,"",3779009.86
,"General Journal","07-06-2024","23837",,,"Packing table 2 depreciation","Expense","Depreciation Expense",,"Accumulated Depreciation",262.49,"",3779272.35
,"General Journal","07-06-2024","23838",,,"Packing table 3 depreciation","Expense","Depreciation Expense",,"Accumulated Depreciation",262.49,"",3779534.84
,"General Journal","07-06-2024","23839",,,"Quality table depreciation","Expense","Depreciation Expense",,"Accumulated Depreciation",86.67,"",3779621.51
,"General Journal","07-06-2024","23840",,,"Welding machine Depreciation","Expense","Depreciation Expense",,"Accumulated Depreciation",178.57,"",3779800.08
,"General Journal","08-06-2024","23842",,,"Bench Grinder 350W Depreciation","Expense","Depreciation Expense",,"Accumulated Depreciation",122.13,"",3779922.21
,"General Journal","08-06-2024","23860",,,"HP Laptop 6 Depreciation","Expense","Depreciation Expense",,"Accumulated Depreciation",416.67,"",3780338.88
,"General Journal","08-06-2024","23865",,,"Mobile Phone 1 Depreciation","Expense","Depreciation Expense",,"Accumulated Depreciation",58.33,"",3780397.21
,"General Journal","08-06-2024","25180",,,"Six step steel ladder 1 Depreciation","Expense","Depreciation Expense",,"Accumulated Depreciation",113.51,"",3780510.72
,"General Journal","09-06-2024","23843",,,"Canteen Table 1 Depreciation","Expense","Depreciation Expense",,"Accumulated Depreciation",184.52,"",3780695.24
,"General Journal","09-06-2024","23844",,,"Canteen Table 2 Depreciation","Expense","Depreciation Expense",,"Accumulated Depreciation",184.52,"",3780879.76
,"General Journal","09-06-2024","23845",,,"Dell Desktop 1 Depreciation","Expense","Depreciation Expense",,"Accumulated Depreciation",178.57,"",3781058.33
,"General Journal","09-06-2024","23846",,,"Fire Alarm System Extension'19 Depreciation","Expense","Depreciation Expense",,"Accumulated Depreciation",9857.14,"",3790915.47
,"General Journal","09-06-2024","23848",,,"Floor Chair 1 Depreciation","Expense","Depreciation Expense",,"Accumulated Depreciation",26.79,"",3790942.26
,"General Journal","09-06-2024","23849",,,"Floor Chair 10 Depreciation","Expense","Depreciation Expense",,"Accumulated Depreciation",53.57,"",3790995.83
,"General Journal","09-06-2024","23850",,,"Floor Chair 2 Depreciation","Expense","Depreciation Expense",,"Accumulated Depreciation",26.79,"",3791022.62
,"General Journal","09-06-2024","23851",,,"Floor Chair 3 Depreciation","Expense","Depreciation Expense",,"Accumulated Depreciation",26.79,"",3791049.41
,"General Journal","09-06-2024","23852",,,"Floor Chair 4 Depreciation","Expense","Depreciation Expense",,"Accumulated Depreciation",26.79,"",3791076.20
,"General Journal","09-06-2024","23853",,,"Floor Chair 5 Depreciation","Expense","Depreciation Expense",,"Accumulated Depreciation",26.79,"",3791102.99
,"General Journal","09-06-2024","23854",,,"Floor Chair 6 Depreciation","Expense","Depreciation Expense",,"Accumulated Depreciation",53.57,"",3791156.56
,"General Journal","09-06-2024","23855",,,"Floor Chair 7 Depreciation","Expense","Depreciation Expense",,"Accumulated Depreciation",53.57,"",3791210.13
,"General Journal","09-06-2024","23856",,,"Floor Chair 8 Depreciation","Expense","Depreciation Expense",,"Accumulated Depreciation",53.57,"",3791263.70
,"General Journal","09-06-2024","23857",,,"Floor Chair 9 Depreciation","Expense","Depreciation Expense",,"Accumulated Depreciation",53.57,"",3791317.27
,"General Journal","09-06-2024","23858",,,"Floor weighing scale Depreciation","Expense","Depreciation Expense",,"Accumulated Depreciation",593.81,"",3791911.08
,"General Journal","09-06-2024","23862",,,"Lab Office Chair 1 Depreciation","Expense","Depreciation Expense",,"Accumulated Depreciation",47.62,"",3791958.70
,"General Journal","09-06-2024","23863",,,"Lab Office Chair 2 Depreciation","Expense","Depreciation Expense",,"Accumulated Depreciation",47.62,"",3792006.32
,"General Journal","09-06-2024","23864",,,"Lab Office Chair 3 Depreciation","Expense","Depreciation Expense",,"Accumulated Depreciation",47.62,"",3792053.94
,"General Journal","09-06-2024","23871","*","Unilever Kenya Ltd:Sunlight Washing Pwd","Sunlight Bag Closing Machine 1 Depreciation","Expense","Depreciation Expense",,"Accumulated Depreciation",738.10,"",3792792.04
,"General Journal","09-06-2024","23872","*","Unilever Kenya Ltd:Sunlight Washing Pwd","Sunlight Packing Chair 1 Depreciation","Expense","Depreciation Expense",,"Accumulated Depreciation",41.67,"",3792833.71
,"General Journal","10-06-2024","23841",,,"5Kg Fire Extinguisher 1 Depreciation","Expense","Depreciation Expense",,"Accumulated Depreciation",65.48,"",3792899.19
,"General Journal","10-06-2024","23859",,,"HP Laptop 10 Depreciation","Expense","Depreciation Expense",,"Accumulated Depreciation",1200.00,"",3794099.19
,"General Journal","10-06-2024","23861",,,"HP Laptop 9 Depreciation","Expense","Depreciation Expense",,"Accumulated Depreciation",1200.00,"",3795299.19
,"General Journal","10-06-2024","23866",,,"Office Seat 1 Depreciation","Expense","Depreciation Expense",,"Accumulated Depreciation",142.86,"",3795442.05
,"General Journal","10-06-2024","23867",,,"Office Seat 2 Depreciation","Expense","Depreciation Expense",,"Accumulated Depreciation",71.43,"",3795513.48
,"General Journal","10-06-2024","23868",,,"Office Seat 3 Depreciation","Expense","Depreciation Expense",,"Accumulated Depreciation",71.43,"",3795584.91
,"General Journal","10-06-2024","23869",,,"Reverse Osmosis Unit 1 Depreciation","Expense","Depreciation Expense",,"Accumulated Depreciation",416.67,"",3796001.58
,"General Journal","10-06-2024","23870",,,"Steam Generator SG24 Depreciation","Expense","Depreciation Expense",,"Accumulated Depreciation",3794.53,"",3799796.11
,"General Journal","10-06-2024","23873",,,"Toilet Cleaner Mixing Machine Depreciation","Expense","Depreciation Expense",,"Accumulated Depreciation",6333.33,"",3806129.44
,"General Journal","11-06-2024","23874",,,"4 GB hard drive for CCTV Depreciation","Expense","Depreciation Expense",,"Accumulated Depreciation",178.57,"",3806308.01
,"General Journal","11-06-2024","23875",,,"4TB Hard Disk Depreciation","Expense","Depreciation Expense",,"Accumulated Depreciation",178.57,"",3806486.58
,"General Journal","11-06-2024","23876","*","Unilever Kenya Ltd:Sunlight Washing Pwd","Chain block trolley 4 depreciation","Expense","Depreciation Expense",,"Accumulated Depreciation",85.00,"",3806571.58
,"General Journal","11-06-2024","23877",,,"Coder Depreciation","Expense","Depreciation Expense",,"Accumulated Depreciation",2261.90,"",3808833.48
,"General Journal","11-06-2024","23878",,,"Coder Stand Depreciation","Expense","Depreciation Expense",,"Accumulated Depreciation",59.52,"",3808893.00
,"General Journal","11-06-2024","23879",,,"Compressor 1 depreciation","Expense","Depreciation Expense",,"Accumulated depreciation",3750.00,"",3812643.00
,"General Journal","11-06-2024","23880",,,"HP Laptop 14 Depreciation","Expense","Depreciation Expense",,"Accumulated Depreciation",1941.67,"",3814584.67
,"General Journal","11-06-2024","23881",,,"HP Laptop 15 Depreciation","Expense","Depreciation Expense",,"Accumulated Depreciation",1750.00,"",3816334.67
,"General Journal","11-06-2024","23882",,,"Pallet truck 2 depreciation","Expense","Depreciation Expense",,"Accumulated depreciation",440.48,"",3816775.15
,"General Journal","11-06-2024","23883","*",,"Steam Label Shrink Tunnel Depreciation","Expense","Depreciation Expense",,"Accumulated  Depreciation",10952.38,"",3827727.53
,"General Journal","12-06-2024","23884",,,"Coder Housing Depreciation","Expense","Depreciation Expense",,"Accumulated Depreciation",80.36,"",3827807.89
,"General Journal","12-06-2024","23885","*","Unilever Kenya Ltd:Sunlight Washing Pwd","Coder UPS 4 Depreciation","Expense","Depreciation Expense",,"Accumulated Depreciation",158.33,"",3827966.22
,"General Journal","12-06-2024","23886",,,"Coding Conveyor Depreciation","Expense","Depreciation Expense",,"Accumulated Depreciation",476.19,"",3828442.41
,"General Journal","12-06-2024","23887",,,"Conveyor 2 Depreciation","Expense","Depreciation Expense",,"Accumulated  Depreciation",169.64,"",3828612.05
,"General Journal","12-06-2024","23888",,,"Eyewash Station 1 Depreciation","Expense","Depreciation Expense",,"Accumulated Depreciation",904.76,"",3829516.81
,"General Journal","12-06-2024","23889",,,"HP Laptop 5 Depreciation","Expense","Depreciation Expense",,"Accumulated Depreciation",416.67,"",3829933.48
,"General Journal","12-06-2024","23890",,,"Tea maker Depreciation","Expense","Depreciation Expense",,"Accumulated Depreciation",225.00,"",3830158.48
,"General Journal","13-06-2024","23891",,,"Alarm System Depreciation","Expense","Depreciation Expense",,"Accumulated Depreciation",580.95,"",3830739.43
,"General Journal","13-06-2024","23892",,,"Bosch Blower 2 Depreciation","Expense","Depreciation Expense",,"Accumulated Depreciation",136.49,"",3830875.92
,"General Journal","13-06-2024","23893",,,"Coder UPS 8 Depreciation","Expense","Depreciation Expense",,"Accumulated Depreciation",81.67,"",3830957.59
,"General Journal","13-06-2024","23894","*",,"HP Laptop 16 Depreciation","Expense","Depreciation Expense",,"Accumulated Depreciation",1000.00,"",3831957.59
,"General Journal","13-06-2024","23895",,,"PIR system extension Depreciation","Expense","Depreciation Expense",,"Accumulated Depreciation",254.67,"",3832212.26
,"General Journal","13-06-2024","23896",,,"Process Water Storage Tank Depreciation","Expense","Depreciation Expense",,"Accumulated Depreciation",1065.16,"",3833277.42
,"General Journal","13-06-2024","23897","*",,"Store Racking 3 FG Depreciation","Expense","Depreciation Expense",,"Accumulated Depreciation",9791.67,"",3843069.09
,"General Journal","13-06-2024","23898",,,"Weighing scale 1","Expense","Depreciation Expense",,"Accumulated Depreciation",559.52,"",3843628.61
,"General Journal","13-06-2024","25174",,,"HP Mini Desktop 4 Depreciation","Expense","Depreciation Expense",,"Accumulated Depreciation",466.67,"",3844095.28
,"General Journal","14-06-2024","23899",,,"Coder UPS 5 Depreciation","Expense","Depreciation Expense",,"Accumulated Depreciation",158.33,"",3844253.61
,"General Journal","14-06-2024","23900",,,"Motor Vehicle 2 Depreciation","Expense","Depreciation Expense",,"Accumulated Depreciation",10297.62,"",3854551.23
,"General Journal","14-06-2024","23901",,,"Paste Packing Machine Depreciation","Expense","Depreciation Expense",,"Accumulated Depreciation",4166.67,"",3858717.90
,"General Journal","14-06-2024","23902",,,"Table Top Scale 10  SS 15Kg Depreciation","Expense","Depreciation Expense",,"Accumulated Depreciation",297.62,"",3859015.52
,"General Journal","15-06-2024","23903",,,"150KVA Enclosed Genset Depreciation","Expense","Depreciation Expense",,"Accumulated Depreciation",24404.76,"",3883420.28
,"General Journal","15-06-2024","23904",,,"20Kg Forklift Gas Cylinder 2 Depreciation","Expense","Depreciation Expense",,"Accumulated Depreciation",769.70,"",3884189.98
,"General Journal","15-06-2024","23907",,,"2Ton Electric Hoist 1 Depreciation","Expense","Depreciation Expense",,"Accumulated Depreciation",3708.33,"",3887898.31
,"General Journal","15-06-2024","23908",,,"Automatic Change Over Switch 1 Depreciation","Expense","Depreciation Expense",,"Accumulated Depreciation",1666.67,"",3889564.98
,"General Journal","15-06-2024","23909",,,"Bench top Weighing Scale 1 Depreciation","Expense","Depreciation Expense",,"Accumulated Depreciation",357.14,"",3889922.12
,"General Journal","15-06-2024","23910",,,"Bench top Weighing Scale 2 Depreciation","Expense","Depreciation Expense",,"Accumulated Depreciation",357.14,"",3890279.26
,"General Journal","15-06-2024","23911",,,"Bench top Weighing Scale 3 Depreciation","Expense","Depreciation Expense",,"Accumulated Depreciation",357.14,"",3890636.40
,"General Journal","15-06-2024","23912",,,"Bench top Weighing Scale 4 Depreciation","Expense","Depreciation Expense",,"Accumulated Depreciation",357.14,"",3890993.54
,"General Journal","15-06-2024","23913",,,"Bosch Blower Depreciation","Expense","Depreciation Expense",,"Accumulated Depreciation",129.31,"",3891122.85
,"General Journal","15-06-2024","23915",,,"Canteen Chair 1 Depreciation","Expense","Depreciation Expense",,"Accumulated Depreciation",6.12,"",3891128.97
,"General Journal","15-06-2024","23916",,,"Canteen Chair 10 Depreciation","Expense","Depreciation Expense",,"Accumulated Depreciation",6.12,"",3891135.09
,"General Journal","15-06-2024","23917",,,"Canteen Chair 11 Depreciation","Expense","Depreciation Expense",,"Accumulated Depreciation",6.12,"",3891141.21
,"General Journal","15-06-2024","23918",,,"Canteen Chair 11 Depreciation","Expense","Depreciation Expense",,"Accumulated Depreciation",6.12,"",3891147.33
,"General Journal","15-06-2024","23919",,,"Canteen Chair 12 Depreciation","Expense","Depreciation Expense",,"Accumulated Depreciation",6.12,"",3891153.45
,"General Journal","15-06-2024","23920",,,"Canteen Chair 13 Depreciation","Expense","Depreciation Expense",,"Accumulated Depreciation",6.12,"",3891159.57
,"General Journal","15-06-2024","23921",,,"Canteen Chair 14 Depreciation","Expense","Depreciation Expense",,"Accumulated Depreciation",6.12,"",3891165.69
,"General Journal","15-06-2024","23922",,,"Canteen Chair 15 Depreciation","Expense","Depreciation Expense",,"Accumulated Depreciation",6.12,"",3891171.81
,"General Journal","15-06-2024","23923",,,"Canteen Chair 16 Depreciation","Expense","Depreciation Expense",,"Accumulated Depreciation",6.12,"",3891177.93
,"General Journal","15-06-2024","23924",,,"Canteen Chair 17 Depreciation","Expense","Depreciation Expense",,"Accumulated Depreciation",6.12,"",3891184.05
,"General Journal","15-06-2024","23925",,,"Canteen Chair 18 Depreciation","Expense","Depreciation Expense",,"Accumulated Depreciation",6.12,"",3891190.17
,"General Journal","15-06-2024","23926",,,"Canteen Chair 19 Depreciation","Expense","Depreciation Expense",,"Accumulated Depreciation",6.12,"",3891196.29
,"General Journal","15-06-2024","23927",,,"Canteen Chair 2 Depreciation","Expense","Depreciation Expense",,"Accumulated Depreciation",6.12,"",3891202.41
,"General Journal","15-06-2024","23928",,,"Canteen Chair 21 Depreciation","Expense","Depreciation Expense",,"Accumulated Depreciation",6.12,"",3891208.53
,"General Journal","15-06-2024","23929",,,"Canteen Chair 22 Depreciation","Expense","Depreciation Expense",,"Accumulated Depreciation",6.12,"",3891214.65
,"General Journal","15-06-2024","23930",,,"Canteen Chair 23 Depreciation","Expense","Depreciation Expense",,"Accumulated Depreciation",6.12,"",3891220.77
,"General Journal","15-06-2024","23931",,,"Canteen Chair 24 Depreciation","Expense","Depreciation Expense",,"Accumulated Depreciation",6.12,"",3891226.89
,"General Journal","15-06-2024","23932",,,"Canteen Chair 25 Depreciation","Expense","Depreciation Expense",,"Accumulated Depreciation",6.12,"",3891233.01
,"General Journal","15-06-2024","23933",,,"Canteen Chair 3 Depreciation","Expense","Depreciation Expense",,"Accumulated Depreciation",6.12,"",3891239.13
,"General Journal","15-06-2024","23934",,,"Canteen Chair 4 Depreciation","Expense","Depreciation Expense",,"Accumulated Depreciation",6.12,"",3891245.25
,"General Journal","15-06-2024","23935",,,"Canteen Chair 5 Depreciation","Expense","Depreciation Expense",,"Accumulated Depreciation",6.12,"",3891251.37
,"General Journal","15-06-2024","23936",,,"Canteen Chair 6 Depreciation","Expense","Depreciation Expense",,"Accumulated Depreciation",6.12,"",3891257.49
,"General Journal","15-06-2024","23937",,,"Canteen Chair 7 Depreciation","Expense","Depreciation Expense",,"Accumulated Depreciation",6.12,"",3891263.61
,"General Journal","15-06-2024","23938",,,"Canteen Chair 8 Depreciation","Expense","Depreciation Expense",,"Accumulated Depreciation",6.12,"",3891269.73
,"General Journal","15-06-2024","23939",,,"Canteen Chair 9 Depreciation","Expense","Depreciation Expense",,"Accumulated Depreciation",6.12,"",3891275.85
,"General Journal","15-06-2024","23948",,,"EOL Case sealer Outfeed Conveyor Depreciation","Expense","Depreciation Expense",,"Accumulated Depreciation",297.62,"",3891573.47
,"General Journal","15-06-2024","23949",,,"Epson L6190 Printer 1 Depreciation","Expense","Depreciation Expense",,"Accumulated Depreciation",654.76,"",3892228.23
,"General Journal","15-06-2024","23950",,,"Fire Extinguisher 1 Depreciation","Expense","Depreciation Expense",,"Accumulated Depreciation",77.38,"",3892305.61
,"General Journal","15-06-2024","23951",,,"Fire Extinguisher 2 Depreciation","Expense","Depreciation Expense",,"Accumulated Depreciation",77.38,"",3892382.99
,"General Journal","15-06-2024","23952",,,"Fire Extinguisher 3 Depreciation","Expense","Depreciation Expense",,"Accumulated Depreciation",77.38,"",3892460.37
,"General Journal","15-06-2024","23953",,,"Fire Extinguisher 4 Depreciation","Expense","Depreciation Expense",,"Accumulated Depreciation",77.38,"",3892537.75
,"General Journal","15-06-2024","23954",,,"Fire Extinguisher 5 Depreciation","Expense","Depreciation Expense",,"Accumulated Depreciation",77.38,"",3892615.13
,"General Journal","15-06-2024","23955",,,"Fire Extinguisher 6 Depreciation","Expense","Depreciation Expense",,"Accumulated Depreciation",77.38,"",3892692.51
,"General Journal","15-06-2024","23957",,,"Grinder 2 Depreciation","Expense","Depreciation Expense",,"Accumulated Depreciation",178.57,"",3892871.08
,"General Journal","15-06-2024","23960",,,"HP Laptop 11 Depreciation","Expense","Depreciation Expense",,"Accumulated Depreciation",1200.00,"",3894071.08
,"General Journal","15-06-2024","23961",,,"HP Laptop 12 Depreciation","Expense","Depreciation Expense",,"Accumulated Depreciation",1200.00,"",3895271.08
,"General Journal","15-06-2024","23968",,,"Microwave 2 Depreciation","Expense","Depreciation Expense",,"Accumulated Depreciation",147.27,"",3895418.35
,"General Journal","15-06-2024","23969",,,"Mobile phone 3 Depreciation","Expense","Depreciation Expense",,"Accumulated Depreciation",41.67,"",3895460.02
,"General Journal","15-06-2024","23970",,,"Movable Ladder 1 Depreciation","Expense","Depreciation Expense",,"Accumulated Depreciation",434.52,"",3895894.54
,"General Journal","15-06-2024","23986",,,"UV water purifier 3 Depreciation","Expense","Depreciation Expense",,"Accumulated Depreciation",543.10,"",3896437.64
,"General Journal","15-06-2024","23989",,,"Water tank 6 Depreciation","Expense","Depreciation Expense",,"Accumulated Depreciation",71.84,"",3896509.48
,"General Journal","16-06-2024","23914",,,"Bosch Grinder 3 Depreciation","Expense","Depreciation Expense",,"Accumulated Depreceiation",86.21,"",3896595.69
,"General Journal","16-06-2024","23941",,,"Chain block 5 depreciation","Expense","Depreciation Expense",,"Accumulated Depreciation",292.49,"",3896888.18
,"General Journal","16-06-2024","23942",,,"Chain block 6 depreciation","Expense","Depreciation Expense",,"Accumulated Depreciation",292.49,"",3897180.67
,"General Journal","16-06-2024","23959",,,"Heat Gun Total 1 Depreciation","Expense","Depreciation Expense",,"Accumulated Depreciation",64.66,"",3897245.33
,"General Journal","16-06-2024","23967",,,"Linx 5900 Coder 1 Depreciation","Expense","Depreciation Expense",,"Accumulated Depreciation",4166.67,"",3901412.00
,"General Journal","16-06-2024","23981",,,"Table Top Scale 11 6Kg Depreciation","Expense","Depreciation Expense",,"Accumulated Depreciation",277.09,"",3901689.09
,"General Journal","16-06-2024","23987",,,"Washing Machine 1 Depreciation","Expense","Depreciation Expense",,"Accumulated Depreciation",2640.01,"",3904329.10
,"General Journal","17-06-2024","23905",,,"2T Mixer Depreciation","Expense","Depreciation Expense",,"Accumulated Depreciation",12633.99,"",3916963.09
,"General Journal","17-06-2024","23906",,,"2T Mixer Installation Depreciation","Expense","Depreciation Expense",,"Accumulated Depreciation",29713.15,"",3946676.24
,"General Journal","17-06-2024","23943",,,"Coder UPS 6 Depreciation","Expense","Depreciation Expense",,"Accumulated Depreciation",94.83,"",3946771.07
,"General Journal","17-06-2024","23944",,,"Coder UPS 7 Depreciation","Expense","Depreciation Expense",,"Accumulated Depreciation",94.83,"",3946865.90
,"General Journal","17-06-2024","23958","*",,"Hand Dryer 1 Depreciation","Expense","Depreciation Expense",,"Accumulated Depreciation",46.18,"",3946912.08
,"General Journal","17-06-2024","23962","*",,"HP Laptop 3 Depreciation","Expense","Depreciation Expense",,"Accumulated Depreciation",297.62,"",3947209.70
,"General Journal","17-06-2024","23971",,,"Office desks  4","Expense","Depreciation Expense",,"Accumulated Depreciation",361.90,"",3947571.60
,"General Journal","17-06-2024","23973",,,"Pallet truck 4 Depreciation","Expense","Depreciation Expense",,"Accumulated Depreciation",428.57,"",3948000.17
,"General Journal","17-06-2024","23974",,,"Pallet truck 5 Depreciation","Expense","Depreciation Expense",,"Accumulated Depreciation",428.57,"",3948428.74
,"General Journal","17-06-2024","23975",,,"Recirculation Pump Depreciation","Expense","Depreciation Expense",,"Accumulated  Depreciation",71.19,"",3948499.93
,"General Journal","17-06-2024","23976",,,"Server 1 Depreciation","Expense","Depreciation Expense",,"Accumulated Depreciation",357.14,"",3948857.07
,"General Journal","17-06-2024","23977",,,"Server Monitor Depreciation","Expense","Depreciation Expense",,"Accumulated Depreciaion",107.14,"",3948964.21
,"General Journal","17-06-2024","23978",,,"Shrink Tunnel Depreciation","Expense","Depreciation Expense",,"Accumulated Depreciation",3750.00,"",3952714.21
,"General Journal","17-06-2024","23979","*",,"Soap Dispenser 1 Depreciation","Expense","Depreciation Expense",,"Accumulated Depreciation",15.39,"",3952729.60
,"General Journal","17-06-2024","23983","*",,"TP Link 3 Depreciation","Expense","Depreciation Expense",,"Accumulated Depreciation",33.33,"",3952762.93
,"General Journal","17-06-2024","23988","*",,"Water Tank 3 Depreciation","Expense","Depreciation Expense",,"Accumulated Depreciation",123.15,"",3952886.08
,"General Journal","18-06-2024","23940",,,"Carton Sealer Manual 1 Depreciation","Expense","Depreciation Expense",,"Accumulated Depreciation",14.80,"",3952900.88
,"General Journal","18-06-2024","23945",,,"Compressor 3 Depreciation","Expense","Depreciation Expense",,"Accumulated Depreciation",5357.14,"",3958258.02
,"General Journal","18-06-2024","23946",,,"Compressor room depreciation","Expense","Depreciation Expense",,"Accumulated depreciation",132.44,"",3958390.46
,"General Journal","18-06-2024","23947",,,"Electric Hoist 1 depreciation","Expense","Depreciation Expense",,"Accumulated depreciation",3452.38,"",3961842.84
,"General Journal","18-06-2024","23956",,,"Gents changing room Lockers Depreciation","Expense","Depreciation Expense",,"Accumulated Depreciation",386.90,"",3962229.74
,"General Journal","18-06-2024","23963",,,"HP Mini Desktop 1 Depreciation","Expense","Depreciation Expense",,"Accumulated Depreciation",733.33,"",3962963.07
,"General Journal","18-06-2024","23964",,,"HP Mini Desktop 2 Depreciation","Expense","Depreciation Expense",,"Accumulated Depreciation",733.33,"",3963696.40
,"General Journal","18-06-2024","23965",,,"HP Mini Desktop 3 Depreciation","Expense","Depreciation Expense",,"Accumulated Depreciation",733.33,"",3964429.73
,"General Journal","18-06-2024","23966",,,"Ladies changing room Lockers Depreciation","Expense","Depreciation Expense",,"Accumulated Depreciation",411.90,"",3964841.63
,"General Journal","18-06-2024","23972",,,"Omrom M1 Basic BP Monitor Depreciation","Expense","Depreciation Expense",,"Accumulated Depreciation",58.33,"",3964899.96
,"General Journal","18-06-2024","23980",,,"SS Hand Washing Station 1 Depreciation","Expense","Depreciation Expense",,"Accumulated Depreciation",690.48,"",3965590.44
,"General Journal","18-06-2024","23982",,,"TP Link 2 Depreciation","Expense","Depreciation Expense",,"Accumulated Depreciation",41.67,"",3965632.11
,"General Journal","18-06-2024","23984",,,"TV Screen 3 Depreciation","Expense","Depreciation Expense",,"Accumulated Depreciation",316.67,"",3965948.78
,"General Journal","18-06-2024","23985",,,"TV Screen 4 Depreciation","Expense","Depreciation Expense",,"Accumulated Depreciation",1550.00,"",3967498.78
,"General Journal","19-06-2024","23991",,,"3T Gas Forklift 1 Depreciation","Expense","Depreciation Expense",,"Accumulated Depreciation",30952.38,"",3998451.16
,"General Journal","19-06-2024","23992",,,"Coding Stamp 3 Depreciation","Expense","Depreciation Expense",,"Accumulated Depreciation",143.68,"",3998594.84
,"General Journal","19-06-2024","25195",,,"Office Stamp 2 Depreciation","Expense","Depreciation Expense",,"Accumulated Depreciaion",30.83,"",3998625.67
,"General Journal","20-06-2024","24003","*","Unilever Kenya Ltd:Sunlight Washing Pwd","Boato Commisioning Depreciation","Expense","Depreciation Expense",,"Accumulated Depreciation",889.88,"",3999515.55
,"General Journal","20-06-2024","24004",,,"Bosch Blower 3 Depreciation","Expense","Depreciation Expense",,"Accumulated Depreciation",79.02,"",3999594.57
,"General Journal","20-06-2024","24005",,,"Bosch Blower 4 Depreciation","Expense","Depreciation Expense",,"Accumulated Depreciation",136.49,"",3999731.06
,"General Journal","20-06-2024","24006",,,"Bosch Blower 5 Depreciation","Expense","Depreciation Expense",,"Accumulated Depreciation",136.49,"",3999867.55
,"General Journal","20-06-2024","24007",,,"Conference Office Desk 1 Depreciation","Expense","Depreciation Expense",,"Accumulated Depreciation",416.67,"",4000284.22
,"General Journal","20-06-2024","24008",,,"Floor Chair 17 depreciation","Expense","Depreciation Expense",,"Accumulated Depreciation",20.24,"",4000304.46
,"General Journal","20-06-2024","24009",,,"Floor Chair 18 depreciation","Expense","Depreciation Expense",,"Accumulated Depreciation",20.24,"",4000324.70
,"General Journal","20-06-2024","24010",,,"Floor Chair 19 depreciation","Expense","Depreciation Expense",,"Accumulated Depreciation",20.24,"",4000344.94
,"General Journal","20-06-2024","24011",,,"Floor Chair 20 depreciation","Expense","Depreciation Expense",,"Accumulated Depreciation",20.24,"",4000365.18
,"General Journal","20-06-2024","24012",,,"Heat Gun CAT Digital 1 Depreciation","Expense","Depreciation Expense",,"Accumulated Depreciation",136.49,"",4000501.67
,"General Journal","20-06-2024","24013","*",,"Lumnia 1 Pro Insect Trap Depreciation","Expense","Depreciation Expense",,"Accumulated Depreciation",316.67,"",4000818.34
,"General Journal","20-06-2024","24015",,,"PF Correction Unit Depreciation","Expense","Depreciation Expense",,"Accumulated Depreciation",1708.33,"",4002526.67
,"General Journal","21-06-2024","24016",,,"5Kg CO2 Fire Extinguisher 2 Depreciation","Expense","Depreciation Expense",,"Accumulated Depreciation",73.81,"",4002600.48
,"General Journal","21-06-2024","24017",,,"6Kg Dry Pwd Fire Extinguisher 1 Depreciaiton","Expense","Depreciation Expense",,"Accumulated Depreciation",59.52,"",4002660.00
,"General Journal","21-06-2024","24018",,,"Board room chair 1 Depreciation","Expense","Depreciation Expense",,"Accumulated Depreciation",59.52,"",4002719.52
,"General Journal","21-06-2024","24019",,,"Board room chair 2 Depreciation","Expense","Depreciation Expense",,"Accumulated Depreciation",59.52,"",4002779.04
,"General Journal","21-06-2024","24020",,,"Board room chair 4 Depreciation","Expense","Depreciation Expense",,"Accumulated Depreciation",59.52,"",4002838.56
,"General Journal","21-06-2024","24021",,,"Board room chair 5 Depreciation","Expense","Depreciation Expense",,"Accumulated Depreciation",59.52,"",4002898.08
,"General Journal","21-06-2024","24022",,,"Board room chair 6 Depreciation","Expense","Depreciation Expense",,"Accumulated Depreciation",59.52,"",4002957.60
,"General Journal","21-06-2024","24023",,,"Board room chair 7 Depreciation","Expense","Depreciation Expense",,"Accumulated Depreciation",59.52,"",4003017.12
,"General Journal","21-06-2024","24024",,,"Board room chair 8 Depreciation","Expense","Depreciation Expense",,"Accumulated Depreciation",59.52,"",4003076.64
,"General Journal","21-06-2024","24025",,,"Coding Stamp 2 Depreciation","Expense","Depreciation Expense",,"Accumulated Depreciation",133.33,"",4003209.97
,"General Journal","21-06-2024","24026",,,"IBC Tank 1 Depreciation","Expense","Depreciation Expense",,"Accumulated Depreciation",41.67,"",4003251.64
,"General Journal","21-06-2024","24027",,,"Empty IBC Tank 2 Depreciation","Expense","Depreciation Expense",,"Accumulated Depreciation",65.48,"",4003317.12
,"General Journal","21-06-2024","24028",,,"FFS Filling Machine 300 1 Depreciation","Expense","Depreciation Expense",,"Accumulated Depreciation",11850.01,"",4015167.13
,"General Journal","21-06-2024","24029",,,"Laboratory Oven & Dessicator  Depreciation","Expense","Depreciation Expense",,"Accumulated Depreciation",766.67,"",4015933.80
,"General Journal","21-06-2024","24030",,,"Nikon D3500 Camera 1 Depreciation","Expense","Depreciation Expense",,"Accumulated Depreciation",766.67,"",4016700.47
,"General Journal","21-06-2024","24031",,,"Tea Urn Depreciation","Expense","Depreciation Expense",,"Accumulated Depreciation",121.67,"",4016822.14
,"General Journal","22-06-2024","24032",,,"6Kg Auto Fire Extinguisher 1 Depreciation","Expense","Depreciation Expense",,"Accumulated Depreciation",53.57,"",4016875.71
,"General Journal","22-06-2024","24033",,,"6Kg Auto Fire Extinguisher 2 Depreciation","Expense","Depreciation Expense",,"Accumulated Depreciation",53.57,"",4016929.28
,"General Journal","22-06-2024","24039","*",,"AVS Voltage Stabilizer Depreciation","Expense","Depreciation Expense",,"Accumulated Depreciation",63.10,"",4016992.38
,"General Journal","22-06-2024","24043",,,"Conveyor Belt Green 1 Depreciation","Expense","Depreciation Expense",,"Accumulated Depreciation",82.14,"",4017074.52
,"General Journal","22-06-2024","24052",,,"HP Laptop 13 Depreciation","Expense","Depreciation Expense",,"Accumulated Depreciation",1200.00,"",4018274.52
,"General Journal","22-06-2024","24053","*",,"HP Laptop 7 Depreciation","Expense","Depreciation Expense",,"Accumulated Depreciation",1200.00,"",4019474.52
,"General Journal","22-06-2024","24057",,,"Office Desk 5 Depreciation","Expense","Depreciation Expense",,"Accumulated Depreciation",180.95,"",4019655.47
,"General Journal","22-06-2024","24058",,,"Office cabinets depreciation","Expense","Depreciation Expense",,"Accumulated Depreciation",119.05,"",4019774.52
,"General Journal","22-06-2024","24062",,,"Platform Scale 2 SS 100Kg Depreciation","Expense","Depreciation Expense",,"Accumulated Depreciation",339.29,"",4020113.81
,"General Journal","22-06-2024","24065",,,"Solar Water Heater 300L Depreciation","Expense","Depreciation Expense",,"Accumulated Depreciation",3125.00,"",4023238.81
,"General Journal","23-06-2024","24035",,,"Analytical Balance Depreciation","Expense","Depreciation Expense",,"Accumulated Depreciation",2405.58,"",4025644.39
,"General Journal","23-06-2024","24036",,,"Auger Filler 1 Depreciation","Expense","Depreciation Expense",,"Accumulated Depreciation",7220.12,"",4032864.51
,"General Journal","23-06-2024","24037",,,"Auger Filler 2 Depreciation","Expense","Depreciation Expense",,"Accumulated Depreciation",13258.63,"",4046123.14
,"General Journal","23-06-2024","24038",,,"Auger Filler 3 Depreciation","Expense","Depreciation Expense",,"Accumulated Depreciation",11788.69,"",4057911.83
,"General Journal","23-06-2024","24040",,,"Bajaj Boxer BM150 UG Depreciation","Expense","Depreciation Expense",,"Accumulated Depreciation",1539.41,"",4059451.24
,"General Journal","23-06-2024","24041",,,"Chain block 4 depreciation","Expense","Depreciation Expense",,"Accumulated Depreciation",133.42,"",4059584.66
,"General Journal","23-06-2024","24042",,,"Coder UPS Depreciation","Expense","Depreciation Expense",,"Accumulated Depreciation",95.24,"",4059679.90
,"General Journal","23-06-2024","24044",,,"Dust Extractor 1 Depreciation","Expense","Depreciation Expense",,"Accumulated Depreciation",446.43,"",4060126.33
,"General Journal","23-06-2024","24045",,,"Dust Extractor 2 Depreciation","Expense","Depreciation Expense",,"Accumulated Depreciation",446.43,"",4060572.76
,"General Journal","23-06-2024","24048",,,"Filler 1 Geared Motor & Feeding System Depreciation","Expense","Depreciation Expense",,"Accumulated Depreciation",333.33,"",4060906.09
,"General Journal","23-06-2024","24049",,,"Filler 2 Geared Motor & Feeding System Depreciation","Expense","Depreciation Expense",,"Accumulated Depreciation",348.72,"",4061254.81
,"General Journal","23-06-2024","24050",,,"Filler 3 Geared Motor & Feeding System Depreciation","Expense","Depreciation Expense",,"Accumulated Depreciation",347.52,"",4061602.33
,"General Journal","23-06-2024","24051",,,"Hotplate with Stirrer Depreciation","Expense","Depreciation Expense",,"Accumulated Depreciation",1785.71,"",4063388.04
,"General Journal","23-06-2024","24055",,,"Makita Hammer Drill Depreciation","Expense","Depreciation Expense",,"Accumulated Depreciation",205.25,"",4063593.29
,"General Journal","23-06-2024","24056",,,"Microwave 1 Depreciation","Expense","Depreciation Expense",,"Accumulated Depreciation",217.13,"",4063810.42
,"General Journal","23-06-2024","24059",,,"Pallet truck 3 Dep","Expense","Depreciation Expense",,"Accumulated Depreciation",510.95,"",4064321.37
,"General Journal","23-06-2024","24063",,,"Pouching Machine Depreciation","Expense","Depreciation Expense",,"Accumulated Depreciation",711.90,"",4065033.27
,"General Journal","23-06-2024","24064",,,"Power bank dep","Expense","Depreciation Expense",,"Accumulated Depreciation",119.05,"",4065152.32
,"General Journal","23-06-2024","24066",,,"Table Top Scale 11  SS 30Kg Depreciation","Expense","Depreciation Expense",,"Accumulated Depreciation",297.62,"",4065449.94
,"General Journal","23-06-2024","24067",,,"Table Top Scale 12  SS 30Kg Depreciation","Expense","Depreciation Expense",,"Accumulated Depreciation",297.62,"",4065747.56
,"General Journal","24-06-2024","24034",,,"Access Control Unit & System Depreciation","Expense","Depreciation Expense",,"Accumulated Depreciation",334.76,"",4066082.32
,"General Journal","24-06-2024","24046",,,"Electrical Enclosure Compressor Depreciation","Expense","Depreciation Expense",,"Accumulated Depreciation",125.00,"",4066207.32
,"General Journal","24-06-2024","24047",,,"ETR Machine Depreciation","Expense","Depreciation Expense",,"Accumulated Depreciation",236.04,"",4066443.36
,"General Journal","24-06-2024","24054",,,"Liquid Plant Depreciation","Expense","Depreciation Expense",,"Accumulated Deprecation",15029.76,"",4081473.12
,"General Journal","24-06-2024","24060",,,"Paste processing & packing line depreciation","Expense","Depreciation Expense",,"Accumulated Depreciation",17348.21,"",4098821.33
,"General Journal","24-06-2024","24061",,,"pH Meter Depreciation","Expense","Depreciation Expense",,"Accumulated Depreciation",741.39,"",4099562.72
,"General Journal","25-06-2024","24068",,,"Clamp Meter 1 Depreciation","Expense","Depreciation Expense",,"Accumulated Depreciation",36.90,"",4099599.62
,"General Journal","25-06-2024","24072",,,"Fire Alarm Sytstem Depreciation","Expense","Depreciation Expense",,"Accumulated Depreciation",728.57,"",4100328.19
,"General Journal","25-06-2024","24073",,,"Floor Chair 11 Depreciation","Expense","Depreciation Expense",,"Accumulated Depreciation",53.57,"",4100381.76
,"General Journal","25-06-2024","24074",,,"Floor Chair 12 Depreciation","Expense","Depreciation Expense",,"Accumulated Depreciation",53.57,"",4100435.33
,"General Journal","25-06-2024","24075",,,"Floor Chair 13 Depreciation","Expense","Depreciation Expense",,"Accumulated Depreciation",53.57,"",4100488.90
,"General Journal","25-06-2024","24076",,,"Floor Chair 14 Depreciation","Expense","Depreciation Expense",,"Accumulated Depreciation",53.57,"",4100542.47
,"General Journal","25-06-2024","24077",,,"Floor Chair 15 Depreciation","Expense","Depreciation Expense",,"Accumulated Depreciation",53.57,"",4100596.04
,"General Journal","25-06-2024","24078",,,"Floor Chair 16 Depreciation","Expense","Depreciation Expense",,"Accumulated Depreciation",53.57,"",4100649.61
,"General Journal","25-06-2024","24081",,,"Liquid Mixer 500Lt Depreciation","Expense","Depreciation Expense",,"Accumulated Depreciation",6172.62,"",4106822.23
,"General Journal","25-06-2024","24083",,,"Plastic Resin Mixer Depreciation","Expense","Depreciation Expense",,"Accumulated  Depreciation",1130.95,"",4107953.18
,"General Journal","25-06-2024","24084",,,"Plastic Resin Mixer Depreciation","Expense","Depreciation Expense",,"Accumulated  Depreciation",1130.95,"",4109084.13
,"General Journal","25-06-2024","25188",,,"Water tank 7 Depreciation","Expense","Depreciation Expense",,"Accumulated Depreciation",71.84,"",4109155.97
,"General Journal","26-06-2024","24069",,,"Dell Desktop 2 Depreciation","Expense","Depreciation Expense",,"Accumulated Depreciation",229.17,"",4109385.14
,"General Journal","26-06-2024","24070",,,"Dell Desktop 3 Depreciation","Expense","Depreciation Expense",,"Accumulated Depreciation",229.17,"",4109614.31
,"General Journal","26-06-2024","24071",,,"Dell Desktop 4 Depreciation","Expense","Depreciation Expense",,"Accumulated Depreciation",229.17,"",4109843.48
,"General Journal","26-06-2024","24079",,,"Grease Gun 1 Depreciation","Expense","Depreciation Expense",,"Accumulated Depreciation",73.21,"",4109916.69
,"General Journal","26-06-2024","24080",,,"Grease Gun 2 Depreciation","Expense","Depreciation Expense",,"Accumulated Depreciation",63.14,"",4109979.83
,"General Journal","26-06-2024","24085",,,"Retort Stand 1 Depreciation","Expense","Depreciation Expense",,"Accumulated Depreciation",10.71,"",4109990.54
,"General Journal","26-06-2024","24086",,,"Retort Stand 2 Depreciation","Expense","Depreciation Expense",,"Accumulated Depreciation",10.71,"",4110001.25
,"General Journal","27-06-2024","24087",,,"Board room chair 10 Depreciation","Expense","Depreciation Expense",,"Accumulated Depreciation",79.55,"",4110080.80
,"General Journal","27-06-2024","24088",,,"Board room chair 11 Depreciation","Expense","Depreciation Expense",,"Accumulated Depreciation",79.55,"",4110160.35
,"General Journal","27-06-2024","24089",,,"Board room chair 12 Depreciation","Expense","Depreciation Expense",,"Accumulated Depreciation",79.55,"",4110239.90
,"General Journal","27-06-2024","24090",,,"Board room chair 13 Depreciation","Expense","Depreciation Expense",,"Accumulated Depreciation",79.55,"",4110319.45
,"General Journal","27-06-2024","24091",,,"Board room chair 14 Depreciation","Expense","Depreciation Expense",,"Accumulated Depreciation",79.55,"",4110399.00
,"General Journal","27-06-2024","24092",,,"Board room chair 15 Depreciation","Expense","Depreciation Expense",,"Accumulated Depreciation",79.55,"",4110478.55
,"General Journal","27-06-2024","24093",,,"Board room chair 16 Depreciation","Expense","Depreciation Expense",,"Accumulated Depreciation",79.55,"",4110558.10
,"General Journal","27-06-2024","24094",,,"Board room chair 17 Depreciation","Expense","Depreciation Expense",,"Accumulated Depreciation",79.55,"",4110637.65
,"General Journal","27-06-2024","24095",,,"Board room chair 18 Depreciation","Expense","Depreciation Expense",,"Accumulated Depreciation",79.55,"",4110717.20
,"General Journal","27-06-2024","24096",,,"Board room chair 19 Depreciation","Expense","Depreciation Expense",,"Accumulated Depreciation",79.55,"",4110796.75
,"General Journal","27-06-2024","24097",,,"Board room chair 9 Depreciation","Expense","Depreciation Expense",,"Accumulated Depreciation",79.55,"",4110876.30
,"General Journal","27-06-2024","24098",,,"Passenger Lift 1000kg Depreciation","Expense","Depreciation Expense",,"Accumulated Depreciation",44484.68,"",4155360.98
,"General Journal","28-06-2024","25164",,,"Heat Gun Bosch 2 Accumulated depreciation","Expense","Depreciation Expense",,"Accumulated Depreciation",75.43,"",4155436.41
,"General Journal","28-06-2024","25170",,,"Heat Gun Bosch 3 Accumulated depreciation","Expense","Depreciation Expense",,"Accumulated Depreciation",75.43,"",4155511.84
,"General Journal","30-06-2024","24099",,,"500gm Jar Blow Mould 3 depreciation","Expense","Depreciation Expense",,"Accumulated Depreciation",1026.79,"",4156538.63
,"General Journal","30-06-2024","24100",,,"500gm Jar Blow Mould 4 depreciation","Expense","Depreciation Expense",,"Accumulated Depreciation",1026.79,"",4157565.42
,"General Journal","30-06-2024","24101",,,"Air cooled chiller depeciation","Expense","Depreciation Expense",,"Accumulated  Depreciation",8916.67,"",4166482.09
,"General Journal","30-06-2024","24103","*","Unilever Kenya Ltd:Sunlight Washing Pwd","Boato Installation Depreciation","Expense","Depreciation Expense",,"Accumulated Depreciation",65114.38,"",4231596.47
,"General Journal","30-06-2024","24104","*",,"Canister Platform Depreciation","Expense","Depreciation Expense",,"Accumulated Depreciation",59246.67,"",4290843.14
,"General Journal","30-06-2024","24105",,,"CCTV DRV & System Depreciation","Expense","Depreciation Expense",,"Accumulated Depreciation",1295.33,"",4292138.47
,"General Journal","30-06-2024","24106",,,"Colour Pressure tank Depreciation","Expense","Depreciation Expense",,"Accumulated Depreciation",232.14,"",4292370.61
,"General Journal","30-06-2024","24107",,,"Compressed air gun Depreciation","Expense","Depreciation Expense",,"Accumulated Depreciation",47.62,"",4292418.23
,"General Journal","30-06-2024","24108",,,"Drum Pump 2 Depreciation","Expense","Depreciation Expense",,"Accumulated Depreciation",123.15,"",4292541.38
,"General Journal","30-06-2024","24109",,,"Extractor Fan down Depreciation","Expense","Depreciation Expense",,"Accumulated Depreciation",150.12,"",4292691.50
,"General Journal","30-06-2024","24110",,,"Extractor Fan Hoisting Depreciation","Expense","Depreciation Expense",,"Accumulated Depreciation",176.67,"",4292868.17
,"General Journal","30-06-2024","24111",,,"Extractor Fan Packaging Depreciation","Expense","Depreciation Expense",,"Accumulated Depreciation",150.12,"",4293018.29
,"General Journal","30-06-2024","24114",,,"Incotex Type C Control Unit Depreciation","Expense","Depreciation Expense",,"Accumulated Depreciation",1939.66,"",4294957.95
,"General Journal","30-06-2024","24115",,,"Lamination Machine 1 Depreciation","Expense","Depreciation Expense",,"Accumulated Depreciation",84.78,"",4295042.73
,"General Journal","30-06-2024","24117",,,"Office Cabinet 5 Depreciation","Expense","Depreciation Expense",,"Accumulated Depreciation",58.33,"",4295101.06
,"General Journal","30-06-2024","24118",,,"Office Desk 6 Depreciation","Expense","Depreciation Expense",,"Accumulated Depreciation",90.48,"",4295191.54
,"General Journal","30-06-2024","24119",,,"Office Desk 7 Depreciation","Expense","Depreciation Expense",,"Accumulated Depreciation",90.48,"",4295282.02
,"General Journal","30-06-2024","24120",,,"Office Desk 8 Depreciation","Expense","Depreciation Expense",,"Accumulated Depreciation",83.33,"",4295365.35
,"General Journal","30-06-2024","24121",,,"Platform Scale 4 tons 1 Depreciation","Expense","Depreciation Expense",,"Accumulated Depreciation",10782.43,"",4306147.78
,"General Journal","30-06-2024","24122",,,"Process Water Filtration System Depreciation","Expense","Depreciation Expense",,"Accumulated Depreciation",1785.71,"",4307933.49
,"General Journal","30-06-2024","24125",,,"Sulphonic Acid pressure tank Depreciation","Expense","Depreciation Expense",,"Accumulated Depreciation",110.48,"",4308043.97
,"General Journal","30-06-2024","24126",,,"Test Sieves 100 & 200 microns Depreciation","Expense","Depreciation Expense",,"Accumulated Depreciation",450.00,"",4308493.97
,"General Journal","30-06-2024","24128",,,"Wall mounted cabinet 1 Dep","Expense","Depreciation Expense",,"Accumulated Depreciation",107.14,"",4308601.11
,"General Journal","30-06-2024","24130",,,"Water tank 5 Depreciation","Expense","Depreciation Expense",,"Accumulated Depreciation",137.79,"",4308738.90
,"General Journal","01-07-2024","24102",,,"Board room chair 3 Depreciation","Expense","Depreciation Expense",,"Accumulated Depreciation",59.52,"",4308798.42
,"General Journal","01-07-2024","24112",,,"Hoisting Bucket 1 Depreciation","Expense","Depreciation Expense",,"Accumulated Depreciation",148.81,"",4308947.23
,"General Journal","01-07-2024","24113",,,"Hoisting Bucket 2 Dereciation","Expense","Depreciation Expense",,"Accumulated Depreciation",148.81,"",4309096.04
,"General Journal","01-07-2024","24116",,,"Lenovo Laptop 2 Depreciation","Expense","Depreciation Expense",,"Accumulated Depreciation",333.33,"",4309429.37
,"General Journal","01-07-2024","24123",,,"Processing Platform Depreciation","Expense","Depreciation Expense",,"Accumulated Depreciation",4880.95,"",4314310.32
,"General Journal","01-07-2024","24124",,,"Security and Computer Sytem UPS Depreciation","Expense","Depreciation Expense",,"Accumulated Depreciation",3584.50,"",4317894.82
,"General Journal","01-07-2024","24127",,,"Trophy Shelf 1 Depreciation","Expense","Depreciation Expense",,"Accumulated Depreciation",95.24,"",4317990.06
,"General Journal","01-07-2024","24129",,,"Water tank 4 Depreciation","Expense","Depreciation Expense",,"Accumulated Depreciation",453.24,"",4318443.30
,"General Journal","02-07-2024","24131",,,"Canteen Chair 20 Depreciation","Expense","Depreciation Expense",,"Accumulated Depreciation",6.12,"",4318449.42
,"General Journal","02-07-2024","24132",,,"CMPP 1kg Jar Blow Mould 1 Depreciation","Expense","Depreciation Expense",,"Accumulated Depreciation",3364.87,"",4321814.29
,"General Journal","02-07-2024","24133",,,"CMPP 1kg Jar Blow Mould 2 Depreciation","Expense","Depreciation Expense",,"Accumulated Depreciation",3364.87,"",4325179.16
,"General Journal","02-07-2024","24134",,,"CMPP 500gm Jar Blow Mould 1 Depreciation","Expense","Depreciation Expense",,"Accumulated Depreciation",2643.82,"",4327822.98
,"General Journal","02-07-2024","24135",,,"CMPP 500gm Jar Blow Mould 2 Depreciation","Expense","Depreciation Expense",,"Accumulated Depreciation",2643.82,"",4330466.80
,"General Journal","02-07-2024","24136",,,"CMPP Blow Moulding Machine 1 Depreciation","Expense","Depreciation Expense",,"Accumulated Depreciation",49344.71,"",4379811.51
,"General Journal","02-07-2024","24137",,,"CMPP Blow Moulding Machine 2 Depreciation","Expense","Depreciation Expense",,"Accumulated Depreciation",49344.71,"",4429156.22
,"General Journal","02-07-2024","24138",,,"Drum Pump 1 Depreiation","Expense","Depreciation Expense",,"Accumulated Depreciation",123.03,"",4429279.25
,"General Journal","02-07-2024","24139",,,"Heat Gun Bosch 1 Depreciation","Expense","Depreciation Expense",,"Accumulated Depreciation",100.57,"",4429379.82
,"General Journal","02-07-2024","24140",,,"Hot ProcessWater Storage Tank1  Depreciation","Expense","Depreciation Expense",,"Accumulated Depreciation",73.99,"",4429453.81
,"General Journal","02-07-2024","24141","*",,"HP Laptop 4 Depreciation","Expense","Depreciation Expense",,"Accumulated Depreciation",297.62,"",4429751.43
,"General Journal","02-07-2024","24142","*",,"HP Laptop 8 Depreciation","Expense","Depreciation Expense",,"Accumulated Depreciation",1200.00,"",4430951.43
,"General Journal","02-07-2024","24143",,,"Store Racking 1 depreciation","Expense","Depreciation Expense",,"Accumulated Depreciation",175.60,"",4431127.03
,"General Journal","02-07-2024","24144",,,"Store Racking 2 Depreciation","Expense","Depreciation Expense",,"Accumulated Depreciation",175.60,"",4431302.63
,"General Journal","02-07-2024","24145",,,"Tank platform Depreciation","Expense","Depreciation Expense",,"Accumulated Depreciation",130.95,"",4431433.58
,"General Journal","02-07-2024","24146",,,"Water tank 1 Depreciation","Expense","Depreciation Expense",,"Accumulated Depreciation",120.07,"",4431553.65
,"General Journal","02-07-2024","24147",,,"Workshop cabinet depreciation","Expense","Depreciation Expense",,"Accumulated Depreciation",172.02,"",4431725.67
,"General Journal","03-07-2024","24148",,,"Alarm System extension","Expense","Depreciation Expense",,"Accumulated Depreciation",602.38,"",4432328.05
,"General Journal","03-07-2024","24149",,,"Domestos sewing machine depreciation","Expense","Depreciation Expense",,"Acummulated depreciation",82.10,"",4432410.15
,"General Journal","03-07-2024","24150",,,"Bench Grinder 2 Depreciation","Expense","Depreciation Expense",,"Accumulated Depreceiation",100.57,"",4432510.72
,"General Journal","03-07-2024","24151",,,"CCTV survellance System extension Depreciation","Expense","Depreciation Expense",,"Accumulated Depreciation",657.14,"",4433167.86
,"General Journal","03-07-2024","24152",,,"Electrical Enclosure CCTV Depreciation","Expense","Depreciation Expense",,"Accumulated Depreciation",126.19,"",4433294.05
,"General Journal","03-07-2024","24153",,,"Electrical Enclosure Main Depreciation","Expense","Depreciation Expense",,"Accumulated Depreciation",2339.29,"",4435633.34
,"General Journal","03-07-2024","24154",,,"Electrical Enclosure P Line Depreciation","Expense","Depreciation Expense",,"Accumulated Depreciation",428.57,"",4436061.91
,"General Journal","03-07-2024","24155",,,"Floodlight Depreciation","Expense","Depreciation Expense",,"Accumulated Depreciation",59.52,"",4436121.43
,"General Journal","03-07-2024","24156",,,"Office Desk 1 Depreciation","Expense","Depreciation Expense",,"Accumulated Depreciation",225.00,"",4436346.43
,"General Journal","03-07-2024","24157",,,"Office Desk 2 Depreciation","Expense","Depreciation Expense",,"Accumulated Depreciation",225.00,"",4436571.43
,"General Journal","03-07-2024","24158",,,"Office Desk 3 Depreciation","Expense","Depreciation Expense",,"Accumulated Depreciation",225.00,"",4436796.43
,"General Journal","03-07-2024","24159",,,"Signet ESD 1 Depreciation","Expense","Depreciation Expense",,"Accumulated Depreciation",928.57,"",4437725.00
,"General Journal","03-07-2024","24160","*",,"Sterling Water Dispenser 1 Depreciation","Expense","Depreciation Expense",,"Accumulated Depreciation",119.05,"",4437844.05
,"General Journal","03-07-2024","24161",,,"Table top Weighing Scale 5 Depreciation","Expense","Depreciation Expense",,"Accumulated Depreciation",248.57,"",4438092.62
,"General Journal","03-07-2024","24162",,,"Table top Weighing Scale 6 Depreciation","Expense","Depreciation Expense",,"Accumulated Depreciation",248.57,"",4438341.19
,"General Journal","03-07-2024","24163",,,"Table top Weighing Scale 7 Depreciation","Expense","Depreciation Expense",,"Accumulated Depreciation",248.57,"",4438589.76
,"General Journal","03-07-2024","24164",,,"Table top Weighing Scale 8 Depreciation","Expense","Depreciation Expense",,"Accumulated Depreciation",248.57,"",4438838.33
,"General Journal","03-07-2024","24165",,,"Table top Weighing Scale 9 Depreciation","Expense","Depreciation Expense",,"Accumulated Depreciation",248.57,"",4439086.90
,"General Journal","04-07-2024","24166",,,"9Kg Powder Fire Extinguisher 1 Depreciation","Expense","Depreciation Expense",,"Accumulated Depreciation",34.52,"",4439121.42
,"General Journal","04-07-2024","24167",,,"9Kg Powder Fire Extinguisher 2 Depreciation","Expense","Depreciation Expense",,"Accumulated Depreciation",34.52,"",4439155.94
,"General Journal","04-07-2024","24168",,,"9Kg Powder Fire Extinguisher 3 Depreciation","Expense","Depreciation Expense",,"Accumulated Depreciation",34.52,"",4439190.46
,"General Journal","04-07-2024","24169",,,"9Kg Powder Fire Extinguisher 5 Depreciation","Expense","Depreciation Expense",,"Accumulated Depreciation",34.52,"",4439224.98
,"General Journal","04-07-2024","24170",,,"Chiller 2 Depreciation","Expense","Depreciation Expense",,"Accumulated Depreciation",8035.71,"",4447260.69
,"General Journal","04-07-2024","24171",,,"Empty IBC Tank 10 Depreciation","Expense","Depreciation Expense",,"Accumulated Depreciation",41.67,"",4447302.36
,"General Journal","04-07-2024","24172",,,"Empty IBC Tank 3 Depreciation","Expense","Depreciation Expense",,"Accumulated Depreciation",65.48,"",4447367.84
,"General Journal","04-07-2024","24173",,,"Empty IBC Tank 4 Depreciation","Expense","Depreciation Expense",,"Accumulated Depreciation",65.48,"",4447433.32
,"General Journal","04-07-2024","24174",,,"Empty IBC Tank 5 Depreciation","Expense","Depreciation Expense",,"Accumulated Depreciation",65.48,"",4447498.80
,"General Journal","04-07-2024","24175",,,"Empty IBC Tank 6 Depreciation","Expense","Depreciation Expense",,"Accumulated Depreciation",65.48,"",4447564.28
,"General Journal","04-07-2024","24176",,,"Empty IBC Tank 7 Depreciation","Expense","Depreciation Expense",,"Accumulated Depreciation",41.67,"",4447605.95
,"General Journal","04-07-2024","24177",,,"Empty IBC Tank 8 Depreciation","Expense","Depreciation Expense",,"Accumulated Depreiation",41.67,"",4447647.62
,"General Journal","04-07-2024","24178",,,"Empty IBC Tank 9 Depreciation","Expense","Depreciation Expense",,"Accumulated Depreciation",41.67,"",4447689.29
,"General Journal","04-07-2024","24179",,,"Linx 8900 Coder 1 Depreciation","Expense","Depreciation Expense",,"Accumulated Depreciation",8333.33,"",4456022.62
,"General Journal","04-07-2024","24180",,,"Mobile Phone 2 Depreciation","Expense","Depreciation Expense",,"Accumulated Depreciation",46.67,"",4456069.29
,"General Journal","04-07-2024","24181",,,"Triple UV water purifier 1 Depreciation","Expense","Depreciation Expense",,"Accumulated Depreciation",296.22,"",4456365.51
,"General Journal","05-07-2024","24182",,,"1Kg Generic Jar Blow Mould 1 depreciation","Expense","Depreciation Expense",,"Accumulated Depreciation",1500.00,"",4457865.51
,"General Journal","05-07-2024","24183",,,"1Kg Generic Jar Blow Mould 2 depreciation","Expense","Depreciation Expense",,"Accumulated Depreciation",1500.00,"",4459365.51
,"General Journal","05-07-2024","24184",,,"500gm Generic Jar Blow Mould 1 depreciation","Expense","Depreciation Expense",,"Accumulated Depreciation",1071.43,"",4460436.94
,"General Journal","05-07-2024","24185",,,"500gm Generic Jar Blow Mould 2 depreciation","Expense","Depreciation Expense",,"Accumulated Depreciation",1071.43,"",4461508.37
,"General Journal","05-07-2024","24186",,,"9Kg Powder Fire Extinguisher 4 Depreciation","Expense","Depreciation Expense",,"Accumulated Depreciation",34.52,"",4461542.89
,"General Journal","05-07-2024","24187",,,"Extractor Fan 4 Depreciation","Expense","Depreciation Expense",,"Accumulated Depreciation",726.19,"",4462269.08
,"General Journal","05-07-2024","24188",,,"FFS  Machine Installation Elct Depreciation","Expense","Depreciation Expense",,"Accumulated Depreciation",200.60,"",4462469.68
,"General Journal","05-07-2024","24189",,,"First Aid Kit Depreciation","Expense","Depreciation Expense",,"Accumulated  Depreciation",77.38,"",4462547.06
,"General Journal","05-07-2024","24190",,,"Linx 8900 Coder 2 Depreciation","Expense","Depreciation Expense",,"Accumulated Depreciation",12500.00,"",4475047.06
,"General Journal","05-07-2024","24191",,,"Packing Platform Depreciation","Expense","Depreciation Expense",,"Accumulated Depreciation",5297.62,"",4480344.68
,"General Journal","05-07-2024","24192",,,"SS Industrial Turntable Depreciation","Expense","Depreciation Expense",,"Accumulated Depreciation",5238.10,"",4485582.78
,"General Journal","05-07-2024","24193",,,"TV Screen 2 Depreciation","Expense","Depreciation Expense",,"Accumulated Depreciation",950.00,"",4486532.78
,"General Journal","05-07-2024","24194",,,"Water Purifier 1 Depreciation","Expense","Depreciation Expense",,"Accumulated Depreciation",117.10,"",4486649.88
,"General Journal","06-07-2024","24197",,,"Blower Depreciation","Expense","Depreciation Expense",,"Accumulated Depreciation",59.52,"",4486709.40
,"General Journal","06-07-2024","24203",,,"Emergency Washing Point Depreciation","Expense","Depreciation Expense",,"Accumulated Deprecation",160.71,"",4486870.11
,"General Journal","06-07-2024","24206","*",,"Infrared Thermometre 1 Depreciation","Expense","Depreciation Expense",,"Accumulated Depreciation",416.67,"",4487286.78
,"General Journal","06-07-2024","24207",,,"Material's Trolley Depreciation","Expense","Depreciation Expense",,"Accumulated Depreciation",297.62,"",4487584.40
,"General Journal","06-07-2024","24212",,,"Plastic Scrap Grinder Machine Depreciation","Expense","Depreciation Expense",,"Accumulated  Depreciation",3452.38,"",4491036.78
,"General Journal","06-07-2024","24214",,,"Ribon Mixer SS depreciation","Expense","Depreciation Expense",,"Accumulated depreciation",4642.86,"",4495679.64
,"General Journal","06-07-2024","24215",,,"Telephone Handset Depreciation","Expense","Depreciation Expense",,"Accumulated Depreciation",29.76,"",4495709.40
,"General Journal","06-07-2024","24216",,,"Telkom Wifi Router Depreciation","Expense","Depreciation Expense",,"Accumulated Depreciation",71.43,"",4495780.83
,"General Journal","06-07-2024","24217",,,"Vacuum Cleaner Depreciation","Expense","Depreciation Expense",,"Accumulated Depreciation",148.81,"",4495929.64
,"General Journal","07-07-2024","24195",,,"9Kg Powder Fire Extinguisher 6 Depreciation","Expense","Depreciation Expense",,"Accumulated Depreciation",44.05,"",4495973.69
,"General Journal","07-07-2024","24198",,,"Cartoning table 4 depreciation","Expense","Depreciation Expense",,"Accumulated Depreciation",262.49,"",4496236.18
,"General Journal","07-07-2024","24199",,,"Case sealing table depreciation","Expense","Depreciation Expense",,"Accumulated Depreciation",86.67,"",4496322.85
,"General Journal","07-07-2024","24200",,,"Chain block 2 depreciation","Expense","Depreciation Expense",,"Accumulated depreciation",398.81,"",4496721.66
,"General Journal","07-07-2024","24201",,,"Chain block 3 depreciation","Expense","Depreciation Expense",,"Accumulated depreciation",398.81,"",4497120.47
,"General Journal","07-07-2024","24202",,,"Drilling machine Depreciation","Expense","Depreciation Expense",,"Accumulated Depreciation",88.39,"",4497208.86
,"General Journal","07-07-2024","24204",,,"Grinder Depreciation","Expense","Depreciation Expense",,"Acccumulated Depreciation",159.82,"",4497368.68
,"General Journal","07-07-2024","24209",,,"Packing table 1 depreciation","Expense","Depreciation Expense",,"Accumulated Depreciation",262.49,"",4497631.17
,"General Journal","07-07-2024","24210",,,"Packing table 2 depreciation","Expense","Depreciation Expense",,"Accumulated Depreciation",262.49,"",4497893.66
,"General Journal","07-07-2024","24211",,,"Packing table 3 depreciation","Expense","Depreciation Expense",,"Accumulated Depreciation",262.49,"",4498156.15
,"General Journal","07-07-2024","24213",,,"Quality table depreciation","Expense","Depreciation Expense",,"Accumulated Depreciation",86.67,"",4498242.82
,"General Journal","07-07-2024","24218",,,"Welding machine Depreciation","Expense","Depreciation Expense",,"Accumulated Depreciation",178.57,"",4498421.39
,"General Journal","08-07-2024","24196",,,"Bench Grinder 350W Depreciation","Expense","Depreciation Expense",,"Accumulated Depreciation",122.13,"",4498543.52
,"General Journal","08-07-2024","24205",,,"HP Laptop 6 Depreciation","Expense","Depreciation Expense",,"Accumulated Depreciation",416.67,"",4498960.19
,"General Journal","08-07-2024","24208",,,"Mobile Phone 1 Depreciation","Expense","Depreciation Expense",,"Accumulated Depreciation",58.33,"",4499018.52
,"General Journal","08-07-2024","25181",,,"Six step steel ladder 1 Depreciation","Expense","Depreciation Expense",,"Accumulated Depreciation",113.51,"",4499132.03
,"General Journal","09-07-2024","24219",,,"Canteen Table 1 Depreciation","Expense","Depreciation Expense",,"Accumulated Depreciation",184.52,"",4499316.55
,"General Journal","09-07-2024","24220",,,"Canteen Table 2 Depreciation","Expense","Depreciation Expense",,"Accumulated Depreciation",184.52,"",4499501.07
,"General Journal","09-07-2024","24221",,,"Dell Desktop 1 Depreciation","Expense","Depreciation Expense",,"Accumulated Depreciation",178.57,"",4499679.64
,"General Journal","09-07-2024","24222",,,"Fire Alarm System Extension'19 Depreciation","Expense","Depreciation Expense",,"Accumulated Depreciation",9857.14,"",4509536.78
,"General Journal","09-07-2024","24224",,,"Floor Chair 1 Depreciation","Expense","Depreciation Expense",,"Accumulated Depreciation",26.79,"",4509563.57
,"General Journal","09-07-2024","24225",,,"Floor Chair 10 Depreciation","Expense","Depreciation Expense",,"Accumulated Depreciation",53.57,"",4509617.14
,"General Journal","09-07-2024","24226",,,"Floor Chair 2 Depreciation","Expense","Depreciation Expense",,"Accumulated Depreciation",26.79,"",4509643.93
,"General Journal","09-07-2024","24227",,,"Floor Chair 3 Depreciation","Expense","Depreciation Expense",,"Accumulated Depreciation",26.79,"",4509670.72
,"General Journal","09-07-2024","24228",,,"Floor Chair 4 Depreciation","Expense","Depreciation Expense",,"Accumulated Depreciation",26.79,"",4509697.51
,"General Journal","09-07-2024","24229",,,"Floor Chair 5 Depreciation","Expense","Depreciation Expense",,"Accumulated Depreciation",26.79,"",4509724.30
,"General Journal","09-07-2024","24230",,,"Floor Chair 6 Depreciation","Expense","Depreciation Expense",,"Accumulated Depreciation",53.57,"",4509777.87
,"General Journal","09-07-2024","24231",,,"Floor Chair 7 Depreciation","Expense","Depreciation Expense",,"Accumulated Depreciation",53.57,"",4509831.44
,"General Journal","09-07-2024","24232",,,"Floor Chair 8 Depreciation","Expense","Depreciation Expense",,"Accumulated Depreciation",53.57,"",4509885.01
,"General Journal","09-07-2024","24233",,,"Floor Chair 9 Depreciation","Expense","Depreciation Expense",,"Accumulated Depreciation",53.57,"",4509938.58
,"General Journal","09-07-2024","24234",,,"Floor weighing scale Depreciation","Expense","Depreciation Expense",,"Accumulated Depreciation",593.81,"",4510532.39
,"General Journal","09-07-2024","24235",,,"Lab Office Chair 1 Depreciation","Expense","Depreciation Expense",,"Accumulated Depreciation",47.62,"",4510580.01
,"General Journal","09-07-2024","24236",,,"Lab Office Chair 2 Depreciation","Expense","Depreciation Expense",,"Accumulated Depreciation",47.62,"",4510627.63
,"General Journal","09-07-2024","24237",,,"Lab Office Chair 3 Depreciation","Expense","Depreciation Expense",,"Accumulated Depreciation",47.62,"",4510675.25
,"General Journal","09-07-2024","24238","*","Unilever Kenya Ltd:Sunlight Washing Pwd","Sunlight Bag Closing Machine 1 Depreciation","Expense","Depreciation Expense",,"Accumulated Depreciation",738.10,"",4511413.35
,"General Journal","09-07-2024","24239","*","Unilever Kenya Ltd:Sunlight Washing Pwd","Sunlight Packing Chair 1 Depreciation","Expense","Depreciation Expense",,"Accumulated Depreciation",41.67,"",4511455.02
,"General Journal","10-07-2024","24240",,,"5Kg Fire Extinguisher 1 Depreciation","Expense","Depreciation Expense",,"Accumulated Depreciation",65.48,"",4511520.50
,"General Journal","10-07-2024","24241",,,"HP Laptop 10 Depreciation","Expense","Depreciation Expense",,"Accumulated Depreciation",1200.00,"",4512720.50
,"General Journal","10-07-2024","24242",,,"HP Laptop 9 Depreciation","Expense","Depreciation Expense",,"Accumulated Depreciation",1200.00,"",4513920.50
,"General Journal","10-07-2024","24243",,,"Office Seat 1 Depreciation","Expense","Depreciation Expense",,"Accumulated Depreciation",142.86,"",4514063.36
,"General Journal","10-07-2024","24244",,,"Office Seat 2 Depreciation","Expense","Depreciation Expense",,"Accumulated Depreciation",71.43,"",4514134.79
,"General Journal","10-07-2024","24245",,,"Office Seat 3 Depreciation","Expense","Depreciation Expense",,"Accumulated Depreciation",71.43,"",4514206.22
,"General Journal","10-07-2024","24246",,,"Reverse Osmosis Unit 1 Depreciation","Expense","Depreciation Expense",,"Accumulated Depreciation",416.67,"",4514622.89
,"General Journal","10-07-2024","24247",,,"Steam Generator SG24 Depreciation","Expense","Depreciation Expense",,"Accumulated Depreciation",3794.53,"",4518417.42
,"General Journal","10-07-2024","24248",,,"Toilet Cleaner Mixing Machine Depreciation","Expense","Depreciation Expense",,"Accumulated Depreciation",6333.33,"",4524750.75
,"General Journal","11-07-2024","24249",,,"4 GB hard drive for CCTV Depreciation","Expense","Depreciation Expense",,"Accumulated Depreciation",178.57,"",4524929.32
,"General Journal","11-07-2024","24250",,,"4TB Hard Disk Depreciation","Expense","Depreciation Expense",,"Accumulated Depreciation",178.57,"",4525107.89
,"General Journal","11-07-2024","24251","*","Unilever Kenya Ltd:Sunlight Washing Pwd","Chain block trolley 4 depreciation","Expense","Depreciation Expense",,"Accumulated Depreciation",85.00,"",4525192.89
,"General Journal","11-07-2024","24252",,,"Coder Depreciation","Expense","Depreciation Expense",,"Accumulated Depreciation",2261.90,"",4527454.79
,"General Journal","11-07-2024","24253",,,"Coder Stand Depreciation","Expense","Depreciation Expense",,"Accumulated Depreciation",59.52,"",4527514.31
,"General Journal","11-07-2024","24254",,,"Compressor 1 depreciation","Expense","Depreciation Expense",,"Accumulated depreciation",3750.00,"",4531264.31
,"General Journal","11-07-2024","24255",,,"HP Laptop 14 Depreciation","Expense","Depreciation Expense",,"Accumulated Depreciation",1941.67,"",4533205.98
,"General Journal","11-07-2024","24256",,,"HP Laptop 15 Depreciation","Expense","Depreciation Expense",,"Accumulated Depreciation",1750.00,"",4534955.98
,"General Journal","11-07-2024","24257",,,"Pallet truck 2 depreciation","Expense","Depreciation Expense",,"Accumulated depreciation",440.48,"",4535396.46
,"General Journal","11-07-2024","24258","*",,"Steam Label Shrink Tunnel Depreciation","Expense","Depreciation Expense",,"Accumulated  Depreciation",10952.38,"",4546348.84
,"General Journal","12-07-2024","24259",,,"Coder Housing Depreciation","Expense","Depreciation Expense",,"Accumulated Depreciation",80.36,"",4546429.20
,"General Journal","12-07-2024","24260","*","Unilever Kenya Ltd:Sunlight Washing Pwd","Coder UPS 4 Depreciation","Expense","Depreciation Expense",,"Accumulated Depreciation",158.33,"",4546587.53
,"General Journal","12-07-2024","24261",,,"Coding Conveyor Depreciation","Expense","Depreciation Expense",,"Accumulated Depreciation",476.19,"",4547063.72
,"General Journal","12-07-2024","24262",,,"Conveyor 2 Depreciation","Expense","Depreciation Expense",,"Accumulated  Depreciation",169.64,"",4547233.36
,"General Journal","12-07-2024","24263",,,"Eyewash Station 1 Depreciation","Expense","Depreciation Expense",,"Accumulated Depreciation",904.76,"",4548138.12
,"General Journal","12-07-2024","24264",,,"HP Laptop 5 Depreciation","Expense","Depreciation Expense",,"Accumulated Depreciation",416.67,"",4548554.79
,"General Journal","12-07-2024","24265",,,"Tea maker Depreciation","Expense","Depreciation Expense",,"Accumulated Depreciation",225.00,"",4548779.79
,"General Journal","13-07-2024","24269",,,"Alarm System Depreciation","Expense","Depreciation Expense",,"Accumulated Depreciation",580.95,"",4549360.74
,"General Journal","13-07-2024","24275",,,"Bosch Blower 2 Depreciation","Expense","Depreciation Expense",,"Accumulated Depreciation",136.49,"",4549497.23
,"General Journal","13-07-2024","24303",,,"Coder UPS 8 Depreciation","Expense","Depreciation Expense",,"Accumulated Depreciation",81.67,"",4549578.90
,"General Journal","13-07-2024","24315","*",,"HP Laptop 16 Depreciation","Expense","Depreciation Expense",,"Accumulated Depreciation",1000.00,"",4550578.90
,"General Journal","13-07-2024","24321",,,"PIR system extension Depreciation","Expense","Depreciation Expense",,"Accumulated Depreciation",254.67,"",4550833.57
,"General Journal","13-07-2024","24322",,,"Process Water Storage Tank Depreciation","Expense","Depreciation Expense",,"Accumulated Depreciation",1065.16,"",4551898.73
,"General Journal","13-07-2024","24323","*",,"Store Racking 3 FG Depreciation","Expense","Depreciation Expense",,"Accumulated Depreciation",9791.67,"",4561690.40
,"General Journal","13-07-2024","24327",,,"Weighing scale 1","Expense","Depreciation Expense",,"Accumulated Depreciation",559.52,"",4562249.92
,"General Journal","13-07-2024","25175",,,"HP Mini Desktop 4 Depreciation","Expense","Depreciation Expense",,"Accumulated Depreciation",466.67,"",4562716.59
,"General Journal","14-07-2024","24302",,,"Coder UPS 5 Depreciation","Expense","Depreciation Expense",,"Accumulated Depreciation",158.33,"",4562874.92
,"General Journal","14-07-2024","24318",,,"Motor Vehicle 2 Depreciation","Expense","Depreciation Expense",,"Accumulated Depreciation",10297.62,"",4573172.54
,"General Journal","14-07-2024","24320",,,"Paste Packing Machine Depreciation","Expense","Depreciation Expense",,"Accumulated Depreciation",4166.67,"",4577339.21
,"General Journal","14-07-2024","24324",,,"Table Top Scale 10  SS 15Kg Depreciation","Expense","Depreciation Expense",,"Accumulated Depreciation",297.62,"",4577636.83
,"General Journal","15-07-2024","24266",,,"150KVA Enclosed Genset Depreciation","Expense","Depreciation Expense",,"Accumulated Depreciation",24404.76,"",4602041.59
,"General Journal","15-07-2024","24267",,,"20Kg Forklift Gas Cylinder 2 Depreciation","Expense","Depreciation Expense",,"Accumulated Depreciation",769.70,"",4602811.29
,"General Journal","15-07-2024","24268",,,"2Ton Electric Hoist 1 Depreciation","Expense","Depreciation Expense",,"Accumulated Depreciation",3708.33,"",4606519.62
,"General Journal","15-07-2024","24270",,,"Automatic Change Over Switch 1 Depreciation","Expense","Depreciation Expense",,"Accumulated Depreciation",1666.67,"",4608186.29
,"General Journal","15-07-2024","24271",,,"Bench top Weighing Scale 1 Depreciation","Expense","Depreciation Expense",,"Accumulated Depreciation",357.14,"",4608543.43
,"General Journal","15-07-2024","24272",,,"Bench top Weighing Scale 2 Depreciation","Expense","Depreciation Expense",,"Accumulated Depreciation",357.14,"",4608900.57
,"General Journal","15-07-2024","24273",,,"Bench top Weighing Scale 3 Depreciation","Expense","Depreciation Expense",,"Accumulated Depreciation",357.14,"",4609257.71
,"General Journal","15-07-2024","24274",,,"Bench top Weighing Scale 4 Depreciation","Expense","Depreciation Expense",,"Accumulated Depreciation",357.14,"",4609614.85
,"General Journal","15-07-2024","24276",,,"Bosch Blower Depreciation","Expense","Depreciation Expense",,"Accumulated Depreciation",129.31,"",4609744.16
,"General Journal","15-07-2024","24277",,,"Canteen Chair 1 Depreciation","Expense","Depreciation Expense",,"Accumulated Depreciation",6.12,"",4609750.28
,"General Journal","15-07-2024","24278",,,"Canteen Chair 10 Depreciation","Expense","Depreciation Expense",,"Accumulated Depreciation",6.12,"",4609756.40
,"General Journal","15-07-2024","24279",,,"Canteen Chair 11 Depreciation","Expense","Depreciation Expense",,"Accumulated Depreciation",6.12,"",4609762.52
,"General Journal","15-07-2024","24280",,,"Canteen Chair 11 Depreciation","Expense","Depreciation Expense",,"Accumulated Depreciation",6.12,"",4609768.64
,"General Journal","15-07-2024","24281",,,"Canteen Chair 12 Depreciation","Expense","Depreciation Expense",,"Accumulated Depreciation",6.12,"",4609774.76
,"General Journal","15-07-2024","24282",,,"Canteen Chair 13 Depreciation","Expense","Depreciation Expense",,"Accumulated Depreciation",6.12,"",4609780.88
,"General Journal","15-07-2024","24283",,,"Canteen Chair 14 Depreciation","Expense","Depreciation Expense",,"Accumulated Depreciation",6.12,"",4609787.00
,"General Journal","15-07-2024","24284",,,"Canteen Chair 15 Depreciation","Expense","Depreciation Expense",,"Accumulated Depreciation",6.12,"",4609793.12
,"General Journal","15-07-2024","24285",,,"Canteen Chair 16 Depreciation","Expense","Depreciation Expense",,"Accumulated Depreciation",6.12,"",4609799.24
,"General Journal","15-07-2024","24286",,,"Canteen Chair 17 Depreciation","Expense","Depreciation Expense",,"Accumulated Depreciation",6.12,"",4609805.36
,"General Journal","15-07-2024","24287",,,"Canteen Chair 18 Depreciation","Expense","Depreciation Expense",,"Accumulated Depreciation",6.12,"",4609811.48
,"General Journal","15-07-2024","24288",,,"Canteen Chair 19 Depreciation","Expense","Depreciation Expense",,"Accumulated Depreciation",6.12,"",4609817.60
,"General Journal","15-07-2024","24289",,,"Canteen Chair 2 Depreciation","Expense","Depreciation Expense",,"Accumulated Depreciation",6.12,"",4609823.72
,"General Journal","15-07-2024","24290",,,"Canteen Chair 21 Depreciation","Expense","Depreciation Expense",,"Accumulated Depreciation",6.12,"",4609829.84
,"General Journal","15-07-2024","24291",,,"Canteen Chair 22 Depreciation","Expense","Depreciation Expense",,"Accumulated Depreciation",6.12,"",4609835.96
,"General Journal","15-07-2024","24292",,,"Canteen Chair 23 Depreciation","Expense","Depreciation Expense",,"Accumulated Depreciation",6.12,"",4609842.08
,"General Journal","15-07-2024","24293",,,"Canteen Chair 24 Depreciation","Expense","Depreciation Expense",,"Accumulated Depreciation",6.12,"",4609848.20
,"General Journal","15-07-2024","24294",,,"Canteen Chair 25 Depreciation","Expense","Depreciation Expense",,"Accumulated Depreciation",6.12,"",4609854.32
,"General Journal","15-07-2024","24295",,,"Canteen Chair 3 Depreciation","Expense","Depreciation Expense",,"Accumulated Depreciation",6.12,"",4609860.44
,"General Journal","15-07-2024","24296",,,"Canteen Chair 4 Depreciation","Expense","Depreciation Expense",,"Accumulated Depreciation",6.12,"",4609866.56
,"General Journal","15-07-2024","24297",,,"Canteen Chair 5 Depreciation","Expense","Depreciation Expense",,"Accumulated Depreciation",6.12,"",4609872.68
,"General Journal","15-07-2024","24298",,,"Canteen Chair 6 Depreciation","Expense","Depreciation Expense",,"Accumulated Depreciation",6.12,"",4609878.80
,"General Journal","15-07-2024","24299",,,"Canteen Chair 7 Depreciation","Expense","Depreciation Expense",,"Accumulated Depreciation",6.12,"",4609884.92
,"General Journal","15-07-2024","24300",,,"Canteen Chair 8 Depreciation","Expense","Depreciation Expense",,"Accumulated Depreciation",6.12,"",4609891.04
,"General Journal","15-07-2024","24301",,,"Canteen Chair 9 Depreciation","Expense","Depreciation Expense",,"Accumulated Depreciation",6.12,"",4609897.16
,"General Journal","15-07-2024","24304",,,"EOL Case sealer Outfeed Conveyor Depreciation","Expense","Depreciation Expense",,"Accumulated Depreciation",297.62,"",4610194.78
,"General Journal","15-07-2024","24305",,,"Epson L6190 Printer 1 Depreciation","Expense","Depreciation Expense",,"Accumulated Depreciation",654.76,"",4610849.54
,"General Journal","15-07-2024","24306",,,"Fire Extinguisher 1 Depreciation","Expense","Depreciation Expense",,"Accumulated Depreciation",77.38,"",4610926.92
,"General Journal","15-07-2024","24307",,,"Fire Extinguisher 2 Depreciation","Expense","Depreciation Expense",,"Accumulated Depreciation",77.38,"",4611004.30
,"General Journal","15-07-2024","24308",,,"Fire Extinguisher 3 Depreciation","Expense","Depreciation Expense",,"Accumulated Depreciation",77.38,"",4611081.68
,"General Journal","15-07-2024","24309",,,"Fire Extinguisher 4 Depreciation","Expense","Depreciation Expense",,"Accumulated Depreciation",77.38,"",4611159.06
,"General Journal","15-07-2024","24310",,,"Fire Extinguisher 5 Depreciation","Expense","Depreciation Expense",,"Accumulated Depreciation",77.38,"",4611236.44
,"General Journal","15-07-2024","24311",,,"Fire Extinguisher 6 Depreciation","Expense","Depreciation Expense",,"Accumulated Depreciation",77.38,"",4611313.82
,"General Journal","15-07-2024","24312",,,"Grinder 2 Depreciation","Expense","Depreciation Expense",,"Accumulated Depreciation",178.57,"",4611492.39
,"General Journal","15-07-2024","24313",,,"HP Laptop 11 Depreciation","Expense","Depreciation Expense",,"Accumulated Depreciation",1200.00,"",4612692.39
,"General Journal","15-07-2024","24314",,,"HP Laptop 12 Depreciation","Expense","Depreciation Expense",,"Accumulated Depreciation",1200.00,"",4613892.39
,"General Journal","15-07-2024","24316",,,"Microwave 2 Depreciation","Expense","Depreciation Expense",,"Accumulated Depreciation",147.27,"",4614039.66
,"General Journal","15-07-2024","24317",,,"Mobile phone 3 Depreciation","Expense","Depreciation Expense",,"Accumulated Depreciation",41.67,"",4614081.33
,"General Journal","15-07-2024","24319",,,"Movable Ladder 1 Depreciation","Expense","Depreciation Expense",,"Accumulated Depreciation",434.52,"",4614515.85
,"General Journal","15-07-2024","24325",,,"UV water purifier 3 Depreciation","Expense","Depreciation Expense",,"Accumulated Depreciation",543.10,"",4615058.95
,"General Journal","15-07-2024","24326",,,"Water tank 6 Depreciation","Expense","Depreciation Expense",,"Accumulated Depreciation",71.84,"",4615130.79
,"General Journal","16-07-2024","24328",,,"Bosch Grinder 3 Depreciation","Expense","Depreciation Expense",,"Accumulated Depreceiation",86.21,"",4615217.00
,"General Journal","16-07-2024","24329",,,"Chain block 5 depreciation","Expense","Depreciation Expense",,"Accumulated Depreciation",292.49,"",4615509.49
,"General Journal","16-07-2024","24330",,,"Chain block 6 depreciation","Expense","Depreciation Expense",,"Accumulated Depreciation",292.49,"",4615801.98
,"General Journal","16-07-2024","24331",,,"Heat Gun Total 1 Depreciation","Expense","Depreciation Expense",,"Accumulated Depreciation",64.66,"",4615866.64
,"General Journal","16-07-2024","24332",,,"Linx 5900 Coder 1 Depreciation","Expense","Depreciation Expense",,"Accumulated Depreciation",4166.67,"",4620033.31
,"General Journal","16-07-2024","24333",,,"Table Top Scale 11 6Kg Depreciation","Expense","Depreciation Expense",,"Accumulated Depreciation",277.09,"",4620310.40
,"General Journal","16-07-2024","24334",,,"Washing Machine 1 Depreciation","Expense","Depreciation Expense",,"Accumulated Depreciation",2640.01,"",4622950.41
,"General Journal","17-07-2024","24335",,,"2T Mixer Depreciation","Expense","Depreciation Expense",,"Accumulated Depreciation",12633.99,"",4635584.40
,"General Journal","17-07-2024","24336",,,"2T Mixer Installation Depreciation","Expense","Depreciation Expense",,"Accumulated Depreciation",29713.15,"",4665297.55
,"General Journal","17-07-2024","24337",,,"Coder UPS 6 Depreciation","Expense","Depreciation Expense",,"Accumulated Depreciation",94.83,"",4665392.38
,"General Journal","17-07-2024","24338",,,"Coder UPS 7 Depreciation","Expense","Depreciation Expense",,"Accumulated Depreciation",94.83,"",4665487.21
,"General Journal","17-07-2024","24339","*",,"Hand Dryer 1 Depreciation","Expense","Depreciation Expense",,"Accumulated Depreciation",46.18,"",4665533.39
,"General Journal","17-07-2024","24340","*",,"HP Laptop 3 Depreciation","Expense","Depreciation Expense",,"Accumulated Depreciation",297.62,"",4665831.01
,"General Journal","17-07-2024","24341",,,"Office desks  4","Expense","Depreciation Expense",,"Accumulated Depreciation",361.90,"",4666192.91
,"General Journal","17-07-2024","24342",,,"Pallet truck 4 Depreciation","Expense","Depreciation Expense",,"Accumulated Depreciation",428.57,"",4666621.48
,"General Journal","17-07-2024","24343",,,"Pallet truck 5 Depreciation","Expense","Depreciation Expense",,"Accumulated Depreciation",428.57,"",4667050.05
,"General Journal","17-07-2024","24344",,,"Recirculation Pump Depreciation","Expense","Depreciation Expense",,"Accumulated  Depreciation",71.19,"",4667121.24
,"General Journal","17-07-2024","24345",,,"Server 1 Depreciation","Expense","Depreciation Expense",,"Accumulated Depreciation",357.14,"",4667478.38
,"General Journal","17-07-2024","24346",,,"Server Monitor Depreciation","Expense","Depreciation Expense",,"Accumulated Depreciaion",107.14,"",4667585.52
,"General Journal","17-07-2024","24347",,,"Shrink Tunnel Depreciation","Expense","Depreciation Expense",,"Accumulated Depreciation",3750.00,"",4671335.52
,"General Journal","17-07-2024","24348","*",,"Soap Dispenser 1 Depreciation","Expense","Depreciation Expense",,"Accumulated Depreciation",15.39,"",4671350.91
,"General Journal","17-07-2024","24349","*",,"TP Link 3 Depreciation","Expense","Depreciation Expense",,"Accumulated Depreciation",33.33,"",4671384.24
,"General Journal","17-07-2024","24350","*",,"Water Tank 3 Depreciation","Expense","Depreciation Expense",,"Accumulated Depreciation",123.15,"",4671507.39
,"General Journal","18-07-2024","24352",,,"Carton Sealer Manual 1 Depreciation","Expense","Depreciation Expense",,"Accumulated Depreciation",14.80,"",4671522.19
,"General Journal","18-07-2024","24353",,,"Compressor 3 Depreciation","Expense","Depreciation Expense",,"Accumulated Depreciation",5357.14,"",4676879.33
,"General Journal","18-07-2024","24354",,,"Compressor room depreciation","Expense","Depreciation Expense",,"Accumulated depreciation",132.44,"",4677011.77
,"General Journal","18-07-2024","24355",,,"Electric Hoist 1 depreciation","Expense","Depreciation Expense",,"Accumulated depreciation",3452.38,"",4680464.15
,"General Journal","18-07-2024","24356",,,"Gents changing room Lockers Depreciation","Expense","Depreciation Expense",,"Accumulated Depreciation",386.90,"",4680851.05
,"General Journal","18-07-2024","24357",,,"HP Mini Desktop 1 Depreciation","Expense","Depreciation Expense",,"Accumulated Depreciation",733.33,"",4681584.38
,"General Journal","18-07-2024","24358",,,"HP Mini Desktop 2 Depreciation","Expense","Depreciation Expense",,"Accumulated Depreciation",733.33,"",4682317.71
,"General Journal","18-07-2024","24359",,,"HP Mini Desktop 3 Depreciation","Expense","Depreciation Expense",,"Accumulated Depreciation",733.33,"",4683051.04
,"General Journal","18-07-2024","24360",,,"Ladies changing room Lockers Depreciation","Expense","Depreciation Expense",,"Accumulated Depreciation",411.90,"",4683462.94
,"General Journal","18-07-2024","24361",,,"Omrom M1 Basic BP Monitor Depreciation","Expense","Depreciation Expense",,"Accumulated Depreciation",58.33,"",4683521.27
,"General Journal","18-07-2024","24362",,,"SS Hand Washing Station 1 Depreciation","Expense","Depreciation Expense",,"Accumulated Depreciation",690.48,"",4684211.75
,"General Journal","18-07-2024","24363",,,"TP Link 2 Depreciation","Expense","Depreciation Expense",,"Accumulated Depreciation",41.67,"",4684253.42
,"General Journal","18-07-2024","24364",,,"TV Screen 3 Depreciation","Expense","Depreciation Expense",,"Accumulated Depreciation",316.67,"",4684570.09
,"General Journal","18-07-2024","24365",,,"TV Screen 4 Depreciation","Expense","Depreciation Expense",,"Accumulated Depreciation",1550.00,"",4686120.09
,"General Journal","19-07-2024","24366",,,"3T Gas Forklift 1 Depreciation","Expense","Depreciation Expense",,"Accumulated Depreciation",30952.38,"",4717072.47
,"General Journal","19-07-2024","24367",,,"Coding Stamp 3 Depreciation","Expense","Depreciation Expense",,"Accumulated Depreciation",143.68,"",4717216.15
,"General Journal","19-07-2024","25196",,,"Office Stamp 2 Depreciation","Expense","Depreciation Expense",,"Accumulated Depreciaion",30.83,"",4717246.98
,"General Journal","20-07-2024","24369","*","Unilever Kenya Ltd:Sunlight Washing Pwd","Boato Commisioning Depreciation","Expense","Depreciation Expense",,"Accumulated Depreciation",889.88,"",4718136.86
,"General Journal","20-07-2024","24370",,,"Bosch Blower 3 Depreciation","Expense","Depreciation Expense",,"Accumulated Depreciation",79.02,"",4718215.88
,"General Journal","20-07-2024","24371",,,"Bosch Blower 4 Depreciation","Expense","Depreciation Expense",,"Accumulated Depreciation",136.49,"",4718352.37
,"General Journal","20-07-2024","24372",,,"Bosch Blower 5 Depreciation","Expense","Depreciation Expense",,"Accumulated Depreciation",136.49,"",4718488.86
,"General Journal","20-07-2024","24373",,,"Conference Office Desk 1 Depreciation","Expense","Depreciation Expense",,"Accumulated Depreciation",416.67,"",4718905.53
,"General Journal","20-07-2024","24374",,,"Floor Chair 17 depreciation","Expense","Depreciation Expense",,"Accumulated Depreciation",20.24,"",4718925.77
,"General Journal","20-07-2024","24375",,,"Floor Chair 18 depreciation","Expense","Depreciation Expense",,"Accumulated Depreciation",20.24,"",4718946.01
,"General Journal","20-07-2024","24376",,,"Floor Chair 19 depreciation","Expense","Depreciation Expense",,"Accumulated Depreciation",20.24,"",4718966.25
,"General Journal","20-07-2024","24377",,,"Floor Chair 20 depreciation","Expense","Depreciation Expense",,"Accumulated Depreciation",20.24,"",4718986.49
,"General Journal","20-07-2024","24378",,,"Heat Gun CAT Digital 1 Depreciation","Expense","Depreciation Expense",,"Accumulated Depreciation",136.49,"",4719122.98
,"General Journal","20-07-2024","24379","*",,"Lumnia 1 Pro Insect Trap Depreciation","Expense","Depreciation Expense",,"Accumulated Depreciation",316.67,"",4719439.65
,"General Journal","20-07-2024","24381",,,"PF Correction Unit Depreciation","Expense","Depreciation Expense",,"Accumulated Depreciation",1708.33,"",4721147.98
,"General Journal","21-07-2024","24382",,,"5Kg CO2 Fire Extinguisher 2 Depreciation","Expense","Depreciation Expense",,"Accumulated Depreciation",73.81,"",4721221.79
,"General Journal","21-07-2024","24383",,,"6Kg Dry Pwd Fire Extinguisher 1 Depreciaiton","Expense","Depreciation Expense",,"Accumulated Depreciation",59.52,"",4721281.31
,"General Journal","21-07-2024","24384",,,"Board room chair 1 Depreciation","Expense","Depreciation Expense",,"Accumulated Depreciation",59.52,"",4721340.83
,"General Journal","21-07-2024","24385",,,"Board room chair 2 Depreciation","Expense","Depreciation Expense",,"Accumulated Depreciation",59.52,"",4721400.35
,"General Journal","21-07-2024","24386",,,"Board room chair 4 Depreciation","Expense","Depreciation Expense",,"Accumulated Depreciation",59.52,"",4721459.87
,"General Journal","21-07-2024","24387",,,"Board room chair 5 Depreciation","Expense","Depreciation Expense",,"Accumulated Depreciation",59.52,"",4721519.39
,"General Journal","21-07-2024","24388",,,"Board room chair 6 Depreciation","Expense","Depreciation Expense",,"Accumulated Depreciation",59.52,"",4721578.91
,"General Journal","21-07-2024","24389",,,"Board room chair 7 Depreciation","Expense","Depreciation Expense",,"Accumulated Depreciation",59.52,"",4721638.43
,"General Journal","21-07-2024","24390",,,"Board room chair 8 Depreciation","Expense","Depreciation Expense",,"Accumulated Depreciation",59.52,"",4721697.95
,"General Journal","21-07-2024","24391",,,"Coding Stamp 2 Depreciation","Expense","Depreciation Expense",,"Accumulated Depreciation",133.33,"",4721831.28
,"General Journal","21-07-2024","24392",,,"IBC Tank 1 Depreciation","Expense","Depreciation Expense",,"Accumulated Depreciation",41.67,"",4721872.95
,"General Journal","21-07-2024","24393",,,"Empty IBC Tank 2 Depreciation","Expense","Depreciation Expense",,"Accumulated Depreciation",65.48,"",4721938.43
,"General Journal","21-07-2024","24394",,,"FFS Filling Machine 300 1 Depreciation","Expense","Depreciation Expense",,"Accumulated Depreciation",11850.01,"",4733788.44
,"General Journal","21-07-2024","24395",,,"Laboratory Oven & Dessicator  Depreciation","Expense","Depreciation Expense",,"Accumulated Depreciation",766.67,"",4734555.11
,"General Journal","21-07-2024","24396",,,"Nikon D3500 Camera 1 Depreciation","Expense","Depreciation Expense",,"Accumulated Depreciation",766.67,"",4735321.78
,"General Journal","21-07-2024","24397",,,"Tea Urn Depreciation","Expense","Depreciation Expense",,"Accumulated Depreciation",121.67,"",4735443.45
,"General Journal","22-07-2024","24398",,,"6Kg Auto Fire Extinguisher 1 Depreciation","Expense","Depreciation Expense",,"Accumulated Depreciation",53.57,"",4735497.02
,"General Journal","22-07-2024","24399",,,"6Kg Auto Fire Extinguisher 2 Depreciation","Expense","Depreciation Expense",,"Accumulated Depreciation",53.57,"",4735550.59
,"General Journal","22-07-2024","24400","*",,"AVS Voltage Stabilizer Depreciation","Expense","Depreciation Expense",,"Accumulated Depreciation",63.10,"",4735613.69
,"General Journal","22-07-2024","24401",,,"Conveyor Belt Green 1 Depreciation","Expense","Depreciation Expense",,"Accumulated Depreciation",82.14,"",4735695.83
,"General Journal","22-07-2024","24402",,,"HP Laptop 13 Depreciation","Expense","Depreciation Expense",,"Accumulated Depreciation",1200.00,"",4736895.83
,"General Journal","22-07-2024","24403","*",,"HP Laptop 7 Depreciation","Expense","Depreciation Expense",,"Accumulated Depreciation",1200.00,"",4738095.83
,"General Journal","22-07-2024","24404",,,"Office Desk 5 Depreciation","Expense","Depreciation Expense",,"Accumulated Depreciation",180.95,"",4738276.78
,"General Journal","22-07-2024","24405",,,"Office cabinets depreciation","Expense","Depreciation Expense",,"Accumulated Depreciation",119.05,"",4738395.83
,"General Journal","22-07-2024","24406",,,"Platform Scale 2 SS 100Kg Depreciation","Expense","Depreciation Expense",,"Accumulated Depreciation",339.29,"",4738735.12
,"General Journal","22-07-2024","24407",,,"Solar Water Heater 300L Depreciation","Expense","Depreciation Expense",,"Accumulated Depreciation",3125.00,"",4741860.12
,"General Journal","23-07-2024","24408",,,"Analytical Balance Depreciation","Expense","Depreciation Expense",,"Accumulated Depreciation",2405.58,"",4744265.70
,"General Journal","23-07-2024","24409",,,"Auger Filler 1 Depreciation","Expense","Depreciation Expense",,"Accumulated Depreciation",7220.12,"",4751485.82
,"General Journal","23-07-2024","24410",,,"Auger Filler 2 Depreciation","Expense","Depreciation Expense",,"Accumulated Depreciation",13258.63,"",4764744.45
,"General Journal","23-07-2024","24411",,,"Auger Filler 3 Depreciation","Expense","Depreciation Expense",,"Accumulated Depreciation",11788.69,"",4776533.14
,"General Journal","23-07-2024","24412",,,"Bajaj Boxer BM150 UG Depreciation","Expense","Depreciation Expense",,"Accumulated Depreciation",1539.41,"",4778072.55
,"General Journal","23-07-2024","24413",,,"Chain block 4 depreciation","Expense","Depreciation Expense",,"Accumulated Depreciation",133.42,"",4778205.97
,"General Journal","23-07-2024","24414",,,"Coder UPS Depreciation","Expense","Depreciation Expense",,"Accumulated Depreciation",95.24,"",4778301.21
,"General Journal","23-07-2024","24415",,,"Dust Extractor 1 Depreciation","Expense","Depreciation Expense",,"Accumulated Depreciation",446.43,"",4778747.64
,"General Journal","23-07-2024","24416",,,"Dust Extractor 2 Depreciation","Expense","Depreciation Expense",,"Accumulated Depreciation",446.43,"",4779194.07
,"General Journal","23-07-2024","24417",,,"Filler 1 Geared Motor & Feeding System Depreciation","Expense","Depreciation Expense",,"Accumulated Depreciation",333.33,"",4779527.40
,"General Journal","23-07-2024","24418",,,"Filler 2 Geared Motor & Feeding System Depreciation","Expense","Depreciation Expense",,"Accumulated Depreciation",348.72,"",4779876.12
,"General Journal","23-07-2024","24419",,,"Filler 3 Geared Motor & Feeding System Depreciation","Expense","Depreciation Expense",,"Accumulated Depreciation",347.52,"",4780223.64
,"General Journal","23-07-2024","24420",,,"Hotplate with Stirrer Depreciation","Expense","Depreciation Expense",,"Accumulated Depreciation",1785.71,"",4782009.35
,"General Journal","23-07-2024","24421",,,"Makita Hammer Drill Depreciation","Expense","Depreciation Expense",,"Accumulated Depreciation",205.25,"",4782214.60
,"General Journal","23-07-2024","24422",,,"Microwave 1 Depreciation","Expense","Depreciation Expense",,"Accumulated Depreciation",217.13,"",4782431.73
,"General Journal","23-07-2024","24423",,,"Pallet truck 3 Dep","Expense","Depreciation Expense",,"Accumulated Depreciation",510.95,"",4782942.68
,"General Journal","23-07-2024","24424",,,"Pouching Machine Depreciation","Expense","Depreciation Expense",,"Accumulated Depreciation",711.90,"",4783654.58
,"General Journal","23-07-2024","24425",,,"Power bank dep","Expense","Depreciation Expense",,"Accumulated Depreciation",119.05,"",4783773.63
,"General Journal","23-07-2024","24426",,,"Table Top Scale 11  SS 30Kg Depreciation","Expense","Depreciation Expense",,"Accumulated Depreciation",297.62,"",4784071.25
,"General Journal","23-07-2024","24427",,,"Table Top Scale 12  SS 30Kg Depreciation","Expense","Depreciation Expense",,"Accumulated Depreciation",297.62,"",4784368.87
,"General Journal","24-07-2024","24431",,,"Access Control Unit & System Depreciation","Expense","Depreciation Expense",,"Accumulated Depreciation",334.76,"",4784703.63
,"General Journal","24-07-2024","24433",,,"Electrical Enclosure Compressor Depreciation","Expense","Depreciation Expense",,"Accumulated Depreciation",125.00,"",4784828.63
,"General Journal","24-07-2024","24434",,,"ETR Machine Depreciation","Expense","Depreciation Expense",,"Accumulated Depreciation",236.04,"",4785064.67
,"General Journal","24-07-2024","24435",,,"Liquid Plant Depreciation","Expense","Depreciation Expense",,"Accumulated Deprecation",15029.76,"",4800094.43
,"General Journal","24-07-2024","24436",,,"Paste processing & packing line depreciation","Expense","Depreciation Expense",,"Accumulated Depreciation",17348.21,"",4817442.64
,"General Journal","24-07-2024","24437",,,"pH Meter Depreciation","Expense","Depreciation Expense",,"Accumulated Depreciation",741.39,"",4818184.03
,"General Journal","25-07-2024","24453",,,"Clamp Meter 1 Depreciation","Expense","Depreciation Expense",,"Accumulated Depreciation",36.90,"",4818220.93
,"General Journal","25-07-2024","24454",,,"Fire Alarm Sytstem Depreciation","Expense","Depreciation Expense",,"Accumulated Depreciation",728.57,"",4818949.50
,"General Journal","25-07-2024","24455",,,"Floor Chair 11 Depreciation","Expense","Depreciation Expense",,"Accumulated Depreciation",53.57,"",4819003.07
,"General Journal","25-07-2024","24456",,,"Floor Chair 12 Depreciation","Expense","Depreciation Expense",,"Accumulated Depreciation",53.57,"",4819056.64
,"General Journal","25-07-2024","24457",,,"Floor Chair 13 Depreciation","Expense","Depreciation Expense",,"Accumulated Depreciation",53.57,"",4819110.21
,"General Journal","25-07-2024","24458",,,"Floor Chair 14 Depreciation","Expense","Depreciation Expense",,"Accumulated Depreciation",53.57,"",4819163.78
,"General Journal","25-07-2024","24459",,,"Floor Chair 15 Depreciation","Expense","Depreciation Expense",,"Accumulated Depreciation",53.57,"",4819217.35
,"General Journal","25-07-2024","24460",,,"Floor Chair 16 Depreciation","Expense","Depreciation Expense",,"Accumulated Depreciation",53.57,"",4819270.92
,"General Journal","25-07-2024","24461",,,"Liquid Mixer 500Lt Depreciation","Expense","Depreciation Expense",,"Accumulated Depreciation",6172.62,"",4825443.54
,"General Journal","25-07-2024","24463",,,"Plastic Resin Mixer Depreciation","Expense","Depreciation Expense",,"Accumulated  Depreciation",1130.95,"",4826574.49
,"General Journal","25-07-2024","24464",,,"Plastic Resin Mixer Depreciation","Expense","Depreciation Expense",,"Accumulated  Depreciation",1130.95,"",4827705.44
,"General Journal","25-07-2024","25189",,,"Water tank 7 Depreciation","Expense","Depreciation Expense",,"Accumulated Depreciation",71.84,"",4827777.28
,"General Journal","26-07-2024","24465",,,"Dell Desktop 2 Depreciation","Expense","Depreciation Expense",,"Accumulated Depreciation",229.17,"",4828006.45
,"General Journal","26-07-2024","24466",,,"Dell Desktop 3 Depreciation","Expense","Depreciation Expense",,"Accumulated Depreciation",229.17,"",4828235.62
,"General Journal","26-07-2024","24467",,,"Dell Desktop 4 Depreciation","Expense","Depreciation Expense",,"Accumulated Depreciation",229.17,"",4828464.79
,"General Journal","26-07-2024","24468",,,"Grease Gun 1 Depreciation","Expense","Depreciation Expense",,"Accumulated Depreciation",73.21,"",4828538.00
,"General Journal","26-07-2024","24469",,,"Grease Gun 2 Depreciation","Expense","Depreciation Expense",,"Accumulated Depreciation",63.14,"",4828601.14
,"General Journal","26-07-2024","24470",,,"Retort Stand 1 Depreciation","Expense","Depreciation Expense",,"Accumulated Depreciation",10.71,"",4828611.85
,"General Journal","26-07-2024","24471",,,"Retort Stand 2 Depreciation","Expense","Depreciation Expense",,"Accumulated Depreciation",10.71,"",4828622.56
,"General Journal","26-07-2024","25192",,,"Tea Urn 2 Depreciation","Expense","Depreciation Expense",,"Accumulated Depreciation",180.00,"",4828802.56
,"General Journal","26-07-2024","25198",,,"Tea Urn 2 Depreciation","Expense","Depreciation Expense",,"Accumulated Depreciation",180.00,"",4828982.56
,"General Journal","27-07-2024","24472",,,"Board room chair 10 Depreciation","Expense","Depreciation Expense",,"Accumulated Depreciation",79.55,"",4829062.11
,"General Journal","27-07-2024","24473",,,"Board room chair 11 Depreciation","Expense","Depreciation Expense",,"Accumulated Depreciation",79.55,"",4829141.66
,"General Journal","27-07-2024","24474",,,"Board room chair 12 Depreciation","Expense","Depreciation Expense",,"Accumulated Depreciation",79.55,"",4829221.21
,"General Journal","27-07-2024","24475",,,"Board room chair 13 Depreciation","Expense","Depreciation Expense",,"Accumulated Depreciation",79.55,"",4829300.76
,"General Journal","27-07-2024","24476",,,"Board room chair 14 Depreciation","Expense","Depreciation Expense",,"Accumulated Depreciation",79.55,"",4829380.31
,"General Journal","27-07-2024","24477",,,"Board room chair 15 Depreciation","Expense","Depreciation Expense",,"Accumulated Depreciation",79.55,"",4829459.86
,"General Journal","27-07-2024","24478",,,"Board room chair 16 Depreciation","Expense","Depreciation Expense",,"Accumulated Depreciation",79.55,"",4829539.41
,"General Journal","27-07-2024","24479",,,"Board room chair 17 Depreciation","Expense","Depreciation Expense",,"Accumulated Depreciation",79.55,"",4829618.96
,"General Journal","27-07-2024","24480",,,"Board room chair 18 Depreciation","Expense","Depreciation Expense",,"Accumulated Depreciation",79.55,"",4829698.51
,"General Journal","27-07-2024","24481",,,"Board room chair 19 Depreciation","Expense","Depreciation Expense",,"Accumulated Depreciation",79.55,"",4829778.06
,"General Journal","27-07-2024","24483",,,"Board room chair 9 Depreciation","Expense","Depreciation Expense",,"Accumulated Depreciation",79.55,"",4829857.61
,"General Journal","27-07-2024","24484",,,"Passenger Lift 1000kg Depreciation","Expense","Depreciation Expense",,"Accumulated Depreciation",44484.68,"",4874342.29
,"General Journal","28-07-2024","25165",,,"Heat Gun Bosch 2 Accumulated depreciation","Expense","Depreciation Expense",,"Accumulated Depreciation",75.43,"",4874417.72
,"General Journal","28-07-2024","25171",,,"Heat Gun Bosch 3 Accumulated depreciation","Expense","Depreciation Expense",,"Accumulated Depreciation",75.43,"",4874493.15
,"General Journal","29-07-2024","24482",,,"Board room chair 3 Depreciation","Expense","Depreciation Expense",,"Accumulated Depreciation",59.52,"",4874552.67
,"General Journal","30-07-2024","24485",,,"Canteen Chair 20 Depreciation","Expense","Depreciation Expense",,"Accumulated Depreciation",6.12,"",4874558.79
,"General Journal","31-07-2024","24486",,,"500gm Jar Blow Mould 3 depreciation","Expense","Depreciation Expense",,"Accumulated Depreciation",1026.79,"",4875585.58
,"General Journal","31-07-2024","24487",,,"500gm Jar Blow Mould 4 depreciation","Expense","Depreciation Expense",,"Accumulated Depreciation",1026.79,"",4876612.37
,"General Journal","31-07-2024","24488",,,"Air cooled chiller depeciation","Expense","Depreciation Expense",,"Accumulated  Depreciation",8916.67,"",4885529.04
,"General Journal","31-07-2024","24489","*","Unilever Kenya Ltd:Sunlight Washing Pwd","Boato Installation Depreciation","Expense","Depreciation Expense",,"Accumulated Depreciation",65114.38,"",4950643.42
,"General Journal","31-07-2024","24490","*",,"Canister Platform Depreciation","Expense","Depreciation Expense",,"Accumulated Depreciation",59246.67,"",5009890.09
,"General Journal","31-07-2024","24491",,,"CCTV DRV & System Depreciation","Expense","Depreciation Expense",,"Accumulated Depreciation",1295.33,"",5011185.42
,"General Journal","31-07-2024","24492",,,"Colour Pressure tank Depreciation","Expense","Depreciation Expense",,"Accumulated Depreciation",232.14,"",5011417.56
,"General Journal","31-07-2024","24493",,,"Compressed air gun Depreciation","Expense","Depreciation Expense",,"Accumulated Depreciation",47.62,"",5011465.18
,"General Journal","31-07-2024","24494",,,"Drum Pump 2 Depreciation","Expense","Depreciation Expense",,"Accumulated Depreciation",123.15,"",5011588.33
,"General Journal","31-07-2024","24495",,,"Extractor Fan down Depreciation","Expense","Depreciation Expense",,"Accumulated Depreciation",150.12,"",5011738.45
,"General Journal","31-07-2024","24496",,,"Extractor Fan Hoisting Depreciation","Expense","Depreciation Expense",,"Accumulated Depreciation",176.67,"",5011915.12
,"General Journal","31-07-2024","24497",,,"Extractor Fan Packaging Depreciation","Expense","Depreciation Expense",,"Accumulated Depreciation",150.12,"",5012065.24
,"General Journal","31-07-2024","24498",,,"Incotex Type C Control Unit Depreciation","Expense","Depreciation Expense",,"Accumulated Depreciation",1939.66,"",5014004.90
,"General Journal","31-07-2024","24499",,,"Lamination Machine 1 Depreciation","Expense","Depreciation Expense",,"Accumulated Depreciation",84.78,"",5014089.68
,"General Journal","31-07-2024","24500",,,"Office Cabinet 5 Depreciation","Expense","Depreciation Expense",,"Accumulated Depreciation",58.33,"",5014148.01
,"General Journal","31-07-2024","24501",,,"Office Desk 6 Depreciation","Expense","Depreciation Expense",,"Accumulated Depreciation",90.48,"",5014238.49
,"General Journal","31-07-2024","24502",,,"Office Desk 7 Depreciation","Expense","Depreciation Expense",,"Accumulated Depreciation",90.48,"",5014328.97
,"General Journal","31-07-2024","24503",,,"Office Desk 8 Depreciation","Expense","Depreciation Expense",,"Accumulated Depreciation",83.33,"",5014412.30
,"General Journal","31-07-2024","24504",,,"Platform Scale 4 tons 1 Depreciation","Expense","Depreciation Expense",,"Accumulated Depreciation",10782.43,"",5025194.73
,"General Journal","31-07-2024","24505",,,"Process Water Filtration System Depreciation","Expense","Depreciation Expense",,"Accumulated Depreciation",1785.71,"",5026980.44
,"General Journal","31-07-2024","24506",,,"Sulphonic Acid pressure tank Depreciation","Expense","Depreciation Expense",,"Accumulated Depreciation",110.48,"",5027090.92
,"General Journal","31-07-2024","24507",,,"Test Sieves 100 & 200 microns Depreciation","Expense","Depreciation Expense",,"Accumulated Depreciation",450.00,"",5027540.92
,"General Journal","31-07-2024","24508",,,"Wall mounted cabinet 1 Dep","Expense","Depreciation Expense",,"Accumulated Depreciation",107.14,"",5027648.06
,"General Journal","31-07-2024","24509",,,"Water tank 5 Depreciation","Expense","Depreciation Expense",,"Accumulated Depreciation",137.79,"",5027785.85
,"General Journal","01-08-2024","24510",,,"Hoisting Bucket 1 Depreciation","Expense","Depreciation Expense",,"Accumulated Depreciation",148.81,"",5027934.66
,"General Journal","01-08-2024","24511",,,"Hoisting Bucket 2 Dereciation","Expense","Depreciation Expense",,"Accumulated Depreciation",148.81,"",5028083.47
,"General Journal","01-08-2024","24512",,,"Lenovo Laptop 2 Depreciation","Expense","Depreciation Expense",,"Accumulated Depreciation",333.33,"",5028416.80
,"General Journal","01-08-2024","24513",,,"Processing Platform Depreciation","Expense","Depreciation Expense",,"Accumulated Depreciation",4880.95,"",5033297.75
,"General Journal","01-08-2024","24514",,,"Security and Computer Sytem UPS Depreciation","Expense","Depreciation Expense",,"Accumulated Depreciation",3584.50,"",5036882.25
,"General Journal","01-08-2024","24515",,,"Trophy Shelf 1 Depreciation","Expense","Depreciation Expense",,"Accumulated Depreciation",95.24,"",5036977.49
,"General Journal","01-08-2024","24516",,,"Water tank 4 Depreciation","Expense","Depreciation Expense",,"Accumulated Depreciation",453.24,"",5037430.73
,"General Journal","02-08-2024","24531",,,"CMPP 1kg Jar Blow Mould 1 Depreciation","Expense","Depreciation Expense",,"Accumulated Depreciation",3364.87,"",5040795.60
,"General Journal","02-08-2024","24532",,,"CMPP 1kg Jar Blow Mould 2 Depreciation","Expense","Depreciation Expense",,"Accumulated Depreciation",3364.87,"",5044160.47
,"General Journal","02-08-2024","24533",,,"CMPP 500gm Jar Blow Mould 1 Depreciation","Expense","Depreciation Expense",,"Accumulated Depreciation",2643.82,"",5046804.29
,"General Journal","02-08-2024","24534",,,"CMPP 500gm Jar Blow Mould 2 Depreciation","Expense","Depreciation Expense",,"Accumulated Depreciation",2643.82,"",5049448.11
,"General Journal","02-08-2024","24535",,,"CMPP Blow Moulding Machine 1 Depreciation","Expense","Depreciation Expense",,"Accumulated Depreciation",49344.71,"",5098792.82
,"General Journal","02-08-2024","24536",,,"CMPP Blow Moulding Machine 2 Depreciation","Expense","Depreciation Expense",,"Accumulated Depreciation",49344.71,"",5148137.53
,"General Journal","02-08-2024","24537",,,"Drum Pump 1 Depreiation","Expense","Depreciation Expense",,"Accumulated Depreciation",123.03,"",5148260.56
,"General Journal","02-08-2024","24553",,,"Heat Gun Bosch 1 Depreciation","Expense","Depreciation Expense",,"Accumulated Depreciation",100.57,"",5148361.13
,"General Journal","02-08-2024","24554",,,"Hot ProcessWater Storage Tank1  Depreciation","Expense","Depreciation Expense",,"Accumulated Depreciation",73.99,"",5148435.12
,"General Journal","02-08-2024","24555","*",,"HP Laptop 4 Depreciation","Expense","Depreciation Expense",,"Accumulated Depreciation",297.62,"",5148732.74
,"General Journal","02-08-2024","24556","*",,"HP Laptop 8 Depreciation","Expense","Depreciation Expense",,"Accumulated Depreciation",1200.00,"",5149932.74
,"General Journal","02-08-2024","24567",,,"Store Racking 1 depreciation","Expense","Depreciation Expense",,"Accumulated Depreciation",175.60,"",5150108.34
,"General Journal","02-08-2024","24568",,,"Store Racking 2 Depreciation","Expense","Depreciation Expense",,"Accumulated Depreciation",175.60,"",5150283.94
,"General Journal","02-08-2024","24574",,,"Tank platform Depreciation","Expense","Depreciation Expense",,"Accumulated Depreciation",130.95,"",5150414.89
,"General Journal","02-08-2024","24578",,,"Water tank 1 Depreciation","Expense","Depreciation Expense",,"Accumulated Depreciation",120.07,"",5150534.96
,"General Journal","02-08-2024","24579",,,"Workshop cabinet depreciation","Expense","Depreciation Expense",,"Accumulated Depreciation",172.02,"",5150706.98
,"General Journal","03-08-2024","24526",,,"Alarm System extension","Expense","Depreciation Expense",,"Accumulated Depreciation",602.38,"",5151309.36
,"General Journal","03-08-2024","24527",,,"Domestos sewing machine depreciation","Expense","Depreciation Expense",,"Acummulated depreciation",82.10,"",5151391.46
,"General Journal","03-08-2024","24528",,,"Bench Grinder 2 Depreciation","Expense","Depreciation Expense",,"Accumulated Depreceiation",100.57,"",5151492.03
,"General Journal","03-08-2024","24529",,,"CCTV survellance System extension Depreciation","Expense","Depreciation Expense",,"Accumulated Depreciation",657.14,"",5152149.17
,"General Journal","03-08-2024","24538",,,"Electrical Enclosure CCTV Depreciation","Expense","Depreciation Expense",,"Accumulated Depreciation",126.19,"",5152275.36
,"General Journal","03-08-2024","24539",,,"Electrical Enclosure Main Depreciation","Expense","Depreciation Expense",,"Accumulated Depreciation",2339.29,"",5154614.65
,"General Journal","03-08-2024","24540",,,"Electrical Enclosure P Line Depreciation","Expense","Depreciation Expense",,"Accumulated Depreciation",428.57,"",5155043.22
,"General Journal","03-08-2024","24552",,,"Floodlight Depreciation","Expense","Depreciation Expense",,"Accumulated Depreciation",59.52,"",5155102.74
,"General Journal","03-08-2024","24560",,,"Office Desk 1 Depreciation","Expense","Depreciation Expense",,"Accumulated Depreciation",225.00,"",5155327.74
,"General Journal","03-08-2024","24561",,,"Office Desk 2 Depreciation","Expense","Depreciation Expense",,"Accumulated Depreciation",225.00,"",5155552.74
,"General Journal","03-08-2024","24562",,,"Office Desk 3 Depreciation","Expense","Depreciation Expense",,"Accumulated Depreciation",225.00,"",5155777.74
,"General Journal","03-08-2024","24564",,,"Signet ESD 1 Depreciation","Expense","Depreciation Expense",,"Accumulated Depreciation",928.57,"",5156706.31
,"General Journal","03-08-2024","24566","*",,"Sterling Water Dispenser 1 Depreciation","Expense","Depreciation Expense",,"Accumulated Depreciation",119.05,"",5156825.36
,"General Journal","03-08-2024","24569",,,"Table top Weighing Scale 5 Depreciation","Expense","Depreciation Expense",,"Accumulated Depreciation",248.57,"",5157073.93
,"General Journal","03-08-2024","24570",,,"Table top Weighing Scale 6 Depreciation","Expense","Depreciation Expense",,"Accumulated Depreciation",248.57,"",5157322.50
,"General Journal","03-08-2024","24571",,,"Table top Weighing Scale 7 Depreciation","Expense","Depreciation Expense",,"Accumulated Depreciation",248.57,"",5157571.07
,"General Journal","03-08-2024","24572",,,"Table top Weighing Scale 8 Depreciation","Expense","Depreciation Expense",,"Accumulated Depreciation",248.57,"",5157819.64
,"General Journal","03-08-2024","24573",,,"Table top Weighing Scale 9 Depreciation","Expense","Depreciation Expense",,"Accumulated Depreciation",248.57,"",5158068.21
,"General Journal","04-08-2024","24521",,,"9Kg Powder Fire Extinguisher 1 Depreciation","Expense","Depreciation Expense",,"Accumulated Depreciation",34.52,"",5158102.73
,"General Journal","04-08-2024","24522",,,"9Kg Powder Fire Extinguisher 2 Depreciation","Expense","Depreciation Expense",,"Accumulated Depreciation",34.52,"",5158137.25
,"General Journal","04-08-2024","24523",,,"9Kg Powder Fire Extinguisher 3 Depreciation","Expense","Depreciation Expense",,"Accumulated Depreciation",34.52,"",5158171.77
,"General Journal","04-08-2024","24525",,,"9Kg Powder Fire Extinguisher 5 Depreciation","Expense","Depreciation Expense",,"Accumulated Depreciation",34.52,"",5158206.29
,"General Journal","04-08-2024","24530",,,"Chiller 2 Depreciation","Expense","Depreciation Expense",,"Accumulated Depreciation",8035.71,"",5166242.00
,"General Journal","04-08-2024","24541",,,"Empty IBC Tank 10 Depreciation","Expense","Depreciation Expense",,"Accumulated Depreciation",41.67,"",5166283.67
,"General Journal","04-08-2024","24542",,,"Empty IBC Tank 3 Depreciation","Expense","Depreciation Expense",,"Accumulated Depreciation",65.48,"",5166349.15
,"General Journal","04-08-2024","24543",,,"Empty IBC Tank 4 Depreciation","Expense","Depreciation Expense",,"Accumulated Depreciation",65.48,"",5166414.63
,"General Journal","04-08-2024","24544",,,"Empty IBC Tank 5 Depreciation","Expense","Depreciation Expense",,"Accumulated Depreciation",65.48,"",5166480.11
,"General Journal","04-08-2024","24545",,,"Empty IBC Tank 6 Depreciation","Expense","Depreciation Expense",,"Accumulated Depreciation",65.48,"",5166545.59
,"General Journal","04-08-2024","24546",,,"Empty IBC Tank 7 Depreciation","Expense","Depreciation Expense",,"Accumulated Depreciation",41.67,"",5166587.26
,"General Journal","04-08-2024","24547",,,"Empty IBC Tank 8 Depreciation","Expense","Depreciation Expense",,"Accumulated Depreiation",41.67,"",5166628.93
,"General Journal","04-08-2024","24548",,,"Empty IBC Tank 9 Depreciation","Expense","Depreciation Expense",,"Accumulated Depreciation",41.67,"",5166670.60
,"General Journal","04-08-2024","24557",,,"Linx 8900 Coder 1 Depreciation","Expense","Depreciation Expense",,"Accumulated Depreciation",8333.33,"",5175003.93
,"General Journal","04-08-2024","24559",,,"Mobile Phone 2 Depreciation","Expense","Depreciation Expense",,"Accumulated Depreciation",46.67,"",5175050.60
,"General Journal","04-08-2024","24575",,,"Triple UV water purifier 1 Depreciation","Expense","Depreciation Expense",,"Accumulated Depreciation",296.22,"",5175346.82
,"General Journal","05-08-2024","24517",,,"1Kg Generic Jar Blow Mould 1 depreciation","Expense","Depreciation Expense",,"Accumulated Depreciation",1500.00,"",5176846.82
,"General Journal","05-08-2024","24518",,,"1Kg Generic Jar Blow Mould 2 depreciation","Expense","Depreciation Expense",,"Accumulated Depreciation",1500.00,"",5178346.82
,"General Journal","05-08-2024","24519",,,"500gm Generic Jar Blow Mould 1 depreciation","Expense","Depreciation Expense",,"Accumulated Depreciation",1071.43,"",5179418.25
,"General Journal","05-08-2024","24520",,,"500gm Generic Jar Blow Mould 2 depreciation","Expense","Depreciation Expense",,"Accumulated Depreciation",1071.43,"",5180489.68
,"General Journal","05-08-2024","24524",,,"9Kg Powder Fire Extinguisher 4 Depreciation","Expense","Depreciation Expense",,"Accumulated Depreciation",34.52,"",5180524.20
,"General Journal","05-08-2024","24549",,,"Extractor Fan 4 Depreciation","Expense","Depreciation Expense",,"Accumulated Depreciation",726.19,"",5181250.39
,"General Journal","05-08-2024","24550",,,"FFS  Machine Installation Elct Depreciation","Expense","Depreciation Expense",,"Accumulated Depreciation",200.60,"",5181450.99
,"General Journal","05-08-2024","24551",,,"First Aid Kit Depreciation","Expense","Depreciation Expense",,"Accumulated  Depreciation",77.38,"",5181528.37
,"General Journal","05-08-2024","24558",,,"Linx 8900 Coder 2 Depreciation","Expense","Depreciation Expense",,"Accumulated Depreciation",12500.00,"",5194028.37
,"General Journal","05-08-2024","24563",,,"Packing Platform Depreciation","Expense","Depreciation Expense",,"Accumulated Depreciation",5297.62,"",5199325.99
,"General Journal","05-08-2024","24565",,,"SS Industrial Turntable Depreciation","Expense","Depreciation Expense",,"Accumulated Depreciation",5238.10,"",5204564.09
,"General Journal","05-08-2024","24576",,,"TV Screen 2 Depreciation","Expense","Depreciation Expense",,"Accumulated Depreciation",950.00,"",5205514.09
,"General Journal","05-08-2024","24577",,,"Water Purifier 1 Depreciation","Expense","Depreciation Expense",,"Accumulated Depreciation",117.10,"",5205631.19
,"General Journal","06-08-2024","24580",,,"Blower Depreciation","Expense","Depreciation Expense",,"Accumulated Depreciation",59.52,"",5205690.71
,"General Journal","06-08-2024","24581",,,"Emergency Washing Point Depreciation","Expense","Depreciation Expense",,"Accumulated Deprecation",160.71,"",5205851.42
,"General Journal","06-08-2024","24582","*",,"Infrared Thermometre 1 Depreciation","Expense","Depreciation Expense",,"Accumulated Depreciation",416.67,"",5206268.09
,"General Journal","06-08-2024","24583",,,"Material's Trolley Depreciation","Expense","Depreciation Expense",,"Accumulated Depreciation",297.62,"",5206565.71
,"General Journal","06-08-2024","24584",,,"Plastic Scrap Grinder Machine Depreciation","Expense","Depreciation Expense",,"Accumulated  Depreciation",3452.38,"",5210018.09
,"General Journal","06-08-2024","24585",,,"Ribon Mixer SS depreciation","Expense","Depreciation Expense",,"Accumulated depreciation",4642.86,"",5214660.95
,"General Journal","06-08-2024","24586",,,"Telephone Handset Depreciation","Expense","Depreciation Expense",,"Accumulated Depreciation",29.76,"",5214690.71
,"General Journal","06-08-2024","24587",,,"Telkom Wifi Router Depreciation","Expense","Depreciation Expense",,"Accumulated Depreciation",71.43,"",5214762.14
,"General Journal","06-08-2024","24588",,,"Vacuum Cleaner Depreciation","Expense","Depreciation Expense",,"Accumulated Depreciation",148.81,"",5214910.95
,"General Journal","07-08-2024","24589",,,"9Kg Powder Fire Extinguisher 6 Depreciation","Expense","Depreciation Expense",,"Accumulated Depreciation",44.05,"",5214955.00
,"General Journal","07-08-2024","24590",,,"Cartoning table 4 depreciation","Expense","Depreciation Expense",,"Accumulated Depreciation",262.49,"",5215217.49
,"General Journal","07-08-2024","24591",,,"Case sealing table depreciation","Expense","Depreciation Expense",,"Accumulated Depreciation",86.67,"",5215304.16
,"General Journal","07-08-2024","24592",,,"Chain block 2 depreciation","Expense","Depreciation Expense",,"Accumulated depreciation",398.81,"",5215702.97
,"General Journal","07-08-2024","24593",,,"Chain block 3 depreciation","Expense","Depreciation Expense",,"Accumulated depreciation",398.81,"",5216101.78
,"General Journal","07-08-2024","24594",,,"Drilling machine Depreciation","Expense","Depreciation Expense",,"Accumulated Depreciation",88.39,"",5216190.17
,"General Journal","07-08-2024","24595",,,"Grinder Depreciation","Expense","Depreciation Expense",,"Acccumulated Depreciation",159.82,"",5216349.99
,"General Journal","07-08-2024","24596",,,"Packing table 1 depreciation","Expense","Depreciation Expense",,"Accumulated Depreciation",262.49,"",5216612.48
,"General Journal","07-08-2024","24597",,,"Packing table 2 depreciation","Expense","Depreciation Expense",,"Accumulated Depreciation",262.49,"",5216874.97
,"General Journal","07-08-2024","24598",,,"Packing table 3 depreciation","Expense","Depreciation Expense",,"Accumulated Depreciation",262.49,"",5217137.46
,"General Journal","07-08-2024","24599",,,"Quality table depreciation","Expense","Depreciation Expense",,"Accumulated Depreciation",86.67,"",5217224.13
,"General Journal","07-08-2024","24600",,,"Welding machine Depreciation","Expense","Depreciation Expense",,"Accumulated Depreciation",178.57,"",5217402.70
,"General Journal","08-08-2024","24601",,,"Bench Grinder 350W Depreciation","Expense","Depreciation Expense",,"Accumulated Depreciation",122.13,"",5217524.83
,"General Journal","08-08-2024","24602",,,"HP Laptop 6 Depreciation","Expense","Depreciation Expense",,"Accumulated Depreciation",416.67,"",5217941.50
,"General Journal","08-08-2024","24603",,,"Mobile Phone 1 Depreciation","Expense","Depreciation Expense",,"Accumulated Depreciation",58.33,"",5217999.83
,"General Journal","08-08-2024","25182",,,"Six step steel ladder 1 Depreciation","Expense","Depreciation Expense",,"Accumulated Depreciation",113.51,"",5218113.34
,"General Journal","09-08-2024","24630",,,"Canteen Table 1 Depreciation","Expense","Depreciation Expense",,"Accumulated Depreciation",184.52,"",5218297.86
,"General Journal","09-08-2024","24631",,,"Canteen Table 2 Depreciation","Expense","Depreciation Expense",,"Accumulated Depreciation",184.52,"",5218482.38
,"General Journal","09-08-2024","24632",,,"Dell Desktop 1 Depreciation","Expense","Depreciation Expense",,"Accumulated Depreciation",178.57,"",5218660.95
,"General Journal","09-08-2024","24633",,,"Fire Alarm System Extension'19 Depreciation","Expense","Depreciation Expense",,"Accumulated Depreciation",9857.14,"",5228518.09
,"General Journal","09-08-2024","24635",,,"Floor Chair 1 Depreciation","Expense","Depreciation Expense",,"Accumulated Depreciation",26.79,"",5228544.88
,"General Journal","09-08-2024","24636",,,"Floor Chair 10 Depreciation","Expense","Depreciation Expense",,"Accumulated Depreciation",53.57,"",5228598.45
,"General Journal","09-08-2024","24637",,,"Floor Chair 2 Depreciation","Expense","Depreciation Expense",,"Accumulated Depreciation",26.79,"",5228625.24
,"General Journal","09-08-2024","24638",,,"Floor Chair 3 Depreciation","Expense","Depreciation Expense",,"Accumulated Depreciation",26.79,"",5228652.03
,"General Journal","09-08-2024","24639",,,"Floor Chair 4 Depreciation","Expense","Depreciation Expense",,"Accumulated Depreciation",26.79,"",5228678.82
,"General Journal","09-08-2024","24640",,,"Floor Chair 5 Depreciation","Expense","Depreciation Expense",,"Accumulated Depreciation",26.79,"",5228705.61
,"General Journal","09-08-2024","24641",,,"Floor Chair 6 Depreciation","Expense","Depreciation Expense",,"Accumulated Depreciation",53.57,"",5228759.18
,"General Journal","09-08-2024","24642",,,"Floor Chair 7 Depreciation","Expense","Depreciation Expense",,"Accumulated Depreciation",53.57,"",5228812.75
,"General Journal","09-08-2024","24643",,,"Floor Chair 8 Depreciation","Expense","Depreciation Expense",,"Accumulated Depreciation",53.57,"",5228866.32
,"General Journal","09-08-2024","24644",,,"Floor Chair 9 Depreciation","Expense","Depreciation Expense",,"Accumulated Depreciation",53.57,"",5228919.89
,"General Journal","09-08-2024","24645",,,"Floor weighing scale Depreciation","Expense","Depreciation Expense",,"Accumulated Depreciation",593.81,"",5229513.70
,"General Journal","09-08-2024","24646",,,"Lab Office Chair 1 Depreciation","Expense","Depreciation Expense",,"Accumulated Depreciation",47.62,"",5229561.32
,"General Journal","09-08-2024","24647",,,"Lab Office Chair 2 Depreciation","Expense","Depreciation Expense",,"Accumulated Depreciation",47.62,"",5229608.94
,"General Journal","09-08-2024","24648",,,"Lab Office Chair 3 Depreciation","Expense","Depreciation Expense",,"Accumulated Depreciation",47.62,"",5229656.56
,"General Journal","09-08-2024","24649","*","Unilever Kenya Ltd:Sunlight Washing Pwd","Sunlight Bag Closing Machine 1 Depreciation","Expense","Depreciation Expense",,"Accumulated Depreciation",738.10,"",5230394.66
,"General Journal","09-08-2024","24650","*","Unilever Kenya Ltd:Sunlight Washing Pwd","Sunlight Packing Chair 1 Depreciation","Expense","Depreciation Expense",,"Accumulated Depreciation",41.67,"",5230436.33
,"General Journal","10-08-2024","24653",,,"5Kg Fire Extinguisher 1 Depreciation","Expense","Depreciation Expense",,"Accumulated Depreciation",65.48,"",5230501.81
,"General Journal","10-08-2024","24663",,,"HP Laptop 10 Depreciation","Expense","Depreciation Expense",,"Accumulated Depreciation",1200.00,"",5231701.81
,"General Journal","10-08-2024","24667",,,"HP Laptop 9 Depreciation","Expense","Depreciation Expense",,"Accumulated Depreciation",1200.00,"",5232901.81
,"General Journal","10-08-2024","24668",,,"Office Seat 1 Depreciation","Expense","Depreciation Expense",,"Accumulated Depreciation",142.86,"",5233044.67
,"General Journal","10-08-2024","24669",,,"Office Seat 2 Depreciation","Expense","Depreciation Expense",,"Accumulated Depreciation",71.43,"",5233116.10
,"General Journal","10-08-2024","24670",,,"Office Seat 3 Depreciation","Expense","Depreciation Expense",,"Accumulated Depreciation",71.43,"",5233187.53
,"General Journal","10-08-2024","24672",,,"Reverse Osmosis Unit 1 Depreciation","Expense","Depreciation Expense",,"Accumulated Depreciation",416.67,"",5233604.20
,"General Journal","10-08-2024","24673",,,"Steam Generator SG24 Depreciation","Expense","Depreciation Expense",,"Accumulated Depreciation",3794.53,"",5237398.73
,"General Journal","10-08-2024","24676",,,"Toilet Cleaner Mixing Machine Depreciation","Expense","Depreciation Expense",,"Accumulated Depreciation",6333.33,"",5243732.06
,"General Journal","11-08-2024","24651",,,"4 GB hard drive for CCTV Depreciation","Expense","Depreciation Expense",,"Accumulated Depreciation",178.57,"",5243910.63
,"General Journal","11-08-2024","24652",,,"4TB Hard Disk Depreciation","Expense","Depreciation Expense",,"Accumulated Depreciation",178.57,"",5244089.20
,"General Journal","11-08-2024","24654","*","Unilever Kenya Ltd:Sunlight Washing Pwd","Chain block trolley 4 depreciation","Expense","Depreciation Expense",,"Accumulated Depreciation",85.00,"",5244174.20
,"General Journal","11-08-2024","24655",,,"Coder Depreciation","Expense","Depreciation Expense",,"Accumulated Depreciation",2261.90,"",5246436.10
,"General Journal","11-08-2024","24657",,,"Coder Stand Depreciation","Expense","Depreciation Expense",,"Accumulated Depreciation",59.52,"",5246495.62
,"General Journal","11-08-2024","24660",,,"Compressor 1 depreciation","Expense","Depreciation Expense",,"Accumulated depreciation",3750.00,"",5250245.62
,"General Journal","11-08-2024","24664",,,"HP Laptop 14 Depreciation","Expense","Depreciation Expense",,"Accumulated Depreciation",1941.67,"",5252187.29
,"General Journal","11-08-2024","24665",,,"HP Laptop 15 Depreciation","Expense","Depreciation Expense",,"Accumulated Depreciation",1750.00,"",5253937.29
,"General Journal","11-08-2024","24671",,,"Pallet truck 2 depreciation","Expense","Depreciation Expense",,"Accumulated depreciation",440.48,"",5254377.77
,"General Journal","11-08-2024","24674","*",,"Steam Label Shrink Tunnel Depreciation","Expense","Depreciation Expense",,"Accumulated  Depreciation",10952.38,"",5265330.15
,"General Journal","12-08-2024","24656",,,"Coder Housing Depreciation","Expense","Depreciation Expense",,"Accumulated Depreciation",80.36,"",5265410.51
,"General Journal","12-08-2024","24658","*","Unilever Kenya Ltd:Sunlight Washing Pwd","Coder UPS 4 Depreciation","Expense","Depreciation Expense",,"Accumulated Depreciation",158.33,"",5265568.84
,"General Journal","12-08-2024","24659",,,"Coding Conveyor Depreciation","Expense","Depreciation Expense",,"Accumulated Depreciation",476.19,"",5266045.03
,"General Journal","12-08-2024","24661",,,"Conveyor 2 Depreciation","Expense","Depreciation Expense",,"Accumulated  Depreciation",169.64,"",5266214.67
,"General Journal","12-08-2024","24662",,,"Eyewash Station 1 Depreciation","Expense","Depreciation Expense",,"Accumulated Depreciation",904.76,"",5267119.43
,"General Journal","12-08-2024","24666",,,"HP Laptop 5 Depreciation","Expense","Depreciation Expense",,"Accumulated Depreciation",416.67,"",5267536.10
,"General Journal","12-08-2024","24675",,,"Tea maker Depreciation","Expense","Depreciation Expense",,"Accumulated Depreciation",225.00,"",5267761.10
,"General Journal","13-08-2024","24685",,,"Alarm System Depreciation","Expense","Depreciation Expense",,"Accumulated Depreciation",580.95,"",5268342.05
,"General Journal","13-08-2024","24686",,,"Bosch Blower 2 Depreciation","Expense","Depreciation Expense",,"Accumulated Depreciation",136.49,"",5268478.54
,"General Journal","13-08-2024","24687",,,"Coder UPS 8 Depreciation","Expense","Depreciation Expense",,"Accumulated Depreciation",81.67,"",5268560.21
,"General Journal","13-08-2024","24688","*",,"HP Laptop 16 Depreciation","Expense","Depreciation Expense",,"Accumulated Depreciation",1000.00,"",5269560.21
,"General Journal","13-08-2024","24689",,,"PIR system extension Depreciation","Expense","Depreciation Expense",,"Accumulated Depreciation",254.67,"",5269814.88
,"General Journal","13-08-2024","24690",,,"Process Water Storage Tank Depreciation","Expense","Depreciation Expense",,"Accumulated Depreciation",1065.16,"",5270880.04
,"General Journal","13-08-2024","24691","*",,"Store Racking 3 FG Depreciation","Expense","Depreciation Expense",,"Accumulated Depreciation",9791.67,"",5280671.71
,"General Journal","13-08-2024","24692",,,"Weighing scale 1","Expense","Depreciation Expense",,"Accumulated Depreciation",559.52,"",5281231.23
,"General Journal","13-08-2024","25176",,,"HP Mini Desktop 4 Depreciation","Expense","Depreciation Expense",,"Accumulated Depreciation",466.67,"",5281697.90
,"General Journal","14-08-2024","24693",,,"Coder UPS 5 Depreciation","Expense","Depreciation Expense",,"Accumulated Depreciation",158.33,"",5281856.23
,"General Journal","14-08-2024","24694",,,"Motor Vehicle 2 Depreciation","Expense","Depreciation Expense",,"Accumulated Depreciation",10297.62,"",5292153.85
,"General Journal","14-08-2024","24695",,,"Paste Packing Machine Depreciation","Expense","Depreciation Expense",,"Accumulated Depreciation",4166.67,"",5296320.52
,"General Journal","14-08-2024","24696",,,"Table Top Scale 10  SS 15Kg Depreciation","Expense","Depreciation Expense",,"Accumulated Depreciation",297.62,"",5296618.14
,"General Journal","15-08-2024","24697",,,"150KVA Enclosed Genset Depreciation","Expense","Depreciation Expense",,"Accumulated Depreciation",24404.76,"",5321022.90
,"General Journal","15-08-2024","24698",,,"20Kg Forklift Gas Cylinder 2 Depreciation","Expense","Depreciation Expense",,"Accumulated Depreciation",769.70,"",5321792.60
,"General Journal","15-08-2024","24699",,,"2Ton Electric Hoist 1 Depreciation","Expense","Depreciation Expense",,"Accumulated Depreciation",3708.33,"",5325500.93
,"General Journal","15-08-2024","24700",,,"Automatic Change Over Switch 1 Depreciation","Expense","Depreciation Expense",,"Accumulated Depreciation",1666.67,"",5327167.60
,"General Journal","15-08-2024","24701",,,"Bench top Weighing Scale 1 Depreciation","Expense","Depreciation Expense",,"Accumulated Depreciation",357.14,"",5327524.74
,"General Journal","15-08-2024","24702",,,"Bench top Weighing Scale 2 Depreciation","Expense","Depreciation Expense",,"Accumulated Depreciation",357.14,"",5327881.88
,"General Journal","15-08-2024","24703",,,"Bench top Weighing Scale 3 Depreciation","Expense","Depreciation Expense",,"Accumulated Depreciation",357.14,"",5328239.02
,"General Journal","15-08-2024","24704",,,"Bench top Weighing Scale 4 Depreciation","Expense","Depreciation Expense",,"Accumulated Depreciation",357.14,"",5328596.16
,"General Journal","15-08-2024","24705",,,"Bosch Blower Depreciation","Expense","Depreciation Expense",,"Accumulated Depreciation",129.31,"",5328725.47
,"General Journal","15-08-2024","24706",,,"Canteen Chair 1 Depreciation","Expense","Depreciation Expense",,"Accumulated Depreciation",6.12,"",5328731.59
,"General Journal","15-08-2024","24707",,,"Canteen Chair 10 Depreciation","Expense","Depreciation Expense",,"Accumulated Depreciation",6.12,"",5328737.71
,"General Journal","15-08-2024","24708",,,"Canteen Chair 11 Depreciation","Expense","Depreciation Expense",,"Accumulated Depreciation",6.12,"",5328743.83
,"General Journal","15-08-2024","24709",,,"Canteen Chair 11 Depreciation","Expense","Depreciation Expense",,"Accumulated Depreciation",6.12,"",5328749.95
,"General Journal","15-08-2024","24710",,,"Canteen Chair 12 Depreciation","Expense","Depreciation Expense",,"Accumulated Depreciation",6.12,"",5328756.07
,"General Journal","15-08-2024","24711",,,"Canteen Chair 13 Depreciation","Expense","Depreciation Expense",,"Accumulated Depreciation",6.12,"",5328762.19
,"General Journal","15-08-2024","24712",,,"Canteen Chair 14 Depreciation","Expense","Depreciation Expense",,"Accumulated Depreciation",6.12,"",5328768.31
,"General Journal","15-08-2024","24713",,,"Canteen Chair 15 Depreciation","Expense","Depreciation Expense",,"Accumulated Depreciation",6.12,"",5328774.43
,"General Journal","15-08-2024","24714",,,"Canteen Chair 16 Depreciation","Expense","Depreciation Expense",,"Accumulated Depreciation",6.12,"",5328780.55
,"General Journal","15-08-2024","24715",,,"Canteen Chair 17 Depreciation","Expense","Depreciation Expense",,"Accumulated Depreciation",6.12,"",5328786.67
,"General Journal","15-08-2024","24716",,,"Canteen Chair 18 Depreciation","Expense","Depreciation Expense",,"Accumulated Depreciation",6.12,"",5328792.79
,"General Journal","15-08-2024","24717",,,"Canteen Chair 19 Depreciation","Expense","Depreciation Expense",,"Accumulated Depreciation",6.12,"",5328798.91
,"General Journal","15-08-2024","24718",,,"Canteen Chair 2 Depreciation","Expense","Depreciation Expense",,"Accumulated Depreciation",6.12,"",5328805.03
,"General Journal","15-08-2024","24719",,,"Canteen Chair 21 Depreciation","Expense","Depreciation Expense",,"Accumulated Depreciation",6.12,"",5328811.15
,"General Journal","15-08-2024","24720",,,"Canteen Chair 22 Depreciation","Expense","Depreciation Expense",,"Accumulated Depreciation",6.12,"",5328817.27
,"General Journal","15-08-2024","24721",,,"Canteen Chair 23 Depreciation","Expense","Depreciation Expense",,"Accumulated Depreciation",6.12,"",5328823.39
,"General Journal","15-08-2024","24722",,,"Canteen Chair 24 Depreciation","Expense","Depreciation Expense",,"Accumulated Depreciation",6.12,"",5328829.51
,"General Journal","15-08-2024","24723",,,"Canteen Chair 25 Depreciation","Expense","Depreciation Expense",,"Accumulated Depreciation",6.12,"",5328835.63
,"General Journal","15-08-2024","24724",,,"Canteen Chair 3 Depreciation","Expense","Depreciation Expense",,"Accumulated Depreciation",6.12,"",5328841.75
,"General Journal","15-08-2024","24725",,,"Canteen Chair 4 Depreciation","Expense","Depreciation Expense",,"Accumulated Depreciation",6.12,"",5328847.87
,"General Journal","15-08-2024","24726",,,"Canteen Chair 5 Depreciation","Expense","Depreciation Expense",,"Accumulated Depreciation",6.12,"",5328853.99
,"General Journal","15-08-2024","24727",,,"Canteen Chair 6 Depreciation","Expense","Depreciation Expense",,"Accumulated Depreciation",6.12,"",5328860.11
,"General Journal","15-08-2024","24728",,,"Canteen Chair 7 Depreciation","Expense","Depreciation Expense",,"Accumulated Depreciation",6.12,"",5328866.23
,"General Journal","15-08-2024","24729",,,"Canteen Chair 8 Depreciation","Expense","Depreciation Expense",,"Accumulated Depreciation",6.12,"",5328872.35
,"General Journal","15-08-2024","24730",,,"Canteen Chair 9 Depreciation","Expense","Depreciation Expense",,"Accumulated Depreciation",6.12,"",5328878.47
,"General Journal","15-08-2024","24731",,,"EOL Case sealer Outfeed Conveyor Depreciation","Expense","Depreciation Expense",,"Accumulated Depreciation",297.62,"",5329176.09
,"General Journal","15-08-2024","24732",,,"Epson L6190 Printer 1 Depreciation","Expense","Depreciation Expense",,"Accumulated Depreciation",654.76,"",5329830.85
,"General Journal","15-08-2024","24733",,,"Fire Extinguisher 1 Depreciation","Expense","Depreciation Expense",,"Accumulated Depreciation",77.38,"",5329908.23
,"General Journal","15-08-2024","24734",,,"Fire Extinguisher 2 Depreciation","Expense","Depreciation Expense",,"Accumulated Depreciation",77.38,"",5329985.61
,"General Journal","15-08-2024","24735",,,"Fire Extinguisher 3 Depreciation","Expense","Depreciation Expense",,"Accumulated Depreciation",77.38,"",5330062.99
,"General Journal","15-08-2024","24736",,,"Fire Extinguisher 4 Depreciation","Expense","Depreciation Expense",,"Accumulated Depreciation",77.38,"",5330140.37
,"General Journal","15-08-2024","24737",,,"Fire Extinguisher 5 Depreciation","Expense","Depreciation Expense",,"Accumulated Depreciation",77.38,"",5330217.75
,"General Journal","15-08-2024","24738",,,"Fire Extinguisher 6 Depreciation","Expense","Depreciation Expense",,"Accumulated Depreciation",77.38,"",5330295.13
,"General Journal","15-08-2024","24739",,,"Grinder 2 Depreciation","Expense","Depreciation Expense",,"Accumulated Depreciation",178.57,"",5330473.70
,"General Journal","15-08-2024","24740",,,"HP Laptop 11 Depreciation","Expense","Depreciation Expense",,"Accumulated Depreciation",1200.00,"",5331673.70
,"General Journal","15-08-2024","24741",,,"HP Laptop 12 Depreciation","Expense","Depreciation Expense",,"Accumulated Depreciation",1200.00,"",5332873.70
,"General Journal","15-08-2024","24742",,,"Microwave 2 Depreciation","Expense","Depreciation Expense",,"Accumulated Depreciation",147.27,"",5333020.97
,"General Journal","15-08-2024","24743",,,"Mobile phone 3 Depreciation","Expense","Depreciation Expense",,"Accumulated Depreciation",41.67,"",5333062.64
,"General Journal","15-08-2024","24744",,,"Movable Ladder 1 Depreciation","Expense","Depreciation Expense",,"Accumulated Depreciation",434.52,"",5333497.16
,"General Journal","15-08-2024","24745",,,"UV water purifier 3 Depreciation","Expense","Depreciation Expense",,"Accumulated Depreciation",543.10,"",5334040.26
,"General Journal","15-08-2024","24746",,,"Water tank 6 Depreciation","Expense","Depreciation Expense",,"Accumulated Depreciation",71.84,"",5334112.10
,"General Journal","16-08-2024","24747",,,"Bosch Grinder 3 Depreciation","Expense","Depreciation Expense",,"Accumulated Depreceiation",86.21,"",5334198.31
,"General Journal","16-08-2024","24748",,,"Chain block 5 depreciation","Expense","Depreciation Expense",,"Accumulated Depreciation",292.49,"",5334490.80
,"General Journal","16-08-2024","24749",,,"Chain block 6 depreciation","Expense","Depreciation Expense",,"Accumulated Depreciation",292.49,"",5334783.29
,"General Journal","16-08-2024","24750",,,"Heat Gun Total 1 Depreciation","Expense","Depreciation Expense",,"Accumulated Depreciation",64.66,"",5334847.95
,"General Journal","16-08-2024","24751",,,"Linx 5900 Coder 1 Depreciation","Expense","Depreciation Expense",,"Accumulated Depreciation",4166.67,"",5339014.62
,"General Journal","16-08-2024","24752",,,"Table Top Scale 11 6Kg Depreciation","Expense","Depreciation Expense",,"Accumulated Depreciation",277.09,"",5339291.71
,"General Journal","16-08-2024","24753",,,"Washing Machine 1 Depreciation","Expense","Depreciation Expense",,"Accumulated Depreciation",2640.01,"",5341931.72
,"General Journal","17-08-2024","24754",,,"2T Mixer Depreciation","Expense","Depreciation Expense",,"Accumulated Depreciation",12633.99,"",5354565.71
,"General Journal","17-08-2024","24755",,,"2T Mixer Installation Depreciation","Expense","Depreciation Expense",,"Accumulated Depreciation",29713.15,"",5384278.86
,"General Journal","17-08-2024","24758",,,"Coder UPS 6 Depreciation","Expense","Depreciation Expense",,"Accumulated Depreciation",94.83,"",5384373.69
,"General Journal","17-08-2024","24759",,,"Coder UPS 7 Depreciation","Expense","Depreciation Expense",,"Accumulated Depreciation",94.83,"",5384468.52
,"General Journal","17-08-2024","24765","*",,"Hand Dryer 1 Depreciation","Expense","Depreciation Expense",,"Accumulated Depreciation",46.18,"",5384514.70
,"General Journal","17-08-2024","24766","*",,"HP Laptop 3 Depreciation","Expense","Depreciation Expense",,"Accumulated Depreciation",297.62,"",5384812.32
,"General Journal","17-08-2024","24771",,,"Office desks  4","Expense","Depreciation Expense",,"Accumulated Depreciation",361.90,"",5385174.22
,"General Journal","17-08-2024","24773",,,"Pallet truck 4 Depreciation","Expense","Depreciation Expense",,"Accumulated Depreciation",428.57,"",5385602.79
,"General Journal","17-08-2024","24774",,,"Pallet truck 5 Depreciation","Expense","Depreciation Expense",,"Accumulated Depreciation",428.57,"",5386031.36
,"General Journal","17-08-2024","24775",,,"Recirculation Pump Depreciation","Expense","Depreciation Expense",,"Accumulated  Depreciation",71.19,"",5386102.55
,"General Journal","17-08-2024","24776",,,"Server 1 Depreciation","Expense","Depreciation Expense",,"Accumulated Depreciation",357.14,"",5386459.69
,"General Journal","17-08-2024","24777",,,"Server Monitor Depreciation","Expense","Depreciation Expense",,"Accumulated Depreciaion",107.14,"",5386566.83
,"General Journal","17-08-2024","24778",,,"Shrink Tunnel Depreciation","Expense","Depreciation Expense",,"Accumulated Depreciation",3750.00,"",5390316.83
,"General Journal","17-08-2024","24779","*",,"Soap Dispenser 1 Depreciation","Expense","Depreciation Expense",,"Accumulated Depreciation",15.39,"",5390332.22
,"General Journal","17-08-2024","24782","*",,"TP Link 3 Depreciation","Expense","Depreciation Expense",,"Accumulated Depreciation",33.33,"",5390365.55
,"General Journal","17-08-2024","24785","*",,"Water Tank 3 Depreciation","Expense","Depreciation Expense",,"Accumulated Depreciation",123.15,"",5390488.70
,"General Journal","18-08-2024","24757",,,"Carton Sealer Manual 1 Depreciation","Expense","Depreciation Expense",,"Accumulated Depreciation",14.80,"",5390503.50
,"General Journal","18-08-2024","24761",,,"Compressor 3 Depreciation","Expense","Depreciation Expense",,"Accumulated Depreciation",5357.14,"",5395860.64
,"General Journal","18-08-2024","24762",,,"Compressor room depreciation","Expense","Depreciation Expense",,"Accumulated depreciation",132.44,"",5395993.08
,"General Journal","18-08-2024","24763",,,"Electric Hoist 1 depreciation","Expense","Depreciation Expense",,"Accumulated depreciation",3452.38,"",5399445.46
,"General Journal","18-08-2024","24764",,,"Gents changing room Lockers Depreciation","Expense","Depreciation Expense",,"Accumulated Depreciation",386.90,"",5399832.36
,"General Journal","18-08-2024","24767",,,"HP Mini Desktop 1 Depreciation","Expense","Depreciation Expense",,"Accumulated Depreciation",733.33,"",5400565.69
,"General Journal","18-08-2024","24768",,,"HP Mini Desktop 2 Depreciation","Expense","Depreciation Expense",,"Accumulated Depreciation",733.33,"",5401299.02
,"General Journal","18-08-2024","24769",,,"HP Mini Desktop 3 Depreciation","Expense","Depreciation Expense",,"Accumulated Depreciation",733.33,"",5402032.35
,"General Journal","18-08-2024","24770",,,"Ladies changing room Lockers Depreciation","Expense","Depreciation Expense",,"Accumulated Depreciation",411.90,"",5402444.25
,"General Journal","18-08-2024","24772",,,"Omrom M1 Basic BP Monitor Depreciation","Expense","Depreciation Expense",,"Accumulated Depreciation",58.33,"",5402502.58
,"General Journal","18-08-2024","24780",,,"SS Hand Washing Station 1 Depreciation","Expense","Depreciation Expense",,"Accumulated Depreciation",690.48,"",5403193.06
,"General Journal","18-08-2024","24781",,,"TP Link 2 Depreciation","Expense","Depreciation Expense",,"Accumulated Depreciation",41.67,"",5403234.73
,"General Journal","18-08-2024","24783",,,"TV Screen 3 Depreciation","Expense","Depreciation Expense",,"Accumulated Depreciation",316.67,"",5403551.40
,"General Journal","18-08-2024","24784",,,"TV Screen 4 Depreciation","Expense","Depreciation Expense",,"Accumulated Depreciation",1550.00,"",5405101.40
,"General Journal","19-08-2024","24756",,,"3T Gas Forklift 1 Depreciation","Expense","Depreciation Expense",,"Accumulated Depreciation",30952.38,"",5436053.78
,"General Journal","19-08-2024","24760",,,"Coding Stamp 3 Depreciation","Expense","Depreciation Expense",,"Accumulated Depreciation",143.68,"",5436197.46
,"General Journal","19-08-2024","25197",,,"Office Stamp 2 Depreciation","Expense","Depreciation Expense",,"Accumulated Depreciaion",30.83,"",5436228.29
,"General Journal","20-08-2024","24788","*","Unilever Kenya Ltd:Sunlight Washing Pwd","Boato Commisioning Depreciation","Expense","Depreciation Expense",,"Accumulated Depreciation",889.88,"",5437118.17
,"General Journal","20-08-2024","24789",,,"Bosch Blower 3 Depreciation","Expense","Depreciation Expense",,"Accumulated Depreciation",79.02,"",5437197.19
,"General Journal","20-08-2024","24790",,,"Bosch Blower 4 Depreciation","Expense","Depreciation Expense",,"Accumulated Depreciation",136.49,"",5437333.68
,"General Journal","20-08-2024","24791",,,"Bosch Blower 5 Depreciation","Expense","Depreciation Expense",,"Accumulated Depreciation",136.49,"",5437470.17
,"General Journal","20-08-2024","24792",,,"Conference Office Desk 1 Depreciation","Expense","Depreciation Expense",,"Accumulated Depreciation",416.67,"",5437886.84
,"General Journal","20-08-2024","24793",,,"Floor Chair 17 depreciation","Expense","Depreciation Expense",,"Accumulated Depreciation",20.24,"",5437907.08
,"General Journal","20-08-2024","24794",,,"Floor Chair 18 depreciation","Expense","Depreciation Expense",,"Accumulated Depreciation",20.24,"",5437927.32
,"General Journal","20-08-2024","24795",,,"Floor Chair 19 depreciation","Expense","Depreciation Expense",,"Accumulated Depreciation",20.24,"",5437947.56
,"General Journal","20-08-2024","24796",,,"Floor Chair 20 depreciation","Expense","Depreciation Expense",,"Accumulated Depreciation",20.24,"",5437967.80
,"General Journal","20-08-2024","24797",,,"Heat Gun CAT Digital 1 Depreciation","Expense","Depreciation Expense",,"Accumulated Depreciation",136.49,"",5438104.29
,"General Journal","20-08-2024","24798","*",,"Lumnia 1 Pro Insect Trap Depreciation","Expense","Depreciation Expense",,"Accumulated Depreciation",316.67,"",5438420.96
,"General Journal","20-08-2024","24800",,,"PF Correction Unit Depreciation","Expense","Depreciation Expense",,"Accumulated Depreciation",1708.33,"",5440129.29
,"General Journal","21-08-2024","24801",,,"5Kg CO2 Fire Extinguisher 2 Depreciation","Expense","Depreciation Expense",,"Accumulated Depreciation",73.81,"",5440203.10
,"General Journal","21-08-2024","24802",,,"6Kg Dry Pwd Fire Extinguisher 1 Depreciaiton","Expense","Depreciation Expense",,"Accumulated Depreciation",59.52,"",5440262.62
,"General Journal","21-08-2024","24803",,,"Board room chair 1 Depreciation","Expense","Depreciation Expense",,"Accumulated Depreciation",59.52,"",5440322.14
,"General Journal","21-08-2024","24804",,,"Board room chair 2 Depreciation","Expense","Depreciation Expense",,"Accumulated Depreciation",59.52,"",5440381.66
,"General Journal","21-08-2024","24805",,,"Board room chair 4 Depreciation","Expense","Depreciation Expense",,"Accumulated Depreciation",59.52,"",5440441.18
,"General Journal","21-08-2024","24806",,,"Board room chair 5 Depreciation","Expense","Depreciation Expense",,"Accumulated Depreciation",59.52,"",5440500.70
,"General Journal","21-08-2024","24807",,,"Board room chair 6 Depreciation","Expense","Depreciation Expense",,"Accumulated Depreciation",59.52,"",5440560.22
,"General Journal","21-08-2024","24808",,,"Board room chair 7 Depreciation","Expense","Depreciation Expense",,"Accumulated Depreciation",59.52,"",5440619.74
,"General Journal","21-08-2024","24809",,,"Board room chair 8 Depreciation","Expense","Depreciation Expense",,"Accumulated Depreciation",59.52,"",5440679.26
,"General Journal","21-08-2024","24810",,,"Coding Stamp 2 Depreciation","Expense","Depreciation Expense",,"Accumulated Depreciation",133.33,"",5440812.59
,"General Journal","21-08-2024","24811",,,"IBC Tank 1 Depreciation","Expense","Depreciation Expense",,"Accumulated Depreciation",41.67,"",5440854.26
,"General Journal","21-08-2024","24812",,,"Empty IBC Tank 2 Depreciation","Expense","Depreciation Expense",,"Accumulated Depreciation",65.48,"",5440919.74
,"General Journal","21-08-2024","24813",,,"FFS Filling Machine 300 1 Depreciation","Expense","Depreciation Expense",,"Accumulated Depreciation",11850.01,"",5452769.75
,"General Journal","21-08-2024","24814",,,"Laboratory Oven & Dessicator  Depreciation","Expense","Depreciation Expense",,"Accumulated Depreciation",766.67,"",5453536.42
,"General Journal","21-08-2024","24815",,,"Nikon D3500 Camera 1 Depreciation","Expense","Depreciation Expense",,"Accumulated Depreciation",766.67,"",5454303.09
,"General Journal","21-08-2024","24816",,,"Tea Urn Depreciation","Expense","Depreciation Expense",,"Accumulated Depreciation",121.67,"",5454424.76
,"General Journal","22-08-2024","24817",,,"6Kg Auto Fire Extinguisher 1 Depreciation","Expense","Depreciation Expense",,"Accumulated Depreciation",53.57,"",5454478.33
,"General Journal","22-08-2024","24818",,,"6Kg Auto Fire Extinguisher 2 Depreciation","Expense","Depreciation Expense",,"Accumulated Depreciation",53.57,"",5454531.90
,"General Journal","22-08-2024","24819","*",,"AVS Voltage Stabilizer Depreciation","Expense","Depreciation Expense",,"Accumulated Depreciation",63.10,"",5454595.00
,"General Journal","22-08-2024","24820",,,"Conveyor Belt Green 1 Depreciation","Expense","Depreciation Expense",,"Accumulated Depreciation",82.14,"",5454677.14
,"General Journal","22-08-2024","24821",,,"HP Laptop 13 Depreciation","Expense","Depreciation Expense",,"Accumulated Depreciation",1200.00,"",5455877.14
,"General Journal","22-08-2024","24822","*",,"HP Laptop 7 Depreciation","Expense","Depreciation Expense",,"Accumulated Depreciation",1200.00,"",5457077.14
,"General Journal","22-08-2024","24823",,,"Office Desk 5 Depreciation","Expense","Depreciation Expense",,"Accumulated Depreciation",180.95,"",5457258.09
,"General Journal","22-08-2024","24824",,,"Office cabinets depreciation","Expense","Depreciation Expense",,"Accumulated Depreciation",119.05,"",5457377.14
,"General Journal","22-08-2024","24825",,,"Platform Scale 2 SS 100Kg Depreciation","Expense","Depreciation Expense",,"Accumulated Depreciation",339.29,"",5457716.43
,"General Journal","22-08-2024","24826",,,"Solar Water Heater 300L Depreciation","Expense","Depreciation Expense",,"Accumulated Depreciation",3125.00,"",5460841.43
,"General Journal","23-08-2024","24827",,,"Analytical Balance Depreciation","Expense","Depreciation Expense",,"Accumulated Depreciation",2405.58,"",5463247.01
,"General Journal","23-08-2024","24828",,,"Auger Filler 1 Depreciation","Expense","Depreciation Expense",,"Accumulated Depreciation",7220.12,"",5470467.13
,"General Journal","23-08-2024","24829",,,"Auger Filler 2 Depreciation","Expense","Depreciation Expense",,"Accumulated Depreciation",13258.63,"",5483725.76
,"General Journal","23-08-2024","24830",,,"Auger Filler 3 Depreciation","Expense","Depreciation Expense",,"Accumulated Depreciation",11788.69,"",5495514.45
,"General Journal","23-08-2024","24831",,,"Bajaj Boxer BM150 UG Depreciation","Expense","Depreciation Expense",,"Accumulated Depreciation",1539.41,"",5497053.86
,"General Journal","23-08-2024","24832",,,"Chain block 4 depreciation","Expense","Depreciation Expense",,"Accumulated Depreciation",133.42,"",5497187.28
,"General Journal","23-08-2024","24833",,,"Coder UPS Depreciation","Expense","Depreciation Expense",,"Accumulated Depreciation",95.24,"",5497282.52
,"General Journal","23-08-2024","24834",,,"Dust Extractor 1 Depreciation","Expense","Depreciation Expense",,"Accumulated Depreciation",446.43,"",5497728.95
,"General Journal","23-08-2024","24835",,,"Dust Extractor 2 Depreciation","Expense","Depreciation Expense",,"Accumulated Depreciation",446.43,"",5498175.38
,"General Journal","23-08-2024","24836",,,"Filler 1 Geared Motor & Feeding System Depreciation","Expense","Depreciation Expense",,"Accumulated Depreciation",333.33,"",5498508.71
,"General Journal","23-08-2024","24837",,,"Filler 2 Geared Motor & Feeding System Depreciation","Expense","Depreciation Expense",,"Accumulated Depreciation",348.72,"",5498857.43
,"General Journal","23-08-2024","24838",,,"Filler 3 Geared Motor & Feeding System Depreciation","Expense","Depreciation Expense",,"Accumulated Depreciation",347.52,"",5499204.95
,"General Journal","23-08-2024","24839",,,"Hotplate with Stirrer Depreciation","Expense","Depreciation Expense",,"Accumulated Depreciation",1785.71,"",5500990.66
,"General Journal","23-08-2024","24840",,,"Makita Hammer Drill Depreciation","Expense","Depreciation Expense",,"Accumulated Depreciation",205.25,"",5501195.91
,"General Journal","23-08-2024","24841",,,"Microwave 1 Depreciation","Expense","Depreciation Expense",,"Accumulated Depreciation",217.13,"",5501413.04
,"General Journal","23-08-2024","24842",,,"Pallet truck 3 Dep","Expense","Depreciation Expense",,"Accumulated Depreciation",510.95,"",5501923.99
,"General Journal","23-08-2024","24843",,,"Pouching Machine Depreciation","Expense","Depreciation Expense",,"Accumulated Depreciation",711.90,"",5502635.89
,"General Journal","23-08-2024","24844",,,"Power bank dep","Expense","Depreciation Expense",,"Accumulated Depreciation",119.05,"",5502754.94
,"General Journal","23-08-2024","24845",,,"Table Top Scale 11  SS 30Kg Depreciation","Expense","Depreciation Expense",,"Accumulated Depreciation",297.62,"",5503052.56
,"General Journal","23-08-2024","24846",,,"Table Top Scale 12  SS 30Kg Depreciation","Expense","Depreciation Expense",,"Accumulated Depreciation",297.62,"",5503350.18
,"General Journal","24-08-2024","24847",,,"Access Control Unit & System Depreciation","Expense","Depreciation Expense",,"Accumulated Depreciation",334.76,"",5503684.94
,"General Journal","24-08-2024","24854",,,"Electrical Enclosure Compressor Depreciation","Expense","Depreciation Expense",,"Accumulated Depreciation",125.00,"",5503809.94
,"General Journal","24-08-2024","24855",,,"ETR Machine Depreciation","Expense","Depreciation Expense",,"Accumulated Depreciation",236.04,"",5504045.98
,"General Journal","24-08-2024","24866",,,"Liquid Plant Depreciation","Expense","Depreciation Expense",,"Accumulated Deprecation",15029.76,"",5519075.74
,"General Journal","24-08-2024","24868",,,"Paste processing & packing line depreciation","Expense","Depreciation Expense",,"Accumulated Depreciation",17348.21,"",5536423.95
,"General Journal","24-08-2024","24869",,,"pH Meter Depreciation","Expense","Depreciation Expense",,"Accumulated Depreciation",741.39,"",5537165.34
,"General Journal","25-08-2024","24850",,,"Clamp Meter 1 Depreciation","Expense","Depreciation Expense",,"Accumulated Depreciation",36.90,"",5537202.24
,"General Journal","25-08-2024","24856",,,"Fire Alarm Sytstem Depreciation","Expense","Depreciation Expense",,"Accumulated Depreciation",728.57,"",5537930.81
,"General Journal","25-08-2024","24857",,,"Floor Chair 11 Depreciation","Expense","Depreciation Expense",,"Accumulated Depreciation",53.57,"",5537984.38
,"General Journal","25-08-2024","24858",,,"Floor Chair 12 Depreciation","Expense","Depreciation Expense",,"Accumulated Depreciation",53.57,"",5538037.95
,"General Journal","25-08-2024","24859",,,"Floor Chair 13 Depreciation","Expense","Depreciation Expense",,"Accumulated Depreciation",53.57,"",5538091.52
,"General Journal","25-08-2024","24860",,,"Floor Chair 14 Depreciation","Expense","Depreciation Expense",,"Accumulated Depreciation",53.57,"",5538145.09
,"General Journal","25-08-2024","24861",,,"Floor Chair 15 Depreciation","Expense","Depreciation Expense",,"Accumulated Depreciation",53.57,"",5538198.66
,"General Journal","25-08-2024","24862",,,"Floor Chair 16 Depreciation","Expense","Depreciation Expense",,"Accumulated Depreciation",53.57,"",5538252.23
,"General Journal","25-08-2024","24865",,,"Liquid Mixer 500Lt Depreciation","Expense","Depreciation Expense",,"Accumulated Depreciation",6172.62,"",5544424.85
,"General Journal","25-08-2024","24870",,,"Plastic Resin Mixer Depreciation","Expense","Depreciation Expense",,"Accumulated  Depreciation",1130.95,"",5545555.80
,"General Journal","25-08-2024","24871",,,"Plastic Resin Mixer Depreciation","Expense","Depreciation Expense",,"Accumulated  Depreciation",1130.95,"",5546686.75
,"General Journal","25-08-2024","25190",,,"Water tank 7 Depreciation","Expense","Depreciation Expense",,"Accumulated Depreciation",71.84,"",5546758.59
,"General Journal","26-08-2024","24849",,,"Board room chair 3 Depreciation","Expense","Depreciation Expense",,"Accumulated Depreciation",59.52,"",5546818.11
,"General Journal","26-08-2024","24851",,,"Dell Desktop 2 Depreciation","Expense","Depreciation Expense",,"Accumulated Depreciation",229.17,"",5547047.28
,"General Journal","26-08-2024","24852",,,"Dell Desktop 3 Depreciation","Expense","Depreciation Expense",,"Accumulated Depreciation",229.17,"",5547276.45
,"General Journal","26-08-2024","24853",,,"Dell Desktop 4 Depreciation","Expense","Depreciation Expense",,"Accumulated Depreciation",229.17,"",5547505.62
,"General Journal","26-08-2024","24863",,,"Grease Gun 1 Depreciation","Expense","Depreciation Expense",,"Accumulated Depreciation",73.21,"",5547578.83
,"General Journal","26-08-2024","24864",,,"Grease Gun 2 Depreciation","Expense","Depreciation Expense",,"Accumulated Depreciation",63.14,"",5547641.97
,"General Journal","26-08-2024","24872",,,"Retort Stand 1 Depreciation","Expense","Depreciation Expense",,"Accumulated Depreciation",10.71,"",5547652.68
,"General Journal","26-08-2024","24873",,,"Retort Stand 2 Depreciation","Expense","Depreciation Expense",,"Accumulated Depreciation",10.71,"",5547663.39
,"General Journal","26-08-2024","25199",,,"Tea Urn 2 Depreciation","Expense","Depreciation Expense",,"Accumulated Depreciation",180.00,"",5547843.39
,"General Journal","27-08-2024","24875",,,"Board room chair 10 Depreciation","Expense","Depreciation Expense",,"Accumulated Depreciation",79.55,"",5547922.94
,"General Journal","27-08-2024","24876",,,"Board room chair 11 Depreciation","Expense","Depreciation Expense",,"Accumulated Depreciation",79.55,"",5548002.49
,"General Journal","27-08-2024","24877",,,"Board room chair 12 Depreciation","Expense","Depreciation Expense",,"Accumulated Depreciation",79.55,"",5548082.04
,"General Journal","27-08-2024","24878",,,"Board room chair 13 Depreciation","Expense","Depreciation Expense",,"Accumulated Depreciation",79.55,"",5548161.59
,"General Journal","27-08-2024","24879",,,"Board room chair 14 Depreciation","Expense","Depreciation Expense",,"Accumulated Depreciation",79.55,"",5548241.14
,"General Journal","27-08-2024","24880",,,"Board room chair 15 Depreciation","Expense","Depreciation Expense",,"Accumulated Depreciation",79.55,"",5548320.69
,"General Journal","27-08-2024","24881",,,"Board room chair 16 Depreciation","Expense","Depreciation Expense",,"Accumulated Depreciation",79.55,"",5548400.24
,"General Journal","27-08-2024","24882",,,"Board room chair 17 Depreciation","Expense","Depreciation Expense",,"Accumulated Depreciation",79.55,"",5548479.79
,"General Journal","27-08-2024","24883",,,"Board room chair 18 Depreciation","Expense","Depreciation Expense",,"Accumulated Depreciation",79.55,"",5548559.34
,"General Journal","27-08-2024","24884",,,"Board room chair 19 Depreciation","Expense","Depreciation Expense",,"Accumulated Depreciation",79.55,"",5548638.89
,"General Journal","27-08-2024","24885",,,"Board room chair 9 Depreciation","Expense","Depreciation Expense",,"Accumulated Depreciation",79.55,"",5548718.44
,"General Journal","27-08-2024","24886",,,"Canteen Chair 20 Depreciation","Expense","Depreciation Expense",,"Accumulated Depreciation",6.12,"",5548724.56
,"General Journal","27-08-2024","24887",,,"Passenger Lift 1000kg Depreciation","Expense","Depreciation Expense",,"Accumulated Depreciation",44484.68,"",5593209.24
,"General Journal","28-08-2024","25166",,,"Heat Gun Bosch 2 Accumulated depreciation","Expense","Depreciation Expense",,"Accumulated Depreciation",75.43,"",5593284.67
,"General Journal","28-08-2024","25172",,,"Heat Gun Bosch 3 Accumulated depreciation","Expense","Depreciation Expense",,"Accumulated Depreciation",75.43,"",5593360.10
,"General Journal","31-08-2024","24888",,,"500gm Jar Blow Mould 3 depreciation","Expense","Depreciation Expense",,"Accumulated Depreciation",1026.79,"",5594386.89
,"General Journal","31-08-2024","24889",,,"500gm Jar Blow Mould 4 depreciation","Expense","Depreciation Expense",,"Accumulated Depreciation",1026.79,"",5595413.68
,"General Journal","31-08-2024","24890",,,"Air cooled chiller depeciation","Expense","Depreciation Expense",,"Accumulated  Depreciation",8916.67,"",5604330.35
,"General Journal","31-08-2024","24891","*","Unilever Kenya Ltd:Sunlight Washing Pwd","Boato Installation Depreciation","Expense","Depreciation Expense",,"Accumulated Depreciation",65114.38,"",5669444.73
,"General Journal","31-08-2024","24892","*",,"Canister Platform Depreciation","Expense","Depreciation Expense",,"Accumulated Depreciation",59246.67,"",5728691.40
,"General Journal","31-08-2024","24893",,,"CCTV DRV & System Depreciation","Expense","Depreciation Expense",,"Accumulated Depreciation",1295.33,"",5729986.73
,"General Journal","31-08-2024","24894",,,"Colour Pressure tank Depreciation","Expense","Depreciation Expense",,"Accumulated Depreciation",232.14,"",5730218.87
,"General Journal","31-08-2024","24895",,,"Compressed air gun Depreciation","Expense","Depreciation Expense",,"Accumulated Depreciation",47.62,"",5730266.49
,"General Journal","31-08-2024","24896",,,"Drum Pump 2 Depreciation","Expense","Depreciation Expense",,"Accumulated Depreciation",123.15,"",5730389.64
,"General Journal","31-08-2024","24897",,,"Extractor Fan down Depreciation","Expense","Depreciation Expense",,"Accumulated Depreciation",150.12,"",5730539.76
,"General Journal","31-08-2024","24898",,,"Extractor Fan Hoisting Depreciation","Expense","Depreciation Expense",,"Accumulated Depreciation",176.67,"",5730716.43
,"General Journal","31-08-2024","24899",,,"Extractor Fan Packaging Depreciation","Expense","Depreciation Expense",,"Accumulated Depreciation",150.12,"",5730866.55
,"General Journal","31-08-2024","24900",,,"Incotex Type C Control Unit Depreciation","Expense","Depreciation Expense",,"Accumulated Depreciation",1939.66,"",5732806.21
,"General Journal","31-08-2024","24901",,,"Lamination Machine 1 Depreciation","Expense","Depreciation Expense",,"Accumulated Depreciation",84.78,"",5732890.99
,"General Journal","31-08-2024","24902",,,"Office Cabinet 5 Depreciation","Expense","Depreciation Expense",,"Accumulated Depreciation",58.33,"",5732949.32
,"General Journal","31-08-2024","24903",,,"Office Desk 6 Depreciation","Expense","Depreciation Expense",,"Accumulated Depreciation",90.48,"",5733039.80
,"General Journal","31-08-2024","24904",,,"Office Desk 7 Depreciation","Expense","Depreciation Expense",,"Accumulated Depreciation",90.48,"",5733130.28
,"General Journal","31-08-2024","24905",,,"Office Desk 8 Depreciation","Expense","Depreciation Expense",,"Accumulated Depreciation",83.33,"",5733213.61
,"General Journal","31-08-2024","24906",,,"Platform Scale 4 tons 1 Depreciation","Expense","Depreciation Expense",,"Accumulated Depreciation",10782.43,"",5743996.04
,"General Journal","31-08-2024","24907",,,"Process Water Filtration System Depreciation","Expense","Depreciation Expense",,"Accumulated Depreciation",1785.71,"",5745781.75
,"General Journal","31-08-2024","24908",,,"Sulphonic Acid pressure tank Depreciation","Expense","Depreciation Expense",,"Accumulated Depreciation",110.48,"",5745892.23
,"General Journal","31-08-2024","24909",,,"Test Sieves 100 & 200 microns Depreciation","Expense","Depreciation Expense",,"Accumulated Depreciation",450.00,"",5746342.23
,"General Journal","31-08-2024","24910",,,"Wall mounted cabinet 1 Dep","Expense","Depreciation Expense",,"Accumulated Depreciation",107.14,"",5746449.37
,"General Journal","31-08-2024","24911",,,"Water tank 5 Depreciation","Expense","Depreciation Expense",,"Accumulated Depreciation",137.79,"",5746587.16
,"General Journal","01-09-2024","24920",,,"Hoisting Bucket 1 Depreciation","Expense","Depreciation Expense",,"Accumulated Depreciation",148.81,"",5746735.97
,"General Journal","01-09-2024","24921",,,"Hoisting Bucket 2 Dereciation","Expense","Depreciation Expense",,"Accumulated Depreciation",148.81,"",5746884.78
,"General Journal","01-09-2024","24925",,,"Lenovo Laptop 2 Depreciation","Expense","Depreciation Expense",,"Accumulated Depreciation",333.33,"",5747218.11
,"General Journal","01-09-2024","24926",,,"Processing Platform Depreciation","Expense","Depreciation Expense",,"Accumulated Depreciation",4880.95,"",5752099.06
,"General Journal","01-09-2024","24927",,,"Security and Computer Sytem UPS Depreciation","Expense","Depreciation Expense",,"Accumulated Depreciation",3584.50,"",5755683.56
,"General Journal","01-09-2024","24931",,,"Trophy Shelf 1 Depreciation","Expense","Depreciation Expense",,"Accumulated Depreciation",95.24,"",5755778.80
,"General Journal","01-09-2024","24933",,,"Water tank 4 Depreciation","Expense","Depreciation Expense",,"Accumulated Depreciation",453.24,"",5756232.04
,"General Journal","02-09-2024","24912",,,"CMPP 1kg Jar Blow Mould 1 Depreciation","Expense","Depreciation Expense",,"Accumulated Depreciation",3364.87,"",5759596.91
,"General Journal","02-09-2024","24913",,,"CMPP 1kg Jar Blow Mould 2 Depreciation","Expense","Depreciation Expense",,"Accumulated Depreciation",3364.87,"",5762961.78
,"General Journal","02-09-2024","24914",,,"CMPP 500gm Jar Blow Mould 1 Depreciation","Expense","Depreciation Expense",,"Accumulated Depreciation",2643.82,"",5765605.60
,"General Journal","02-09-2024","24915",,,"CMPP 500gm Jar Blow Mould 2 Depreciation","Expense","Depreciation Expense",,"Accumulated Depreciation",2643.82,"",5768249.42
,"General Journal","02-09-2024","24916",,,"CMPP Blow Moulding Machine 1 Depreciation","Expense","Depreciation Expense",,"Accumulated Depreciation",49344.71,"",5817594.13
,"General Journal","02-09-2024","24917",,,"CMPP Blow Moulding Machine 2 Depreciation","Expense","Depreciation Expense",,"Accumulated Depreciation",49344.71,"",5866938.84
,"General Journal","02-09-2024","24918",,,"Drum Pump 1 Depreiation","Expense","Depreciation Expense",,"Accumulated Depreciation",123.03,"",5867061.87
,"General Journal","02-09-2024","24919",,,"Heat Gun Bosch 1 Depreciation","Expense","Depreciation Expense",,"Accumulated Depreciation",100.57,"",5867162.44
,"General Journal","02-09-2024","24922",,,"Hot ProcessWater Storage Tank1  Depreciation","Expense","Depreciation Expense",,"Accumulated Depreciation",73.99,"",5867236.43
,"General Journal","02-09-2024","24923","*",,"HP Laptop 4 Depreciation","Expense","Depreciation Expense",,"Accumulated Depreciation",297.62,"",5867534.05
,"General Journal","02-09-2024","24924","*",,"HP Laptop 8 Depreciation","Expense","Depreciation Expense",,"Accumulated Depreciation",1200.00,"",5868734.05
,"General Journal","02-09-2024","24928",,,"Store Racking 1 depreciation","Expense","Depreciation Expense",,"Accumulated Depreciation",175.60,"",5868909.65
,"General Journal","02-09-2024","24929",,,"Store Racking 2 Depreciation","Expense","Depreciation Expense",,"Accumulated Depreciation",175.60,"",5869085.25
,"General Journal","02-09-2024","24930",,,"Tank platform Depreciation","Expense","Depreciation Expense",,"Accumulated Depreciation",130.95,"",5869216.20
,"General Journal","02-09-2024","24932",,,"Water tank 1 Depreciation","Expense","Depreciation Expense",,"Accumulated Depreciation",120.07,"",5869336.27
,"General Journal","02-09-2024","24934",,,"Workshop cabinet depreciation","Expense","Depreciation Expense",,"Accumulated Depreciation",172.02,"",5869508.29
,"General Journal","03-09-2024","24936",,,"Alarm System extension","Expense","Depreciation Expense",,"Accumulated Depreciation",602.38,"",5870110.67
,"General Journal","03-09-2024","24937",,,"Domestos sewing machine depreciation","Expense","Depreciation Expense",,"Acummulated depreciation",82.10,"",5870192.77
,"General Journal","03-09-2024","24938",,,"Bench Grinder 2 Depreciation","Expense","Depreciation Expense",,"Accumulated Depreceiation",100.57,"",5870293.34
,"General Journal","03-09-2024","24939",,,"CCTV survellance System extension Depreciation","Expense","Depreciation Expense",,"Accumulated Depreciation",657.14,"",5870950.48
,"General Journal","03-09-2024","24940",,,"Electrical Enclosure CCTV Depreciation","Expense","Depreciation Expense",,"Accumulated Depreciation",126.19,"",5871076.67
,"General Journal","03-09-2024","24941",,,"Electrical Enclosure Main Depreciation","Expense","Depreciation Expense",,"Accumulated Depreciation",2339.29,"",5873415.96
,"General Journal","03-09-2024","24942",,,"Electrical Enclosure P Line Depreciation","Expense","Depreciation Expense",,"Accumulated Depreciation",428.57,"",5873844.53
,"General Journal","03-09-2024","24943",,,"Floodlight Depreciation","Expense","Depreciation Expense",,"Accumulated Depreciation",59.52,"",5873904.05
,"General Journal","03-09-2024","24944",,,"Office Desk 1 Depreciation","Expense","Depreciation Expense",,"Accumulated Depreciation",225.00,"",5874129.05
,"General Journal","03-09-2024","24945",,,"Office Desk 2 Depreciation","Expense","Depreciation Expense",,"Accumulated Depreciation",225.00,"",5874354.05
,"General Journal","03-09-2024","24946",,,"Office Desk 3 Depreciation","Expense","Depreciation Expense",,"Accumulated Depreciation",225.00,"",5874579.05
,"General Journal","03-09-2024","24947",,,"Signet ESD 1 Depreciation","Expense","Depreciation Expense",,"Accumulated Depreciation",928.57,"",5875507.62
,"General Journal","03-09-2024","24948","*",,"Sterling Water Dispenser 1 Depreciation","Expense","Depreciation Expense",,"Accumulated Depreciation",119.05,"",5875626.67
,"General Journal","03-09-2024","24949",,,"Table top Weighing Scale 5 Depreciation","Expense","Depreciation Expense",,"Accumulated Depreciation",248.57,"",5875875.24
,"General Journal","03-09-2024","24950",,,"Table top Weighing Scale 6 Depreciation","Expense","Depreciation Expense",,"Accumulated Depreciation",248.57,"",5876123.81
,"General Journal","03-09-2024","24951",,,"Table top Weighing Scale 7 Depreciation","Expense","Depreciation Expense",,"Accumulated Depreciation",248.57,"",5876372.38
,"General Journal","03-09-2024","24952",,,"Table top Weighing Scale 8 Depreciation","Expense","Depreciation Expense",,"Accumulated Depreciation",248.57,"",5876620.95
,"General Journal","03-09-2024","24953",,,"Table top Weighing Scale 9 Depreciation","Expense","Depreciation Expense",,"Accumulated Depreciation",248.57,"",5876869.52
,"General Journal","04-09-2024","24955",,,"9Kg Powder Fire Extinguisher 1 Depreciation","Expense","Depreciation Expense",,"Accumulated Depreciation",34.52,"",5876904.04
,"General Journal","04-09-2024","24956",,,"9Kg Powder Fire Extinguisher 2 Depreciation","Expense","Depreciation Expense",,"Accumulated Depreciation",34.52,"",5876938.56
,"General Journal","04-09-2024","24957",,,"9Kg Powder Fire Extinguisher 3 Depreciation","Expense","Depreciation Expense",,"Accumulated Depreciation",34.52,"",5876973.08
,"General Journal","04-09-2024","24958",,,"9Kg Powder Fire Extinguisher 5 Depreciation","Expense","Depreciation Expense",,"Accumulated Depreciation",34.52,"",5877007.60
,"General Journal","04-09-2024","24959",,,"Chiller 2 Depreciation","Expense","Depreciation Expense",,"Accumulated Depreciation",8035.71,"",5885043.31
,"General Journal","04-09-2024","24960",,,"Empty IBC Tank 10 Depreciation","Expense","Depreciation Expense",,"Accumulated Depreciation",41.67,"",5885084.98
,"General Journal","04-09-2024","24961",,,"Empty IBC Tank 3 Depreciation","Expense","Depreciation Expense",,"Accumulated Depreciation",65.48,"",5885150.46
,"General Journal","04-09-2024","24962",,,"Empty IBC Tank 4 Depreciation","Expense","Depreciation Expense",,"Accumulated Depreciation",65.48,"",5885215.94
,"General Journal","04-09-2024","24963",,,"Empty IBC Tank 5 Depreciation","Expense","Depreciation Expense",,"Accumulated Depreciation",65.48,"",5885281.42
,"General Journal","04-09-2024","24964",,,"Empty IBC Tank 6 Depreciation","Expense","Depreciation Expense",,"Accumulated Depreciation",65.48,"",5885346.90
,"General Journal","04-09-2024","24965",,,"Empty IBC Tank 7 Depreciation","Expense","Depreciation Expense",,"Accumulated Depreciation",41.67,"",5885388.57
,"General Journal","04-09-2024","24966",,,"Empty IBC Tank 8 Depreciation","Expense","Depreciation Expense",,"Accumulated Depreiation",41.67,"",5885430.24
,"General Journal","04-09-2024","24967",,,"Empty IBC Tank 9 Depreciation","Expense","Depreciation Expense",,"Accumulated Depreciation",41.67,"",5885471.91
,"General Journal","04-09-2024","24968",,,"Linx 8900 Coder 1 Depreciation","Expense","Depreciation Expense",,"Accumulated Depreciation",8333.33,"",5893805.24
,"General Journal","04-09-2024","24969",,,"Mobile Phone 2 Depreciation","Expense","Depreciation Expense",,"Accumulated Depreciation",46.67,"",5893851.91
,"General Journal","04-09-2024","24970",,,"Triple UV water purifier 1 Depreciation","Expense","Depreciation Expense",,"Accumulated Depreciation",296.22,"",5894148.13
,"General Journal","05-09-2024","24971",,,"1Kg Generic Jar Blow Mould 1 depreciation","Expense","Depreciation Expense",,"Accumulated Depreciation",1500.00,"",5895648.13
,"General Journal","05-09-2024","24972",,,"1Kg Generic Jar Blow Mould 2 depreciation","Expense","Depreciation Expense",,"Accumulated Depreciation",1500.00,"",5897148.13
,"General Journal","05-09-2024","24973",,,"500gm Generic Jar Blow Mould 1 depreciation","Expense","Depreciation Expense",,"Accumulated Depreciation",1071.43,"",5898219.56
,"General Journal","05-09-2024","24974",,,"500gm Generic Jar Blow Mould 2 depreciation","Expense","Depreciation Expense",,"Accumulated Depreciation",1071.43,"",5899290.99
,"General Journal","05-09-2024","24975",,,"9Kg Powder Fire Extinguisher 4 Depreciation","Expense","Depreciation Expense",,"Accumulated Depreciation",34.52,"",5899325.51
,"General Journal","05-09-2024","24976",,,"Extractor Fan 4 Depreciation","Expense","Depreciation Expense",,"Accumulated Depreciation",726.19,"",5900051.70
,"General Journal","05-09-2024","24977",,,"FFS  Machine Installation Elct Depreciation","Expense","Depreciation Expense",,"Accumulated Depreciation",200.60,"",5900252.30
,"General Journal","05-09-2024","24978",,,"First Aid Kit Depreciation","Expense","Depreciation Expense",,"Accumulated  Depreciation",77.38,"",5900329.68
,"General Journal","05-09-2024","24979",,,"Linx 8900 Coder 2 Depreciation","Expense","Depreciation Expense",,"Accumulated Depreciation",12500.00,"",5912829.68
,"General Journal","05-09-2024","24980",,,"Packing Platform Depreciation","Expense","Depreciation Expense",,"Accumulated Depreciation",5297.62,"",5918127.30
,"General Journal","05-09-2024","24981",,,"SS Industrial Turntable Depreciation","Expense","Depreciation Expense",,"Accumulated Depreciation",5238.10,"",5923365.40
,"General Journal","05-09-2024","24982",,,"TV Screen 2 Depreciation","Expense","Depreciation Expense",,"Accumulated Depreciation",950.00,"",5924315.40
,"General Journal","05-09-2024","24983",,,"Water Purifier 1 Depreciation","Expense","Depreciation Expense",,"Accumulated Depreciation",117.10,"",5924432.50
,"General Journal","06-09-2024","24984",,,"Blower Depreciation","Expense","Depreciation Expense",,"Accumulated Depreciation",59.52,"",5924492.02
,"General Journal","06-09-2024","24985",,,"Emergency Washing Point Depreciation","Expense","Depreciation Expense",,"Accumulated Deprecation",160.71,"",5924652.73
,"General Journal","06-09-2024","24986","*",,"Infrared Thermometre 1 Depreciation","Expense","Depreciation Expense",,"Accumulated Depreciation",416.67,"",5925069.40
,"General Journal","06-09-2024","24987",,,"Material's Trolley Depreciation","Expense","Depreciation Expense",,"Accumulated Depreciation",297.62,"",5925367.02
,"General Journal","06-09-2024","24988",,,"Plastic Scrap Grinder Machine Depreciation","Expense","Depreciation Expense",,"Accumulated  Depreciation",3452.38,"",5928819.40
,"General Journal","06-09-2024","24989",,,"Ribon Mixer SS depreciation","Expense","Depreciation Expense",,"Accumulated depreciation",4642.86,"",5933462.26
,"General Journal","06-09-2024","24990",,,"Telephone Handset Depreciation","Expense","Depreciation Expense",,"Accumulated Depreciation",29.76,"",5933492.02
,"General Journal","06-09-2024","24991",,,"Telkom Wifi Router Depreciation","Expense","Depreciation Expense",,"Accumulated Depreciation",71.43,"",5933563.45
,"General Journal","06-09-2024","24992",,,"Vacuum Cleaner Depreciation","Expense","Depreciation Expense",,"Accumulated Depreciation",148.81,"",5933712.26
,"General Journal","07-09-2024","24997",,,"9Kg Powder Fire Extinguisher 6 Depreciation","Expense","Depreciation Expense",,"Accumulated Depreciation",44.05,"",5933756.31
,"General Journal","07-09-2024","25001",,,"Cartoning table 4 depreciation","Expense","Depreciation Expense",,"Accumulated Depreciation",262.49,"",5934018.80
,"General Journal","07-09-2024","25002",,,"Case sealing table depreciation","Expense","Depreciation Expense",,"Accumulated Depreciation",86.67,"",5934105.47
,"General Journal","07-09-2024","25003",,,"Chain block 2 depreciation","Expense","Depreciation Expense",,"Accumulated depreciation",398.81,"",5934504.28
,"General Journal","07-09-2024","25004",,,"Chain block 3 depreciation","Expense","Depreciation Expense",,"Accumulated depreciation",398.81,"",5934903.09
,"General Journal","07-09-2024","25006",,,"Drilling machine Depreciation","Expense","Depreciation Expense",,"Accumulated Depreciation",88.39,"",5934991.48
,"General Journal","07-09-2024","25020",,,"Grinder Depreciation","Expense","Depreciation Expense",,"Acccumulated Depreciation",159.82,"",5935151.30
,"General Journal","07-09-2024","25026",,,"Packing table 1 depreciation","Expense","Depreciation Expense",,"Accumulated Depreciation",262.49,"",5935413.79
,"General Journal","07-09-2024","25027",,,"Packing table 2 depreciation","Expense","Depreciation Expense",,"Accumulated Depreciation",262.49,"",5935676.28
,"General Journal","07-09-2024","25028",,,"Packing table 3 depreciation","Expense","Depreciation Expense",,"Accumulated Depreciation",262.49,"",5935938.77
,"General Journal","07-09-2024","25029",,,"Quality table depreciation","Expense","Depreciation Expense",,"Accumulated Depreciation",86.67,"",5936025.44
,"General Journal","07-09-2024","25031",,,"Welding machine Depreciation","Expense","Depreciation Expense",,"Accumulated Depreciation",178.57,"",5936204.01
,"General Journal","08-09-2024","24998",,,"Bench Grinder 350W Depreciation","Expense","Depreciation Expense",,"Accumulated Depreciation",122.13,"",5936326.14
,"General Journal","08-09-2024","25021",,,"HP Laptop 6 Depreciation","Expense","Depreciation Expense",,"Accumulated Depreciation",416.67,"",5936742.81
,"General Journal","08-09-2024","25025",,,"Mobile Phone 1 Depreciation","Expense","Depreciation Expense",,"Accumulated Depreciation",58.33,"",5936801.14
,"General Journal","08-09-2024","25183",,,"Six step steel ladder 1 Depreciation","Expense","Depreciation Expense",,"Accumulated Depreciation",113.51,"",5936914.65
,"General Journal","09-09-2024","24999",,,"Canteen Table 1 Depreciation","Expense","Depreciation Expense",,"Accumulated Depreciation",184.52,"",5937099.17
,"General Journal","09-09-2024","25000",,,"Canteen Table 2 Depreciation","Expense","Depreciation Expense",,"Accumulated Depreciation",184.52,"",5937283.69
,"General Journal","09-09-2024","25005",,,"Dell Desktop 1 Depreciation","Expense","Depreciation Expense",,"Accumulated Depreciation",178.57,"",5937462.26
,"General Journal","09-09-2024","25007",,,"Fire Alarm System Extension'19 Depreciation","Expense","Depreciation Expense",,"Accumulated Depreciation",9857.14,"",5947319.40
,"General Journal","09-09-2024","25009",,,"Floor Chair 1 Depreciation","Expense","Depreciation Expense",,"Accumulated Depreciation",26.79,"",5947346.19
,"General Journal","09-09-2024","25010",,,"Floor Chair 10 Depreciation","Expense","Depreciation Expense",,"Accumulated Depreciation",53.57,"",5947399.76
,"General Journal","09-09-2024","25011",,,"Floor Chair 2 Depreciation","Expense","Depreciation Expense",,"Accumulated Depreciation",26.79,"",5947426.55
,"General Journal","09-09-2024","25012",,,"Floor Chair 3 Depreciation","Expense","Depreciation Expense",,"Accumulated Depreciation",26.79,"",5947453.34
,"General Journal","09-09-2024","25013",,,"Floor Chair 4 Depreciation","Expense","Depreciation Expense",,"Accumulated Depreciation",26.79,"",5947480.13
,"General Journal","09-09-2024","25014",,,"Floor Chair 5 Depreciation","Expense","Depreciation Expense",,"Accumulated Depreciation",26.79,"",5947506.92
,"General Journal","09-09-2024","25015",,,"Floor Chair 6 Depreciation","Expense","Depreciation Expense",,"Accumulated Depreciation",53.57,"",5947560.49
,"General Journal","09-09-2024","25016",,,"Floor Chair 7 Depreciation","Expense","Depreciation Expense",,"Accumulated Depreciation",53.57,"",5947614.06
,"General Journal","09-09-2024","25017",,,"Floor Chair 8 Depreciation","Expense","Depreciation Expense",,"Accumulated Depreciation",53.57,"",5947667.63
,"General Journal","09-09-2024","25018",,,"Floor Chair 9 Depreciation","Expense","Depreciation Expense",,"Accumulated Depreciation",53.57,"",5947721.20
,"General Journal","09-09-2024","25019",,,"Floor weighing scale Depreciation","Expense","Depreciation Expense",,"Accumulated Depreciation",593.81,"",5948315.01
,"General Journal","09-09-2024","25022",,,"Lab Office Chair 1 Depreciation","Expense","Depreciation Expense",,"Accumulated Depreciation",47.62,"",5948362.63
,"General Journal","09-09-2024","25023",,,"Lab Office Chair 2 Depreciation","Expense","Depreciation Expense",,"Accumulated Depreciation",47.62,"",5948410.25
,"General Journal","09-09-2024","25024",,,"Lab Office Chair 3 Depreciation","Expense","Depreciation Expense",,"Accumulated Depreciation",47.62,"",5948457.87
,"General Journal","09-09-2024","25030","*","Unilever Kenya Ltd:Sunlight Washing Pwd","Sunlight Bag Closing Machine 1 Depreciation","Expense","Depreciation Expense",,"Accumulated Depreciation",738.10,"",5949195.97
,"General Journal","10-09-2024","25032",,,"5Kg Fire Extinguisher 1 Depreciation","Expense","Depreciation Expense",,"Accumulated Depreciation",65.48,"",5949261.45
,"General Journal","10-09-2024","25033",,,"HP Laptop 10 Depreciation","Expense","Depreciation Expense",,"Accumulated Depreciation",1200.00,"",5950461.45
,"General Journal","10-09-2024","25034",,,"HP Laptop 9 Depreciation","Expense","Depreciation Expense",,"Accumulated Depreciation",1200.00,"",5951661.45
,"General Journal","10-09-2024","25035",,,"Office Seat 1 Depreciation","Expense","Depreciation Expense",,"Accumulated Depreciation",142.86,"",5951804.31
,"General Journal","10-09-2024","25036",,,"Office Seat 2 Depreciation","Expense","Depreciation Expense",,"Accumulated Depreciation",71.43,"",5951875.74
,"General Journal","10-09-2024","25037",,,"Office Seat 3 Depreciation","Expense","Depreciation Expense",,"Accumulated Depreciation",71.43,"",5951947.17
,"General Journal","10-09-2024","25038",,,"Reverse Osmosis Unit 1 Depreciation","Expense","Depreciation Expense",,"Accumulated Depreciation",416.67,"",5952363.84
,"General Journal","10-09-2024","25039",,,"Steam Generator SG24 Depreciation","Expense","Depreciation Expense",,"Accumulated Depreciation",3794.53,"",5956158.37
,"General Journal","10-09-2024","25040",,,"Toilet Cleaner Mixing Machine Depreciation","Expense","Depreciation Expense",,"Accumulated Depreciation",6333.33,"",5962491.70
,"General Journal","11-09-2024","25041",,,"4 GB hard drive for CCTV Depreciation","Expense","Depreciation Expense",,"Accumulated Depreciation",178.57,"",5962670.27
,"General Journal","11-09-2024","25042",,,"4TB Hard Disk Depreciation","Expense","Depreciation Expense",,"Accumulated Depreciation",178.57,"",5962848.84
,"General Journal","11-09-2024","25043","*","Unilever Kenya Ltd:Sunlight Washing Pwd","Chain block trolley 4 depreciation","Expense","Depreciation Expense",,"Accumulated Depreciation",85.00,"",5962933.84
,"General Journal","11-09-2024","25044",,,"Coder Depreciation","Expense","Depreciation Expense",,"Accumulated Depreciation",2261.90,"",5965195.74
,"General Journal","11-09-2024","25045",,,"Coder Stand Depreciation","Expense","Depreciation Expense",,"Accumulated Depreciation",59.52,"",5965255.26
,"General Journal","11-09-2024","25046",,,"Compressor 1 depreciation","Expense","Depreciation Expense",,"Accumulated depreciation",3750.00,"",5969005.26
,"General Journal","11-09-2024","25047",,,"HP Laptop 14 Depreciation","Expense","Depreciation Expense",,"Accumulated Depreciation",1941.67,"",5970946.93
,"General Journal","11-09-2024","25048",,,"HP Laptop 15 Depreciation","Expense","Depreciation Expense",,"Accumulated Depreciation",1750.00,"",5972696.93
,"General Journal","11-09-2024","25049",,,"Pallet truck 2 depreciation","Expense","Depreciation Expense",,"Accumulated depreciation",440.48,"",5973137.41
,"General Journal","11-09-2024","25050","*",,"Steam Label Shrink Tunnel Depreciation","Expense","Depreciation Expense",,"Accumulated  Depreciation",10952.38,"",5984089.79
,"General Journal","12-09-2024","25052",,,"Coder Housing Depreciation","Expense","Depreciation Expense",,"Accumulated Depreciation",80.36,"",5984170.15
,"General Journal","12-09-2024","25053",,,"Coding Conveyor Depreciation","Expense","Depreciation Expense",,"Accumulated Depreciation",476.19,"",5984646.34
,"General Journal","12-09-2024","25054",,,"Conveyor 2 Depreciation","Expense","Depreciation Expense",,"Accumulated  Depreciation",169.64,"",5984815.98
,"General Journal","12-09-2024","25055",,,"Eyewash Station 1 Depreciation","Expense","Depreciation Expense",,"Accumulated Depreciation",904.76,"",5985720.74
,"General Journal","12-09-2024","25056",,,"HP Laptop 5 Depreciation","Expense","Depreciation Expense",,"Accumulated Depreciation",416.67,"",5986137.41
,"General Journal","12-09-2024","25057",,,"Tea maker Depreciation","Expense","Depreciation Expense",,"Accumulated Depreciation",225.00,"",5986362.41
,"General Journal","13-09-2024","25070",,,"Alarm System Depreciation","Expense","Depreciation Expense",,"Accumulated Depreciation",580.95,"",5986943.36
,"General Journal","13-09-2024","25071",,,"Bosch Blower 2 Depreciation","Expense","Depreciation Expense",,"Accumulated Depreciation",136.49,"",5987079.85
,"General Journal","13-09-2024","25072",,,"Coder UPS 8 Depreciation","Expense","Depreciation Expense",,"Accumulated Depreciation",81.67,"",5987161.52
,"General Journal","13-09-2024","25073","*",,"HP Laptop 16 Depreciation","Expense","Depreciation Expense",,"Accumulated Depreciation",1000.00,"",5988161.52
,"General Journal","13-09-2024","25074",,,"PIR system extension Depreciation","Expense","Depreciation Expense",,"Accumulated Depreciation",254.67,"",5988416.19
,"General Journal","13-09-2024","25075",,,"Process Water Storage Tank Depreciation","Expense","Depreciation Expense",,"Accumulated Depreciation",1065.16,"",5989481.35
,"General Journal","13-09-2024","25076","*",,"Store Racking 3 FG Depreciation","Expense","Depreciation Expense",,"Accumulated Depreciation",9791.67,"",5999273.02
,"General Journal","13-09-2024","25077",,,"Weighing scale 1","Expense","Depreciation Expense",,"Accumulated Depreciation",559.52,"",5999832.54
,"General Journal","13-09-2024","25177",,,"HP Mini Desktop 4 Depreciation","Expense","Depreciation Expense",,"Accumulated Depreciation",466.67,"",6000299.21
,"General Journal","14-09-2024","25115",,,"Coder UPS 5 Depreciation","Expense","Depreciation Expense",,"Accumulated Depreciation",158.33,"",6000457.54
,"General Journal","14-09-2024","25131",,,"Motor Vehicle 2 Depreciation","Expense","Depreciation Expense",,"Accumulated Depreciation",10297.62,"",6010755.16
,"General Journal","14-09-2024","25133",,,"Paste Packing Machine Depreciation","Expense","Depreciation Expense",,"Accumulated Depreciation",4166.67,"",6014921.83
,"General Journal","14-09-2024","25134",,,"Table Top Scale 10  SS 15Kg Depreciation","Expense","Depreciation Expense",,"Accumulated Depreciation",297.62,"",6015219.45
,"General Journal","15-09-2024","25078",,,"150KVA Enclosed Genset Depreciation","Expense","Depreciation Expense",,"Accumulated Depreciation",24404.76,"",6039624.21
,"General Journal","15-09-2024","25079",,,"20Kg Forklift Gas Cylinder 2 Depreciation","Expense","Depreciation Expense",,"Accumulated Depreciation",769.70,"",6040393.91
,"General Journal","15-09-2024","25080",,,"2Ton Electric Hoist 1 Depreciation","Expense","Depreciation Expense",,"Accumulated Depreciation",3708.33,"",6044102.24
,"General Journal","15-09-2024","25081",,,"Automatic Change Over Switch 1 Depreciation","Expense","Depreciation Expense",,"Accumulated Depreciation",1666.67,"",6045768.91
,"General Journal","15-09-2024","25082",,,"Bench top Weighing Scale 1 Depreciation","Expense","Depreciation Expense",,"Accumulated Depreciation",357.14,"",6046126.05
,"General Journal","15-09-2024","25083",,,"Bench top Weighing Scale 2 Depreciation","Expense","Depreciation Expense",,"Accumulated Depreciation",357.14,"",6046483.19
,"General Journal","15-09-2024","25084",,,"Bench top Weighing Scale 3 Depreciation","Expense","Depreciation Expense",,"Accumulated Depreciation",357.14,"",6046840.33
,"General Journal","15-09-2024","25085",,,"Bench top Weighing Scale 4 Depreciation","Expense","Depreciation Expense",,"Accumulated Depreciation",357.14,"",6047197.47
,"General Journal","15-09-2024","25086",,,"Bosch Blower Depreciation","Expense","Depreciation Expense",,"Accumulated Depreciation",129.31,"",6047326.78
,"General Journal","15-09-2024","25088",,,"Canteen Chair 1 Depreciation","Expense","Depreciation Expense",,"Accumulated Depreciation",6.12,"",6047332.90
,"General Journal","15-09-2024","25089",,,"Canteen Chair 10 Depreciation","Expense","Depreciation Expense",,"Accumulated Depreciation",6.12,"",6047339.02
,"General Journal","15-09-2024","25090",,,"Canteen Chair 11 Depreciation","Expense","Depreciation Expense",,"Accumulated Depreciation",6.12,"",6047345.14
,"General Journal","15-09-2024","25091",,,"Canteen Chair 11 Depreciation","Expense","Depreciation Expense",,"Accumulated Depreciation",6.12,"",6047351.26
,"General Journal","15-09-2024","25092",,,"Canteen Chair 12 Depreciation","Expense","Depreciation Expense",,"Accumulated Depreciation",6.12,"",6047357.38
,"General Journal","15-09-2024","25093",,,"Canteen Chair 13 Depreciation","Expense","Depreciation Expense",,"Accumulated Depreciation",6.12,"",6047363.50
,"General Journal","15-09-2024","25094",,,"Canteen Chair 14 Depreciation","Expense","Depreciation Expense",,"Accumulated Depreciation",6.12,"",6047369.62
,"General Journal","15-09-2024","25095",,,"Canteen Chair 15 Depreciation","Expense","Depreciation Expense",,"Accumulated Depreciation",6.12,"",6047375.74
,"General Journal","15-09-2024","25096",,,"Canteen Chair 16 Depreciation","Expense","Depreciation Expense",,"Accumulated Depreciation",6.12,"",6047381.86
,"General Journal","15-09-2024","25097",,,"Canteen Chair 17 Depreciation","Expense","Depreciation Expense",,"Accumulated Depreciation",6.12,"",6047387.98
,"General Journal","15-09-2024","25098",,,"Canteen Chair 18 Depreciation","Expense","Depreciation Expense",,"Accumulated Depreciation",6.12,"",6047394.10
,"General Journal","15-09-2024","25099",,,"Canteen Chair 19 Depreciation","Expense","Depreciation Expense",,"Accumulated Depreciation",6.12,"",6047400.22
,"General Journal","15-09-2024","25100",,,"Canteen Chair 2 Depreciation","Expense","Depreciation Expense",,"Accumulated Depreciation",6.12,"",6047406.34
,"General Journal","15-09-2024","25101",,,"Canteen Chair 21 Depreciation","Expense","Depreciation Expense",,"Accumulated Depreciation",6.12,"",6047412.46
,"General Journal","15-09-2024","25102",,,"Canteen Chair 22 Depreciation","Expense","Depreciation Expense",,"Accumulated Depreciation",6.12,"",6047418.58
,"General Journal","15-09-2024","25103",,,"Canteen Chair 23 Depreciation","Expense","Depreciation Expense",,"Accumulated Depreciation",6.12,"",6047424.70
,"General Journal","15-09-2024","25104",,,"Canteen Chair 24 Depreciation","Expense","Depreciation Expense",,"Accumulated Depreciation",6.12,"",6047430.82
,"General Journal","15-09-2024","25105",,,"Canteen Chair 25 Depreciation","Expense","Depreciation Expense",,"Accumulated Depreciation",6.12,"",6047436.94
,"General Journal","15-09-2024","25106",,,"Canteen Chair 3 Depreciation","Expense","Depreciation Expense",,"Accumulated Depreciation",6.12,"",6047443.06
,"General Journal","15-09-2024","25107",,,"Canteen Chair 4 Depreciation","Expense","Depreciation Expense",,"Accumulated Depreciation",6.12,"",6047449.18
,"General Journal","15-09-2024","25108",,,"Canteen Chair 5 Depreciation","Expense","Depreciation Expense",,"Accumulated Depreciation",6.12,"",6047455.30
,"General Journal","15-09-2024","25109",,,"Canteen Chair 6 Depreciation","Expense","Depreciation Expense",,"Accumulated Depreciation",6.12,"",6047461.42
,"General Journal","15-09-2024","25110",,,"Canteen Chair 7 Depreciation","Expense","Depreciation Expense",,"Accumulated Depreciation",6.12,"",6047467.54
,"General Journal","15-09-2024","25111",,,"Canteen Chair 8 Depreciation","Expense","Depreciation Expense",,"Accumulated Depreciation",6.12,"",6047473.66
,"General Journal","15-09-2024","25112",,,"Canteen Chair 9 Depreciation","Expense","Depreciation Expense",,"Accumulated Depreciation",6.12,"",6047479.78
,"General Journal","15-09-2024","25116",,,"EOL Case sealer Outfeed Conveyor Depreciation","Expense","Depreciation Expense",,"Accumulated Depreciation",297.62,"",6047777.40
,"General Journal","15-09-2024","25117",,,"Epson L6190 Printer 1 Depreciation","Expense","Depreciation Expense",,"Accumulated Depreciation",654.76,"",6048432.16
,"General Journal","15-09-2024","25118",,,"Fire Extinguisher 1 Depreciation","Expense","Depreciation Expense",,"Accumulated Depreciation",77.38,"",6048509.54
,"General Journal","15-09-2024","25119",,,"Fire Extinguisher 2 Depreciation","Expense","Depreciation Expense",,"Accumulated Depreciation",77.38,"",6048586.92
,"General Journal","15-09-2024","25120",,,"Fire Extinguisher 3 Depreciation","Expense","Depreciation Expense",,"Accumulated Depreciation",77.38,"",6048664.30
,"General Journal","15-09-2024","25121",,,"Fire Extinguisher 4 Depreciation","Expense","Depreciation Expense",,"Accumulated Depreciation",77.38,"",6048741.68
,"General Journal","15-09-2024","25122",,,"Fire Extinguisher 5 Depreciation","Expense","Depreciation Expense",,"Accumulated Depreciation",77.38,"",6048819.06
,"General Journal","15-09-2024","25123",,,"Fire Extinguisher 6 Depreciation","Expense","Depreciation Expense",,"Accumulated Depreciation",77.38,"",6048896.44
,"General Journal","15-09-2024","25124",,,"Grinder 2 Depreciation","Expense","Depreciation Expense",,"Accumulated Depreciation",178.57,"",6049075.01
,"General Journal","15-09-2024","25126",,,"HP Laptop 11 Depreciation","Expense","Depreciation Expense",,"Accumulated Depreciation",1200.00,"",6050275.01
,"General Journal","15-09-2024","25127",,,"HP Laptop 12 Depreciation","Expense","Depreciation Expense",,"Accumulated Depreciation",1200.00,"",6051475.01
,"General Journal","15-09-2024","25129",,,"Microwave 2 Depreciation","Expense","Depreciation Expense",,"Accumulated Depreciation",147.27,"",6051622.28
,"General Journal","15-09-2024","25130",,,"Mobile phone 3 Depreciation","Expense","Depreciation Expense",,"Accumulated Depreciation",41.67,"",6051663.95
,"General Journal","15-09-2024","25132",,,"Movable Ladder 1 Depreciation","Expense","Depreciation Expense",,"Accumulated Depreciation",434.52,"",6052098.47
,"General Journal","15-09-2024","25136",,,"UV water purifier 3 Depreciation","Expense","Depreciation Expense",,"Accumulated Depreciation",543.10,"",6052641.57
,"General Journal","15-09-2024","25138",,,"Water tank 6 Depreciation","Expense","Depreciation Expense",,"Accumulated Depreciation",71.84,"",6052713.41
,"General Journal","16-09-2024","25087",,,"Bosch Grinder 3 Depreciation","Expense","Depreciation Expense",,"Accumulated Depreceiation",86.21,"",6052799.62
,"General Journal","16-09-2024","25113",,,"Chain block 5 depreciation","Expense","Depreciation Expense",,"Accumulated Depreciation",292.49,"",6053092.11
,"General Journal","16-09-2024","25114",,,"Chain block 6 depreciation","Expense","Depreciation Expense",,"Accumulated Depreciation",292.49,"",6053384.60
,"General Journal","16-09-2024","25125",,,"Heat Gun Total 1 Depreciation","Expense","Depreciation Expense",,"Accumulated Depreciation",64.66,"",6053449.26
,"General Journal","16-09-2024","25128",,,"Linx 5900 Coder 1 Depreciation","Expense","Depreciation Expense",,"Accumulated Depreciation",4166.67,"",6057615.93
,"General Journal","16-09-2024","25135",,,"Table Top Scale 11 6Kg Depreciation","Expense","Depreciation Expense",,"Accumulated Depreciation",277.09,"",6057893.02
,"General Journal","16-09-2024","25137",,,"Washing Machine 1 Depreciation","Expense","Depreciation Expense",,"Accumulated Depreciation",2640.01,"",6060533.03
,"General Journal","17-09-2024","25139",,,"2T Mixer Depreciation","Expense","Depreciation Expense",,"Accumulated Depreciation",12633.99,"",6073167.02
,"General Journal","17-09-2024","25140",,,"2T Mixer Installation Depreciation","Expense","Depreciation Expense",,"Accumulated Depreciation",29713.15,"",6102880.17
,"General Journal","17-09-2024","25141",,,"Coder UPS 6 Depreciation","Expense","Depreciation Expense",,"Accumulated Depreciation",94.83,"",6102975.00
,"General Journal","17-09-2024","25142",,,"Coder UPS 7 Depreciation","Expense","Depreciation Expense",,"Accumulated Depreciation",94.83,"",6103069.83
,"General Journal","17-09-2024","25143","*",,"Hand Dryer 1 Depreciation","Expense","Depreciation Expense",,"Accumulated Depreciation",46.18,"",6103116.01
,"General Journal","17-09-2024","25144","*",,"HP Laptop 3 Depreciation","Expense","Depreciation Expense",,"Accumulated Depreciation",297.62,"",6103413.63
,"General Journal","17-09-2024","25145",,,"Office desks  4","Expense","Depreciation Expense",,"Accumulated Depreciation",361.90,"",6103775.53
,"General Journal","17-09-2024","25146",,,"Pallet truck 4 Depreciation","Expense","Depreciation Expense",,"Accumulated Depreciation",428.57,"",6104204.10
,"General Journal","17-09-2024","25147",,,"Pallet truck 5 Depreciation","Expense","Depreciation Expense",,"Accumulated Depreciation",428.57,"",6104632.67
,"General Journal","17-09-2024","25148",,,"Recirculation Pump Depreciation","Expense","Depreciation Expense",,"Accumulated  Depreciation",71.19,"",6104703.86
,"General Journal","17-09-2024","25149",,,"Server 1 Depreciation","Expense","Depreciation Expense",,"Accumulated Depreciation",357.14,"",6105061.00
,"General Journal","17-09-2024","25150",,,"Server Monitor Depreciation","Expense","Depreciation Expense",,"Accumulated Depreciaion",107.14,"",6105168.14
,"General Journal","17-09-2024","25151",,,"Shrink Tunnel Depreciation","Expense","Depreciation Expense",,"Accumulated Depreciation",3750.00,"",6108918.14
,"General Journal","17-09-2024","25152","*",,"Soap Dispenser 1 Depreciation","Expense","Depreciation Expense",,"Accumulated Depreciation",15.39,"",6108933.53
,"General Journal","17-09-2024","25153","*",,"TP Link 3 Depreciation","Expense","Depreciation Expense",,"Accumulated Depreciation",33.33,"",6108966.86
,"General Journal","17-09-2024","25154","*",,"Water Tank 3 Depreciation","Expense","Depreciation Expense",,"Accumulated Depreciation",123.15,"",6109090.01
,"General Journal","17-09-2024","25157",,,"Pouch Packing Machine 2 Accumulated depreciation","Expense","Depreciation Expense",,"Accumulated Depreciation",976.19,"",6110066.20
,"General Journal","17-09-2024","25178",,,"Pouch Packing Machine 2 Accumulated depreciation","Expense","Depreciation Expense",,"Accumulated Depreciation",976.19,"",6111042.39
,"General Journal","18-09-2024","25200",,,"Carton Sealer Manual 1 Depreciation","Expense","Depreciation Expense",,"Accumulated Depreciation",14.80,"",6111057.19
,"General Journal","18-09-2024","25201",,,"Compressor 3 Depreciation","Expense","Depreciation Expense",,"Accumulated Depreciation",5357.14,"",6116414.33
,"General Journal","18-09-2024","25202",,,"Compressor room depreciation","Expense","Depreciation Expense",,"Accumulated depreciation",132.44,"",6116546.77
,"General Journal","18-09-2024","25203",,,"Electric Hoist 1 depreciation","Expense","Depreciation Expense",,"Accumulated depreciation",3452.38,"",6119999.15
,"General Journal","18-09-2024","25204",,,"Gents changing room Lockers Depreciation","Expense","Depreciation Expense",,"Accumulated Depreciation",386.90,"",6120386.05
,"General Journal","18-09-2024","25205",,,"HP Mini Desktop 1 Depreciation","Expense","Depreciation Expense",,"Accumulated Depreciation",733.33,"",6121119.38
,"General Journal","18-09-2024","25206",,,"HP Mini Desktop 2 Depreciation","Expense","Depreciation Expense",,"Accumulated Depreciation",733.33,"",6121852.71
,"General Journal","18-09-2024","25207",,,"HP Mini Desktop 3 Depreciation","Expense","Depreciation Expense",,"Accumulated Depreciation",733.33,"",6122586.04
,"General Journal","18-09-2024","25208",,,"Ladies changing room Lockers Depreciation","Expense","Depreciation Expense",,"Accumulated Depreciation",411.90,"",6122997.94
,"General Journal","18-09-2024","25209",,,"Omrom M1 Basic BP Monitor Depreciation","Expense","Depreciation Expense",,"Accumulated Depreciation",58.33,"",6123056.27
,"General Journal","18-09-2024","25210",,,"SS Hand Washing Station 1 Depreciation","Expense","Depreciation Expense",,"Accumulated Depreciation",690.48,"",6123746.75
,"General Journal","18-09-2024","25211",,,"TP Link 2 Depreciation","Expense","Depreciation Expense",,"Accumulated Depreciation",41.67,"",6123788.42
,"General Journal","18-09-2024","25212",,,"TV Screen 3 Depreciation","Expense","Depreciation Expense",,"Accumulated Depreciation",316.67,"",6124105.09
,"General Journal","18-09-2024","25213",,,"TV Screen 4 Depreciation","Expense","Depreciation Expense",,"Accumulated Depreciation",1550.00,"",6125655.09
,"General Journal","19-09-2024","25214",,,"3T Gas Forklift 1 Depreciation","Expense","Depreciation Expense",,"Accumulated Depreciation",30952.38,"",6156607.47
,"General Journal","19-09-2024","25215",,,"Coding Stamp 3 Depreciation","Expense","Depreciation Expense",,"Accumulated Depreciation",143.68,"",6156751.15
,"General Journal","19-09-2024","25216",,,"Office Stamp 2 Depreciation","Expense","Depreciation Expense",,"Accumulated Depreciaion",30.83,"",6156781.98
,"General Journal","20-09-2024","25217","*","Unilever Kenya Ltd:Sunlight Washing Pwd","Boato Commisioning Depreciation","Expense","Depreciation Expense",,"Accumulated Depreciation",889.88,"",6157671.86
,"General Journal","20-09-2024","25218",,,"Bosch Blower 3 Depreciation","Expense","Depreciation Expense",,"Accumulated Depreciation",79.02,"",6157750.88
,"General Journal","20-09-2024","25219",,,"Bosch Blower 4 Depreciation","Expense","Depreciation Expense",,"Accumulated Depreciation",136.49,"",6157887.37
,"General Journal","20-09-2024","25220",,,"Bosch Blower 5 Depreciation","Expense","Depreciation Expense",,"Accumulated Depreciation",136.49,"",6158023.86
,"General Journal","20-09-2024","25221",,,"Conference Office Desk 1 Depreciation","Expense","Depreciation Expense",,"Accumulated Depreciation",416.67,"",6158440.53
,"General Journal","20-09-2024","25222",,,"Floor Chair 17 depreciation","Expense","Depreciation Expense",,"Accumulated Depreciation",20.24,"",6158460.77
,"General Journal","20-09-2024","25223",,,"Floor Chair 18 depreciation","Expense","Depreciation Expense",,"Accumulated Depreciation",20.24,"",6158481.01
,"General Journal","20-09-2024","25224",,,"Floor Chair 19 depreciation","Expense","Depreciation Expense",,"Accumulated Depreciation",20.24,"",6158501.25
,"General Journal","20-09-2024","25225",,,"Floor Chair 20 depreciation","Expense","Depreciation Expense",,"Accumulated Depreciation",20.24,"",6158521.49
,"General Journal","20-09-2024","25226",,,"Heat Gun CAT Digital 1 Depreciation","Expense","Depreciation Expense",,"Accumulated Depreciation",136.49,"",6158657.98
,"General Journal","20-09-2024","25227","*",,"Lumnia 1 Pro Insect Trap Depreciation","Expense","Depreciation Expense",,"Accumulated Depreciation",316.67,"",6158974.65
,"General Journal","20-09-2024","25229",,,"PF Correction Unit Depreciation","Expense","Depreciation Expense",,"Accumulated Depreciation",1708.33,"",6160682.98
,"General Journal","21-09-2024","25230",,,"5Kg CO2 Fire Extinguisher 2 Depreciation","Expense","Depreciation Expense",,"Accumulated Depreciation",73.81,"",6160756.79
,"General Journal","21-09-2024","25231",,,"6Kg Dry Pwd Fire Extinguisher 1 Depreciaiton","Expense","Depreciation Expense",,"Accumulated Depreciation",59.52,"",6160816.31
,"General Journal","21-09-2024","25232",,,"Board room chair 1 Depreciation","Expense","Depreciation Expense",,"Accumulated Depreciation",59.52,"",6160875.83
,"General Journal","21-09-2024","25233",,,"Board room chair 2 Depreciation","Expense","Depreciation Expense",,"Accumulated Depreciation",59.52,"",6160935.35
,"General Journal","21-09-2024","25234",,,"Board room chair 4 Depreciation","Expense","Depreciation Expense",,"Accumulated Depreciation",59.52,"",6160994.87
,"General Journal","21-09-2024","25235",,,"Board room chair 5 Depreciation","Expense","Depreciation Expense",,"Accumulated Depreciation",59.52,"",6161054.39
,"General Journal","21-09-2024","25236",,,"Board room chair 6 Depreciation","Expense","Depreciation Expense",,"Accumulated Depreciation",59.52,"",6161113.91
,"General Journal","21-09-2024","25237",,,"Board room chair 7 Depreciation","Expense","Depreciation Expense",,"Accumulated Depreciation",59.52,"",6161173.43
,"General Journal","21-09-2024","25238",,,"Board room chair 8 Depreciation","Expense","Depreciation Expense",,"Accumulated Depreciation",59.52,"",6161232.95
,"General Journal","21-09-2024","25239",,,"Coding Stamp 2 Depreciation","Expense","Depreciation Expense",,"Accumulated Depreciation",133.33,"",6161366.28
,"General Journal","21-09-2024","25240",,,"IBC Tank 1 Depreciation","Expense","Depreciation Expense",,"Accumulated Depreciation",41.67,"",6161407.95
,"General Journal","21-09-2024","25241",,,"Empty IBC Tank 2 Depreciation","Expense","Depreciation Expense",,"Accumulated Depreciation",65.48,"",6161473.43
,"General Journal","21-09-2024","25242",,,"FFS Filling Machine 300 1 Depreciation","Expense","Depreciation Expense",,"Accumulated Depreciation",11850.01,"",6173323.44
,"General Journal","21-09-2024","25243",,,"Laboratory Oven & Dessicator  Depreciation","Expense","Depreciation Expense",,"Accumulated Depreciation",766.67,"",6174090.11
,"General Journal","21-09-2024","25244",,,"Nikon D3500 Camera 1 Depreciation","Expense","Depreciation Expense",,"Accumulated Depreciation",766.67,"",6174856.78
,"General Journal","21-09-2024","25245",,,"Tea Urn Depreciation","Expense","Depreciation Expense",,"Accumulated Depreciation",121.67,"",6174978.45
,"General Journal","22-09-2024","25246",,,"6Kg Auto Fire Extinguisher 1 Depreciation","Expense","Depreciation Expense",,"Accumulated Depreciation",53.57,"",6175032.02
,"General Journal","22-09-2024","25247",,,"6Kg Auto Fire Extinguisher 2 Depreciation","Expense","Depreciation Expense",,"Accumulated Depreciation",53.57,"",6175085.59
,"General Journal","22-09-2024","25252","*",,"AVS Voltage Stabilizer Depreciation","Expense","Depreciation Expense",,"Accumulated Depreciation",63.10,"",6175148.69
,"General Journal","22-09-2024","25257",,,"Conveyor Belt Green 1 Depreciation","Expense","Depreciation Expense",,"Accumulated Depreciation",82.14,"",6175230.83
,"General Journal","22-09-2024","25264",,,"HP Laptop 13 Depreciation","Expense","Depreciation Expense",,"Accumulated Depreciation",1200.00,"",6176430.83
,"General Journal","22-09-2024","25265","*",,"HP Laptop 7 Depreciation","Expense","Depreciation Expense",,"Accumulated Depreciation",1200.00,"",6177630.83
,"General Journal","22-09-2024","25268",,,"Office Desk 5 Depreciation","Expense","Depreciation Expense",,"Accumulated Depreciation",180.95,"",6177811.78
,"General Journal","22-09-2024","25269",,,"Office cabinets depreciation","Expense","Depreciation Expense",,"Accumulated Depreciation",119.05,"",6177930.83
,"General Journal","22-09-2024","25271",,,"Platform Scale 2 SS 100Kg Depreciation","Expense","Depreciation Expense",,"Accumulated Depreciation",339.29,"",6178270.12
,"General Journal","22-09-2024","25274",,,"Solar Water Heater 300L Depreciation","Expense","Depreciation Expense",,"Accumulated Depreciation",3125.00,"",6181395.12
,"General Journal","23-09-2024","25248",,,"Analytical Balance Depreciation","Expense","Depreciation Expense",,"Accumulated Depreciation",2405.58,"",6183800.70
,"General Journal","23-09-2024","25249",,,"Auger Filler 1 Depreciation","Expense","Depreciation Expense",,"Accumulated Depreciation",7220.12,"",6191020.82
,"General Journal","23-09-2024","25250",,,"Auger Filler 2 Depreciation","Expense","Depreciation Expense",,"Accumulated Depreciation",13258.63,"",6204279.45
,"General Journal","23-09-2024","25251",,,"Auger Filler 3 Depreciation","Expense","Depreciation Expense",,"Accumulated Depreciation",11788.69,"",6216068.14
,"General Journal","23-09-2024","25253",,,"Bajaj Boxer BM150 UG Depreciation","Expense","Depreciation Expense",,"Accumulated Depreciation",1539.41,"",6217607.55
,"General Journal","23-09-2024","25254",,,"Board room chair 3 Depreciation","Expense","Depreciation Expense",,"Accumulated Depreciation",59.52,"",6217667.07
,"General Journal","23-09-2024","25255",,,"Chain block 4 depreciation","Expense","Depreciation Expense",,"Accumulated Depreciation",133.42,"",6217800.49
,"General Journal","23-09-2024","25256",,,"Coder UPS Depreciation","Expense","Depreciation Expense",,"Accumulated Depreciation",95.24,"",6217895.73
,"General Journal","23-09-2024","25258",,,"Dust Extractor 1 Depreciation","Expense","Depreciation Expense",,"Accumulated Depreciation",446.43,"",6218342.16
,"General Journal","23-09-2024","25259",,,"Dust Extractor 2 Depreciation","Expense","Depreciation Expense",,"Accumulated Depreciation",446.43,"",6218788.59
,"General Journal","23-09-2024","25260",,,"Filler 1 Geared Motor & Feeding System Depreciation","Expense","Depreciation Expense",,"Accumulated Depreciation",333.33,"",6219121.92
,"General Journal","23-09-2024","25261",,,"Filler 2 Geared Motor & Feeding System Depreciation","Expense","Depreciation Expense",,"Accumulated Depreciation",348.72,"",6219470.64
,"General Journal","23-09-2024","25262",,,"Filler 3 Geared Motor & Feeding System Depreciation","Expense","Depreciation Expense",,"Accumulated Depreciation",347.52,"",6219818.16
,"General Journal","23-09-2024","25263",,,"Hotplate with Stirrer Depreciation","Expense","Depreciation Expense",,"Accumulated Depreciation",1785.71,"",6221603.87
,"General Journal","23-09-2024","25266",,,"Makita Hammer Drill Depreciation","Expense","Depreciation Expense",,"Accumulated Depreciation",205.25,"",6221809.12
,"General Journal","23-09-2024","25267",,,"Microwave 1 Depreciation","Expense","Depreciation Expense",,"Accumulated Depreciation",217.13,"",6222026.25
,"General Journal","23-09-2024","25270",,,"Pallet truck 3 Dep","Expense","Depreciation Expense",,"Accumulated Depreciation",510.95,"",6222537.20
,"General Journal","23-09-2024","25272",,,"Pouching Machine Depreciation","Expense","Depreciation Expense",,"Accumulated Depreciation",711.90,"",6223249.10
,"General Journal","23-09-2024","25273",,,"Power bank dep","Expense","Depreciation Expense",,"Accumulated Depreciation",119.05,"",6223368.15
,"General Journal","23-09-2024","25275",,,"Table Top Scale 11  SS 30Kg Depreciation","Expense","Depreciation Expense",,"Accumulated Depreciation",297.62,"",6223665.77
,"General Journal","23-09-2024","25276",,,"Table Top Scale 12  SS 30Kg Depreciation","Expense","Depreciation Expense",,"Accumulated Depreciation",297.62,"",6223963.39
,"General Journal","24-09-2024","25277",,,"Access Control Unit & System Depreciation","Expense","Depreciation Expense",,"Accumulated Depreciation",334.76,"",6224298.15
,"General Journal","24-09-2024","25279",,,"Electrical Enclosure Compressor Depreciation","Expense","Depreciation Expense",,"Accumulated Depreciation",125.00,"",6224423.15
,"General Journal","24-09-2024","25280",,,"ETR Machine Depreciation","Expense","Depreciation Expense",,"Accumulated Depreciation",236.04,"",6224659.19
,"General Journal","24-09-2024","25281",,,"Liquid Plant Depreciation","Expense","Depreciation Expense",,"Accumulated Deprecation",15029.76,"",6239688.95
,"General Journal","24-09-2024","25282",,,"Paste processing & packing line depreciation","Expense","Depreciation Expense",,"Accumulated Depreciation",17348.21,"",6257037.16
,"General Journal","24-09-2024","25283",,,"pH Meter Depreciation","Expense","Depreciation Expense",,"Accumulated Depreciation",741.39,"",6257778.55
,"General Journal","25-09-2024","25284",,,"Clamp Meter 1 Depreciation","Expense","Depreciation Expense",,"Accumulated Depreciation",36.90,"",6257815.45
,"General Journal","25-09-2024","25285",,,"Fire Alarm Sytstem Depreciation","Expense","Depreciation Expense",,"Accumulated Depreciation",728.57,"",6258544.02
,"General Journal","25-09-2024","25286",,,"Floor Chair 11 Depreciation","Expense","Depreciation Expense",,"Accumulated Depreciation",53.57,"",6258597.59
,"General Journal","25-09-2024","25287",,,"Floor Chair 12 Depreciation","Expense","Depreciation Expense",,"Accumulated Depreciation",53.57,"",6258651.16
,"General Journal","25-09-2024","25288",,,"Floor Chair 13 Depreciation","Expense","Depreciation Expense",,"Accumulated Depreciation",53.57,"",6258704.73
,"General Journal","25-09-2024","25289",,,"Floor Chair 14 Depreciation","Expense","Depreciation Expense",,"Accumulated Depreciation",53.57,"",6258758.30
,"General Journal","25-09-2024","25290",,,"Floor Chair 15 Depreciation","Expense","Depreciation Expense",,"Accumulated Depreciation",53.57,"",6258811.87
,"General Journal","25-09-2024","25291",,,"Floor Chair 16 Depreciation","Expense","Depreciation Expense",,"Accumulated Depreciation",53.57,"",6258865.44
,"General Journal","25-09-2024","25292",,,"Liquid Mixer 500Lt Depreciation","Expense","Depreciation Expense",,"Accumulated Depreciation",6172.62,"",6265038.06
,"General Journal","25-09-2024","25294",,,"Plastic Resin Mixer Depreciation","Expense","Depreciation Expense",,"Accumulated  Depreciation",1130.95,"",6266169.01
,"General Journal","25-09-2024","25295",,,"Plastic Resin Mixer Depreciation","Expense","Depreciation Expense",,"Accumulated  Depreciation",1130.95,"",6267299.96
,"General Journal","25-09-2024","25296",,,"Water tank 7 Depreciation","Expense","Depreciation Expense",,"Accumulated Depreciation",71.84,"",6267371.80
,"General Journal","26-09-2024","25297",,,"Dell Desktop 2 Depreciation","Expense","Depreciation Expense",,"Accumulated Depreciation",229.17,"",6267600.97
,"General Journal","26-09-2024","25298",,,"Dell Desktop 3 Depreciation","Expense","Depreciation Expense",,"Accumulated Depreciation",229.17,"",6267830.14
,"General Journal","26-09-2024","25299",,,"Dell Desktop 4 Depreciation","Expense","Depreciation Expense",,"Accumulated Depreciation",229.17,"",6268059.31
,"General Journal","26-09-2024","25300",,,"Grease Gun 1 Depreciation","Expense","Depreciation Expense",,"Accumulated Depreciation",73.21,"",6268132.52
,"General Journal","26-09-2024","25301",,,"Grease Gun 2 Depreciation","Expense","Depreciation Expense",,"Accumulated Depreciation",63.14,"",6268195.66
,"General Journal","26-09-2024","25302",,,"Retort Stand 1 Depreciation","Expense","Depreciation Expense",,"Accumulated Depreciation",10.71,"",6268206.37
,"General Journal","26-09-2024","25303",,,"Retort Stand 2 Depreciation","Expense","Depreciation Expense",,"Accumulated Depreciation",10.71,"",6268217.08
,"General Journal","26-09-2024","25304",,,"Tea Urn 2 Depreciation","Expense","Depreciation Expense",,"Accumulated Depreciation",180.00,"",6268397.08
,"General Journal","27-09-2024","25305",,,"Board room chair 10 Depreciation","Expense","Depreciation Expense",,"Accumulated Depreciation",79.55,"",6268476.63
,"General Journal","27-09-2024","25306",,,"Board room chair 11 Depreciation","Expense","Depreciation Expense",,"Accumulated Depreciation",79.55,"",6268556.18
,"General Journal","27-09-2024","25307",,,"Board room chair 12 Depreciation","Expense","Depreciation Expense",,"Accumulated Depreciation",79.55,"",6268635.73
,"General Journal","27-09-2024","25308",,,"Board room chair 13 Depreciation","Expense","Depreciation Expense",,"Accumulated Depreciation",79.55,"",6268715.28
,"General Journal","27-09-2024","25309",,,"Board room chair 14 Depreciation","Expense","Depreciation Expense",,"Accumulated Depreciation",79.55,"",6268794.83
,"General Journal","27-09-2024","25310",,,"Board room chair 15 Depreciation","Expense","Depreciation Expense",,"Accumulated Depreciation",79.55,"",6268874.38
,"General Journal","27-09-2024","25311",,,"Board room chair 16 Depreciation","Expense","Depreciation Expense",,"Accumulated Depreciation",79.55,"",6268953.93
,"General Journal","27-09-2024","25312",,,"Board room chair 17 Depreciation","Expense","Depreciation Expense",,"Accumulated Depreciation",79.55,"",6269033.48
,"General Journal","27-09-2024","25313",,,"Board room chair 18 Depreciation","Expense","Depreciation Expense",,"Accumulated Depreciation",79.55,"",6269113.03
,"General Journal","27-09-2024","25314",,,"Board room chair 19 Depreciation","Expense","Depreciation Expense",,"Accumulated Depreciation",79.55,"",6269192.58
,"General Journal","27-09-2024","25315",,,"Board room chair 9 Depreciation","Expense","Depreciation Expense",,"Accumulated Depreciation",79.55,"",6269272.13
,"General Journal","27-09-2024","25316",,,"Passenger Lift 1000kg Depreciation","Expense","Depreciation Expense",,"Accumulated Depreciation",44484.68,"",6313756.81
,"General Journal","28-09-2024","25329",,,"Heat Gun Bosch 2 Accumulated depreciation","Expense","Depreciation Expense",,"Accumulated Depreciation",75.43,"",6313832.24
,"General Journal","28-09-2024","25330",,,"Heat Gun Bosch 3 Accumulated depreciation","Expense","Depreciation Expense",,"Accumulated Depreciation",75.43,"",6313907.67
,"General Journal","30-09-2024","25317",,,"500gm Jar Blow Mould 3 depreciation","Expense","Depreciation Expense",,"Accumulated Depreciation",1026.79,"",6314934.46
,"General Journal","30-09-2024","25318",,,"500gm Jar Blow Mould 4 depreciation","Expense","Depreciation Expense",,"Accumulated Depreciation",1026.79,"",6315961.25
,"General Journal","30-09-2024","25319",,,"Air cooled chiller depeciation","Expense","Depreciation Expense",,"Accumulated  Depreciation",8916.67,"",6324877.92
,"General Journal","30-09-2024","25320","*","Unilever Kenya Ltd:Sunlight Washing Pwd","Boato Installation Depreciation","Expense","Depreciation Expense",,"Accumulated Depreciation",65114.38,"",6389992.30
,"General Journal","30-09-2024","25321","*",,"Canister Platform Depreciation","Expense","Depreciation Expense",,"Accumulated Depreciation",59246.67,"",6449238.97
,"General Journal","30-09-2024","25322",,,"CCTV DRV & System Depreciation","Expense","Depreciation Expense",,"Accumulated Depreciation",1295.33,"",6450534.30
,"General Journal","30-09-2024","25323",,,"Colour Pressure tank Depreciation","Expense","Depreciation Expense",,"Accumulated Depreciation",232.14,"",6450766.44
,"General Journal","30-09-2024","25324",,,"Compressed air gun Depreciation","Expense","Depreciation Expense",,"Accumulated Depreciation",47.62,"",6450814.06
,"General Journal","30-09-2024","25325",,,"Drum Pump 2 Depreciation","Expense","Depreciation Expense",,"Accumulated Depreciation",123.15,"",6450937.21
,"General Journal","30-09-2024","25326",,,"Extractor Fan down Depreciation","Expense","Depreciation Expense",,"Accumulated Depreciation",150.12,"",6451087.33
,"General Journal","30-09-2024","25327",,,"Extractor Fan Hoisting Depreciation","Expense","Depreciation Expense",,"Accumulated Depreciation",176.67,"",6451264.00
,"General Journal","30-09-2024","25328",,,"Extractor Fan Packaging Depreciation","Expense","Depreciation Expense",,"Accumulated Depreciation",150.12,"",6451414.12
,"General Journal","30-09-2024","25331",,,"Incotex Type C Control Unit Depreciation","Expense","Depreciation Expense",,"Accumulated Depreciation",1939.66,"",6453353.78
,"General Journal","30-09-2024","25332",,,"Lamination Machine 1 Depreciation","Expense","Depreciation Expense",,"Accumulated Depreciation",84.78,"",6453438.56
,"General Journal","30-09-2024","25333",,,"Office Cabinet 5 Depreciation","Expense","Depreciation Expense",,"Accumulated Depreciation",58.33,"",6453496.89
,"General Journal","30-09-2024","25334",,,"Office Desk 6 Depreciation","Expense","Depreciation Expense",,"Accumulated Depreciation",90.48,"",6453587.37
,"General Journal","30-09-2024","25335",,,"Office Desk 7 Depreciation","Expense","Depreciation Expense",,"Accumulated Depreciation",90.48,"",6453677.85
,"General Journal","30-09-2024","25336",,,"Office Desk 8 Depreciation","Expense","Depreciation Expense",,"Accumulated Depreciation",83.33,"",6453761.18
,"General Journal","30-09-2024","25337",,,"Platform Scale 4 tons 1 Depreciation","Expense","Depreciation Expense",,"Accumulated Depreciation",10782.43,"",6464543.61
,"General Journal","30-09-2024","25338",,,"Process Water Filtration System Depreciation","Expense","Depreciation Expense",,"Accumulated Depreciation",1785.71,"",6466329.32
,"General Journal","30-09-2024","25339",,,"Sulphonic Acid pressure tank Depreciation","Expense","Depreciation Expense",,"Accumulated Depreciation",110.48,"",6466439.80
,"General Journal","30-09-2024","25340",,,"Test Sieves 100 & 200 microns Depreciation","Expense","Depreciation Expense",,"Accumulated Depreciation",450.00,"",6466889.80
,"General Journal","30-09-2024","25341",,,"Wall mounted cabinet 1 Dep","Expense","Depreciation Expense",,"Accumulated Depreciation",107.14,"",6466996.94
,"General Journal","30-09-2024","25342",,,"Water tank 5 Depreciation","Expense","Depreciation Expense",,"Accumulated Depreciation",137.79,"",6467134.73
,"General Journal","01-10-2024","25343",,,"Hoisting Bucket 1 Depreciation","Expense","Depreciation Expense",,"Accumulated Depreciation",148.81,"",6467283.54
,"General Journal","01-10-2024","25344",,,"Hoisting Bucket 2 Dereciation","Expense","Depreciation Expense",,"Accumulated Depreciation",148.81,"",6467432.35
,"General Journal","01-10-2024","25345",,,"Lenovo Laptop 2 Depreciation","Expense","Depreciation Expense",,"Accumulated Depreciation",333.33,"",6467765.68
,"General Journal","01-10-2024","25346",,,"Processing Platform Depreciation","Expense","Depreciation Expense",,"Accumulated Depreciation",4880.95,"",6472646.63
,"General Journal","01-10-2024","25347",,,"Security and Computer Sytem UPS Depreciation","Expense","Depreciation Expense",,"Accumulated Depreciation",3584.50,"",6476231.13
,"General Journal","01-10-2024","25348",,,"Trophy Shelf 1 Depreciation","Expense","Depreciation Expense",,"Accumulated Depreciation",95.24,"",6476326.37
,"General Journal","01-10-2024","25349",,,"Water tank 4 Depreciation","Expense","Depreciation Expense",,"Accumulated Depreciation",453.24,"",6476779.61
,"General Journal","02-10-2024","25351",,,"CMPP 1kg Jar Blow Mould 1 Depreciation","Expense","Depreciation Expense",,"Accumulated Depreciation",3364.87,"",6480144.48
,"General Journal","02-10-2024","25352",,,"CMPP 1kg Jar Blow Mould 2 Depreciation","Expense","Depreciation Expense",,"Accumulated Depreciation",3364.87,"",6483509.35
,"General Journal","02-10-2024","25353",,,"CMPP 500gm Jar Blow Mould 1 Depreciation","Expense","Depreciation Expense",,"Accumulated Depreciation",2643.82,"",6486153.17
,"General Journal","02-10-2024","25354",,,"CMPP 500gm Jar Blow Mould 2 Depreciation","Expense","Depreciation Expense",,"Accumulated Depreciation",2643.82,"",6488796.99
,"General Journal","02-10-2024","25355",,,"CMPP Blow Moulding Machine 1 Depreciation","Expense","Depreciation Expense",,"Accumulated Depreciation",49344.71,"",6538141.70
,"General Journal","02-10-2024","25356",,,"CMPP Blow Moulding Machine 2 Depreciation","Expense","Depreciation Expense",,"Accumulated Depreciation",49344.71,"",6587486.41
,"General Journal","02-10-2024","25357",,,"Drum Pump 1 Depreiation","Expense","Depreciation Expense",,"Accumulated Depreciation",123.03,"",6587609.44
,"General Journal","02-10-2024","25358",,,"Heat Gun Bosch 1 Depreciation","Expense","Depreciation Expense",,"Accumulated Depreciation",100.57,"",6587710.01
,"General Journal","02-10-2024","25359",,,"Hot ProcessWater Storage Tank1  Depreciation","Expense","Depreciation Expense",,"Accumulated Depreciation",73.99,"",6587784.00
,"General Journal","02-10-2024","25360","*",,"HP Laptop 4 Depreciation","Expense","Depreciation Expense",,"Accumulated Depreciation",297.62,"",6588081.62
,"General Journal","02-10-2024","25361","*",,"HP Laptop 8 Depreciation","Expense","Depreciation Expense",,"Accumulated Depreciation",1200.00,"",6589281.62
,"General Journal","02-10-2024","25362",,,"Store Racking 1 depreciation","Expense","Depreciation Expense",,"Accumulated Depreciation",175.60,"",6589457.22
,"General Journal","02-10-2024","25363",,,"Store Racking 2 Depreciation","Expense","Depreciation Expense",,"Accumulated Depreciation",175.60,"",6589632.82
,"General Journal","02-10-2024","25364",,,"Tank platform Depreciation","Expense","Depreciation Expense",,"Accumulated Depreciation",130.95,"",6589763.77
,"General Journal","02-10-2024","25365",,,"Water tank 1 Depreciation","Expense","Depreciation Expense",,"Accumulated Depreciation",120.07,"",6589883.84
,"General Journal","02-10-2024","25366",,,"Workshop cabinet depreciation","Expense","Depreciation Expense",,"Accumulated Depreciation",172.02,"",6590055.86
,"General Journal","03-10-2024","25367",,,"Alarm System extension","Expense","Depreciation Expense",,"Accumulated Depreciation",602.38,"",6590658.24
,"General Journal","03-10-2024","25368",,,"Domestos sewing machine depreciation","Expense","Depreciation Expense",,"Acummulated depreciation",82.10,"",6590740.34
,"General Journal","03-10-2024","25369",,,"Bench Grinder 2 Depreciation","Expense","Depreciation Expense",,"Accumulated Depreceiation",100.57,"",6590840.91
,"General Journal","03-10-2024","25370",,,"CCTV survellance System extension Depreciation","Expense","Depreciation Expense",,"Accumulated Depreciation",657.14,"",6591498.05
,"General Journal","03-10-2024","25371",,,"Electrical Enclosure CCTV Depreciation","Expense","Depreciation Expense",,"Accumulated Depreciation",126.19,"",6591624.24
,"General Journal","03-10-2024","25372",,,"Electrical Enclosure Main Depreciation","Expense","Depreciation Expense",,"Accumulated Depreciation",2339.29,"",6593963.53
,"General Journal","03-10-2024","25373",,,"Electrical Enclosure P Line Depreciation","Expense","Depreciation Expense",,"Accumulated Depreciation",428.57,"",6594392.10
,"General Journal","03-10-2024","25374",,,"Floodlight Depreciation","Expense","Depreciation Expense",,"Accumulated Depreciation",59.52,"",6594451.62
,"General Journal","03-10-2024","25375",,,"Office Desk 1 Depreciation","Expense","Depreciation Expense",,"Accumulated Depreciation",225.00,"",6594676.62
,"General Journal","03-10-2024","25376",,,"Office Desk 2 Depreciation","Expense","Depreciation Expense",,"Accumulated Depreciation",225.00,"",6594901.62
,"General Journal","03-10-2024","25377",,,"Office Desk 3 Depreciation","Expense","Depreciation Expense",,"Accumulated Depreciation",225.00,"",6595126.62
,"General Journal","03-10-2024","25378",,,"Signet ESD 1 Depreciation","Expense","Depreciation Expense",,"Accumulated Depreciation",928.57,"",6596055.19
,"General Journal","03-10-2024","25379","*",,"Sterling Water Dispenser 1 Depreciation","Expense","Depreciation Expense",,"Accumulated Depreciation",119.05,"",6596174.24
,"General Journal","03-10-2024","25380",,,"Table top Weighing Scale 5 Depreciation","Expense","Depreciation Expense",,"Accumulated Depreciation",248.57,"",6596422.81
,"General Journal","03-10-2024","25381",,,"Table top Weighing Scale 6 Depreciation","Expense","Depreciation Expense",,"Accumulated Depreciation",248.57,"",6596671.38
,"General Journal","03-10-2024","25382",,,"Table top Weighing Scale 7 Depreciation","Expense","Depreciation Expense",,"Accumulated Depreciation",248.57,"",6596919.95
,"General Journal","03-10-2024","25383",,,"Table top Weighing Scale 8 Depreciation","Expense","Depreciation Expense",,"Accumulated Depreciation",248.57,"",6597168.52
,"General Journal","03-10-2024","25384",,,"Table top Weighing Scale 9 Depreciation","Expense","Depreciation Expense",,"Accumulated Depreciation",248.57,"",6597417.09
,"General Journal","03-10-2024","25573",,,"Bosch Optical Level Gol 32D Depreciation","Expense","Depreciation Expense",,"Accumulated Depreciation",679.38,"",6598096.47
,"General Journal","04-10-2024","25385",,,"9Kg Powder Fire Extinguisher 1 Depreciation","Expense","Depreciation Expense",,"Accumulated Depreciation",34.52,"",6598130.99
,"General Journal","04-10-2024","25386",,,"9Kg Powder Fire Extinguisher 2 Depreciation","Expense","Depreciation Expense",,"Accumulated Depreciation",34.52,"",6598165.51
,"General Journal","04-10-2024","25387",,,"9Kg Powder Fire Extinguisher 3 Depreciation","Expense","Depreciation Expense",,"Accumulated Depreciation",34.52,"",6598200.03
,"General Journal","04-10-2024","25388",,,"9Kg Powder Fire Extinguisher 5 Depreciation","Expense","Depreciation Expense",,"Accumulated Depreciation",34.52,"",6598234.55
,"General Journal","04-10-2024","25389",,,"Chiller 2 Depreciation","Expense","Depreciation Expense",,"Accumulated Depreciation",8035.71,"",6606270.26
,"General Journal","04-10-2024","25390",,,"Empty IBC Tank 10 Depreciation","Expense","Depreciation Expense",,"Accumulated Depreciation",41.67,"",6606311.93
,"General Journal","04-10-2024","25391",,,"Empty IBC Tank 3 Depreciation","Expense","Depreciation Expense",,"Accumulated Depreciation",65.48,"",6606377.41
,"General Journal","04-10-2024","25392",,,"Empty IBC Tank 4 Depreciation","Expense","Depreciation Expense",,"Accumulated Depreciation",65.48,"",6606442.89
,"General Journal","04-10-2024","25393",,,"Empty IBC Tank 5 Depreciation","Expense","Depreciation Expense",,"Accumulated Depreciation",65.48,"",6606508.37
,"General Journal","04-10-2024","25394",,,"Empty IBC Tank 6 Depreciation","Expense","Depreciation Expense",,"Accumulated Depreciation",65.48,"",6606573.85
,"General Journal","04-10-2024","25395",,,"Empty IBC Tank 7 Depreciation","Expense","Depreciation Expense",,"Accumulated Depreciation",41.67,"",6606615.52
,"General Journal","04-10-2024","25396",,,"Empty IBC Tank 8 Depreciation","Expense","Depreciation Expense",,"Accumulated Depreiation",41.67,"",6606657.19
,"General Journal","04-10-2024","25397",,,"Empty IBC Tank 9 Depreciation","Expense","Depreciation Expense",,"Accumulated Depreciation",41.67,"",6606698.86
,"General Journal","04-10-2024","25398",,,"Linx 8900 Coder 1 Depreciation","Expense","Depreciation Expense",,"Accumulated Depreciation",8333.33,"",6615032.19
,"General Journal","04-10-2024","25399",,,"Mobile Phone 2 Depreciation","Expense","Depreciation Expense",,"Accumulated Depreciation",46.67,"",6615078.86
,"General Journal","04-10-2024","25400",,,"Triple UV water purifier 1 Depreciation","Expense","Depreciation Expense",,"Accumulated Depreciation",296.22,"",6615375.08
,"General Journal","05-10-2024","25401",,,"1Kg Generic Jar Blow Mould 1 depreciation","Expense","Depreciation Expense",,"Accumulated Depreciation",1500.00,"",6616875.08
,"General Journal","05-10-2024","25402",,,"1Kg Generic Jar Blow Mould 2 depreciation","Expense","Depreciation Expense",,"Accumulated Depreciation",1500.00,"",6618375.08
,"General Journal","05-10-2024","25403",,,"500gm Generic Jar Blow Mould 1 depreciation","Expense","Depreciation Expense",,"Accumulated Depreciation",1071.43,"",6619446.51
,"General Journal","05-10-2024","25404",,,"500gm Generic Jar Blow Mould 2 depreciation","Expense","Depreciation Expense",,"Accumulated Depreciation",1071.43,"",6620517.94
,"General Journal","05-10-2024","25405",,,"9Kg Powder Fire Extinguisher 4 Depreciation","Expense","Depreciation Expense",,"Accumulated Depreciation",34.52,"",6620552.46
,"General Journal","05-10-2024","25414",,,"Extractor Fan 4 Depreciation","Expense","Depreciation Expense",,"Accumulated Depreciation",726.19,"",6621278.65
,"General Journal","05-10-2024","25415",,,"FFS  Machine Installation Elct Depreciation","Expense","Depreciation Expense",,"Accumulated Depreciation",200.60,"",6621479.25
,"General Journal","05-10-2024","25416",,,"First Aid Kit Depreciation","Expense","Depreciation Expense",,"Accumulated  Depreciation",77.38,"",6621556.63
,"General Journal","05-10-2024","25419",,,"Linx 8900 Coder 2 Depreciation","Expense","Depreciation Expense",,"Accumulated Depreciation",12500.00,"",6634056.63
,"General Journal","05-10-2024","25421",,,"Packing Platform Depreciation","Expense","Depreciation Expense",,"Accumulated Depreciation",5297.62,"",6639354.25
,"General Journal","05-10-2024","25428",,,"SS Industrial Turntable Depreciation","Expense","Depreciation Expense",,"Accumulated Depreciation",5238.10,"",6644592.35
,"General Journal","05-10-2024","25431",,,"TV Screen 2 Depreciation","Expense","Depreciation Expense",,"Accumulated Depreciation",950.00,"",6645542.35
,"General Journal","05-10-2024","25433",,,"Water Purifier 1 Depreciation","Expense","Depreciation Expense",,"Accumulated Depreciation",117.10,"",6645659.45
,"General Journal","06-10-2024","25407",,,"Blower Depreciation","Expense","Depreciation Expense",,"Accumulated Depreciation",59.52,"",6645718.97
,"General Journal","06-10-2024","25413",,,"Emergency Washing Point Depreciation","Expense","Depreciation Expense",,"Accumulated Deprecation",160.71,"",6645879.68
,"General Journal","06-10-2024","25418","*",,"Infrared Thermometre 1 Depreciation","Expense","Depreciation Expense",,"Accumulated Depreciation",416.67,"",6646296.35
,"General Journal","06-10-2024","25420",,,"Material's Trolley Depreciation","Expense","Depreciation Expense",,"Accumulated Depreciation",297.62,"",6646593.97
,"General Journal","06-10-2024","25425",,,"Plastic Scrap Grinder Machine Depreciation","Expense","Depreciation Expense",,"Accumulated  Depreciation",3452.38,"",6650046.35
,"General Journal","06-10-2024","25427",,,"Ribon Mixer SS depreciation","Expense","Depreciation Expense",,"Accumulated depreciation",4642.86,"",6654689.21
,"General Journal","06-10-2024","25429",,,"Telephone Handset Depreciation","Expense","Depreciation Expense",,"Accumulated Depreciation",29.76,"",6654718.97
,"General Journal","06-10-2024","25430",,,"Telkom Wifi Router Depreciation","Expense","Depreciation Expense",,"Accumulated Depreciation",71.43,"",6654790.40
,"General Journal","06-10-2024","25432",,,"Vacuum Cleaner Depreciation","Expense","Depreciation Expense",,"Accumulated Depreciation",148.81,"",6654939.21
,"General Journal","07-10-2024","25406",,,"9Kg Powder Fire Extinguisher 6 Depreciation","Expense","Depreciation Expense",,"Accumulated Depreciation",44.05,"",6654983.26
,"General Journal","07-10-2024","25408",,,"Cartoning table 4 depreciation","Expense","Depreciation Expense",,"Accumulated Depreciation",262.49,"",6655245.75
,"General Journal","07-10-2024","25409",,,"Case sealing table depreciation","Expense","Depreciation Expense",,"Accumulated Depreciation",86.67,"",6655332.42
,"General Journal","07-10-2024","25410",,,"Chain block 2 depreciation","Expense","Depreciation Expense",,"Accumulated depreciation",398.81,"",6655731.23
,"General Journal","07-10-2024","25411",,,"Chain block 3 depreciation","Expense","Depreciation Expense",,"Accumulated depreciation",398.81,"",6656130.04
,"General Journal","07-10-2024","25412",,,"Drilling machine Depreciation","Expense","Depreciation Expense",,"Accumulated Depreciation",88.39,"",6656218.43
,"General Journal","07-10-2024","25417",,,"Grinder Depreciation","Expense","Depreciation Expense",,"Acccumulated Depreciation",159.82,"",6656378.25
,"General Journal","07-10-2024","25422",,,"Packing table 1 depreciation","Expense","Depreciation Expense",,"Accumulated Depreciation",262.49,"",6656640.74
,"General Journal","07-10-2024","25423",,,"Packing table 2 depreciation","Expense","Depreciation Expense",,"Accumulated Depreciation",262.49,"",6656903.23
,"General Journal","07-10-2024","25424",,,"Packing table 3 depreciation","Expense","Depreciation Expense",,"Accumulated Depreciation",262.49,"",6657165.72
,"General Journal","07-10-2024","25426",,,"Quality table depreciation","Expense","Depreciation Expense",,"Accumulated Depreciation",86.67,"",6657252.39
,"General Journal","07-10-2024","25434",,,"Welding machine Depreciation","Expense","Depreciation Expense",,"Accumulated Depreciation",178.57,"",6657430.96
,"General Journal","08-10-2024","25440",,,"Bench Grinder 350W Depreciation","Expense","Depreciation Expense",,"Accumulated Depreciation",122.13,"",6657553.09
,"General Journal","08-10-2024","25441",,,"HP Laptop 6 Depreciation","Expense","Depreciation Expense",,"Accumulated Depreciation",416.67,"",6657969.76
,"General Journal","08-10-2024","25442",,,"Mobile Phone 1 Depreciation","Expense","Depreciation Expense",,"Accumulated Depreciation",58.33,"",6658028.09
,"General Journal","08-10-2024","25443",,,"Six step steel ladder 1 Depreciation","Expense","Depreciation Expense",,"Accumulated Depreciation",113.51,"",6658141.60
,"General Journal","09-10-2024","25446",,,"Canteen Table 1 Depreciation","Expense","Depreciation Expense",,"Accumulated Depreciation",184.52,"",6658326.12
,"General Journal","09-10-2024","25447",,,"Canteen Table 2 Depreciation","Expense","Depreciation Expense",,"Accumulated Depreciation",184.52,"",6658510.64
,"General Journal","09-10-2024","25448",,,"Dell Desktop 1 Depreciation","Expense","Depreciation Expense",,"Accumulated Depreciation",178.57,"",6658689.21
,"General Journal","09-10-2024","25449",,,"Fire Alarm System Extension'19 Depreciation","Expense","Depreciation Expense",,"Accumulated Depreciation",9857.14,"",6668546.35
,"General Journal","09-10-2024","25451",,,"Floor Chair 1 Depreciation","Expense","Depreciation Expense",,"Accumulated Depreciation",26.79,"",6668573.14
,"General Journal","09-10-2024","25452",,,"Floor Chair 2 Depreciation","Expense","Depreciation Expense",,"Accumulated Depreciation",26.79,"",6668599.93
,"General Journal","09-10-2024","25453",,,"Floor Chair 3 Depreciation","Expense","Depreciation Expense",,"Accumulated Depreciation",26.79,"",6668626.72
,"General Journal","09-10-2024","25454",,,"Floor Chair 4 Depreciation","Expense","Depreciation Expense",,"Accumulated Depreciation",26.79,"",6668653.51
,"General Journal","09-10-2024","25455",,,"Floor Chair 5 Depreciation","Expense","Depreciation Expense",,"Accumulated Depreciation",26.79,"",6668680.30
,"General Journal","09-10-2024","25456",,,"Lab Office Chair 1 Depreciation","Expense","Depreciation Expense",,"Accumulated Depreciation",47.62,"",6668727.92
,"General Journal","09-10-2024","25457",,,"Lab Office Chair 2 Depreciation","Expense","Depreciation Expense",,"Accumulated Depreciation",47.62,"",6668775.54
,"General Journal","09-10-2024","25458",,,"Lab Office Chair 3 Depreciation","Expense","Depreciation Expense",,"Accumulated Depreciation",47.62,"",6668823.16
,"General Journal","09-10-2024","25459","*","Unilever Kenya Ltd:Sunlight Washing Pwd","Sunlight Bag Closing Machine 1 Depreciation","Expense","Depreciation Expense",,"Accumulated Depreciation",738.10,"",6669561.26
,"General Journal","10-10-2024","25462",,,"5Kg Fire Extinguisher 1 Depreciation","Expense","Depreciation Expense",,"Accumulated Depreciation",65.48,"",6669626.74
,"General Journal","10-10-2024","25467",,,"HP Laptop 10 Depreciation","Expense","Depreciation Expense",,"Accumulated Depreciation",1200.00,"",6670826.74
,"General Journal","10-10-2024","25470",,,"HP Laptop 9 Depreciation","Expense","Depreciation Expense",,"Accumulated Depreciation",1200.00,"",6672026.74
,"General Journal","10-10-2024","25471",,,"Office Seat 1 Depreciation","Expense","Depreciation Expense",,"Accumulated Depreciation",142.86,"",6672169.60
,"General Journal","10-10-2024","25472",,,"Office Seat 2 Depreciation","Expense","Depreciation Expense",,"Accumulated Depreciation",71.43,"",6672241.03
,"General Journal","10-10-2024","25473",,,"Office Seat 3 Depreciation","Expense","Depreciation Expense",,"Accumulated Depreciation",71.43,"",6672312.46
,"General Journal","10-10-2024","25475",,,"Reverse Osmosis Unit 1 Depreciation","Expense","Depreciation Expense",,"Accumulated Depreciation",416.67,"",6672729.13
,"General Journal","10-10-2024","25476",,,"Steam Generator SG24 Depreciation","Expense","Depreciation Expense",,"Accumulated Depreciation",3794.53,"",6676523.66
,"General Journal","10-10-2024","25478",,,"Toilet Cleaner Mixing Machine Depreciation","Expense","Depreciation Expense",,"Accumulated Depreciation",6333.33,"",6682856.99
,"General Journal","11-10-2024","25460",,,"4 GB hard drive for CCTV Depreciation","Expense","Depreciation Expense",,"Accumulated Depreciation",178.57,"",6683035.56
,"General Journal","11-10-2024","25461",,,"4TB Hard Disk Depreciation","Expense","Depreciation Expense",,"Accumulated Depreciation",178.57,"",6683214.13
,"General Journal","11-10-2024","25463","*","Unilever Kenya Ltd:Sunlight Washing Pwd","Chain block trolley 4 depreciation","Expense","Depreciation Expense",,"Accumulated Depreciation",85.00,"",6683299.13
,"General Journal","11-10-2024","25464",,,"Coder Depreciation","Expense","Depreciation Expense",,"Accumulated Depreciation",2261.90,"",6685561.03
,"General Journal","11-10-2024","25465",,,"Coder Stand Depreciation","Expense","Depreciation Expense",,"Accumulated Depreciation",59.52,"",6685620.55
,"General Journal","11-10-2024","25466",,,"Compressor 1 depreciation","Expense","Depreciation Expense",,"Accumulated depreciation",3750.00,"",6689370.55
,"General Journal","11-10-2024","25468",,,"HP Laptop 14 Depreciation","Expense","Depreciation Expense",,"Accumulated Depreciation",1941.67,"",6691312.22
,"General Journal","11-10-2024","25469",,,"HP Laptop 15 Depreciation","Expense","Depreciation Expense",,"Accumulated Depreciation",1750.00,"",6693062.22
,"General Journal","11-10-2024","25474",,,"Pallet truck 2 depreciation","Expense","Depreciation Expense",,"Accumulated depreciation",440.48,"",6693502.70
,"General Journal","11-10-2024","25477","*",,"Steam Label Shrink Tunnel Depreciation","Expense","Depreciation Expense",,"Accumulated  Depreciation",10952.38,"",6704455.08
,"General Journal","12-10-2024","25481",,,"Coder Housing Depreciation","Expense","Depreciation Expense",,"Accumulated Depreciation",80.36,"",6704535.44
,"General Journal","12-10-2024","25484",,,"Coding Conveyor Depreciation","Expense","Depreciation Expense",,"Accumulated Depreciation",476.19,"",6705011.63
,"General Journal","12-10-2024","25485",,,"Conveyor 2 Depreciation","Expense","Depreciation Expense",,"Accumulated  Depreciation",169.64,"",6705181.27
,"General Journal","12-10-2024","25486",,,"Eyewash Station 1 Depreciation","Expense","Depreciation Expense",,"Accumulated Depreciation",904.76,"",6706086.03
,"General Journal","12-10-2024","25488",,,"HP Laptop 5 Depreciation","Expense","Depreciation Expense",,"Accumulated Depreciation",416.67,"",6706502.70
,"General Journal","12-10-2024","25496",,,"Tea maker Depreciation","Expense","Depreciation Expense",,"Accumulated Depreciation",225.00,"",6706727.70
,"General Journal","13-10-2024","25479",,,"Alarm System Depreciation","Expense","Depreciation Expense",,"Accumulated Depreciation",580.95,"",6707308.65
,"General Journal","13-10-2024","25480",,,"Bosch Blower 2 Depreciation","Expense","Depreciation Expense",,"Accumulated Depreciation",136.49,"",6707445.14
,"General Journal","13-10-2024","25483",,,"Coder UPS 8 Depreciation","Expense","Depreciation Expense",,"Accumulated Depreciation",81.67,"",6707526.81
,"General Journal","13-10-2024","25487","*",,"HP Laptop 16 Depreciation","Expense","Depreciation Expense",,"Accumulated Depreciation",1000.00,"",6708526.81
,"General Journal","13-10-2024","25489",,,"HP Mini Desktop 4 Depreciation","Expense","Depreciation Expense",,"Accumulated Depreciation",466.67,"",6708993.48
,"General Journal","13-10-2024","25492",,,"PIR system extension Depreciation","Expense","Depreciation Expense",,"Accumulated Depreciation",254.67,"",6709248.15
,"General Journal","13-10-2024","25493",,,"Process Water Storage Tank Depreciation","Expense","Depreciation Expense",,"Accumulated Depreciation",1065.16,"",6710313.31
,"General Journal","13-10-2024","25494","*",,"Store Racking 3 FG Depreciation","Expense","Depreciation Expense",,"Accumulated Depreciation",9791.67,"",6720104.98
,"General Journal","13-10-2024","25497",,,"Weighing scale 1","Expense","Depreciation Expense",,"Accumulated Depreciation",559.52,"",6720664.50
,"General Journal","14-10-2024","25482",,,"Coder UPS 5 Depreciation","Expense","Depreciation Expense",,"Accumulated Depreciation",158.33,"",6720822.83
,"General Journal","14-10-2024","25490",,,"Motor Vehicle 2 Depreciation","Expense","Depreciation Expense",,"Accumulated Depreciation",10297.62,"",6731120.45
,"General Journal","14-10-2024","25491",,,"Paste Packing Machine Depreciation","Expense","Depreciation Expense",,"Accumulated Depreciation",4166.67,"",6735287.12
,"General Journal","14-10-2024","25495",,,"Table Top Scale 10  SS 15Kg Depreciation","Expense","Depreciation Expense",,"Accumulated Depreciation",297.62,"",6735584.74
,"General Journal","15-10-2024","25504",,,"150KVA Enclosed Genset Depreciation","Expense","Depreciation Expense",,"Accumulated Depreciation",24404.76,"",6759989.50
,"General Journal","15-10-2024","25505",,,"20Kg Forklift Gas Cylinder 2 Depreciation","Expense","Depreciation Expense",,"Accumulated Depreciation",769.70,"",6760759.20
,"General Journal","15-10-2024","25506",,,"2Ton Electric Hoist 1 Depreciation","Expense","Depreciation Expense",,"Accumulated Depreciation",3708.33,"",6764467.53
,"General Journal","15-10-2024","25507",,,"Automatic Change Over Switch 1 Depreciation","Expense","Depreciation Expense",,"Accumulated Depreciation",1666.67,"",6766134.20
,"General Journal","15-10-2024","25508",,,"Bench top Weighing Scale 1 Depreciation","Expense","Depreciation Expense",,"Accumulated Depreciation",357.14,"",6766491.34
,"General Journal","15-10-2024","25509",,,"Bench top Weighing Scale 2 Depreciation","Expense","Depreciation Expense",,"Accumulated Depreciation",357.14,"",6766848.48
,"General Journal","15-10-2024","25510",,,"Bench top Weighing Scale 3 Depreciation","Expense","Depreciation Expense",,"Accumulated Depreciation",357.14,"",6767205.62
,"General Journal","15-10-2024","25511",,,"Bench top Weighing Scale 4 Depreciation","Expense","Depreciation Expense",,"Accumulated Depreciation",357.14,"",6767562.76
,"General Journal","15-10-2024","25512",,,"Bosch Blower Depreciation","Expense","Depreciation Expense",,"Accumulated Depreciation",129.31,"",6767692.07
,"General Journal","15-10-2024","25513",,,"Canteen Chair 1 Depreciation","Expense","Depreciation Expense",,"Accumulated Depreciation",6.12,"",6767698.19
,"General Journal","15-10-2024","25514",,,"Canteen Chair 10 Depreciation","Expense","Depreciation Expense",,"Accumulated Depreciation",6.12,"",6767704.31
,"General Journal","15-10-2024","25515",,,"Canteen Chair 11 Depreciation","Expense","Depreciation Expense",,"Accumulated Depreciation",6.12,"",6767710.43
,"General Journal","15-10-2024","25516",,,"Canteen Chair 11 Depreciation","Expense","Depreciation Expense",,"Accumulated Depreciation",6.12,"",6767716.55
,"General Journal","15-10-2024","25517",,,"Canteen Chair 12 Depreciation","Expense","Depreciation Expense",,"Accumulated Depreciation",6.12,"",6767722.67
,"General Journal","15-10-2024","25518",,,"Canteen Chair 13 Depreciation","Expense","Depreciation Expense",,"Accumulated Depreciation",6.12,"",6767728.79
,"General Journal","15-10-2024","25519",,,"Canteen Chair 14 Depreciation","Expense","Depreciation Expense",,"Accumulated Depreciation",6.12,"",6767734.91
,"General Journal","15-10-2024","25520",,,"Canteen Chair 15 Depreciation","Expense","Depreciation Expense",,"Accumulated Depreciation",6.12,"",6767741.03
,"General Journal","15-10-2024","25521",,,"Canteen Chair 16 Depreciation","Expense","Depreciation Expense",,"Accumulated Depreciation",6.12,"",6767747.15
,"General Journal","15-10-2024","25522",,,"Canteen Chair 17 Depreciation","Expense","Depreciation Expense",,"Accumulated Depreciation",6.12,"",6767753.27
,"General Journal","15-10-2024","25523",,,"Canteen Chair 18 Depreciation","Expense","Depreciation Expense",,"Accumulated Depreciation",6.12,"",6767759.39
,"General Journal","15-10-2024","25524",,,"Canteen Chair 19 Depreciation","Expense","Depreciation Expense",,"Accumulated Depreciation",6.12,"",6767765.51
,"General Journal","15-10-2024","25525",,,"Canteen Chair 2 Depreciation","Expense","Depreciation Expense",,"Accumulated Depreciation",6.12,"",6767771.63
,"General Journal","15-10-2024","25526",,,"Canteen Chair 21 Depreciation","Expense","Depreciation Expense",,"Accumulated Depreciation",6.12,"",6767777.75
,"General Journal","15-10-2024","25527",,,"Canteen Chair 22 Depreciation","Expense","Depreciation Expense",,"Accumulated Depreciation",6.12,"",6767783.87
,"General Journal","15-10-2024","25528",,,"Canteen Chair 23 Depreciation","Expense","Depreciation Expense",,"Accumulated Depreciation",6.12,"",6767789.99
,"General Journal","15-10-2024","25529",,,"Canteen Chair 24 Depreciation","Expense","Depreciation Expense",,"Accumulated Depreciation",6.12,"",6767796.11
,"General Journal","15-10-2024","25530",,,"Canteen Chair 25 Depreciation","Expense","Depreciation Expense",,"Accumulated Depreciation",6.12,"",6767802.23
,"General Journal","15-10-2024","25531",,,"Canteen Chair 3 Depreciation","Expense","Depreciation Expense",,"Accumulated Depreciation",6.12,"",6767808.35
,"General Journal","15-10-2024","25532",,,"Canteen Chair 4 Depreciation","Expense","Depreciation Expense",,"Accumulated Depreciation",6.12,"",6767814.47
,"General Journal","15-10-2024","25533",,,"Canteen Chair 5 Depreciation","Expense","Depreciation Expense",,"Accumulated Depreciation",6.12,"",6767820.59
,"General Journal","15-10-2024","25534",,,"Canteen Chair 6 Depreciation","Expense","Depreciation Expense",,"Accumulated Depreciation",6.12,"",6767826.71
,"General Journal","15-10-2024","25535",,,"Canteen Chair 7 Depreciation","Expense","Depreciation Expense",,"Accumulated Depreciation",6.12,"",6767832.83
,"General Journal","15-10-2024","25536",,,"Canteen Chair 8 Depreciation","Expense","Depreciation Expense",,"Accumulated Depreciation",6.12,"",6767838.95
,"General Journal","15-10-2024","25537",,,"Canteen Chair 9 Depreciation","Expense","Depreciation Expense",,"Accumulated Depreciation",6.12,"",6767845.07
,"General Journal","15-10-2024","25538",,,"EOL Case sealer Outfeed Conveyor Depreciation","Expense","Depreciation Expense",,"Accumulated Depreciation",297.62,"",6768142.69
,"General Journal","15-10-2024","25539",,,"Epson L6190 Printer 1 Depreciation","Expense","Depreciation Expense",,"Accumulated Depreciation",654.76,"",6768797.45
,"General Journal","15-10-2024","25540",,,"Fire Extinguisher 6 Depreciation","Expense","Depreciation Expense",,"Accumulated Depreciation",77.38,"",6768874.83
,"General Journal","15-10-2024","25541",,,"Grinder 2 Depreciation","Expense","Depreciation Expense",,"Accumulated Depreciation",178.57,"",6769053.40
,"General Journal","15-10-2024","25542",,,"HP Laptop 11 Depreciation","Expense","Depreciation Expense",,"Accumulated Depreciation",1200.00,"",6770253.40
,"General Journal","15-10-2024","25543",,,"HP Laptop 12 Depreciation","Expense","Depreciation Expense",,"Accumulated Depreciation",1200.00,"",6771453.40
,"General Journal","15-10-2024","25544",,,"Microwave 2 Depreciation","Expense","Depreciation Expense",,"Accumulated Depreciation",147.27,"",6771600.67
,"General Journal","15-10-2024","25545",,,"Mobile phone 3 Depreciation","Expense","Depreciation Expense",,"Accumulated Depreciation",41.67,"",6771642.34
,"General Journal","15-10-2024","25546",,,"Movable Ladder 1 Depreciation","Expense","Depreciation Expense",,"Accumulated Depreciation",434.52,"",6772076.86
,"General Journal","15-10-2024","25547",,,"UV water purifier 3 Depreciation","Expense","Depreciation Expense",,"Accumulated Depreciation",543.10,"",6772619.96
,"General Journal","15-10-2024","25548",,,"Water tank 6 Depreciation","Expense","Depreciation Expense",,"Accumulated Depreciation",71.84,"",6772691.80
,"General Journal","16-10-2024","25549",,,"Bosch Grinder 3 Depreciation","Expense","Depreciation Expense",,"Accumulated Depreceiation",86.21,"",6772778.01
,"General Journal","16-10-2024","25550",,,"Chain block 5 depreciation","Expense","Depreciation Expense",,"Accumulated Depreciation",292.49,"",6773070.50
,"General Journal","16-10-2024","25551",,,"Chain block 6 depreciation","Expense","Depreciation Expense",,"Accumulated Depreciation",292.49,"",6773362.99
,"General Journal","16-10-2024","25552",,,"Heat Gun Total 1 Depreciation","Expense","Depreciation Expense",,"Accumulated Depreciation",64.66,"",6773427.65
,"General Journal","16-10-2024","25553",,,"Linx 5900 Coder 1 Depreciation","Expense","Depreciation Expense",,"Accumulated Depreciation",4166.67,"",6777594.32
,"General Journal","16-10-2024","25554",,,"Table Top Scale 11 6Kg Depreciation","Expense","Depreciation Expense",,"Accumulated Depreciation",277.09,"",6777871.41
,"General Journal","16-10-2024","25555",,,"Washing Machine 1 Depreciation","Expense","Depreciation Expense",,"Accumulated Depreciation",2640.01,"",6780511.42
,"General Journal","17-10-2024","25556",,,"2T Mixer Depreciation","Expense","Depreciation Expense",,"Accumulated Depreciation",12633.99,"",6793145.41
,"General Journal","17-10-2024","25557",,,"2T Mixer Installation Depreciation","Expense","Depreciation Expense",,"Accumulated Depreciation",29713.15,"",6822858.56
,"General Journal","17-10-2024","25558",,,"Coder UPS 6 Depreciation","Expense","Depreciation Expense",,"Accumulated Depreciation",94.83,"",6822953.39
,"General Journal","17-10-2024","25559",,,"Coder UPS 7 Depreciation","Expense","Depreciation Expense",,"Accumulated Depreciation",94.83,"",6823048.22
,"General Journal","17-10-2024","25560","*",,"Hand Dryer 1 Depreciation","Expense","Depreciation Expense",,"Accumulated Depreciation",46.18,"",6823094.40
,"General Journal","17-10-2024","25561","*",,"HP Laptop 3 Depreciation","Expense","Depreciation Expense",,"Accumulated Depreciation",297.62,"",6823392.02
,"General Journal","17-10-2024","25562",,,"Office desks  4","Expense","Depreciation Expense",,"Accumulated Depreciation",361.90,"",6823753.92
,"General Journal","17-10-2024","25563",,,"Pallet truck 4 Depreciation","Expense","Depreciation Expense",,"Accumulated Depreciation",428.57,"",6824182.49
,"General Journal","17-10-2024","25564",,,"Pallet truck 5 Depreciation","Expense","Depreciation Expense",,"Accumulated Depreciation",428.57,"",6824611.06
,"General Journal","17-10-2024","25565",,,"Pouch Packing Machine 2 Accumulated depreciation","Expense","Depreciation Expense",,"Accumulated Depreciation",976.19,"",6825587.25
,"General Journal","17-10-2024","25566",,,"Recirculation Pump Depreciation","Expense","Depreciation Expense",,"Accumulated  Depreciation",71.19,"",6825658.44
,"General Journal","17-10-2024","25567",,,"Server 1 Depreciation","Expense","Depreciation Expense",,"Accumulated Depreciation",357.14,"",6826015.58
,"General Journal","17-10-2024","25568",,,"Server Monitor Depreciation","Expense","Depreciation Expense",,"Accumulated Depreciaion",107.14,"",6826122.72
,"General Journal","17-10-2024","25569",,,"Shrink Tunnel Depreciation","Expense","Depreciation Expense",,"Accumulated Depreciation",3750.00,"",6829872.72
,"General Journal","17-10-2024","25570","*",,"Soap Dispenser 1 Depreciation","Expense","Depreciation Expense",,"Accumulated Depreciation",15.39,"",6829888.11
,"General Journal","17-10-2024","25571","*",,"TP Link 3 Depreciation","Expense","Depreciation Expense",,"Accumulated Depreciation",33.33,"",6829921.44
,"General Journal","17-10-2024","25572","*",,"Water Tank 3 Depreciation","Expense","Depreciation Expense",,"Accumulated Depreciation",123.15,"",6830044.59
,"General Journal","18-10-2024","25574",,,"Carton Sealer Manual 1 Depreciation","Expense","Depreciation Expense",,"Accumulated Depreciation",14.80,"",6830059.39
,"General Journal","18-10-2024","25575",,,"Compressor 3 Depreciation","Expense","Depreciation Expense",,"Accumulated Depreciation",5357.14,"",6835416.53
,"General Journal","18-10-2024","25576",,,"Compressor room depreciation","Expense","Depreciation Expense",,"Accumulated depreciation",132.44,"",6835548.97
,"General Journal","18-10-2024","25577",,,"Electric Hoist 1 depreciation","Expense","Depreciation Expense",,"Accumulated depreciation",3452.38,"",6839001.35
,"General Journal","18-10-2024","25578",,,"Gents changing room Lockers Depreciation","Expense","Depreciation Expense",,"Accumulated Depreciation",386.90,"",6839388.25
,"General Journal","18-10-2024","25579",,,"HP Mini Desktop 1 Depreciation","Expense","Depreciation Expense",,"Accumulated Depreciation",733.33,"",6840121.58
,"General Journal","18-10-2024","25580",,,"HP Mini Desktop 2 Depreciation","Expense","Depreciation Expense",,"Accumulated Depreciation",733.33,"",6840854.91
,"General Journal","18-10-2024","25581",,,"HP Mini Desktop 3 Depreciation","Expense","Depreciation Expense",,"Accumulated Depreciation",733.33,"",6841588.24
,"General Journal","18-10-2024","25582",,,"Ladies changing room Lockers Depreciation","Expense","Depreciation Expense",,"Accumulated Depreciation",411.90,"",6842000.14
,"General Journal","18-10-2024","25583",,,"Omrom M1 Basic BP Monitor Depreciation","Expense","Depreciation Expense",,"Accumulated Depreciation",58.33,"",6842058.47
,"General Journal","18-10-2024","25584",,,"SS Hand Washing Station 1 Depreciation","Expense","Depreciation Expense",,"Accumulated Depreciation",690.48,"",6842748.95
,"General Journal","18-10-2024","25585",,,"TV Screen 3 Depreciation","Expense","Depreciation Expense",,"Accumulated Depreciation",316.67,"",6843065.62
,"General Journal","18-10-2024","25586",,,"TV Screen 4 Depreciation","Expense","Depreciation Expense",,"Accumulated Depreciation",1550.00,"",6844615.62
,"General Journal","19-10-2024","25587",,,"3T Gas Forklift 1 Depreciation","Expense","Depreciation Expense",,"Accumulated Depreciation",30952.38,"",6875568.00
,"General Journal","19-10-2024","25606",,,"Coding Stamp 3 Depreciation","Expense","Depreciation Expense",,"Accumulated Depreciation",143.68,"",6875711.68
,"General Journal","19-10-2024","25625",,,"Office Stamp 2 Depreciation","Expense","Depreciation Expense",,"Accumulated Depreciaion",30.83,"",6875742.51
,"General Journal","20-10-2024","25601","*","Unilever Kenya Ltd:Sunlight Washing Pwd","Boato Commisioning Depreciation","Expense","Depreciation Expense",,"Accumulated Depreciation",889.88,"",6876632.39
,"General Journal","20-10-2024","25602",,,"Bosch Blower 3 Depreciation","Expense","Depreciation Expense",,"Accumulated Depreciation",79.02,"",6876711.41
,"General Journal","20-10-2024","25603",,,"Bosch Blower 4 Depreciation","Expense","Depreciation Expense",,"Accumulated Depreciation",136.49,"",6876847.90
,"General Journal","20-10-2024","25604",,,"Bosch Blower 5 Depreciation","Expense","Depreciation Expense",,"Accumulated Depreciation",136.49,"",6876984.39
,"General Journal","20-10-2024","25607",,,"Conference Office Desk 1 Depreciation","Expense","Depreciation Expense",,"Accumulated Depreciation",416.67,"",6877401.06
,"General Journal","20-10-2024","25612",,,"Floor Chair 17 depreciation","Expense","Depreciation Expense",,"Accumulated Depreciation",20.24,"",6877421.30
,"General Journal","20-10-2024","25613",,,"Floor Chair 18 depreciation","Expense","Depreciation Expense",,"Accumulated Depreciation",20.24,"",6877441.54
,"General Journal","20-10-2024","25614",,,"Floor Chair 19 depreciation","Expense","Depreciation Expense",,"Accumulated Depreciation",20.24,"",6877461.78
,"General Journal","20-10-2024","25615",,,"Floor Chair 20 depreciation","Expense","Depreciation Expense",,"Accumulated Depreciation",20.24,"",6877482.02
,"General Journal","20-10-2024","25616",,,"Heat Gun CAT Digital 1 Depreciation","Expense","Depreciation Expense",,"Accumulated Depreciation",136.49,"",6877618.51
,"General Journal","20-10-2024","25620","*",,"Lumnia 1 Pro Insect Trap Depreciation","Expense","Depreciation Expense",,"Accumulated Depreciation",316.67,"",6877935.18
,"General Journal","20-10-2024","25626",,,"PF Correction Unit Depreciation","Expense","Depreciation Expense",,"Accumulated Depreciation",1708.33,"",6879643.51
,"General Journal","21-10-2024","25588",,,"5Kg CO2 Fire Extinguisher 2 Depreciation","Expense","Depreciation Expense",,"Accumulated Depreciation",73.81,"",6879717.32
,"General Journal","21-10-2024","25591",,,"6Kg Dry Pwd Fire Extinguisher 1 Depreciaiton","Expense","Depreciation Expense",,"Accumulated Depreciation",59.52,"",6879776.84
,"General Journal","21-10-2024","25593",,,"Board room chair 1 Depreciation","Expense","Depreciation Expense",,"Accumulated Depreciation",59.52,"",6879836.36
,"General Journal","21-10-2024","25594",,,"Board room chair 2 Depreciation","Expense","Depreciation Expense",,"Accumulated Depreciation",59.52,"",6879895.88
,"General Journal","21-10-2024","25595",,,"Board room chair 3 Depreciation","Expense","Depreciation Expense",,"Accumulated Depreciation",59.52,"",6879955.40
,"General Journal","21-10-2024","25596",,,"Board room chair 4 Depreciation","Expense","Depreciation Expense",,"Accumulated Depreciation",59.52,"",6880014.92
,"General Journal","21-10-2024","25597",,,"Board room chair 5 Depreciation","Expense","Depreciation Expense",,"Accumulated Depreciation",59.52,"",6880074.44
,"General Journal","21-10-2024","25598",,,"Board room chair 6 Depreciation","Expense","Depreciation Expense",,"Accumulated Depreciation",59.52,"",6880133.96
,"General Journal","21-10-2024","25599",,,"Board room chair 7 Depreciation","Expense","Depreciation Expense",,"Accumulated Depreciation",59.52,"",6880193.48
,"General Journal","21-10-2024","25600",,,"Board room chair 8 Depreciation","Expense","Depreciation Expense",,"Accumulated Depreciation",59.52,"",6880253.00
,"General Journal","21-10-2024","25605",,,"Coding Stamp 2 Depreciation","Expense","Depreciation Expense",,"Accumulated Depreciation",133.33,"",6880386.33
,"General Journal","21-10-2024","25609",,,"IBC Tank 1 Depreciation","Expense","Depreciation Expense",,"Accumulated Depreciation",41.67,"",6880428.00
,"General Journal","21-10-2024","25610",,,"Empty IBC Tank 2 Depreciation","Expense","Depreciation Expense",,"Accumulated Depreciation",65.48,"",6880493.48
,"General Journal","21-10-2024","25611",,,"FFS Filling Machine 300 1 Depreciation","Expense","Depreciation Expense",,"Accumulated Depreciation",11850.01,"",6892343.49
,"General Journal","21-10-2024","25619",,,"Laboratory Oven & Dessicator  Depreciation","Expense","Depreciation Expense",,"Accumulated Depreciation",766.67,"",6893110.16
,"General Journal","21-10-2024","25622",,,"Nikon D3500 Camera 1 Depreciation","Expense","Depreciation Expense",,"Accumulated Depreciation",766.67,"",6893876.83
,"General Journal","21-10-2024","25629",,,"Tea Urn Depreciation","Expense","Depreciation Expense",,"Accumulated Depreciation",121.67,"",6893998.50
,"General Journal","22-10-2024","25589",,,"6Kg Auto Fire Extinguisher 1 Depreciation","Expense","Depreciation Expense",,"Accumulated Depreciation",53.57,"",6894052.07
,"General Journal","22-10-2024","25590",,,"6Kg Auto Fire Extinguisher 2 Depreciation","Expense","Depreciation Expense",,"Accumulated Depreciation",53.57,"",6894105.64
,"General Journal","22-10-2024","25592","*",,"AVS Voltage Stabilizer Depreciation","Expense","Depreciation Expense",,"Accumulated Depreciation",63.10,"",6894168.74
,"General Journal","22-10-2024","25608",,,"Conveyor Belt Green 1 Depreciation","Expense","Depreciation Expense",,"Accumulated Depreciation",82.14,"",6894250.88
,"General Journal","22-10-2024","25617",,,"HP Laptop 13 Depreciation","Expense","Depreciation Expense",,"Accumulated Depreciation",1200.00,"",6895450.88
,"General Journal","22-10-2024","25618","*",,"HP Laptop 7 Depreciation","Expense","Depreciation Expense",,"Accumulated Depreciation",1200.00,"",6896650.88
,"General Journal","22-10-2024","25623",,,"Office Desk 5 Depreciation","Expense","Depreciation Expense",,"Accumulated Depreciation",180.95,"",6896831.83
,"General Journal","22-10-2024","25624",,,"Office cabinets depreciation","Expense","Depreciation Expense",,"Accumulated Depreciation",119.05,"",6896950.88
,"General Journal","22-10-2024","25627",,,"Platform Scale 2 SS 100Kg Depreciation","Expense","Depreciation Expense",,"Accumulated Depreciation",339.29,"",6897290.17
,"General Journal","22-10-2024","25628",,,"Solar Water Heater 300L Depreciation","Expense","Depreciation Expense",,"Accumulated Depreciation",3125.00,"",6900415.17
,"General Journal","23-10-2024","25630",,,"Analytical Balance Depreciation","Expense","Depreciation Expense",,"Accumulated Depreciation",2405.58,"",6902820.75
,"General Journal","23-10-2024","25631",,,"Auger Filler 1 Depreciation","Expense","Depreciation Expense",,"Accumulated Depreciation",7220.12,"",6910040.87
,"General Journal","23-10-2024","25632",,,"Auger Filler 2 Depreciation","Expense","Depreciation Expense",,"Accumulated Depreciation",13258.63,"",6923299.50
,"General Journal","23-10-2024","25633",,,"Auger Filler 3 Depreciation","Expense","Depreciation Expense",,"Accumulated Depreciation",11788.69,"",6935088.19
,"General Journal","23-10-2024","25634",,,"Bajaj Boxer BM150 UG Depreciation","Expense","Depreciation Expense",,"Accumulated Depreciation",1539.41,"",6936627.60
,"General Journal","23-10-2024","25635",,,"Chain block 4 depreciation","Expense","Depreciation Expense",,"Accumulated Depreciation",133.42,"",6936761.02
,"General Journal","23-10-2024","25636",,,"Coder UPS Depreciation","Expense","Depreciation Expense",,"Accumulated Depreciation",95.24,"",6936856.26
,"General Journal","23-10-2024","25637",,,"Dust Extractor 1 Depreciation","Expense","Depreciation Expense",,"Accumulated Depreciation",446.43,"",6937302.69
,"General Journal","23-10-2024","25638",,,"Dust Extractor 2 Depreciation","Expense","Depreciation Expense",,"Accumulated Depreciation",446.43,"",6937749.12
,"General Journal","23-10-2024","25639",,,"Filler 1 Geared Motor & Feeding System Depreciation","Expense","Depreciation Expense",,"Accumulated Depreciation",333.33,"",6938082.45
,"General Journal","23-10-2024","25640",,,"Filler 2 Geared Motor & Feeding System Depreciation","Expense","Depreciation Expense",,"Accumulated Depreciation",348.72,"",6938431.17
,"General Journal","23-10-2024","25641",,,"Filler 3 Geared Motor & Feeding System Depreciation","Expense","Depreciation Expense",,"Accumulated Depreciation",347.52,"",6938778.69
,"General Journal","23-10-2024","25642",,,"Hotplate with Stirrer Depreciation","Expense","Depreciation Expense",,"Accumulated Depreciation",1785.71,"",6940564.40
,"General Journal","23-10-2024","25643",,,"Makita Hammer Drill Depreciation","Expense","Depreciation Expense",,"Accumulated Depreciation",205.25,"",6940769.65
,"General Journal","23-10-2024","25644",,,"Microwave 1 Depreciation","Expense","Depreciation Expense",,"Accumulated Depreciation",217.13,"",6940986.78
,"General Journal","23-10-2024","25645",,,"Pallet truck 3 Dep","Expense","Depreciation Expense",,"Accumulated Depreciation",510.95,"",6941497.73
,"General Journal","23-10-2024","25646",,,"Pouching Machine Depreciation","Expense","Depreciation Expense",,"Accumulated Depreciation",711.90,"",6942209.63
,"General Journal","23-10-2024","25647",,,"Power bank dep","Expense","Depreciation Expense",,"Accumulated Depreciation",119.05,"",6942328.68
,"General Journal","23-10-2024","25648",,,"Table Top Scale 11  SS 30Kg Depreciation","Expense","Depreciation Expense",,"Accumulated Depreciation",297.62,"",6942626.30
,"General Journal","23-10-2024","25649",,,"Table Top Scale 12  SS 30Kg Depreciation","Expense","Depreciation Expense",,"Accumulated Depreciation",297.62,"",6942923.92
,"General Journal","24-10-2024","25650",,,"Access Control Unit & System Depreciation","Expense","Depreciation Expense",,"Accumulated Depreciation",334.76,"",6943258.68
,"General Journal","24-10-2024","25652",,,"Electrical Enclosure Compressor Depreciation","Expense","Depreciation Expense",,"Accumulated Depreciation",125.00,"",6943383.68
,"General Journal","24-10-2024","25653",,,"ETR Machine Depreciation","Expense","Depreciation Expense",,"Accumulated Depreciation",236.04,"",6943619.72
,"General Journal","24-10-2024","25654",,,"Liquid Plant Depreciation","Expense","Depreciation Expense",,"Accumulated Deprecation",15029.76,"",6958649.48
,"General Journal","24-10-2024","25655",,,"Paste processing & packing line depreciation","Expense","Depreciation Expense",,"Accumulated Depreciation",17348.21,"",6975997.69
,"General Journal","24-10-2024","25656",,,"pH Meter Depreciation","Expense","Depreciation Expense",,"Accumulated Depreciation",741.39,"",6976739.08
,"General Journal","25-10-2024","25658",,,"Clamp Meter 1 Depreciation","Expense","Depreciation Expense",,"Accumulated Depreciation",36.90,"",6976775.98
,"General Journal","25-10-2024","25659",,,"Fire Alarm Sytstem Depreciation","Expense","Depreciation Expense",,"Accumulated Depreciation",728.57,"",6977504.55
,"General Journal","25-10-2024","25660",,,"Floor Chair 11 Depreciation","Expense","Depreciation Expense",,"Accumulated Depreciation",53.57,"",6977558.12
,"General Journal","25-10-2024","25661",,,"Floor Chair 12 Depreciation","Expense","Depreciation Expense",,"Accumulated Depreciation",53.57,"",6977611.69
,"General Journal","25-10-2024","25662",,,"Floor Chair 13 Depreciation","Expense","Depreciation Expense",,"Accumulated Depreciation",53.57,"",6977665.26
,"General Journal","25-10-2024","25663",,,"Floor Chair 14 Depreciation","Expense","Depreciation Expense",,"Accumulated Depreciation",53.57,"",6977718.83
,"General Journal","25-10-2024","25664",,,"Floor Chair 15 Depreciation","Expense","Depreciation Expense",,"Accumulated Depreciation",53.57,"",6977772.40
,"General Journal","25-10-2024","25665",,,"Floor Chair 16 Depreciation","Expense","Depreciation Expense",,"Accumulated Depreciation",53.57,"",6977825.97
,"General Journal","25-10-2024","25666",,,"Liquid Mixer 500Lt Depreciation","Expense","Depreciation Expense",,"Accumulated Depreciation",6172.62,"",6983998.59
,"General Journal","25-10-2024","25668",,,"Plastic Resin Mixer Depreciation","Expense","Depreciation Expense",,"Accumulated  Depreciation",1130.95,"",6985129.54
,"General Journal","25-10-2024","25669",,,"Plastic Resin Mixer Depreciation","Expense","Depreciation Expense",,"Accumulated  Depreciation",1130.95,"",6986260.49
,"General Journal","25-10-2024","25670",,,"Water tank 7 Depreciation","Expense","Depreciation Expense",,"Accumulated Depreciation",71.84,"",6986332.33
,"General Journal","26-10-2024","25682",,,"Grease Gun 1 Depreciation","Expense","Depreciation Expense",,"Accumulated Depreciation",73.21,"",6986405.54
,"General Journal","26-10-2024","25683",,,"Grease Gun 2 Depreciation","Expense","Depreciation Expense",,"Accumulated Depreciation",63.14,"",6986468.68
,"General Journal","26-10-2024","25687",,,"Retort Stand 1 Depreciation","Expense","Depreciation Expense",,"Accumulated Depreciation",10.71,"",6986479.39
,"General Journal","26-10-2024","25688",,,"Retort Stand 2 Depreciation","Expense","Depreciation Expense",,"Accumulated Depreciation",10.71,"",6986490.10
,"General Journal","26-10-2024","25689",,,"Tea Urn 2 Depreciation","Expense","Depreciation Expense",,"Accumulated Depreciation",180.00,"",6986670.10
,"General Journal","27-10-2024","25671",,,"Board room chair 10 Depreciation","Expense","Depreciation Expense",,"Accumulated Depreciation",79.55,"",6986749.65
,"General Journal","27-10-2024","25672",,,"Board room chair 11 Depreciation","Expense","Depreciation Expense",,"Accumulated Depreciation",79.55,"",6986829.20
,"General Journal","27-10-2024","25673",,,"Board room chair 12 Depreciation","Expense","Depreciation Expense",,"Accumulated Depreciation",79.55,"",6986908.75
,"General Journal","27-10-2024","25674",,,"Board room chair 13 Depreciation","Expense","Depreciation Expense",,"Accumulated Depreciation",79.55,"",6986988.30
,"General Journal","27-10-2024","25675",,,"Board room chair 14 Depreciation","Expense","Depreciation Expense",,"Accumulated Depreciation",79.55,"",6987067.85
,"General Journal","27-10-2024","25676",,,"Board room chair 15 Depreciation","Expense","Depreciation Expense",,"Accumulated Depreciation",79.55,"",6987147.40
,"General Journal","27-10-2024","25677",,,"Board room chair 16 Depreciation","Expense","Depreciation Expense",,"Accumulated Depreciation",79.55,"",6987226.95
,"General Journal","27-10-2024","25678",,,"Board room chair 17 Depreciation","Expense","Depreciation Expense",,"Accumulated Depreciation",79.55,"",6987306.50
,"General Journal","27-10-2024","25679",,,"Board room chair 18 Depreciation","Expense","Depreciation Expense",,"Accumulated Depreciation",79.55,"",6987386.05
,"General Journal","27-10-2024","25680",,,"Board room chair 19 Depreciation","Expense","Depreciation Expense",,"Accumulated Depreciation",79.55,"",6987465.60
,"General Journal","27-10-2024","25681",,,"Board room chair 9 Depreciation","Expense","Depreciation Expense",,"Accumulated Depreciation",79.55,"",6987545.15
,"General Journal","27-10-2024","25686",,,"Passenger Lift 1000kg Depreciation","Expense","Depreciation Expense",,"Accumulated Depreciation",44484.68,"",7032029.83
,"General Journal","28-10-2024","25684",,,"Heat Gun Bosch 2 Accumulated depreciation","Expense","Depreciation Expense",,"Accumulated Depreciation",75.43,"",7032105.26
,"General Journal","28-10-2024","25685",,,"Heat Gun Bosch 3 Accumulated depreciation","Expense","Depreciation Expense",,"Accumulated Depreciation",75.43,"",7032180.69
,"General Journal","31-10-2024","25690",,,"500gm Jar Blow Mould 3 depreciation","Expense","Depreciation Expense",,"Accumulated Depreciation",1026.79,"",7033207.48
,"General Journal","31-10-2024","25691",,,"500gm Jar Blow Mould 4 depreciation","Expense","Depreciation Expense",,"Accumulated Depreciation",1026.79,"",7034234.27
,"General Journal","31-10-2024","25696",,,"Air cooled chiller depeciation","Expense","Depreciation Expense",,"Accumulated  Depreciation",8916.67,"",7043150.94
,"General Journal","31-10-2024","25700","*","Unilever Kenya Ltd:Sunlight Washing Pwd","Boato Installation Depreciation","Expense","Depreciation Expense",,"Accumulated Depreciation",65114.38,"",7108265.32
,"General Journal","31-10-2024","25702","*",,"Canister Platform Depreciation","Expense","Depreciation Expense",,"Accumulated Depreciation",59246.67,"",7167511.99
,"General Journal","31-10-2024","25703",,,"CCTV DRV & System Depreciation","Expense","Depreciation Expense",,"Accumulated Depreciation",1295.33,"",7168807.32
,"General Journal","31-10-2024","25712",,,"Colour Pressure tank Depreciation","Expense","Depreciation Expense",,"Accumulated Depreciation",232.14,"",7169039.46
,"General Journal","31-10-2024","25713",,,"Compressed air gun Depreciation","Expense","Depreciation Expense",,"Accumulated Depreciation",47.62,"",7169087.08
,"General Journal","31-10-2024","25715",,,"Drum Pump 2 Depreciation","Expense","Depreciation Expense",,"Accumulated Depreciation",123.15,"",7169210.23
,"General Journal","31-10-2024","25727",,,"Extractor Fan down Depreciation","Expense","Depreciation Expense",,"Accumulated Depreciation",150.12,"",7169360.35
,"General Journal","31-10-2024","25728",,,"Extractor Fan Hoisting Depreciation","Expense","Depreciation Expense",,"Accumulated Depreciation",176.67,"",7169537.02
,"General Journal","31-10-2024","25729",,,"Extractor Fan Packaging Depreciation","Expense","Depreciation Expense",,"Accumulated Depreciation",150.12,"",7169687.14
,"General Journal","31-10-2024","25737",,,"Incotex Type C Control Unit Depreciation","Expense","Depreciation Expense",,"Accumulated Depreciation",1939.66,"",7171626.80
,"General Journal","31-10-2024","25738",,,"Lamination Machine 1 Depreciation","Expense","Depreciation Expense",,"Accumulated Depreciation",84.78,"",7171711.58
,"General Journal","31-10-2024","25742",,,"Office Cabinet 5 Depreciation","Expense","Depreciation Expense",,"Accumulated Depreciation",58.33,"",7171769.91
,"General Journal","31-10-2024","25746",,,"Office Desk 6 Depreciation","Expense","Depreciation Expense",,"Accumulated Depreciation",90.48,"",7171860.39
,"General Journal","31-10-2024","25747",,,"Office Desk 7 Depreciation","Expense","Depreciation Expense",,"Accumulated Depreciation",90.48,"",7171950.87
,"General Journal","31-10-2024","25748",,,"Office Desk 8 Depreciation","Expense","Depreciation Expense",,"Accumulated Depreciation",83.33,"",7172034.20
,"General Journal","31-10-2024","25749",,,"Platform Scale 4 tons 1 Depreciation","Expense","Depreciation Expense",,"Accumulated Depreciation",10782.43,"",7182816.63
,"General Journal","31-10-2024","25750",,,"Process Water Filtration System Depreciation","Expense","Depreciation Expense",,"Accumulated Depreciation",1785.71,"",7184602.34
,"General Journal","31-10-2024","25757",,,"Sulphonic Acid pressure tank Depreciation","Expense","Depreciation Expense",,"Accumulated Depreciation",110.48,"",7184712.82
,"General Journal","31-10-2024","25764",,,"Test Sieves 100 & 200 microns Depreciation","Expense","Depreciation Expense",,"Accumulated Depreciation",450.00,"",7185162.82
,"General Journal","31-10-2024","25767",,,"Wall mounted cabinet 1 Dep","Expense","Depreciation Expense",,"Accumulated Depreciation",107.14,"",7185269.96
,"General Journal","31-10-2024","25770",,,"Water tank 5 Depreciation","Expense","Depreciation Expense",,"Accumulated Depreciation",137.79,"",7185407.75
,"General Journal","01-11-2024","25732",,,"Hoisting Bucket 1 Depreciation","Expense","Depreciation Expense",,"Accumulated Depreciation",148.81,"",7185556.56
,"General Journal","01-11-2024","25733",,,"Hoisting Bucket 2 Dereciation","Expense","Depreciation Expense",,"Accumulated Depreciation",148.81,"",7185705.37
,"General Journal","01-11-2024","25739",,,"Lenovo Laptop 2 Depreciation","Expense","Depreciation Expense",,"Accumulated Depreciation",333.33,"",7186038.70
,"General Journal","01-11-2024","25751",,,"Processing Platform Depreciation","Expense","Depreciation Expense",,"Accumulated Depreciation",4880.95,"",7190919.65
,"General Journal","01-11-2024","25752",,,"Security and Computer Sytem UPS Depreciation","Expense","Depreciation Expense",,"Accumulated Depreciation",3584.50,"",7194504.15
,"General Journal","01-11-2024","25766",,,"Trophy Shelf 1 Depreciation","Expense","Depreciation Expense",,"Accumulated Depreciation",95.24,"",7194599.39
,"General Journal","01-11-2024","25769",,,"Water tank 4 Depreciation","Expense","Depreciation Expense",,"Accumulated Depreciation",453.24,"",7195052.63
,"General Journal","02-11-2024","25706",,,"CMPP 1kg Jar Blow Mould 1 Depreciation","Expense","Depreciation Expense",,"Accumulated Depreciation",3364.87,"",7198417.50
,"General Journal","02-11-2024","25707",,,"CMPP 1kg Jar Blow Mould 2 Depreciation","Expense","Depreciation Expense",,"Accumulated Depreciation",3364.87,"",7201782.37
,"General Journal","02-11-2024","25708",,,"CMPP 500gm Jar Blow Mould 1 Depreciation","Expense","Depreciation Expense",,"Accumulated Depreciation",2643.82,"",7204426.19
,"General Journal","02-11-2024","25709",,,"CMPP 500gm Jar Blow Mould 2 Depreciation","Expense","Depreciation Expense",,"Accumulated Depreciation",2643.82,"",7207070.01
,"General Journal","02-11-2024","25710",,,"CMPP Blow Moulding Machine 1 Depreciation","Expense","Depreciation Expense",,"Accumulated Depreciation",49344.71,"",7256414.72
,"General Journal","02-11-2024","25711",,,"CMPP Blow Moulding Machine 2 Depreciation","Expense","Depreciation Expense",,"Accumulated Depreciation",49344.71,"",7305759.43
,"General Journal","02-11-2024","25714",,,"Drum Pump 1 Depreiation","Expense","Depreciation Expense",,"Accumulated Depreciation",123.03,"",7305882.46
,"General Journal","02-11-2024","25731",,,"Heat Gun Bosch 1 Depreciation","Expense","Depreciation Expense",,"Accumulated Depreciation",100.57,"",7305983.03
,"General Journal","02-11-2024","25734",,,"Hot ProcessWater Storage Tank1  Depreciation","Expense","Depreciation Expense",,"Accumulated Depreciation",73.99,"",7306057.02
,"General Journal","02-11-2024","25735","*",,"HP Laptop 4 Depreciation","Expense","Depreciation Expense",,"Accumulated Depreciation",297.62,"",7306354.64
,"General Journal","02-11-2024","25736","*",,"HP Laptop 8 Depreciation","Expense","Depreciation Expense",,"Accumulated Depreciation",1200.00,"",7307554.64
,"General Journal","02-11-2024","25755",,,"Store Racking 1 depreciation","Expense","Depreciation Expense",,"Accumulated Depreciation",175.60,"",7307730.24
,"General Journal","02-11-2024","25756",,,"Store Racking 2 Depreciation","Expense","Depreciation Expense",,"Accumulated Depreciation",175.60,"",7307905.84
,"General Journal","02-11-2024","25763",,,"Tank platform Depreciation","Expense","Depreciation Expense",,"Accumulated Depreciation",130.95,"",7308036.79
,"General Journal","02-11-2024","25768",,,"Water tank 1 Depreciation","Expense","Depreciation Expense",,"Accumulated Depreciation",120.07,"",7308156.86
,"General Journal","02-11-2024","25771",,,"Workshop cabinet depreciation","Expense","Depreciation Expense",,"Accumulated Depreciation",172.02,"",7308328.88
,"General Journal","03-11-2024","25697",,,"Alarm System extension","Expense","Depreciation Expense",,"Accumulated Depreciation",602.38,"",7308931.26
,"General Journal","03-11-2024","25698",,,"Domestos sewing machine depreciation","Expense","Depreciation Expense",,"Acummulated depreciation",82.10,"",7309013.36
,"General Journal","03-11-2024","25699",,,"Bench Grinder 2 Depreciation","Expense","Depreciation Expense",,"Accumulated Depreceiation",100.57,"",7309113.93
,"General Journal","03-11-2024","25701",,,"Bosch Optical Level Gol 32D Depreciation","Expense","Depreciation Expense",,"Accumulated Depreciation",679.38,"",7309793.31
,"General Journal","03-11-2024","25704",,,"CCTV survellance System extension Depreciation","Expense","Depreciation Expense",,"Accumulated Depreciation",657.14,"",7310450.45
,"General Journal","03-11-2024","25716",,,"Electrical Enclosure CCTV Depreciation","Expense","Depreciation Expense",,"Accumulated Depreciation",126.19,"",7310576.64
,"General Journal","03-11-2024","25717",,,"Electrical Enclosure Main Depreciation","Expense","Depreciation Expense",,"Accumulated Depreciation",2339.29,"",7312915.93
,"General Journal","03-11-2024","25718",,,"Electrical Enclosure P Line Depreciation","Expense","Depreciation Expense",,"Accumulated Depreciation",428.57,"",7313344.50
,"General Journal","03-11-2024","25730",,,"Floodlight Depreciation","Expense","Depreciation Expense",,"Accumulated Depreciation",59.52,"",7313404.02
,"General Journal","03-11-2024","25743",,,"Office Desk 1 Depreciation","Expense","Depreciation Expense",,"Accumulated Depreciation",225.00,"",7313629.02
,"General Journal","03-11-2024","25744",,,"Office Desk 2 Depreciation","Expense","Depreciation Expense",,"Accumulated Depreciation",225.00,"",7313854.02
,"General Journal","03-11-2024","25745",,,"Office Desk 3 Depreciation","Expense","Depreciation Expense",,"Accumulated Depreciation",225.00,"",7314079.02
,"General Journal","03-11-2024","25753",,,"Signet ESD 1 Depreciation","Expense","Depreciation Expense",,"Accumulated Depreciation",928.57,"",7315007.59
,"General Journal","03-11-2024","25754","*",,"Sterling Water Dispenser 1 Depreciation","Expense","Depreciation Expense",,"Accumulated Depreciation",119.05,"",7315126.64
,"General Journal","03-11-2024","25758",,,"Table top Weighing Scale 5 Depreciation","Expense","Depreciation Expense",,"Accumulated Depreciation",248.57,"",7315375.21
,"General Journal","03-11-2024","25759",,,"Table top Weighing Scale 6 Depreciation","Expense","Depreciation Expense",,"Accumulated Depreciation",248.57,"",7315623.78
,"General Journal","03-11-2024","25760",,,"Table top Weighing Scale 7 Depreciation","Expense","Depreciation Expense",,"Accumulated Depreciation",248.57,"",7315872.35
,"General Journal","03-11-2024","25761",,,"Table top Weighing Scale 8 Depreciation","Expense","Depreciation Expense",,"Accumulated Depreciation",248.57,"",7316120.92
,"General Journal","03-11-2024","25762",,,"Table top Weighing Scale 9 Depreciation","Expense","Depreciation Expense",,"Accumulated Depreciation",248.57,"",7316369.49
,"General Journal","04-11-2024","25692",,,"9Kg Powder Fire Extinguisher 1 Depreciation","Expense","Depreciation Expense",,"Accumulated Depreciation",34.52,"",7316404.01
,"General Journal","04-11-2024","25693",,,"9Kg Powder Fire Extinguisher 2 Depreciation","Expense","Depreciation Expense",,"Accumulated Depreciation",34.52,"",7316438.53
,"General Journal","04-11-2024","25694",,,"9Kg Powder Fire Extinguisher 3 Depreciation","Expense","Depreciation Expense",,"Accumulated Depreciation",34.52,"",7316473.05
,"General Journal","04-11-2024","25695",,,"9Kg Powder Fire Extinguisher 5 Depreciation","Expense","Depreciation Expense",,"Accumulated Depreciation",34.52,"",7316507.57
,"General Journal","04-11-2024","25705",,,"Chiller 2 Depreciation","Expense","Depreciation Expense",,"Accumulated Depreciation",8035.71,"",7324543.28
,"General Journal","04-11-2024","25719",,,"Empty IBC Tank 10 Depreciation","Expense","Depreciation Expense",,"Accumulated Depreciation",41.67,"",7324584.95
,"General Journal","04-11-2024","25720",,,"Empty IBC Tank 3 Depreciation","Expense","Depreciation Expense",,"Accumulated Depreciation",65.48,"",7324650.43
,"General Journal","04-11-2024","25721",,,"Empty IBC Tank 4 Depreciation","Expense","Depreciation Expense",,"Accumulated Depreciation",65.48,"",7324715.91
,"General Journal","04-11-2024","25722",,,"Empty IBC Tank 5 Depreciation","Expense","Depreciation Expense",,"Accumulated Depreciation",65.48,"",7324781.39
,"General Journal","04-11-2024","25723",,,"Empty IBC Tank 6 Depreciation","Expense","Depreciation Expense",,"Accumulated Depreciation",65.48,"",7324846.87
,"General Journal","04-11-2024","25724",,,"Empty IBC Tank 7 Depreciation","Expense","Depreciation Expense",,"Accumulated Depreciation",41.67,"",7324888.54
,"General Journal","04-11-2024","25725",,,"Empty IBC Tank 8 Depreciation","Expense","Depreciation Expense",,"Accumulated Depreiation",41.67,"",7324930.21
,"General Journal","04-11-2024","25726",,,"Empty IBC Tank 9 Depreciation","Expense","Depreciation Expense",,"Accumulated Depreciation",41.67,"",7324971.88
,"General Journal","04-11-2024","25740",,,"Linx 8900 Coder 1 Depreciation","Expense","Depreciation Expense",,"Accumulated Depreciation",8333.33,"",7333305.21
,"General Journal","04-11-2024","25741",,,"Mobile Phone 2 Depreciation","Expense","Depreciation Expense",,"Accumulated Depreciation",46.67,"",7333351.88
,"General Journal","04-11-2024","25765",,,"Triple UV water purifier 1 Depreciation","Expense","Depreciation Expense",,"Accumulated Depreciation",296.22,"",7333648.10
,"General Journal","05-11-2024","25772",,,"1Kg Generic Jar Blow Mould 1 depreciation","Expense","Depreciation Expense",,"Accumulated Depreciation",1500.00,"",7335148.10
,"General Journal","05-11-2024","25773",,,"1Kg Generic Jar Blow Mould 2 depreciation","Expense","Depreciation Expense",,"Accumulated Depreciation",1500.00,"",7336648.10
,"General Journal","05-11-2024","25774",,,"500gm Generic Jar Blow Mould 1 depreciation","Expense","Depreciation Expense",,"Accumulated Depreciation",1071.43,"",7337719.53
,"General Journal","05-11-2024","25775",,,"500gm Generic Jar Blow Mould 2 depreciation","Expense","Depreciation Expense",,"Accumulated Depreciation",1071.43,"",7338790.96
,"General Journal","05-11-2024","25776",,,"9Kg Powder Fire Extinguisher 4 Depreciation","Expense","Depreciation Expense",,"Accumulated Depreciation",34.52,"",7338825.48
,"General Journal","05-11-2024","25777",,,"Extractor Fan 4 Depreciation","Expense","Depreciation Expense",,"Accumulated Depreciation",726.19,"",7339551.67
,"General Journal","05-11-2024","25778",,,"FFS  Machine Installation Elct Depreciation","Expense","Depreciation Expense",,"Accumulated Depreciation",200.60,"",7339752.27
,"General Journal","05-11-2024","25779",,,"First Aid Kit Depreciation","Expense","Depreciation Expense",,"Accumulated  Depreciation",77.38,"",7339829.65
,"General Journal","05-11-2024","25780",,,"Linx 8900 Coder 2 Depreciation","Expense","Depreciation Expense",,"Accumulated Depreciation",12500.00,"",7352329.65
,"General Journal","05-11-2024","25781",,,"Packing Platform Depreciation","Expense","Depreciation Expense",,"Accumulated Depreciation",5297.62,"",7357627.27
,"General Journal","05-11-2024","25782",,,"SS Industrial Turntable Depreciation","Expense","Depreciation Expense",,"Accumulated Depreciation",5238.10,"",7362865.37
,"General Journal","05-11-2024","25783",,,"TV Screen 2 Depreciation","Expense","Depreciation Expense",,"Accumulated Depreciation",950.00,"",7363815.37
,"General Journal","05-11-2024","25784",,,"Water Purifier 1 Depreciation","Expense","Depreciation Expense",,"Accumulated Depreciation",117.10,"",7363932.47
,"General Journal","06-11-2024","25785",,,"Blower Depreciation","Expense","Depreciation Expense",,"Accumulated Depreciation",59.52,"",7363991.99
,"General Journal","06-11-2024","25786",,,"Emergency Washing Point Depreciation","Expense","Depreciation Expense",,"Accumulated Deprecation",160.71,"",7364152.70
,"General Journal","06-11-2024","25787","*",,"Infrared Thermometre 1 Depreciation","Expense","Depreciation Expense",,"Accumulated Depreciation",416.67,"",7364569.37
,"General Journal","06-11-2024","25788",,,"Material's Trolley Depreciation","Expense","Depreciation Expense",,"Accumulated Depreciation",297.62,"",7364866.99
,"General Journal","06-11-2024","25789",,,"Plastic Scrap Grinder Machine Depreciation","Expense","Depreciation Expense",,"Accumulated  Depreciation",3452.38,"",7368319.37
,"General Journal","06-11-2024","25790",,,"Ribon Mixer SS depreciation","Expense","Depreciation Expense",,"Accumulated depreciation",4642.86,"",7372962.23
,"General Journal","06-11-2024","25791",,,"Telephone Handset Depreciation","Expense","Depreciation Expense",,"Accumulated Depreciation",29.76,"",7372991.99
,"General Journal","06-11-2024","25792",,,"Telkom Wifi Router Depreciation","Expense","Depreciation Expense",,"Accumulated Depreciation",71.43,"",7373063.42
,"General Journal","06-11-2024","25793",,,"Vacuum Cleaner Depreciation","Expense","Depreciation Expense",,"Accumulated Depreciation",148.81,"",7373212.23
,"General Journal","07-11-2024","25794",,,"9Kg Powder Fire Extinguisher 6 Depreciation","Expense","Depreciation Expense",,"Accumulated Depreciation",44.05,"",7373256.28
,"General Journal","07-11-2024","25795",,,"Cartoning table 4 depreciation","Expense","Depreciation Expense",,"Accumulated Depreciation",262.49,"",7373518.77
,"General Journal","07-11-2024","25796",,,"Case sealing table depreciation","Expense","Depreciation Expense",,"Accumulated Depreciation",86.67,"",7373605.44
,"General Journal","07-11-2024","25797",,,"Chain block 2 depreciation","Expense","Depreciation Expense",,"Accumulated depreciation",398.81,"",7374004.25
,"General Journal","07-11-2024","25798",,,"Chain block 3 depreciation","Expense","Depreciation Expense",,"Accumulated depreciation",398.81,"",7374403.06
,"General Journal","07-11-2024","25799",,,"Drilling machine Depreciation","Expense","Depreciation Expense",,"Accumulated Depreciation",88.39,"",7374491.45
,"General Journal","07-11-2024","25800",,,"Grinder Depreciation","Expense","Depreciation Expense",,"Acccumulated Depreciation",159.82,"",7374651.27
,"General Journal","07-11-2024","25801",,,"Packing table 1 depreciation","Expense","Depreciation Expense",,"Accumulated Depreciation",262.49,"",7374913.76
,"General Journal","07-11-2024","25802",,,"Packing table 2 depreciation","Expense","Depreciation Expense",,"Accumulated Depreciation",262.49,"",7375176.25
,"General Journal","07-11-2024","25803",,,"Packing table 3 depreciation","Expense","Depreciation Expense",,"Accumulated Depreciation",262.49,"",7375438.74
,"General Journal","07-11-2024","25804",,,"Quality table depreciation","Expense","Depreciation Expense",,"Accumulated Depreciation",86.67,"",7375525.41
,"General Journal","07-11-2024","25805",,,"Welding machine Depreciation","Expense","Depreciation Expense",,"Accumulated Depreciation",178.57,"",7375703.98
,"General Journal","08-11-2024","25806",,,"Bench Grinder 350W Depreciation","Expense","Depreciation Expense",,"Accumulated Depreciation",122.13,"",7375826.11
,"General Journal","08-11-2024","25807",,,"HP Laptop 6 Depreciation","Expense","Depreciation Expense",,"Accumulated Depreciation",416.67,"",7376242.78
,"General Journal","08-11-2024","25808",,,"Mobile Phone 1 Depreciation","Expense","Depreciation Expense",,"Accumulated Depreciation",58.33,"",7376301.11
,"General Journal","08-11-2024","25809",,,"Six step steel ladder 1 Depreciation","Expense","Depreciation Expense",,"Accumulated Depreciation",113.51,"",7376414.62
,"General Journal","09-11-2024","25813",,,"Canteen Table 1 Depreciation","Expense","Depreciation Expense",,"Accumulated Depreciation",184.52,"",7376599.14
,"General Journal","09-11-2024","25814",,,"Canteen Table 2 Depreciation","Expense","Depreciation Expense",,"Accumulated Depreciation",184.52,"",7376783.66
,"General Journal","09-11-2024","25819",,,"Dell Desktop 1 Depreciation","Expense","Depreciation Expense",,"Accumulated Depreciation",178.57,"",7376962.23
,"General Journal","09-11-2024","25820",,,"Fire Alarm System Extension'19 Depreciation","Expense","Depreciation Expense",,"Accumulated Depreciation",9857.14,"",7386819.37
,"General Journal","09-11-2024","25822",,,"Floor Chair 1 Depreciation","Expense","Depreciation Expense",,"Accumulated Depreciation",26.79,"",7386846.16
,"General Journal","09-11-2024","25823",,,"Floor Chair 2 Depreciation","Expense","Depreciation Expense",,"Accumulated Depreciation",26.79,"",7386872.95
,"General Journal","09-11-2024","25824",,,"Floor Chair 3 Depreciation","Expense","Depreciation Expense",,"Accumulated Depreciation",26.79,"",7386899.74
,"General Journal","09-11-2024","25825",,,"Floor Chair 4 Depreciation","Expense","Depreciation Expense",,"Accumulated Depreciation",26.79,"",7386926.53
,"General Journal","09-11-2024","25826",,,"Floor Chair 5 Depreciation","Expense","Depreciation Expense",,"Accumulated Depreciation",26.79,"",7386953.32
,"General Journal","09-11-2024","25831",,,"Lab Office Chair 1 Depreciation","Expense","Depreciation Expense",,"Accumulated Depreciation",47.62,"",7387000.94
,"General Journal","09-11-2024","25832",,,"Lab Office Chair 2 Depreciation","Expense","Depreciation Expense",,"Accumulated Depreciation",47.62,"",7387048.56
,"General Journal","09-11-2024","25833",,,"Lab Office Chair 3 Depreciation","Expense","Depreciation Expense",,"Accumulated Depreciation",47.62,"",7387096.18
,"General Journal","09-11-2024","25841","*","Unilever Kenya Ltd:Sunlight Washing Pwd","Sunlight Bag Closing Machine 1 Depreciation","Expense","Depreciation Expense",,"Accumulated Depreciation",738.10,"",7387834.28
,"General Journal","10-11-2024","25812",,,"5Kg Fire Extinguisher 1 Depreciation","Expense","Depreciation Expense",,"Accumulated Depreciation",65.48,"",7387899.76
,"General Journal","10-11-2024","25827",,,"HP Laptop 10 Depreciation","Expense","Depreciation Expense",,"Accumulated Depreciation",1200.00,"",7389099.76
,"General Journal","10-11-2024","25830",,,"HP Laptop 9 Depreciation","Expense","Depreciation Expense",,"Accumulated Depreciation",1200.00,"",7390299.76
,"General Journal","10-11-2024","25834",,,"Office Seat 1 Depreciation","Expense","Depreciation Expense",,"Accumulated Depreciation",142.86,"",7390442.62
,"General Journal","10-11-2024","25835",,,"Office Seat 2 Depreciation","Expense","Depreciation Expense",,"Accumulated Depreciation",71.43,"",7390514.05
,"General Journal","10-11-2024","25836",,,"Office Seat 3 Depreciation","Expense","Depreciation Expense",,"Accumulated Depreciation",71.43,"",7390585.48
,"General Journal","10-11-2024","25838",,,"Reverse Osmosis Unit 1 Depreciation","Expense","Depreciation Expense",,"Accumulated Depreciation",416.67,"",7391002.15
,"General Journal","10-11-2024","25839",,,"Steam Generator SG24 Depreciation","Expense","Depreciation Expense",,"Accumulated Depreciation",3794.53,"",7394796.68
,"General Journal","10-11-2024","25842",,,"Toilet Cleaner Mixing Machine Depreciation","Expense","Depreciation Expense",,"Accumulated Depreciation",6333.33,"",7401130.01
,"General Journal","11-11-2024","25810",,,"4 GB hard drive for CCTV Depreciation","Expense","Depreciation Expense",,"Accumulated Depreciation",178.57,"",7401308.58
,"General Journal","11-11-2024","25811",,,"4TB Hard Disk Depreciation","Expense","Depreciation Expense",,"Accumulated Depreciation",178.57,"",7401487.15
,"General Journal","11-11-2024","25815","*","Unilever Kenya Ltd:Sunlight Washing Pwd","Chain block trolley 4 depreciation","Expense","Depreciation Expense",,"Accumulated Depreciation",85.00,"",7401572.15
,"General Journal","11-11-2024","25816",,,"Coder Depreciation","Expense","Depreciation Expense",,"Accumulated Depreciation",2261.90,"",7403834.05
,"General Journal","11-11-2024","25817",,,"Coder Stand Depreciation","Expense","Depreciation Expense",,"Accumulated Depreciation",59.52,"",7403893.57
,"General Journal","11-11-2024","25818",,,"Compressor 1 depreciation","Expense","Depreciation Expense",,"Accumulated depreciation",3750.00,"",7407643.57
,"General Journal","11-11-2024","25828",,,"HP Laptop 14 Depreciation","Expense","Depreciation Expense",,"Accumulated Depreciation",1941.67,"",7409585.24
,"General Journal","11-11-2024","25829",,,"HP Laptop 15 Depreciation","Expense","Depreciation Expense",,"Accumulated Depreciation",1750.00,"",7411335.24
,"General Journal","11-11-2024","25837",,,"Pallet truck 2 depreciation","Expense","Depreciation Expense",,"Accumulated depreciation",440.48,"",7411775.72
,"General Journal","11-11-2024","25840","*",,"Steam Label Shrink Tunnel Depreciation","Expense","Depreciation Expense",,"Accumulated  Depreciation",10952.38,"",7422728.10
,"General Journal","12-11-2024","25843",,,"Coder Housing Depreciation","Expense","Depreciation Expense",,"Accumulated Depreciation",80.36,"",7422808.46
,"General Journal","12-11-2024","25844",,,"Coding Conveyor Depreciation","Expense","Depreciation Expense",,"Accumulated Depreciation",476.19,"",7423284.65
,"General Journal","12-11-2024","25845",,,"Conveyor 2 Depreciation","Expense","Depreciation Expense",,"Accumulated  Depreciation",169.64,"",7423454.29
,"General Journal","12-11-2024","25846",,,"Eyewash Station 1 Depreciation","Expense","Depreciation Expense",,"Accumulated Depreciation",904.76,"",7424359.05
,"General Journal","12-11-2024","25847",,,"HP Laptop 5 Depreciation","Expense","Depreciation Expense",,"Accumulated Depreciation",416.67,"",7424775.72
,"General Journal","12-11-2024","25848",,,"Tea maker Depreciation","Expense","Depreciation Expense",,"Accumulated Depreciation",225.00,"",7425000.72
,"General Journal","13-11-2024","25849",,,"Alarm System Depreciation","Expense","Depreciation Expense",,"Accumulated Depreciation",580.95,"",7425581.67
,"General Journal","13-11-2024","25850",,,"Bosch Blower 2 Depreciation","Expense","Depreciation Expense",,"Accumulated Depreciation",136.49,"",7425718.16
,"General Journal","13-11-2024","25851",,,"Coder UPS 8 Depreciation","Expense","Depreciation Expense",,"Accumulated Depreciation",81.67,"",7425799.83
,"General Journal","13-11-2024","25852","*",,"HP Laptop 16 Depreciation","Expense","Depreciation Expense",,"Accumulated Depreciation",1000.00,"",7426799.83
,"General Journal","13-11-2024","25853",,,"HP Mini Desktop 4 Depreciation","Expense","Depreciation Expense",,"Accumulated Depreciation",466.67,"",7427266.50
,"General Journal","13-11-2024","25854",,,"PIR system extension Depreciation","Expense","Depreciation Expense",,"Accumulated Depreciation",254.67,"",7427521.17
,"General Journal","13-11-2024","25855",,,"Process Water Storage Tank Depreciation","Expense","Depreciation Expense",,"Accumulated Depreciation",1065.16,"",7428586.33
,"General Journal","13-11-2024","25856","*",,"Store Racking 3 FG Depreciation","Expense","Depreciation Expense",,"Accumulated Depreciation",9791.67,"",7438378.00
,"General Journal","13-11-2024","25857",,,"Weighing scale 1","Expense","Depreciation Expense",,"Accumulated Depreciation",559.52,"",7438937.52
,"General Journal","14-11-2024","25858",,,"Motor Vehicle 2 Depreciation","Expense","Depreciation Expense",,"Accumulated Depreciation",10297.62,"",7449235.14
,"General Journal","14-11-2024","25859",,,"Paste Packing Machine Depreciation","Expense","Depreciation Expense",,"Accumulated Depreciation",4166.67,"",7453401.81
,"General Journal","14-11-2024","25860",,,"Table Top Scale 10  SS 15Kg Depreciation","Expense","Depreciation Expense",,"Accumulated Depreciation",297.62,"",7453699.43
,"General Journal","15-11-2024","25861",,,"150KVA Enclosed Genset Depreciation","Expense","Depreciation Expense",,"Accumulated Depreciation",24404.76,"",7478104.19
,"General Journal","15-11-2024","25862",,,"20Kg Forklift Gas Cylinder 2 Depreciation","Expense","Depreciation Expense",,"Accumulated Depreciation",769.70,"",7478873.89
,"General Journal","15-11-2024","25863",,,"2Ton Electric Hoist 1 Depreciation","Expense","Depreciation Expense",,"Accumulated Depreciation",3708.33,"",7482582.22
,"General Journal","15-11-2024","25864",,,"Automatic Change Over Switch 1 Depreciation","Expense","Depreciation Expense",,"Accumulated Depreciation",1666.67,"",7484248.89
,"General Journal","15-11-2024","25865",,,"Bench top Weighing Scale 1 Depreciation","Expense","Depreciation Expense",,"Accumulated Depreciation",357.14,"",7484606.03
,"General Journal","15-11-2024","25866",,,"Bench top Weighing Scale 2 Depreciation","Expense","Depreciation Expense",,"Accumulated Depreciation",357.14,"",7484963.17
,"General Journal","15-11-2024","25867",,,"Bench top Weighing Scale 3 Depreciation","Expense","Depreciation Expense",,"Accumulated Depreciation",357.14,"",7485320.31
,"General Journal","15-11-2024","25868",,,"Bench top Weighing Scale 4 Depreciation","Expense","Depreciation Expense",,"Accumulated Depreciation",357.14,"",7485677.45
,"General Journal","15-11-2024","25869",,,"Bosch Blower Depreciation","Expense","Depreciation Expense",,"Accumulated Depreciation",129.31,"",7485806.76
,"General Journal","15-11-2024","25870",,,"Canteen Chair 1 Depreciation","Expense","Depreciation Expense",,"Accumulated Depreciation",6.12,"",7485812.88
,"General Journal","15-11-2024","25871",,,"Canteen Chair 10 Depreciation","Expense","Depreciation Expense",,"Accumulated Depreciation",6.12,"",7485819.00
,"General Journal","15-11-2024","25872",,,"Canteen Chair 11 Depreciation","Expense","Depreciation Expense",,"Accumulated Depreciation",6.12,"",7485825.12
,"General Journal","15-11-2024","25873",,,"Canteen Chair 11 Depreciation","Expense","Depreciation Expense",,"Accumulated Depreciation",6.12,"",7485831.24
,"General Journal","15-11-2024","25874",,,"Canteen Chair 12 Depreciation","Expense","Depreciation Expense",,"Accumulated Depreciation",6.12,"",7485837.36
,"General Journal","15-11-2024","25875",,,"Canteen Chair 13 Depreciation","Expense","Depreciation Expense",,"Accumulated Depreciation",6.12,"",7485843.48
,"General Journal","15-11-2024","25876",,,"Canteen Chair 14 Depreciation","Expense","Depreciation Expense",,"Accumulated Depreciation",6.12,"",7485849.60
,"General Journal","15-11-2024","25877",,,"Canteen Chair 15 Depreciation","Expense","Depreciation Expense",,"Accumulated Depreciation",6.12,"",7485855.72
,"General Journal","15-11-2024","25878",,,"Canteen Chair 16 Depreciation","Expense","Depreciation Expense",,"Accumulated Depreciation",6.12,"",7485861.84
,"General Journal","15-11-2024","25879",,,"Canteen Chair 17 Depreciation","Expense","Depreciation Expense",,"Accumulated Depreciation",6.12,"",7485867.96
,"General Journal","15-11-2024","25880",,,"Canteen Chair 18 Depreciation","Expense","Depreciation Expense",,"Accumulated Depreciation",6.12,"",7485874.08
,"General Journal","15-11-2024","25881",,,"Canteen Chair 19 Depreciation","Expense","Depreciation Expense",,"Accumulated Depreciation",6.12,"",7485880.20
,"General Journal","15-11-2024","25882",,,"Canteen Chair 2 Depreciation","Expense","Depreciation Expense",,"Accumulated Depreciation",6.12,"",7485886.32
,"General Journal","15-11-2024","25883",,,"Canteen Chair 21 Depreciation","Expense","Depreciation Expense",,"Accumulated Depreciation",6.12,"",7485892.44
,"General Journal","15-11-2024","25884",,,"Canteen Chair 22 Depreciation","Expense","Depreciation Expense",,"Accumulated Depreciation",6.12,"",7485898.56
,"General Journal","15-11-2024","25885",,,"Canteen Chair 23 Depreciation","Expense","Depreciation Expense",,"Accumulated Depreciation",6.12,"",7485904.68
,"General Journal","15-11-2024","25886",,,"Canteen Chair 24 Depreciation","Expense","Depreciation Expense",,"Accumulated Depreciation",6.12,"",7485910.80
,"General Journal","15-11-2024","25887",,,"Canteen Chair 25 Depreciation","Expense","Depreciation Expense",,"Accumulated Depreciation",6.12,"",7485916.92
,"General Journal","15-11-2024","25888",,,"Canteen Chair 3 Depreciation","Expense","Depreciation Expense",,"Accumulated Depreciation",6.12,"",7485923.04
,"General Journal","15-11-2024","25889",,,"Canteen Chair 4 Depreciation","Expense","Depreciation Expense",,"Accumulated Depreciation",6.12,"",7485929.16
,"General Journal","15-11-2024","25890",,,"Canteen Chair 5 Depreciation","Expense","Depreciation Expense",,"Accumulated Depreciation",6.12,"",7485935.28
,"General Journal","15-11-2024","25891",,,"Canteen Chair 6 Depreciation","Expense","Depreciation Expense",,"Accumulated Depreciation",6.12,"",7485941.40
,"General Journal","15-11-2024","25892",,,"Canteen Chair 7 Depreciation","Expense","Depreciation Expense",,"Accumulated Depreciation",6.12,"",7485947.52
,"General Journal","15-11-2024","25893",,,"Canteen Chair 8 Depreciation","Expense","Depreciation Expense",,"Accumulated Depreciation",6.12,"",7485953.64
,"General Journal","15-11-2024","25894",,,"Canteen Chair 9 Depreciation","Expense","Depreciation Expense",,"Accumulated Depreciation",6.12,"",7485959.76
,"General Journal","15-11-2024","25895",,,"EOL Case sealer Outfeed Conveyor Depreciation","Expense","Depreciation Expense",,"Accumulated Depreciation",297.62,"",7486257.38
,"General Journal","15-11-2024","25896",,,"Epson L6190 Printer 1 Depreciation","Expense","Depreciation Expense",,"Accumulated Depreciation",654.76,"",7486912.14
,"General Journal","15-11-2024","25897",,,"Fire Extinguisher 6 Depreciation","Expense","Depreciation Expense",,"Accumulated Depreciation",77.38,"",7486989.52
,"General Journal","15-11-2024","25898",,,"Grinder 2 Depreciation","Expense","Depreciation Expense",,"Accumulated Depreciation",178.57,"",7487168.09
,"General Journal","15-11-2024","25899",,,"HP Laptop 11 Depreciation","Expense","Depreciation Expense",,"Accumulated Depreciation",1200.00,"",7488368.09
,"General Journal","15-11-2024","25900",,,"HP Laptop 12 Depreciation","Expense","Depreciation Expense",,"Accumulated Depreciation",1200.00,"",7489568.09
,"General Journal","15-11-2024","25901",,,"Microwave 2 Depreciation","Expense","Depreciation Expense",,"Accumulated Depreciation",147.27,"",7489715.36
,"General Journal","15-11-2024","25902",,,"Mobile phone 3 Depreciation","Expense","Depreciation Expense",,"Accumulated Depreciation",41.67,"",7489757.03
,"General Journal","15-11-2024","25903",,,"Movable Ladder 1 Depreciation","Expense","Depreciation Expense",,"Accumulated Depreciation",434.52,"",7490191.55
,"General Journal","15-11-2024","25904",,,"UV water purifier 3 Depreciation","Expense","Depreciation Expense",,"Accumulated Depreciation",543.10,"",7490734.65
,"General Journal","15-11-2024","25905",,,"Water tank 6 Depreciation","Expense","Depreciation Expense",,"Accumulated Depreciation",71.84,"",7490806.49
,"General Journal","16-11-2024","25909",,,"Bosch Grinder 3 Depreciation","Expense","Depreciation Expense",,"Accumulated Depreceiation",86.21,"",7490892.70
,"General Journal","16-11-2024","25911",,,"Chain block 5 depreciation","Expense","Depreciation Expense",,"Accumulated Depreciation",292.49,"",7491185.19
,"General Journal","16-11-2024","25912",,,"Chain block 6 depreciation","Expense","Depreciation Expense",,"Accumulated Depreciation",292.49,"",7491477.68
,"General Journal","16-11-2024","25920",,,"Heat Gun Total 1 Depreciation","Expense","Depreciation Expense",,"Accumulated Depreciation",64.66,"",7491542.34
,"General Journal","16-11-2024","25926",,,"Linx 5900 Coder 1 Depreciation","Expense","Depreciation Expense",,"Accumulated Depreciation",4166.67,"",7495709.01
,"General Journal","16-11-2024","25938",,,"Table Top Scale 11 6Kg Depreciation","Expense","Depreciation Expense",,"Accumulated Depreciation",277.09,"",7495986.10
,"General Journal","16-11-2024","25942",,,"Washing Machine 1 Depreciation","Expense","Depreciation Expense",,"Accumulated Depreciation",2640.01,"",7498626.11
,"General Journal","17-11-2024","25906",,,"2T Mixer Depreciation","Expense","Depreciation Expense",,"Accumulated Depreciation",12633.99,"",7511260.10
,"General Journal","17-11-2024","25907",,,"2T Mixer Installation Depreciation","Expense","Depreciation Expense",,"Accumulated Depreciation",29713.15,"",7540973.25
,"General Journal","17-11-2024","25913",,,"Coder UPS 6 Depreciation","Expense","Depreciation Expense",,"Accumulated Depreciation",94.83,"",7541068.08
,"General Journal","17-11-2024","25914",,,"Coder UPS 7 Depreciation","Expense","Depreciation Expense",,"Accumulated Depreciation",94.83,"",7541162.91
,"General Journal","17-11-2024","25919","*",,"Hand Dryer 1 Depreciation","Expense","Depreciation Expense",,"Accumulated Depreciation",46.18,"",7541209.09
,"General Journal","17-11-2024","25921","*",,"HP Laptop 3 Depreciation","Expense","Depreciation Expense",,"Accumulated Depreciation",297.62,"",7541506.71
,"General Journal","17-11-2024","25927",,,"Office desks  4","Expense","Depreciation Expense",,"Accumulated Depreciation",361.90,"",7541868.61
,"General Journal","17-11-2024","25929",,,"Pallet truck 4 Depreciation","Expense","Depreciation Expense",,"Accumulated Depreciation",428.57,"",7542297.18
,"General Journal","17-11-2024","25930",,,"Pallet truck 5 Depreciation","Expense","Depreciation Expense",,"Accumulated Depreciation",428.57,"",7542725.75
,"General Journal","17-11-2024","25931",,,"Pouch Packing Machine 2 Accumulated depreciation","Expense","Depreciation Expense",,"Accumulated Depreciation",976.19,"",7543701.94
,"General Journal","17-11-2024","25932",,,"Recirculation Pump Depreciation","Expense","Depreciation Expense",,"Accumulated  Depreciation",71.19,"",7543773.13
,"General Journal","17-11-2024","25933",,,"Server 1 Depreciation","Expense","Depreciation Expense",,"Accumulated Depreciation",357.14,"",7544130.27
,"General Journal","17-11-2024","25934",,,"Server Monitor Depreciation","Expense","Depreciation Expense",,"Accumulated Depreciaion",107.14,"",7544237.41
,"General Journal","17-11-2024","25935",,,"Shrink Tunnel Depreciation","Expense","Depreciation Expense",,"Accumulated Depreciation",3750.00,"",7547987.41
,"General Journal","17-11-2024","25936","*",,"Soap Dispenser 1 Depreciation","Expense","Depreciation Expense",,"Accumulated Depreciation",15.39,"",7548002.80
,"General Journal","17-11-2024","25939","*",,"TP Link 3 Depreciation","Expense","Depreciation Expense",,"Accumulated Depreciation",33.33,"",7548036.13
,"General Journal","17-11-2024","25943","*",,"Water Tank 3 Depreciation","Expense","Depreciation Expense",,"Accumulated Depreciation",123.15,"",7548159.28
,"General Journal","18-11-2024","25908",,,"Board room chair 3 Depreciation","Expense","Depreciation Expense",,"Accumulated Depreciation",59.52,"",7548218.80
,"General Journal","18-11-2024","25910",,,"Carton Sealer Manual 1 Depreciation","Expense","Depreciation Expense",,"Accumulated Depreciation",14.80,"",7548233.60
,"General Journal","18-11-2024","25915",,,"Compressor 3 Depreciation","Expense","Depreciation Expense",,"Accumulated Depreciation",5357.14,"",7553590.74
,"General Journal","18-11-2024","25916",,,"Compressor room depreciation","Expense","Depreciation Expense",,"Accumulated depreciation",132.44,"",7553723.18
,"General Journal","18-11-2024","25917",,,"Electric Hoist 1 depreciation","Expense","Depreciation Expense",,"Accumulated depreciation",3452.38,"",7557175.56
,"General Journal","18-11-2024","25918",,,"Gents changing room Lockers Depreciation","Expense","Depreciation Expense",,"Accumulated Depreciation",386.90,"",7557562.46
,"General Journal","18-11-2024","25922",,,"HP Mini Desktop 1 Depreciation","Expense","Depreciation Expense",,"Accumulated Depreciation",733.33,"",7558295.79
,"General Journal","18-11-2024","25923",,,"HP Mini Desktop 2 Depreciation","Expense","Depreciation Expense",,"Accumulated Depreciation",733.33,"",7559029.12
,"General Journal","18-11-2024","25924",,,"HP Mini Desktop 3 Depreciation","Expense","Depreciation Expense",,"Accumulated Depreciation",733.33,"",7559762.45
,"General Journal","18-11-2024","25925",,,"Ladies changing room Lockers Depreciation","Expense","Depreciation Expense",,"Accumulated Depreciation",411.90,"",7560174.35
,"General Journal","18-11-2024","25928",,,"Omrom M1 Basic BP Monitor Depreciation","Expense","Depreciation Expense",,"Accumulated Depreciation",58.33,"",7560232.68
,"General Journal","18-11-2024","25937",,,"SS Hand Washing Station 1 Depreciation","Expense","Depreciation Expense",,"Accumulated Depreciation",690.48,"",7560923.16
,"General Journal","18-11-2024","25940",,,"TV Screen 3 Depreciation","Expense","Depreciation Expense",,"Accumulated Depreciation",316.67,"",7561239.83
,"General Journal","18-11-2024","25941",,,"TV Screen 4 Depreciation","Expense","Depreciation Expense",,"Accumulated Depreciation",1550.00,"",7562789.83
,"General Journal","19-11-2024","25944",,,"3T Gas Forklift 1 Depreciation","Expense","Depreciation Expense",,"Accumulated Depreciation",30952.38,"",7593742.21
,"General Journal","19-11-2024","25945",,,"Coding Stamp 3 Depreciation","Expense","Depreciation Expense",,"Accumulated Depreciation",143.68,"",7593885.89
,"General Journal","19-11-2024","25946",,,"Office Stamp 2 Depreciation","Expense","Depreciation Expense",,"Accumulated Depreciaion",30.83,"",7593916.72
,"General Journal","20-11-2024","25947","*","Unilever Kenya Ltd:Sunlight Washing Pwd","Boato Commisioning Depreciation","Expense","Depreciation Expense",,"Accumulated Depreciation",889.88,"",7594806.60
,"General Journal","20-11-2024","25948",,,"Bosch Blower 3 Depreciation","Expense","Depreciation Expense",,"Accumulated Depreciation",79.02,"",7594885.62
,"General Journal","20-11-2024","25949",,,"Bosch Blower 4 Depreciation","Expense","Depreciation Expense",,"Accumulated Depreciation",136.49,"",7595022.11
,"General Journal","20-11-2024","25950",,,"Bosch Blower 5 Depreciation","Expense","Depreciation Expense",,"Accumulated Depreciation",136.49,"",7595158.60
,"General Journal","20-11-2024","25951",,,"Conference Office Desk 1 Depreciation","Expense","Depreciation Expense",,"Accumulated Depreciation",416.67,"",7595575.27
,"General Journal","20-11-2024","25952",,,"Floor Chair 17 depreciation","Expense","Depreciation Expense",,"Accumulated Depreciation",20.24,"",7595595.51
,"General Journal","20-11-2024","25953",,,"Floor Chair 18 depreciation","Expense","Depreciation Expense",,"Accumulated Depreciation",20.24,"",7595615.75
,"General Journal","20-11-2024","25954",,,"Floor Chair 19 depreciation","Expense","Depreciation Expense",,"Accumulated Depreciation",20.24,"",7595635.99
,"General Journal","20-11-2024","25955",,,"Floor Chair 20 depreciation","Expense","Depreciation Expense",,"Accumulated Depreciation",20.24,"",7595656.23
,"General Journal","20-11-2024","25956",,,"Heat Gun CAT Digital 1 Depreciation","Expense","Depreciation Expense",,"Accumulated Depreciation",136.49,"",7595792.72
,"General Journal","20-11-2024","25957","*",,"Lumnia 1 Pro Insect Trap Depreciation","Expense","Depreciation Expense",,"Accumulated Depreciation",316.67,"",7596109.39
,"General Journal","20-11-2024","25959",,,"PF Correction Unit Depreciation","Expense","Depreciation Expense",,"Accumulated Depreciation",1708.33,"",7597817.72
,"General Journal","21-11-2024","25960",,,"5Kg CO2 Fire Extinguisher 2 Depreciation","Expense","Depreciation Expense",,"Accumulated Depreciation",73.81,"",7597891.53
,"General Journal","21-11-2024","25961",,,"6Kg Dry Pwd Fire Extinguisher 1 Depreciaiton","Expense","Depreciation Expense",,"Accumulated Depreciation",59.52,"",7597951.05
,"General Journal","21-11-2024","25962",,,"Board room chair 1 Depreciation","Expense","Depreciation Expense",,"Accumulated Depreciation",59.52,"",7598010.57
,"General Journal","21-11-2024","25963",,,"Board room chair 2 Depreciation","Expense","Depreciation Expense",,"Accumulated Depreciation",59.52,"",7598070.09
,"General Journal","21-11-2024","25964",,,"Board room chair 4 Depreciation","Expense","Depreciation Expense",,"Accumulated Depreciation",59.52,"",7598129.61
,"General Journal","21-11-2024","25965",,,"Board room chair 5 Depreciation","Expense","Depreciation Expense",,"Accumulated Depreciation",59.52,"",7598189.13
,"General Journal","21-11-2024","25966",,,"Board room chair 6 Depreciation","Expense","Depreciation Expense",,"Accumulated Depreciation",59.52,"",7598248.65
,"General Journal","21-11-2024","25967",,,"Board room chair 7 Depreciation","Expense","Depreciation Expense",,"Accumulated Depreciation",59.52,"",7598308.17
,"General Journal","21-11-2024","25968",,,"Board room chair 8 Depreciation","Expense","Depreciation Expense",,"Accumulated Depreciation",59.52,"",7598367.69
,"General Journal","21-11-2024","25969",,,"Coding Stamp 2 Depreciation","Expense","Depreciation Expense",,"Accumulated Depreciation",133.33,"",7598501.02
,"General Journal","21-11-2024","25970",,,"IBC Tank 1 Depreciation","Expense","Depreciation Expense",,"Accumulated Depreciation",41.67,"",7598542.69
,"General Journal","21-11-2024","25971",,,"Empty IBC Tank 2 Depreciation","Expense","Depreciation Expense",,"Accumulated Depreciation",65.48,"",7598608.17
,"General Journal","21-11-2024","25972",,,"FFS Filling Machine 300 1 Depreciation","Expense","Depreciation Expense",,"Accumulated Depreciation",11850.01,"",7610458.18
,"General Journal","21-11-2024","25973",,,"Laboratory Oven & Dessicator  Depreciation","Expense","Depreciation Expense",,"Accumulated Depreciation",766.67,"",7611224.85
,"General Journal","21-11-2024","25974",,,"Tea Urn Depreciation","Expense","Depreciation Expense",,"Accumulated Depreciation",121.67,"",7611346.52
,"General Journal","22-11-2024","25975",,,"6Kg Auto Fire Extinguisher 1 Depreciation","Expense","Depreciation Expense",,"Accumulated Depreciation",53.57,"",7611400.09
,"General Journal","22-11-2024","25976",,,"6Kg Auto Fire Extinguisher 2 Depreciation","Expense","Depreciation Expense",,"Accumulated Depreciation",53.57,"",7611453.66
,"General Journal","22-11-2024","25977","*",,"AVS Voltage Stabilizer Depreciation","Expense","Depreciation Expense",,"Accumulated Depreciation",63.10,"",7611516.76
,"General Journal","22-11-2024","25978",,,"Conveyor Belt Green 1 Depreciation","Expense","Depreciation Expense",,"Accumulated Depreciation",82.14,"",7611598.90
,"General Journal","22-11-2024","25979",,,"HP Laptop 13 Depreciation","Expense","Depreciation Expense",,"Accumulated Depreciation",1200.00,"",7612798.90
,"General Journal","22-11-2024","25980","*",,"HP Laptop 7 Depreciation","Expense","Depreciation Expense",,"Accumulated Depreciation",1200.00,"",7613998.90
,"General Journal","22-11-2024","25981",,,"Office Desk 5 Depreciation","Expense","Depreciation Expense",,"Accumulated Depreciation",180.95,"",7614179.85
,"General Journal","22-11-2024","25982",,,"Office cabinets depreciation","Expense","Depreciation Expense",,"Accumulated Depreciation",119.05,"",7614298.90
,"General Journal","22-11-2024","25983",,,"Platform Scale 2 SS 100Kg Depreciation","Expense","Depreciation Expense",,"Accumulated Depreciation",339.29,"",7614638.19
,"General Journal","22-11-2024","25984",,,"Solar Water Heater 300L Depreciation","Expense","Depreciation Expense",,"Accumulated Depreciation",3125.00,"",7617763.19
,"General Journal","23-11-2024","25985",,,"Analytical Balance Depreciation","Expense","Depreciation Expense",,"Accumulated Depreciation",2405.58,"",7620168.77
,"General Journal","23-11-2024","25986",,,"Auger Filler 1 Depreciation","Expense","Depreciation Expense",,"Accumulated Depreciation",7220.12,"",7627388.89
,"General Journal","23-11-2024","25987",,,"Auger Filler 2 Depreciation","Expense","Depreciation Expense",,"Accumulated Depreciation",13258.63,"",7640647.52
,"General Journal","23-11-2024","25988",,,"Auger Filler 3 Depreciation","Expense","Depreciation Expense",,"Accumulated Depreciation",11788.69,"",7652436.21
,"General Journal","23-11-2024","25989",,,"Bajaj Boxer BM150 UG Depreciation","Expense","Depreciation Expense",,"Accumulated Depreciation",1539.41,"",7653975.62
,"General Journal","23-11-2024","25990",,,"Chain block 4 depreciation","Expense","Depreciation Expense",,"Accumulated Depreciation",133.42,"",7654109.04
,"General Journal","23-11-2024","25991",,,"Coder UPS Depreciation","Expense","Depreciation Expense",,"Accumulated Depreciation",95.24,"",7654204.28
,"General Journal","23-11-2024","25992",,,"Dust Extractor 1 Depreciation","Expense","Depreciation Expense",,"Accumulated Depreciation",446.43,"",7654650.71
,"General Journal","23-11-2024","25993",,,"Dust Extractor 2 Depreciation","Expense","Depreciation Expense",,"Accumulated Depreciation",446.43,"",7655097.14
,"General Journal","23-11-2024","25994",,,"Filler 1 Geared Motor & Feeding System Depreciation","Expense","Depreciation Expense",,"Accumulated Depreciation",333.33,"",7655430.47
,"General Journal","23-11-2024","25995",,,"Filler 2 Geared Motor & Feeding System Depreciation","Expense","Depreciation Expense",,"Accumulated Depreciation",348.72,"",7655779.19
,"General Journal","23-11-2024","25996",,,"Filler 3 Geared Motor & Feeding System Depreciation","Expense","Depreciation Expense",,"Accumulated Depreciation",347.52,"",7656126.71
,"General Journal","23-11-2024","25997",,,"Hotplate with Stirrer Depreciation","Expense","Depreciation Expense",,"Accumulated Depreciation",1785.71,"",7657912.42
,"General Journal","23-11-2024","25998",,,"Makita Hammer Drill Depreciation","Expense","Depreciation Expense",,"Accumulated Depreciation",205.25,"",7658117.67
,"General Journal","23-11-2024","25999",,,"Microwave 1 Depreciation","Expense","Depreciation Expense",,"Accumulated Depreciation",217.13,"",7658334.80
,"General Journal","23-11-2024","26000",,,"Pallet truck 3 Dep","Expense","Depreciation Expense",,"Accumulated Depreciation",510.95,"",7658845.75
,"General Journal","23-11-2024","26001",,,"Pouching Machine Depreciation","Expense","Depreciation Expense",,"Accumulated Depreciation",711.90,"",7659557.65
,"General Journal","23-11-2024","26002",,,"Power bank dep","Expense","Depreciation Expense",,"Accumulated Depreciation",119.05,"",7659676.70
,"General Journal","23-11-2024","26003",,,"Table Top Scale 11  SS 30Kg Depreciation","Expense","Depreciation Expense",,"Accumulated Depreciation",297.62,"",7659974.32
,"General Journal","23-11-2024","26004",,,"Table Top Scale 12  SS 30Kg Depreciation","Expense","Depreciation Expense",,"Accumulated Depreciation",297.62,"",7660271.94
,"General Journal","24-11-2024","26005",,,"Access Control Unit & System Depreciation","Expense","Depreciation Expense",,"Accumulated Depreciation",334.76,"",7660606.70
,"General Journal","24-11-2024","26008",,,"Electrical Enclosure Compressor Depreciation","Expense","Depreciation Expense",,"Accumulated Depreciation",125.00,"",7660731.70
,"General Journal","24-11-2024","26009",,,"ETR Machine Depreciation","Expense","Depreciation Expense",,"Accumulated Depreciation",236.04,"",7660967.74
,"General Journal","24-11-2024","26018",,,"Liquid Plant Depreciation","Expense","Depreciation Expense",,"Accumulated Deprecation",15029.76,"",7675997.50
,"General Journal","24-11-2024","26020",,,"Paste processing & packing line depreciation","Expense","Depreciation Expense",,"Accumulated Depreciation",17348.21,"",7693345.71
,"General Journal","24-11-2024","26021",,,"pH Meter Depreciation","Expense","Depreciation Expense",,"Accumulated Depreciation",741.39,"",7694087.10
,"General Journal","25-11-2024","26007",,,"Clamp Meter 1 Depreciation","Expense","Depreciation Expense",,"Accumulated Depreciation",36.90,"",7694124.00
,"General Journal","25-11-2024","26010",,,"Fire Alarm Sytstem Depreciation","Expense","Depreciation Expense",,"Accumulated Depreciation",728.57,"",7694852.57
,"General Journal","25-11-2024","26011",,,"Floor Chair 11 Depreciation","Expense","Depreciation Expense",,"Accumulated Depreciation",53.57,"",7694906.14
,"General Journal","25-11-2024","26012",,,"Floor Chair 12 Depreciation","Expense","Depreciation Expense",,"Accumulated Depreciation",53.57,"",7694959.71
,"General Journal","25-11-2024","26013",,,"Floor Chair 13 Depreciation","Expense","Depreciation Expense",,"Accumulated Depreciation",53.57,"",7695013.28
,"General Journal","25-11-2024","26014",,,"Floor Chair 14 Depreciation","Expense","Depreciation Expense",,"Accumulated Depreciation",53.57,"",7695066.85
,"General Journal","25-11-2024","26015",,,"Floor Chair 15 Depreciation","Expense","Depreciation Expense",,"Accumulated Depreciation",53.57,"",7695120.42
,"General Journal","25-11-2024","26016",,,"Floor Chair 16 Depreciation","Expense","Depreciation Expense",,"Accumulated Depreciation",53.57,"",7695173.99
,"General Journal","25-11-2024","26017",,,"Liquid Mixer 500Lt Depreciation","Expense","Depreciation Expense",,"Accumulated Depreciation",6172.62,"",7701346.61
,"General Journal","25-11-2024","26022",,,"Plastic Resin Mixer Depreciation","Expense","Depreciation Expense",,"Accumulated  Depreciation",1130.95,"",7702477.56
,"General Journal","25-11-2024","26023",,,"Plastic Resin Mixer Depreciation","Expense","Depreciation Expense",,"Accumulated  Depreciation",1130.95,"",7703608.51
,"General Journal","25-11-2024","26024",,,"Water tank 7 Depreciation","Expense","Depreciation Expense",,"Accumulated Depreciation",71.84,"",7703680.35
,"General Journal","26-11-2024","26025",,,"Grease Gun 1 Depreciation","Expense","Depreciation Expense",,"Accumulated Depreciation",73.21,"",7703753.56
,"General Journal","26-11-2024","26026",,,"Grease Gun 2 Depreciation","Expense","Depreciation Expense",,"Accumulated Depreciation",63.14,"",7703816.70
,"General Journal","26-11-2024","26027",,,"Retort Stand 1 Depreciation","Expense","Depreciation Expense",,"Accumulated Depreciation",10.71,"",7703827.41
,"General Journal","26-11-2024","26028",,,"Retort Stand 2 Depreciation","Expense","Depreciation Expense",,"Accumulated Depreciation",10.71,"",7703838.12
,"General Journal","26-11-2024","26029",,,"Tea Urn 2 Depreciation","Expense","Depreciation Expense",,"Accumulated Depreciation",180.00,"",7704018.12
,"General Journal","27-11-2024","26043",,,"Board room chair 10 Depreciation","Expense","Depreciation Expense",,"Accumulated Depreciation",79.55,"",7704097.67
,"General Journal","27-11-2024","26044",,,"Board room chair 11 Depreciation","Expense","Depreciation Expense",,"Accumulated Depreciation",79.55,"",7704177.22
,"General Journal","27-11-2024","26045",,,"Board room chair 12 Depreciation","Expense","Depreciation Expense",,"Accumulated Depreciation",79.55,"",7704256.77
,"General Journal","27-11-2024","26046",,,"Board room chair 13 Depreciation","Expense","Depreciation Expense",,"Accumulated Depreciation",79.55,"",7704336.32
,"General Journal","27-11-2024","26047",,,"Board room chair 14 Depreciation","Expense","Depreciation Expense",,"Accumulated Depreciation",79.55,"",7704415.87
,"General Journal","27-11-2024","26048",,,"Board room chair 15 Depreciation","Expense","Depreciation Expense",,"Accumulated Depreciation",79.55,"",7704495.42
,"General Journal","27-11-2024","26049",,,"Board room chair 16 Depreciation","Expense","Depreciation Expense",,"Accumulated Depreciation",79.55,"",7704574.97
,"General Journal","27-11-2024","26050",,,"Board room chair 17 Depreciation","Expense","Depreciation Expense",,"Accumulated Depreciation",79.55,"",7704654.52
,"General Journal","27-11-2024","26051",,,"Board room chair 18 Depreciation","Expense","Depreciation Expense",,"Accumulated Depreciation",79.55,"",7704734.07
,"General Journal","27-11-2024","26052",,,"Board room chair 19 Depreciation","Expense","Depreciation Expense",,"Accumulated Depreciation",79.55,"",7704813.62
,"General Journal","27-11-2024","26053",,,"Board room chair 9 Depreciation","Expense","Depreciation Expense",,"Accumulated Depreciation",79.55,"",7704893.17
,"General Journal","27-11-2024","26054",,,"Passenger Lift 1000kg Depreciation","Expense","Depreciation Expense",,"Accumulated Depreciation",44484.68,"",7749377.85
,"General Journal","28-11-2024","26055",,,"Heat Gun Bosch 2 Accumulated depreciation","Expense","Depreciation Expense",,"Accumulated Depreciation",75.43,"",7749453.28
,"General Journal","28-11-2024","26056",,,"Heat Gun Bosch 3 Accumulated depreciation","Expense","Depreciation Expense",,"Accumulated Depreciation",75.43,"",7749528.71
,"General Journal","30-11-2024","26057",,,"500gm Jar Blow Mould 3 depreciation","Expense","Depreciation Expense",,"Accumulated Depreciation",1026.79,"",7750555.50
,"General Journal","30-11-2024","26058",,,"500gm Jar Blow Mould 4 depreciation","Expense","Depreciation Expense",,"Accumulated Depreciation",1026.79,"",7751582.29
,"General Journal","30-11-2024","26059",,,"Air cooled chiller depeciation","Expense","Depreciation Expense",,"Accumulated  Depreciation",8916.67,"",7760498.96
,"General Journal","30-11-2024","26060","*","Unilever Kenya Ltd:Sunlight Washing Pwd","Boato Installation Depreciation","Expense","Depreciation Expense",,"Accumulated Depreciation",65114.38,"",7825613.34
,"General Journal","30-11-2024","26061","*",,"Canister Platform Depreciation","Expense","Depreciation Expense",,"Accumulated Depreciation",59246.67,"",7884860.01
,"General Journal","30-11-2024","26062",,,"CCTV DRV & System Depreciation","Expense","Depreciation Expense",,"Accumulated Depreciation",1295.33,"",7886155.34
,"General Journal","30-11-2024","26069",,,"Colour Pressure tank Depreciation","Expense","Depreciation Expense",,"Accumulated Depreciation",232.14,"",7886387.48
,"General Journal","30-11-2024","26070",,,"Compressed air gun Depreciation","Expense","Depreciation Expense",,"Accumulated Depreciation",47.62,"",7886435.10
,"General Journal","30-11-2024","26072",,,"Drum Pump 2 Depreciation","Expense","Depreciation Expense",,"Accumulated Depreciation",123.15,"",7886558.25
,"General Journal","30-11-2024","26073",,,"Extractor Fan down Depreciation","Expense","Depreciation Expense",,"Accumulated Depreciation",150.12,"",7886708.37
,"General Journal","30-11-2024","26074",,,"Extractor Fan Hoisting Depreciation","Expense","Depreciation Expense",,"Accumulated Depreciation",176.67,"",7886885.04
,"General Journal","30-11-2024","26075",,,"Extractor Fan Packaging Depreciation","Expense","Depreciation Expense",,"Accumulated Depreciation",150.12,"",7887035.16
,"General Journal","30-11-2024","26082",,,"Incotex Type C Control Unit Depreciation","Expense","Depreciation Expense",,"Accumulated Depreciation",1939.66,"",7888974.82
,"General Journal","30-11-2024","26083",,,"Lamination Machine 1 Depreciation","Expense","Depreciation Expense",,"Accumulated Depreciation",84.78,"",7889059.60
,"General Journal","30-11-2024","26085",,,"Office Cabinet 5 Depreciation","Expense","Depreciation Expense",,"Accumulated Depreciation",58.33,"",7889117.93
,"General Journal","30-11-2024","26086",,,"Office Desk 6 Depreciation","Expense","Depreciation Expense",,"Accumulated Depreciation",90.48,"",7889208.41
,"General Journal","30-11-2024","26087",,,"Office Desk 7 Depreciation","Expense","Depreciation Expense",,"Accumulated Depreciation",90.48,"",7889298.89
,"General Journal","30-11-2024","26088",,,"Office Desk 8 Depreciation","Expense","Depreciation Expense",,"Accumulated Depreciation",83.33,"",7889382.22
,"General Journal","30-11-2024","26089",,,"Platform Scale 4 tons 1 Depreciation","Expense","Depreciation Expense",,"Accumulated Depreciation",10782.43,"",7900164.65
,"General Journal","30-11-2024","26090",,,"Process Water Filtration System Depreciation","Expense","Depreciation Expense",,"Accumulated Depreciation",1785.71,"",7901950.36
,"General Journal","30-11-2024","26095",,,"Sulphonic Acid pressure tank Depreciation","Expense","Depreciation Expense",,"Accumulated Depreciation",110.48,"",7902060.84
,"General Journal","30-11-2024","26097",,,"Test Sieves 100 & 200 microns Depreciation","Expense","Depreciation Expense",,"Accumulated Depreciation",450.00,"",7902510.84
,"General Journal","30-11-2024","26099",,,"Wall mounted cabinet 1 Dep","Expense","Depreciation Expense",,"Accumulated Depreciation",107.14,"",7902617.98
,"General Journal","30-11-2024","26102",,,"Water tank 5 Depreciation","Expense","Depreciation Expense",,"Accumulated Depreciation",137.79,"",7902755.77
,"General Journal","01-12-2024","26077",,,"Hoisting Bucket 1 Depreciation","Expense","Depreciation Expense",,"Accumulated Depreciation",148.81,"",7902904.58
,"General Journal","01-12-2024","26078",,,"Hoisting Bucket 2 Dereciation","Expense","Depreciation Expense",,"Accumulated Depreciation",148.81,"",7903053.39
,"General Journal","01-12-2024","26084",,,"Lenovo Laptop 2 Depreciation","Expense","Depreciation Expense",,"Accumulated Depreciation",333.33,"",7903386.72
,"General Journal","01-12-2024","26091",,,"Processing Platform Depreciation","Expense","Depreciation Expense",,"Accumulated Depreciation",4880.95,"",7908267.67
,"General Journal","01-12-2024","26092",,,"Security and Computer Sytem UPS Depreciation","Expense","Depreciation Expense",,"Accumulated Depreciation",3584.50,"",7911852.17
,"General Journal","01-12-2024","26098",,,"Trophy Shelf 1 Depreciation","Expense","Depreciation Expense",,"Accumulated Depreciation",95.24,"",7911947.41
,"General Journal","01-12-2024","26101",,,"Water tank 4 Depreciation","Expense","Depreciation Expense",,"Accumulated Depreciation",453.24,"",7912400.65
,"General Journal","02-12-2024","26063",,,"CMPP 1kg Jar Blow Mould 1 Depreciation","Expense","Depreciation Expense",,"Accumulated Depreciation",3364.87,"",7915765.52
,"General Journal","02-12-2024","26064",,,"CMPP 1kg Jar Blow Mould 2 Depreciation","Expense","Depreciation Expense",,"Accumulated Depreciation",3364.87,"",7919130.39
,"General Journal","02-12-2024","26065",,,"CMPP 500gm Jar Blow Mould 1 Depreciation","Expense","Depreciation Expense",,"Accumulated Depreciation",2643.82,"",7921774.21
,"General Journal","02-12-2024","26066",,,"CMPP 500gm Jar Blow Mould 2 Depreciation","Expense","Depreciation Expense",,"Accumulated Depreciation",2643.82,"",7924418.03
,"General Journal","02-12-2024","26067",,,"CMPP Blow Moulding Machine 1 Depreciation","Expense","Depreciation Expense",,"Accumulated Depreciation",49344.71,"",7973762.74
,"General Journal","02-12-2024","26068",,,"CMPP Blow Moulding Machine 2 Depreciation","Expense","Depreciation Expense",,"Accumulated Depreciation",49344.71,"",8023107.45
,"General Journal","02-12-2024","26071",,,"Drum Pump 1 Depreiation","Expense","Depreciation Expense",,"Accumulated Depreciation",123.03,"",8023230.48
,"General Journal","02-12-2024","26076",,,"Heat Gun Bosch 1 Depreciation","Expense","Depreciation Expense",,"Accumulated Depreciation",100.57,"",8023331.05
,"General Journal","02-12-2024","26079",,,"Hot ProcessWater Storage Tank1  Depreciation","Expense","Depreciation Expense",,"Accumulated Depreciation",73.99,"",8023405.04
,"General Journal","02-12-2024","26080","*",,"HP Laptop 4 Depreciation","Expense","Depreciation Expense",,"Accumulated Depreciation",297.62,"",8023702.66
,"General Journal","02-12-2024","26081","*",,"HP Laptop 8 Depreciation","Expense","Depreciation Expense",,"Accumulated Depreciation",1200.00,"",8024902.66
,"General Journal","02-12-2024","26093",,,"Store Racking 1 depreciation","Expense","Depreciation Expense",,"Accumulated Depreciation",175.60,"",8025078.26
,"General Journal","02-12-2024","26094",,,"Store Racking 2 Depreciation","Expense","Depreciation Expense",,"Accumulated Depreciation",175.60,"",8025253.86
,"General Journal","02-12-2024","26096",,,"Tank platform Depreciation","Expense","Depreciation Expense",,"Accumulated Depreciation",130.95,"",8025384.81
,"General Journal","02-12-2024","26100",,,"Water tank 1 Depreciation","Expense","Depreciation Expense",,"Accumulated Depreciation",120.07,"",8025504.88
,"General Journal","02-12-2024","26103",,,"Workshop cabinet depreciation","Expense","Depreciation Expense",,"Accumulated Depreciation",172.02,"",8025676.90
,"General Journal","03-12-2024","26104",,,"Alarm System extension","Expense","Depreciation Expense",,"Accumulated Depreciation",602.38,"",8026279.28
,"General Journal","03-12-2024","26105",,,"Domestos sewing machine depreciation","Expense","Depreciation Expense",,"Acummulated depreciation",82.10,"",8026361.38
,"General Journal","03-12-2024","26106",,,"Bench Grinder 2 Depreciation","Expense","Depreciation Expense",,"Accumulated Depreceiation",100.57,"",8026461.95
,"General Journal","03-12-2024","26107",,,"Bosch Optical Level Gol 32D Depreciation","Expense","Depreciation Expense",,"Accumulated Depreciation",679.38,"",8027141.33
,"General Journal","03-12-2024","26108",,,"CCTV survellance System extension Depreciation","Expense","Depreciation Expense",,"Accumulated Depreciation",657.14,"",8027798.47
,"General Journal","03-12-2024","26109",,,"Electrical Enclosure CCTV Depreciation","Expense","Depreciation Expense",,"Accumulated Depreciation",126.19,"",8027924.66
,"General Journal","03-12-2024","26110",,,"Electrical Enclosure Main Depreciation","Expense","Depreciation Expense",,"Accumulated Depreciation",2339.29,"",8030263.95
,"General Journal","03-12-2024","26111",,,"Electrical Enclosure P Line Depreciation","Expense","Depreciation Expense",,"Accumulated Depreciation",428.57,"",8030692.52
,"General Journal","03-12-2024","26112",,,"Floodlight Depreciation","Expense","Depreciation Expense",,"Accumulated Depreciation",59.52,"",8030752.04
,"General Journal","03-12-2024","26113",,,"Office Desk 1 Depreciation","Expense","Depreciation Expense",,"Accumulated Depreciation",225.00,"",8030977.04
,"General Journal","03-12-2024","26114",,,"Office Desk 2 Depreciation","Expense","Depreciation Expense",,"Accumulated Depreciation",225.00,"",8031202.04
,"General Journal","03-12-2024","26115",,,"Office Desk 3 Depreciation","Expense","Depreciation Expense",,"Accumulated Depreciation",225.00,"",8031427.04
,"General Journal","03-12-2024","26116",,,"Signet ESD 1 Depreciation","Expense","Depreciation Expense",,"Accumulated Depreciation",928.57,"",8032355.61
,"General Journal","03-12-2024","26117","*",,"Sterling Water Dispenser 1 Depreciation","Expense","Depreciation Expense",,"Accumulated Depreciation",119.05,"",8032474.66
,"General Journal","03-12-2024","26118",,,"Table top Weighing Scale 5 Depreciation","Expense","Depreciation Expense",,"Accumulated Depreciation",248.57,"",8032723.23
,"General Journal","03-12-2024","26119",,,"Table top Weighing Scale 6 Depreciation","Expense","Depreciation Expense",,"Accumulated Depreciation",248.57,"",8032971.80
,"General Journal","03-12-2024","26120",,,"Table top Weighing Scale 7 Depreciation","Expense","Depreciation Expense",,"Accumulated Depreciation",248.57,"",8033220.37
,"General Journal","03-12-2024","26121",,,"Table top Weighing Scale 8 Depreciation","Expense","Depreciation Expense",,"Accumulated Depreciation",248.57,"",8033468.94
,"General Journal","03-12-2024","26122",,,"Table top Weighing Scale 9 Depreciation","Expense","Depreciation Expense",,"Accumulated Depreciation",248.57,"",8033717.51
,"General Journal","04-12-2024","26124",,,"9Kg Powder Fire Extinguisher 1 Depreciation","Expense","Depreciation Expense",,"Accumulated Depreciation",34.52,"",8033752.03
,"General Journal","04-12-2024","26125",,,"9Kg Powder Fire Extinguisher 2 Depreciation","Expense","Depreciation Expense",,"Accumulated Depreciation",34.52,"",8033786.55
,"General Journal","04-12-2024","26126",,,"9Kg Powder Fire Extinguisher 3 Depreciation","Expense","Depreciation Expense",,"Accumulated Depreciation",34.52,"",8033821.07
,"General Journal","04-12-2024","26127",,,"9Kg Powder Fire Extinguisher 5 Depreciation","Expense","Depreciation Expense",,"Accumulated Depreciation",34.52,"",8033855.59
,"General Journal","04-12-2024","26128",,,"Chiller 2 Depreciation","Expense","Depreciation Expense",,"Accumulated Depreciation",8035.71,"",8041891.30
,"General Journal","04-12-2024","26129",,,"Empty IBC Tank 10 Depreciation","Expense","Depreciation Expense",,"Accumulated Depreciation",41.67,"",8041932.97
,"General Journal","04-12-2024","26130",,,"Empty IBC Tank 3 Depreciation","Expense","Depreciation Expense",,"Accumulated Depreciation",65.48,"",8041998.45
,"General Journal","04-12-2024","26131",,,"Empty IBC Tank 4 Depreciation","Expense","Depreciation Expense",,"Accumulated Depreciation",65.48,"",8042063.93
,"General Journal","04-12-2024","26132",,,"Empty IBC Tank 5 Depreciation","Expense","Depreciation Expense",,"Accumulated Depreciation",65.48,"",8042129.41
,"General Journal","04-12-2024","26133",,,"Empty IBC Tank 6 Depreciation","Expense","Depreciation Expense",,"Accumulated Depreciation",65.48,"",8042194.89
,"General Journal","04-12-2024","26134",,,"Empty IBC Tank 7 Depreciation","Expense","Depreciation Expense",,"Accumulated Depreciation",41.67,"",8042236.56
,"General Journal","04-12-2024","26135",,,"Empty IBC Tank 8 Depreciation","Expense","Depreciation Expense",,"Accumulated Depreiation",41.67,"",8042278.23
,"General Journal","04-12-2024","26136",,,"Empty IBC Tank 9 Depreciation","Expense","Depreciation Expense",,"Accumulated Depreciation",41.67,"",8042319.90
,"General Journal","04-12-2024","26137",,,"Linx 8900 Coder 1 Depreciation","Expense","Depreciation Expense",,"Accumulated Depreciation",8333.33,"",8050653.23
,"General Journal","04-12-2024","26138",,,"Mobile Phone 2 Depreciation","Expense","Depreciation Expense",,"Accumulated Depreciation",46.67,"",8050699.90
,"General Journal","04-12-2024","26139",,,"Triple UV water purifier 1 Depreciation","Expense","Depreciation Expense",,"Accumulated Depreciation",296.22,"",8050996.12
,"General Journal","05-12-2024","26140",,,"1Kg Generic Jar Blow Mould 1 depreciation","Expense","Depreciation Expense",,"Accumulated Depreciation",1500.00,"",8052496.12
,"General Journal","05-12-2024","26141",,,"1Kg Generic Jar Blow Mould 2 depreciation","Expense","Depreciation Expense",,"Accumulated Depreciation",1500.00,"",8053996.12
,"General Journal","05-12-2024","26142",,,"500gm Generic Jar Blow Mould 1 depreciation","Expense","Depreciation Expense",,"Accumulated Depreciation",1071.43,"",8055067.55
,"General Journal","05-12-2024","26143",,,"500gm Generic Jar Blow Mould 2 depreciation","Expense","Depreciation Expense",,"Accumulated Depreciation",1071.43,"",8056138.98
,"General Journal","05-12-2024","26144",,,"9Kg Powder Fire Extinguisher 4 Depreciation","Expense","Depreciation Expense",,"Accumulated Depreciation",34.52,"",8056173.50
,"General Journal","05-12-2024","26145",,,"Extractor Fan 4 Depreciation","Expense","Depreciation Expense",,"Accumulated Depreciation",726.19,"",8056899.69
,"General Journal","05-12-2024","26146",,,"FFS  Machine Installation Elct Depreciation","Expense","Depreciation Expense",,"Accumulated Depreciation",200.60,"",8057100.29
,"General Journal","05-12-2024","26147",,,"First Aid Kit Depreciation","Expense","Depreciation Expense",,"Accumulated  Depreciation",77.38,"",8057177.67
,"General Journal","05-12-2024","26148",,,"Linx 8900 Coder 2 Depreciation","Expense","Depreciation Expense",,"Accumulated Depreciation",12500.00,"",8069677.67
,"General Journal","05-12-2024","26149",,,"Packing Platform Depreciation","Expense","Depreciation Expense",,"Accumulated Depreciation",5297.62,"",8074975.29
,"General Journal","05-12-2024","26150",,,"SS Industrial Turntable Depreciation","Expense","Depreciation Expense",,"Accumulated Depreciation",5238.10,"",8080213.39
,"General Journal","05-12-2024","26151",,,"TV Screen 2 Depreciation","Expense","Depreciation Expense",,"Accumulated Depreciation",950.00,"",8081163.39
,"General Journal","05-12-2024","26152",,,"Water Purifier 1 Depreciation","Expense","Depreciation Expense",,"Accumulated Depreciation",117.10,"",8081280.49
,"General Journal","06-12-2024","26154",,,"Blower Depreciation","Expense","Depreciation Expense",,"Accumulated Depreciation",59.52,"",8081340.01
,"General Journal","06-12-2024","26160",,,"Emergency Washing Point Depreciation","Expense","Depreciation Expense",,"Accumulated Deprecation",160.71,"",8081500.72
,"General Journal","06-12-2024","26162","*",,"Infrared Thermometre 1 Depreciation","Expense","Depreciation Expense",,"Accumulated Depreciation",416.67,"",8081917.39
,"General Journal","06-12-2024","26163",,,"Material's Trolley Depreciation","Expense","Depreciation Expense",,"Accumulated Depreciation",297.62,"",8082215.01
,"General Journal","06-12-2024","26167",,,"Plastic Scrap Grinder Machine Depreciation","Expense","Depreciation Expense",,"Accumulated  Depreciation",3452.38,"",8085667.39
,"General Journal","06-12-2024","26169",,,"Ribon Mixer SS depreciation","Expense","Depreciation Expense",,"Accumulated depreciation",4642.86,"",8090310.25
,"General Journal","06-12-2024","26170",,,"Telephone Handset Depreciation","Expense","Depreciation Expense",,"Accumulated Depreciation",29.76,"",8090340.01
,"General Journal","06-12-2024","26171",,,"Telkom Wifi Router Depreciation","Expense","Depreciation Expense",,"Accumulated Depreciation",71.43,"",8090411.44
,"General Journal","06-12-2024","26172",,,"Vacuum Cleaner Depreciation","Expense","Depreciation Expense",,"Accumulated Depreciation",148.81,"",8090560.25
,"General Journal","07-12-2024","26153",,,"9Kg Powder Fire Extinguisher 6 Depreciation","Expense","Depreciation Expense",,"Accumulated Depreciation",44.05,"",8090604.30
,"General Journal","07-12-2024","26155",,,"Cartoning table 4 depreciation","Expense","Depreciation Expense",,"Accumulated Depreciation",262.49,"",8090866.79
,"General Journal","07-12-2024","26156",,,"Case sealing table depreciation","Expense","Depreciation Expense",,"Accumulated Depreciation",86.67,"",8090953.46
,"General Journal","07-12-2024","26157",,,"Chain block 2 depreciation","Expense","Depreciation Expense",,"Accumulated depreciation",398.81,"",8091352.27
,"General Journal","07-12-2024","26158",,,"Chain block 3 depreciation","Expense","Depreciation Expense",,"Accumulated depreciation",398.81,"",8091751.08
,"General Journal","07-12-2024","26159",,,"Drilling machine Depreciation","Expense","Depreciation Expense",,"Accumulated Depreciation",88.39,"",8091839.47
,"General Journal","07-12-2024","26161",,,"Grinder Depreciation","Expense","Depreciation Expense",,"Acccumulated Depreciation",159.82,"",8091999.29
,"General Journal","07-12-2024","26164",,,"Packing table 1 depreciation","Expense","Depreciation Expense",,"Accumulated Depreciation",262.49,"",8092261.78
,"General Journal","07-12-2024","26165",,,"Packing table 2 depreciation","Expense","Depreciation Expense",,"Accumulated Depreciation",262.49,"",8092524.27
,"General Journal","07-12-2024","26166",,,"Packing table 3 depreciation","Expense","Depreciation Expense",,"Accumulated Depreciation",262.49,"",8092786.76
,"General Journal","07-12-2024","26168",,,"Quality table depreciation","Expense","Depreciation Expense",,"Accumulated Depreciation",86.67,"",8092873.43
,"General Journal","07-12-2024","26173",,,"Welding machine Depreciation","Expense","Depreciation Expense",,"Accumulated Depreciation",178.57,"",8093052.00
,"General Journal","08-12-2024","26177",,,"Bench Grinder 350W Depreciation","Expense","Depreciation Expense",,"Accumulated Depreciation",122.13,"",8093174.13
,"General Journal","08-12-2024","26195",,,"HP Laptop 6 Depreciation","Expense","Depreciation Expense",,"Accumulated Depreciation",416.67,"",8093590.80
,"General Journal","08-12-2024","26205",,,"Six step steel ladder 1 Depreciation","Expense","Depreciation Expense",,"Accumulated Depreciation",113.51,"",8093704.31
,"General Journal","09-12-2024","26178",,,"Canteen Table 1 Depreciation","Expense","Depreciation Expense",,"Accumulated Depreciation",184.52,"",8093888.83
,"General Journal","09-12-2024","26179",,,"Canteen Table 2 Depreciation","Expense","Depreciation Expense",,"Accumulated Depreciation",184.52,"",8094073.35
,"General Journal","09-12-2024","26184",,,"Dell Desktop 1 Depreciation","Expense","Depreciation Expense",,"Accumulated Depreciation",178.57,"",8094251.92
,"General Journal","09-12-2024","26185",,,"Fire Alarm System Extension'19 Depreciation","Expense","Depreciation Expense",,"Accumulated Depreciation",9857.14,"",8104109.06
,"General Journal","09-12-2024","26187",,,"Floor Chair 1 Depreciation","Expense","Depreciation Expense",,"Accumulated Depreciation",26.79,"",8104135.85
,"General Journal","09-12-2024","26188",,,"Floor Chair 2 Depreciation","Expense","Depreciation Expense",,"Accumulated Depreciation",26.79,"",8104162.64
,"General Journal","09-12-2024","26189",,,"Floor Chair 3 Depreciation","Expense","Depreciation Expense",,"Accumulated Depreciation",26.79,"",8104189.43
,"General Journal","09-12-2024","26190",,,"Floor Chair 4 Depreciation","Expense","Depreciation Expense",,"Accumulated Depreciation",26.79,"",8104216.22
,"General Journal","09-12-2024","26191",,,"Floor Chair 5 Depreciation","Expense","Depreciation Expense",,"Accumulated Depreciation",26.79,"",8104243.01
,"General Journal","09-12-2024","26197",,,"Lab Office Chair 1 Depreciation","Expense","Depreciation Expense",,"Accumulated Depreciation",47.62,"",8104290.63
,"General Journal","09-12-2024","26198",,,"Lab Office Chair 2 Depreciation","Expense","Depreciation Expense",,"Accumulated Depreciation",47.62,"",8104338.25
,"General Journal","09-12-2024","26199",,,"Lab Office Chair 3 Depreciation","Expense","Depreciation Expense",,"Accumulated Depreciation",47.62,"",8104385.87
,"General Journal","09-12-2024","26208","*","Unilever Kenya Ltd:Sunlight Washing Pwd","Sunlight Bag Closing Machine 1 Depreciation","Expense","Depreciation Expense",,"Accumulated Depreciation",738.10,"",8105123.97
,"General Journal","10-12-2024","26176",,,"5Kg Fire Extinguisher 1 Depreciation","Expense","Depreciation Expense",,"Accumulated Depreciation",65.48,"",8105189.45
,"General Journal","10-12-2024","26192",,,"HP Laptop 10 Depreciation","Expense","Depreciation Expense",,"Accumulated Depreciation",1200.00,"",8106389.45
,"General Journal","10-12-2024","26196",,,"HP Laptop 9 Depreciation","Expense","Depreciation Expense",,"Accumulated Depreciation",1200.00,"",8107589.45
,"General Journal","10-12-2024","26200",,,"Office Seat 1 Depreciation","Expense","Depreciation Expense",,"Accumulated Depreciation",142.86,"",8107732.31
,"General Journal","10-12-2024","26201",,,"Office Seat 2 Depreciation","Expense","Depreciation Expense",,"Accumulated Depreciation",71.43,"",8107803.74
,"General Journal","10-12-2024","26202",,,"Office Seat 3 Depreciation","Expense","Depreciation Expense",,"Accumulated Depreciation",71.43,"",8107875.17
,"General Journal","10-12-2024","26204",,,"Reverse Osmosis Unit 1 Depreciation","Expense","Depreciation Expense",,"Accumulated Depreciation",416.67,"",8108291.84
,"General Journal","10-12-2024","26206",,,"Steam Generator SG24 Depreciation","Expense","Depreciation Expense",,"Accumulated Depreciation",3794.53,"",8112086.37
,"General Journal","10-12-2024","26209",,,"Toilet Cleaner Mixing Machine Depreciation","Expense","Depreciation Expense",,"Accumulated Depreciation",6333.33,"",8118419.70
,"General Journal","11-12-2024","26174",,,"4 GB hard drive for CCTV Depreciation","Expense","Depreciation Expense",,"Accumulated Depreciation",178.57,"",8118598.27
,"General Journal","11-12-2024","26175",,,"4TB Hard Disk Depreciation","Expense","Depreciation Expense",,"Accumulated Depreciation",178.57,"",8118776.84
,"General Journal","11-12-2024","26180","*","Unilever Kenya Ltd:Sunlight Washing Pwd","Chain block trolley 4 depreciation","Expense","Depreciation Expense",,"Accumulated Depreciation",85.00,"",8118861.84
,"General Journal","11-12-2024","26181",,,"Coder Depreciation","Expense","Depreciation Expense",,"Accumulated Depreciation",2261.90,"",8121123.74
,"General Journal","11-12-2024","26182",,,"Coder Stand Depreciation","Expense","Depreciation Expense",,"Accumulated Depreciation",59.52,"",8121183.26
,"General Journal","11-12-2024","26183",,,"Compressor 1 depreciation","Expense","Depreciation Expense",,"Accumulated depreciation",3750.00,"",8124933.26
,"General Journal","11-12-2024","26193",,,"HP Laptop 14 Depreciation","Expense","Depreciation Expense",,"Accumulated Depreciation",1941.67,"",8126874.93
,"General Journal","11-12-2024","26194",,,"HP Laptop 15 Depreciation","Expense","Depreciation Expense",,"Accumulated Depreciation",1750.00,"",8128624.93
,"General Journal","11-12-2024","26203",,,"Pallet truck 2 depreciation","Expense","Depreciation Expense",,"Accumulated depreciation",440.48,"",8129065.41
,"General Journal","11-12-2024","26207","*",,"Steam Label Shrink Tunnel Depreciation","Expense","Depreciation Expense",,"Accumulated  Depreciation",10952.38,"",8140017.79
,"General Journal","12-12-2024","26246",,,"Coder Housing Depreciation","Expense","Depreciation Expense",,"Accumulated Depreciation",80.36,"",8140098.15
,"General Journal","12-12-2024","26248",,,"Coding Conveyor Depreciation","Expense","Depreciation Expense",,"Accumulated Depreciation",476.19,"",8140574.34
,"General Journal","12-12-2024","26249",,,"Conveyor 2 Depreciation","Expense","Depreciation Expense",,"Accumulated  Depreciation",169.64,"",8140743.98
,"General Journal","12-12-2024","26252",,,"Eyewash Station 1 Depreciation","Expense","Depreciation Expense",,"Accumulated Depreciation",904.76,"",8141648.74
,"General Journal","12-12-2024","26259",,,"HP Laptop 5 Depreciation","Expense","Depreciation Expense",,"Accumulated Depreciation",416.67,"",8142065.41
,"General Journal","12-12-2024","26272",,,"Tea maker Depreciation","Expense","Depreciation Expense",,"Accumulated Depreciation",225.00,"",8142290.41
,"General Journal","13-12-2024","26213",,,"Alarm System Depreciation","Expense","Depreciation Expense",,"Accumulated Depreciation",580.95,"",8142871.36
,"General Journal","13-12-2024","26216",,,"Bosch Blower 2 Depreciation","Expense","Depreciation Expense",,"Accumulated Depreciation",136.49,"",8143007.85
,"General Journal","13-12-2024","26247",,,"Coder UPS 8 Depreciation","Expense","Depreciation Expense",,"Accumulated Depreciation",81.67,"",8143089.52
,"General Journal","13-12-2024","26258","*",,"HP Laptop 16 Depreciation","Expense","Depreciation Expense",,"Accumulated Depreciation",1000.00,"",8144089.52
,"General Journal","13-12-2024","26260",,,"HP Mini Desktop 4 Depreciation","Expense","Depreciation Expense",,"Accumulated Depreciation",466.67,"",8144556.19
,"General Journal","13-12-2024","26267",,,"PIR system extension Depreciation","Expense","Depreciation Expense",,"Accumulated Depreciation",254.67,"",8144810.86
,"General Journal","13-12-2024","26268",,,"Process Water Storage Tank Depreciation","Expense","Depreciation Expense",,"Accumulated Depreciation",1065.16,"",8145876.02
,"General Journal","13-12-2024","26269","*",,"Store Racking 3 FG Depreciation","Expense","Depreciation Expense",,"Accumulated Depreciation",9791.67,"",8155667.69
,"General Journal","13-12-2024","26276",,,"Weighing scale 1","Expense","Depreciation Expense",,"Accumulated Depreciation",559.52,"",8156227.21
,"General Journal","14-12-2024","26264",,,"Motor Vehicle 2 Depreciation","Expense","Depreciation Expense",,"Accumulated Depreciation",10297.62,"",8166524.83
,"General Journal","14-12-2024","26266",,,"Paste Packing Machine Depreciation","Expense","Depreciation Expense",,"Accumulated Depreciation",4166.67,"",8170691.50
,"General Journal","14-12-2024","26270",,,"Table Top Scale 10  SS 15Kg Depreciation","Expense","Depreciation Expense",,"Accumulated Depreciation",297.62,"",8170989.12
,"General Journal","15-12-2024","26210",,,"150KVA Enclosed Genset Depreciation","Expense","Depreciation Expense",,"Accumulated Depreciation",24404.76,"",8195393.88
,"General Journal","15-12-2024","26211",,,"20Kg Forklift Gas Cylinder 2 Depreciation","Expense","Depreciation Expense",,"Accumulated Depreciation",769.70,"",8196163.58
,"General Journal","15-12-2024","26212",,,"2Ton Electric Hoist 1 Depreciation","Expense","Depreciation Expense",,"Accumulated Depreciation",3708.33,"",8199871.91
,"General Journal","15-12-2024","26214",,,"Automatic Change Over Switch 1 Depreciation","Expense","Depreciation Expense",,"Accumulated Depreciation",1666.67,"",8201538.58
,"General Journal","15-12-2024","26217",,,"Bosch Blower Depreciation","Expense","Depreciation Expense",,"Accumulated Depreciation",129.31,"",8201667.89
,"General Journal","15-12-2024","26219",,,"Canteen Chair 1 Depreciation","Expense","Depreciation Expense",,"Accumulated Depreciation",6.12,"",8201674.01
,"General Journal","15-12-2024","26220",,,"Canteen Chair 10 Depreciation","Expense","Depreciation Expense",,"Accumulated Depreciation",6.12,"",8201680.13
,"General Journal","15-12-2024","26221",,,"Canteen Chair 11 Depreciation","Expense","Depreciation Expense",,"Accumulated Depreciation",6.12,"",8201686.25
,"General Journal","15-12-2024","26222",,,"Canteen Chair 11 Depreciation","Expense","Depreciation Expense",,"Accumulated Depreciation",6.12,"",8201692.37
,"General Journal","15-12-2024","26223",,,"Canteen Chair 12 Depreciation","Expense","Depreciation Expense",,"Accumulated Depreciation",6.12,"",8201698.49
,"General Journal","15-12-2024","26224",,,"Canteen Chair 13 Depreciation","Expense","Depreciation Expense",,"Accumulated Depreciation",6.12,"",8201704.61
,"General Journal","15-12-2024","26225",,,"Canteen Chair 14 Depreciation","Expense","Depreciation Expense",,"Accumulated Depreciation",6.12,"",8201710.73
,"General Journal","15-12-2024","26226",,,"Canteen Chair 15 Depreciation","Expense","Depreciation Expense",,"Accumulated Depreciation",6.12,"",8201716.85
,"General Journal","15-12-2024","26227",,,"Canteen Chair 16 Depreciation","Expense","Depreciation Expense",,"Accumulated Depreciation",6.12,"",8201722.97
,"General Journal","15-12-2024","26228",,,"Canteen Chair 17 Depreciation","Expense","Depreciation Expense",,"Accumulated Depreciation",6.12,"",8201729.09
,"General Journal","15-12-2024","26229",,,"Canteen Chair 18 Depreciation","Expense","Depreciation Expense",,"Accumulated Depreciation",6.12,"",8201735.21
,"General Journal","15-12-2024","26230",,,"Canteen Chair 19 Depreciation","Expense","Depreciation Expense",,"Accumulated Depreciation",6.12,"",8201741.33
,"General Journal","15-12-2024","26231",,,"Canteen Chair 2 Depreciation","Expense","Depreciation Expense",,"Accumulated Depreciation",6.12,"",8201747.45
,"General Journal","15-12-2024","26232",,,"Canteen Chair 21 Depreciation","Expense","Depreciation Expense",,"Accumulated Depreciation",6.12,"",8201753.57
,"General Journal","15-12-2024","26233",,,"Canteen Chair 22 Depreciation","Expense","Depreciation Expense",,"Accumulated Depreciation",6.12,"",8201759.69
,"General Journal","15-12-2024","26234",,,"Canteen Chair 23 Depreciation","Expense","Depreciation Expense",,"Accumulated Depreciation",6.12,"",8201765.81
,"General Journal","15-12-2024","26235",,,"Canteen Chair 24 Depreciation","Expense","Depreciation Expense",,"Accumulated Depreciation",6.12,"",8201771.93
,"General Journal","15-12-2024","26236",,,"Canteen Chair 25 Depreciation","Expense","Depreciation Expense",,"Accumulated Depreciation",6.12,"",8201778.05
,"General Journal","15-12-2024","26237",,,"Canteen Chair 3 Depreciation","Expense","Depreciation Expense",,"Accumulated Depreciation",6.12,"",8201784.17
,"General Journal","15-12-2024","26238",,,"Canteen Chair 4 Depreciation","Expense","Depreciation Expense",,"Accumulated Depreciation",6.12,"",8201790.29
,"General Journal","15-12-2024","26239",,,"Canteen Chair 5 Depreciation","Expense","Depreciation Expense",,"Accumulated Depreciation",6.12,"",8201796.41
,"General Journal","15-12-2024","26240",,,"Canteen Chair 6 Depreciation","Expense","Depreciation Expense",,"Accumulated Depreciation",6.12,"",8201802.53
,"General Journal","15-12-2024","26241",,,"Canteen Chair 7 Depreciation","Expense","Depreciation Expense",,"Accumulated Depreciation",6.12,"",8201808.65
,"General Journal","15-12-2024","26242",,,"Canteen Chair 8 Depreciation","Expense","Depreciation Expense",,"Accumulated Depreciation",6.12,"",8201814.77
,"General Journal","15-12-2024","26243",,,"Canteen Chair 9 Depreciation","Expense","Depreciation Expense",,"Accumulated Depreciation",6.12,"",8201820.89
,"General Journal","15-12-2024","26250",,,"EOL Case sealer Outfeed Conveyor Depreciation","Expense","Depreciation Expense",,"Accumulated Depreciation",297.62,"",8202118.51
,"General Journal","15-12-2024","26251",,,"Epson L6190 Printer 1 Depreciation","Expense","Depreciation Expense",,"Accumulated Depreciation",654.76,"",8202773.27
,"General Journal","15-12-2024","26253",,,"Fire Extinguisher 6 Depreciation","Expense","Depreciation Expense",,"Accumulated Depreciation",77.38,"",8202850.65
,"General Journal","15-12-2024","26254",,,"Grinder 2 Depreciation","Expense","Depreciation Expense",,"Accumulated Depreciation",178.57,"",8203029.22
,"General Journal","15-12-2024","26256",,,"HP Laptop 11 Depreciation","Expense","Depreciation Expense",,"Accumulated Depreciation",1200.00,"",8204229.22
,"General Journal","15-12-2024","26257",,,"HP Laptop 12 Depreciation","Expense","Depreciation Expense",,"Accumulated Depreciation",1200.00,"",8205429.22
,"General Journal","15-12-2024","26262",,,"Microwave 2 Depreciation","Expense","Depreciation Expense",,"Accumulated Depreciation",147.27,"",8205576.49
,"General Journal","15-12-2024","26263",,,"Mobile phone 3 Depreciation","Expense","Depreciation Expense",,"Accumulated Depreciation",41.67,"",8205618.16
,"General Journal","15-12-2024","26265",,,"Movable Ladder 1 Depreciation","Expense","Depreciation Expense",,"Accumulated Depreciation",434.52,"",8206052.68
,"General Journal","15-12-2024","26273",,,"UV water purifier 3 Depreciation","Expense","Depreciation Expense",,"Accumulated Depreciation",543.10,"",8206595.78
,"General Journal","15-12-2024","26275",,,"Water tank 6 Depreciation","Expense","Depreciation Expense",,"Accumulated Depreciation",71.84,"",8206667.62
,"General Journal","16-12-2024","26215",,,"Board room chair 3 Depreciation","Expense","Depreciation Expense",,"Accumulated Depreciation",59.52,"",8206727.14
,"General Journal","16-12-2024","26218",,,"Bosch Grinder 3 Depreciation","Expense","Depreciation Expense",,"Accumulated Depreceiation",86.21,"",8206813.35
,"General Journal","16-12-2024","26244",,,"Chain block 5 depreciation","Expense","Depreciation Expense",,"Accumulated Depreciation",292.49,"",8207105.84
,"General Journal","16-12-2024","26245",,,"Chain block 6 depreciation","Expense","Depreciation Expense",,"Accumulated Depreciation",292.49,"",8207398.33
,"General Journal","16-12-2024","26255",,,"Heat Gun Total 1 Depreciation","Expense","Depreciation Expense",,"Accumulated Depreciation",64.66,"",8207462.99
,"General Journal","16-12-2024","26261",,,"Linx 5900 Coder 1 Depreciation","Expense","Depreciation Expense",,"Accumulated Depreciation",4166.67,"",8211629.66
,"General Journal","16-12-2024","26271",,,"Table Top Scale 11 6Kg Depreciation","Expense","Depreciation Expense",,"Accumulated Depreciation",277.09,"",8211906.75
,"General Journal","16-12-2024","26274",,,"Washing Machine 1 Depreciation","Expense","Depreciation Expense",,"Accumulated Depreciation",2640.01,"",8214546.76
,"General Journal","17-12-2024","26277",,,"2T Mixer Depreciation","Expense","Depreciation Expense",,"Accumulated Depreciation",12633.99,"",8227180.75
,"General Journal","17-12-2024","26278",,,"2T Mixer Installation Depreciation","Expense","Depreciation Expense",,"Accumulated Depreciation",29713.15,"",8256893.90
,"General Journal","17-12-2024","26279",,,"Coder UPS 6 Depreciation","Expense","Depreciation Expense",,"Accumulated Depreciation",94.83,"",8256988.73
,"General Journal","17-12-2024","26280",,,"Coder UPS 7 Depreciation","Expense","Depreciation Expense",,"Accumulated Depreciation",94.83,"",8257083.56
,"General Journal","17-12-2024","26281","*",,"Hand Dryer 1 Depreciation","Expense","Depreciation Expense",,"Accumulated Depreciation",46.18,"",8257129.74
,"General Journal","17-12-2024","26282","*",,"HP Laptop 3 Depreciation","Expense","Depreciation Expense",,"Accumulated Depreciation",297.62,"",8257427.36
,"General Journal","17-12-2024","26283",,,"Office desks  4","Expense","Depreciation Expense",,"Accumulated Depreciation",361.90,"",8257789.26
,"General Journal","17-12-2024","26284",,,"Pallet truck 4 Depreciation","Expense","Depreciation Expense",,"Accumulated Depreciation",428.57,"",8258217.83
,"General Journal","17-12-2024","26285",,,"Pallet truck 5 Depreciation","Expense","Depreciation Expense",,"Accumulated Depreciation",428.57,"",8258646.40
,"General Journal","17-12-2024","26286",,,"Pouch Packing Machine 2 Accumulated depreciation","Expense","Depreciation Expense",,"Accumulated Depreciation",976.19,"",8259622.59
,"General Journal","17-12-2024","26287",,,"Recirculation Pump Depreciation","Expense","Depreciation Expense",,"Accumulated  Depreciation",71.19,"",8259693.78
,"General Journal","17-12-2024","26288",,,"Server 1 Depreciation","Expense","Depreciation Expense",,"Accumulated Depreciation",357.14,"",8260050.92
,"General Journal","17-12-2024","26289",,,"Server Monitor Depreciation","Expense","Depreciation Expense",,"Accumulated Depreciaion",107.14,"",8260158.06
,"General Journal","17-12-2024","26290",,,"Shrink Tunnel Depreciation","Expense","Depreciation Expense",,"Accumulated Depreciation",3750.00,"",8263908.06
,"General Journal","17-12-2024","26291","*",,"Soap Dispenser 1 Depreciation","Expense","Depreciation Expense",,"Accumulated Depreciation",15.39,"",8263923.45
,"General Journal","17-12-2024","26292","*",,"Water Tank 3 Depreciation","Expense","Depreciation Expense",,"Accumulated Depreciation",123.15,"",8264046.60
,"General Journal","18-12-2024","26293",,,"Carton Sealer Manual 1 Depreciation","Expense","Depreciation Expense",,"Accumulated Depreciation",14.80,"",8264061.40
,"General Journal","18-12-2024","26294",,,"Compressor 3 Depreciation","Expense","Depreciation Expense",,"Accumulated Depreciation",5357.14,"",8269418.54
,"General Journal","18-12-2024","26295",,,"Compressor room depreciation","Expense","Depreciation Expense",,"Accumulated depreciation",132.44,"",8269550.98
,"General Journal","18-12-2024","26296",,,"Electric Hoist 1 depreciation","Expense","Depreciation Expense",,"Accumulated depreciation",3452.38,"",8273003.36
,"General Journal","18-12-2024","26297",,,"Gents changing room Lockers Depreciation","Expense","Depreciation Expense",,"Accumulated Depreciation",386.90,"",8273390.26
,"General Journal","18-12-2024","26298",,,"HP Mini Desktop 1 Depreciation","Expense","Depreciation Expense",,"Accumulated Depreciation",733.33,"",8274123.59
,"General Journal","18-12-2024","26299",,,"HP Mini Desktop 2 Depreciation","Expense","Depreciation Expense",,"Accumulated Depreciation",733.33,"",8274856.92
,"General Journal","18-12-2024","26300",,,"HP Mini Desktop 3 Depreciation","Expense","Depreciation Expense",,"Accumulated Depreciation",733.33,"",8275590.25
,"General Journal","18-12-2024","26301",,,"Ladies changing room Lockers Depreciation","Expense","Depreciation Expense",,"Accumulated Depreciation",411.90,"",8276002.15
,"General Journal","18-12-2024","26302",,,"Omrom M1 Basic BP Monitor Depreciation","Expense","Depreciation Expense",,"Accumulated Depreciation",58.33,"",8276060.48
,"General Journal","18-12-2024","26303",,,"SS Hand Washing Station 1 Depreciation","Expense","Depreciation Expense",,"Accumulated Depreciation",690.48,"",8276750.96
,"General Journal","18-12-2024","26304",,,"TV Screen 3 Depreciation","Expense","Depreciation Expense",,"Accumulated Depreciation",316.67,"",8277067.63
,"General Journal","18-12-2024","26305",,,"TV Screen 4 Depreciation","Expense","Depreciation Expense",,"Accumulated Depreciation",1550.00,"",8278617.63
,"General Journal","19-12-2024","26306",,,"3T Gas Forklift 1 Depreciation","Expense","Depreciation Expense",,"Accumulated Depreciation",30952.38,"",8309570.01
,"General Journal","19-12-2024","26307",,,"Office Stamp 2 Depreciation","Expense","Depreciation Expense",,"Accumulated Depreciaion",30.83,"",8309600.84
,"General Journal","20-12-2024","26308","*","Unilever Kenya Ltd:Sunlight Washing Pwd","Boato Commisioning Depreciation","Expense","Depreciation Expense",,"Accumulated Depreciation",889.88,"",8310490.72
,"General Journal","20-12-2024","26309",,,"Bosch Blower 3 Depreciation","Expense","Depreciation Expense",,"Accumulated Depreciation",79.02,"",8310569.74
,"General Journal","20-12-2024","26310",,,"Bosch Blower 4 Depreciation","Expense","Depreciation Expense",,"Accumulated Depreciation",136.49,"",8310706.23
,"General Journal","20-12-2024","26311",,,"Bosch Blower 5 Depreciation","Expense","Depreciation Expense",,"Accumulated Depreciation",136.49,"",8310842.72
,"General Journal","20-12-2024","26312",,,"Conference Office Desk 1 Depreciation","Expense","Depreciation Expense",,"Accumulated Depreciation",416.67,"",8311259.39
,"General Journal","20-12-2024","26313",,,"Floor Chair 17 depreciation","Expense","Depreciation Expense",,"Accumulated Depreciation",20.24,"",8311279.63
,"General Journal","20-12-2024","26314",,,"Floor Chair 18 depreciation","Expense","Depreciation Expense",,"Accumulated Depreciation",20.24,"",8311299.87
,"General Journal","20-12-2024","26315",,,"Floor Chair 19 depreciation","Expense","Depreciation Expense",,"Accumulated Depreciation",20.24,"",8311320.11
,"General Journal","20-12-2024","26316",,,"Floor Chair 20 depreciation","Expense","Depreciation Expense",,"Accumulated Depreciation",20.24,"",8311340.35
,"General Journal","20-12-2024","26317",,,"Heat Gun CAT Digital 1 Depreciation","Expense","Depreciation Expense",,"Accumulated Depreciation",136.49,"",8311476.84
,"General Journal","20-12-2024","26318","*",,"Lumnia 1 Pro Insect Trap Depreciation","Expense","Depreciation Expense",,"Accumulated Depreciation",316.67,"",8311793.51
,"General Journal","20-12-2024","26320",,,"PF Correction Unit Depreciation","Expense","Depreciation Expense",,"Accumulated Depreciation",1708.33,"",8313501.84
,"General Journal","21-12-2024","26321",,,"5Kg CO2 Fire Extinguisher 2 Depreciation","Expense","Depreciation Expense",,"Accumulated Depreciation",73.81,"",8313575.65
,"General Journal","21-12-2024","26322",,,"6Kg Dry Pwd Fire Extinguisher 1 Depreciaiton","Expense","Depreciation Expense",,"Accumulated Depreciation",59.52,"",8313635.17
,"General Journal","21-12-2024","26323",,,"Board room chair 1 Depreciation","Expense","Depreciation Expense",,"Accumulated Depreciation",59.52,"",8313694.69
,"General Journal","21-12-2024","26324",,,"Board room chair 2 Depreciation","Expense","Depreciation Expense",,"Accumulated Depreciation",59.52,"",8313754.21
,"General Journal","21-12-2024","26325",,,"Board room chair 4 Depreciation","Expense","Depreciation Expense",,"Accumulated Depreciation",59.52,"",8313813.73
,"General Journal","21-12-2024","26326",,,"Board room chair 5 Depreciation","Expense","Depreciation Expense",,"Accumulated Depreciation",59.52,"",8313873.25
,"General Journal","21-12-2024","26327",,,"Board room chair 6 Depreciation","Expense","Depreciation Expense",,"Accumulated Depreciation",59.52,"",8313932.77
,"General Journal","21-12-2024","26328",,,"Board room chair 7 Depreciation","Expense","Depreciation Expense",,"Accumulated Depreciation",59.52,"",8313992.29
,"General Journal","21-12-2024","26329",,,"Board room chair 8 Depreciation","Expense","Depreciation Expense",,"Accumulated Depreciation",59.52,"",8314051.81
,"General Journal","21-12-2024","26330",,,"Coding Stamp 2 Depreciation","Expense","Depreciation Expense",,"Accumulated Depreciation",133.33,"",8314185.14
,"General Journal","21-12-2024","26331",,,"IBC Tank 1 Depreciation","Expense","Depreciation Expense",,"Accumulated Depreciation",41.67,"",8314226.81
,"General Journal","21-12-2024","26332",,,"Empty IBC Tank 2 Depreciation","Expense","Depreciation Expense",,"Accumulated Depreciation",65.48,"",8314292.29
,"General Journal","21-12-2024","26333",,,"FFS Filling Machine 300 1 Depreciation","Expense","Depreciation Expense",,"Accumulated Depreciation",11850.01,"",8326142.30
,"General Journal","21-12-2024","26334",,,"Laboratory Oven & Dessicator  Depreciation","Expense","Depreciation Expense",,"Accumulated Depreciation",766.67,"",8326908.97
,"General Journal","21-12-2024","26335",,,"Tea Urn Depreciation","Expense","Depreciation Expense",,"Accumulated Depreciation",121.67,"",8327030.64
,"General Journal","22-12-2024","26336",,,"6Kg Auto Fire Extinguisher 1 Depreciation","Expense","Depreciation Expense",,"Accumulated Depreciation",53.57,"",8327084.21
,"General Journal","22-12-2024","26337",,,"6Kg Auto Fire Extinguisher 2 Depreciation","Expense","Depreciation Expense",,"Accumulated Depreciation",53.57,"",8327137.78
,"General Journal","22-12-2024","26342","*",,"AVS Voltage Stabilizer Depreciation","Expense","Depreciation Expense",,"Accumulated Depreciation",63.10,"",8327200.88
,"General Journal","22-12-2024","26346",,,"Conveyor Belt Green 1 Depreciation","Expense","Depreciation Expense",,"Accumulated Depreciation",82.14,"",8327283.02
,"General Journal","22-12-2024","26353",,,"HP Laptop 13 Depreciation","Expense","Depreciation Expense",,"Accumulated Depreciation",1200.00,"",8328483.02
,"General Journal","22-12-2024","26354","*",,"HP Laptop 7 Depreciation","Expense","Depreciation Expense",,"Accumulated Depreciation",1200.00,"",8329683.02
,"General Journal","22-12-2024","26357",,,"Office Desk 5 Depreciation","Expense","Depreciation Expense",,"Accumulated Depreciation",180.95,"",8329863.97
,"General Journal","22-12-2024","26358",,,"Office cabinets depreciation","Expense","Depreciation Expense",,"Accumulated Depreciation",119.05,"",8329983.02
,"General Journal","22-12-2024","26360",,,"Platform Scale 2 SS 100Kg Depreciation","Expense","Depreciation Expense",,"Accumulated Depreciation",339.29,"",8330322.31
,"General Journal","22-12-2024","26363",,,"Solar Water Heater 300L Depreciation","Expense","Depreciation Expense",,"Accumulated Depreciation",3125.00,"",8333447.31
,"General Journal","23-12-2024","26338",,,"Analytical Balance Depreciation","Expense","Depreciation Expense",,"Accumulated Depreciation",2405.58,"",8335852.89
,"General Journal","23-12-2024","26339",,,"Auger Filler 1 Depreciation","Expense","Depreciation Expense",,"Accumulated Depreciation",7220.12,"",8343073.01
,"General Journal","23-12-2024","26340",,,"Auger Filler 2 Depreciation","Expense","Depreciation Expense",,"Accumulated Depreciation",13258.63,"",8356331.64
,"General Journal","23-12-2024","26341",,,"Auger Filler 3 Depreciation","Expense","Depreciation Expense",,"Accumulated Depreciation",11788.69,"",8368120.33
,"General Journal","23-12-2024","26343",,,"Bajaj Boxer BM150 UG Depreciation","Expense","Depreciation Expense",,"Accumulated Depreciation",1539.41,"",8369659.74
,"General Journal","23-12-2024","26344",,,"Chain block 4 depreciation","Expense","Depreciation Expense",,"Accumulated Depreciation",133.42,"",8369793.16
,"General Journal","23-12-2024","26345",,,"Coder UPS Depreciation","Expense","Depreciation Expense",,"Accumulated Depreciation",95.24,"",8369888.40
,"General Journal","23-12-2024","26347",,,"Dust Extractor 1 Depreciation","Expense","Depreciation Expense",,"Accumulated Depreciation",446.43,"",8370334.83
,"General Journal","23-12-2024","26348",,,"Dust Extractor 2 Depreciation","Expense","Depreciation Expense",,"Accumulated Depreciation",446.43,"",8370781.26
,"General Journal","23-12-2024","26349",,,"Filler 1 Geared Motor & Feeding System Depreciation","Expense","Depreciation Expense",,"Accumulated Depreciation",333.33,"",8371114.59
,"General Journal","23-12-2024","26350",,,"Filler 2 Geared Motor & Feeding System Depreciation","Expense","Depreciation Expense",,"Accumulated Depreciation",348.72,"",8371463.31
,"General Journal","23-12-2024","26351",,,"Filler 3 Geared Motor & Feeding System Depreciation","Expense","Depreciation Expense",,"Accumulated Depreciation",347.52,"",8371810.83
,"General Journal","23-12-2024","26352",,,"Hotplate with Stirrer Depreciation","Expense","Depreciation Expense",,"Accumulated Depreciation",1785.71,"",8373596.54
,"General Journal","23-12-2024","26355",,,"Makita Hammer Drill Depreciation","Expense","Depreciation Expense",,"Accumulated Depreciation",205.25,"",8373801.79
,"General Journal","23-12-2024","26356",,,"Microwave 1 Depreciation","Expense","Depreciation Expense",,"Accumulated Depreciation",217.13,"",8374018.92
,"General Journal","23-12-2024","26359",,,"Pallet truck 3 Dep","Expense","Depreciation Expense",,"Accumulated Depreciation",510.95,"",8374529.87
,"General Journal","23-12-2024","26361",,,"Pouching Machine Depreciation","Expense","Depreciation Expense",,"Accumulated Depreciation",711.90,"",8375241.77
,"General Journal","23-12-2024","26362",,,"Power bank dep","Expense","Depreciation Expense",,"Accumulated Depreciation",119.05,"",8375360.82
,"General Journal","23-12-2024","26364",,,"Table Top Scale 11  SS 30Kg Depreciation","Expense","Depreciation Expense",,"Accumulated Depreciation",297.62,"",8375658.44
,"General Journal","23-12-2024","26365",,,"Table Top Scale 12  SS 30Kg Depreciation","Expense","Depreciation Expense",,"Accumulated Depreciation",297.62,"",8375956.06
,"General Journal","24-12-2024","26367",,,"Access Control Unit & System Depreciation","Expense","Depreciation Expense",,"Accumulated Depreciation",334.76,"",8376290.82
,"General Journal","24-12-2024","26369",,,"Electrical Enclosure Compressor Depreciation","Expense","Depreciation Expense",,"Accumulated Depreciation",125.00,"",8376415.82
,"General Journal","24-12-2024","26370",,,"ETR Machine Depreciation","Expense","Depreciation Expense",,"Accumulated Depreciation",236.04,"",8376651.86
,"General Journal","24-12-2024","26371",,,"Liquid Plant Depreciation","Expense","Depreciation Expense",,"Accumulated Deprecation",15029.76,"",8391681.62
,"General Journal","24-12-2024","26372",,,"Paste processing & packing line depreciation","Expense","Depreciation Expense",,"Accumulated Depreciation",17348.21,"",8409029.83
,"General Journal","24-12-2024","26373",,,"pH Meter Depreciation","Expense","Depreciation Expense",,"Accumulated Depreciation",741.39,"",8409771.22
,"General Journal","25-12-2024","26391",,,"Clamp Meter 1 Depreciation","Expense","Depreciation Expense",,"Accumulated Depreciation",36.90,"",8409808.12
,"General Journal","25-12-2024","26405",,,"Fire Alarm Sytstem Depreciation","Expense","Depreciation Expense",,"Accumulated Depreciation",728.57,"",8410536.69
,"General Journal","25-12-2024","26406",,,"Floor Chair 11 Depreciation","Expense","Depreciation Expense",,"Accumulated Depreciation",53.57,"",8410590.26
,"General Journal","25-12-2024","26407",,,"Floor Chair 12 Depreciation","Expense","Depreciation Expense",,"Accumulated Depreciation",53.57,"",8410643.83
,"General Journal","25-12-2024","26408",,,"Floor Chair 13 Depreciation","Expense","Depreciation Expense",,"Accumulated Depreciation",53.57,"",8410697.40
,"General Journal","25-12-2024","26409",,,"Floor Chair 14 Depreciation","Expense","Depreciation Expense",,"Accumulated Depreciation",53.57,"",8410750.97
,"General Journal","25-12-2024","26410",,,"Floor Chair 15 Depreciation","Expense","Depreciation Expense",,"Accumulated Depreciation",53.57,"",8410804.54
,"General Journal","25-12-2024","26411",,,"Floor Chair 16 Depreciation","Expense","Depreciation Expense",,"Accumulated Depreciation",53.57,"",8410858.11
,"General Journal","25-12-2024","26424",,,"Liquid Mixer 500Lt Depreciation","Expense","Depreciation Expense",,"Accumulated Depreciation",6172.62,"",8417030.73
,"General Journal","25-12-2024","26431",,,"Plastic Resin Mixer Depreciation","Expense","Depreciation Expense",,"Accumulated  Depreciation",1130.95,"",8418161.68
,"General Journal","25-12-2024","26432",,,"Plastic Resin Mixer Depreciation","Expense","Depreciation Expense",,"Accumulated  Depreciation",1130.95,"",8419292.63
,"General Journal","25-12-2024","26450",,,"Water tank 7 Depreciation","Expense","Depreciation Expense",,"Accumulated Depreciation",71.84,"",8419364.47
,"General Journal","26-12-2024","26412",,,"Grease Gun 1 Depreciation","Expense","Depreciation Expense",,"Accumulated Depreciation",73.21,"",8419437.68
,"General Journal","26-12-2024","26413",,,"Grease Gun 2 Depreciation","Expense","Depreciation Expense",,"Accumulated Depreciation",63.14,"",8419500.82
,"General Journal","26-12-2024","26436",,,"Retort Stand 1 Depreciation","Expense","Depreciation Expense",,"Accumulated Depreciation",10.71,"",8419511.53
,"General Journal","26-12-2024","26437",,,"Retort Stand 2 Depreciation","Expense","Depreciation Expense",,"Accumulated Depreciation",10.71,"",8419522.24
,"General Journal","26-12-2024","26443",,,"Tea Urn 2 Depreciation","Expense","Depreciation Expense",,"Accumulated Depreciation",180.00,"",8419702.24
,"General Journal","27-12-2024","26377",,,"Board room chair 10 Depreciation","Expense","Depreciation Expense",,"Accumulated Depreciation",79.55,"",8419781.79
,"General Journal","27-12-2024","26378",,,"Board room chair 11 Depreciation","Expense","Depreciation Expense",,"Accumulated Depreciation",79.55,"",8419861.34
,"General Journal","27-12-2024","26379",,,"Board room chair 12 Depreciation","Expense","Depreciation Expense",,"Accumulated Depreciation",79.55,"",8419940.89
,"General Journal","27-12-2024","26380",,,"Board room chair 13 Depreciation","Expense","Depreciation Expense",,"Accumulated Depreciation",79.55,"",8420020.44
,"General Journal","27-12-2024","26381",,,"Board room chair 14 Depreciation","Expense","Depreciation Expense",,"Accumulated Depreciation",79.55,"",8420099.99
,"General Journal","27-12-2024","26382",,,"Board room chair 15 Depreciation","Expense","Depreciation Expense",,"Accumulated Depreciation",79.55,"",8420179.54
,"General Journal","27-12-2024","26383",,,"Board room chair 16 Depreciation","Expense","Depreciation Expense",,"Accumulated Depreciation",79.55,"",8420259.09
,"General Journal","27-12-2024","26384",,,"Board room chair 17 Depreciation","Expense","Depreciation Expense",,"Accumulated Depreciation",79.55,"",8420338.64
,"General Journal","27-12-2024","26385",,,"Board room chair 18 Depreciation","Expense","Depreciation Expense",,"Accumulated Depreciation",79.55,"",8420418.19
,"General Journal","27-12-2024","26386",,,"Board room chair 19 Depreciation","Expense","Depreciation Expense",,"Accumulated Depreciation",79.55,"",8420497.74
,"General Journal","27-12-2024","26387",,,"Board room chair 9 Depreciation","Expense","Depreciation Expense",,"Accumulated Depreciation",79.55,"",8420577.29
,"General Journal","27-12-2024","26430",,,"Passenger Lift 1000kg Depreciation","Expense","Depreciation Expense",,"Accumulated Depreciation",44484.68,"",8465061.97
,"General Journal","28-12-2024","26415",,,"Heat Gun Bosch 2 Accumulated depreciation","Expense","Depreciation Expense",,"Accumulated Depreciation",75.43,"",8465137.40
,"General Journal","28-12-2024","26416",,,"Heat Gun Bosch 3 Accumulated depreciation","Expense","Depreciation Expense",,"Accumulated Depreciation",75.43,"",8465212.83
,"General Journal","31-12-2024","26374",,,"500gm Jar Blow Mould 3 depreciation","Expense","Depreciation Expense",,"Accumulated Depreciation",1026.79,"",8466239.62
,"General Journal","31-12-2024","26375",,,"500gm Jar Blow Mould 4 depreciation","Expense","Depreciation Expense",,"Accumulated Depreciation",1026.79,"",8467266.41
,"General Journal","31-12-2024","26376",,,"Air cooled chiller depeciation","Expense","Depreciation Expense",,"Accumulated  Depreciation",8916.67,"",8476183.08
,"General Journal","31-12-2024","26388","*","Unilever Kenya Ltd:Sunlight Washing Pwd","Boato Installation Depreciation","Expense","Depreciation Expense",,"Accumulated Depreciation",65114.38,"",8541297.46
,"General Journal","31-12-2024","26389","*",,"Canister Platform Depreciation","Expense","Depreciation Expense",,"Accumulated Depreciation",59246.67,"",8600544.13
,"General Journal","31-12-2024","26390",,,"CCTV DRV & System Depreciation","Expense","Depreciation Expense",,"Accumulated Depreciation",1295.33,"",8601839.46
,"General Journal","31-12-2024","26398",,,"Colour Pressure tank Depreciation","Expense","Depreciation Expense",,"Accumulated Depreciation",232.14,"",8602071.60
,"General Journal","31-12-2024","26399",,,"Compressed air gun Depreciation","Expense","Depreciation Expense",,"Accumulated Depreciation",47.62,"",8602119.22
,"General Journal","31-12-2024","26401",,,"Drum Pump 2 Depreciation","Expense","Depreciation Expense",,"Accumulated Depreciation",123.15,"",8602242.37
,"General Journal","31-12-2024","26402",,,"Extractor Fan down Depreciation","Expense","Depreciation Expense",,"Accumulated Depreciation",150.12,"",8602392.49
,"General Journal","31-12-2024","26403",,,"Extractor Fan Hoisting Depreciation","Expense","Depreciation Expense",,"Accumulated Depreciation",176.67,"",8602569.16
,"General Journal","31-12-2024","26404",,,"Extractor Fan Packaging Depreciation","Expense","Depreciation Expense",,"Accumulated Depreciation",150.12,"",8602719.28
,"General Journal","31-12-2024","26422",,,"Incotex Type C Control Unit Depreciation","Expense","Depreciation Expense",,"Accumulated Depreciation",1939.66,"",8604658.94
,"General Journal","31-12-2024","26426",,,"Office Cabinet 5 Depreciation","Expense","Depreciation Expense",,"Accumulated Depreciation",58.33,"",8604717.27
,"General Journal","31-12-2024","26427",,,"Office Desk 6 Depreciation","Expense","Depreciation Expense",,"Accumulated Depreciation",90.48,"",8604807.75
,"General Journal","31-12-2024","26428",,,"Office Desk 7 Depreciation","Expense","Depreciation Expense",,"Accumulated Depreciation",90.48,"",8604898.23
,"General Journal","31-12-2024","26429",,,"Office Desk 8 Depreciation","Expense","Depreciation Expense",,"Accumulated Depreciation",83.33,"",8604981.56
,"General Journal","31-12-2024","26433",,,"Platform Scale 4 tons 1 Depreciation","Expense","Depreciation Expense",,"Accumulated Depreciation",10782.43,"",8615763.99
,"General Journal","31-12-2024","26434",,,"Process Water Filtration System Depreciation","Expense","Depreciation Expense",,"Accumulated Depreciation",1785.71,"",8617549.70
,"General Journal","31-12-2024","26441",,,"Sulphonic Acid pressure tank Depreciation","Expense","Depreciation Expense",,"Accumulated Depreciation",110.48,"",8617660.18
,"General Journal","31-12-2024","26444",,,"Test Sieves 100 & 200 microns Depreciation","Expense","Depreciation Expense",,"Accumulated Depreciation",450.00,"",8618110.18
,"General Journal","31-12-2024","26446",,,"Wall mounted cabinet 1 Dep","Expense","Depreciation Expense",,"Accumulated Depreciation",107.14,"",8618217.32
,"General Journal","31-12-2024","26449",,,"Water tank 5 Depreciation","Expense","Depreciation Expense",,"Accumulated Depreciation",137.79,"",8618355.11
"Total Depreciation Expense",,,,,,,,,,,8618355.11,0.00,8618355.11
"Factory Overheads",,,,,,,,,,,,,""
"Bad Debts",,,,,,,,,,,,,""
,"General Journal","02-01-2024","23827","*","Brenntag Kenya Limited","Rounding off","Expense","Bad Debts",,"Accounts Payable",274.72,"",274.72
,"General Journal","02-01-2024","23828","*","Chemigas Ltd","Rounding off","Expense","Bad Debts",,"Accounts Payable",900.00,"",1174.72
,"Credit","07-06-2024","0090973800000001300",,"Statpack Industries Limited","Price correction","Expense","Bad Debts",,"Accounts Payable","",15026.58,-13851.86
"Total Bad Debts",,,,,,,,,,,1174.72,15026.58,-13851.86
"Charitable Donations",,,,,,,,,,,,,""
,"Bill","10-05-2024","326521-100",,"Raage Mart Ltd","items","Expense","Charitable Donations",,"Accounts Payable",1950.00,"",1950.00
,"Bill","10-05-2024","326520-100",,"Raage Mart Ltd","items","Expense","Charitable Donations",,"Accounts Payable",5100.00,"",7050.00
,"Bill","10-05-2024","326519-100",,"Raage Mart Ltd","items","Expense","Charitable Donations",,"Accounts Payable",6750.00,"",13800.00
"Total Charitable Donations",,,,,,,,,,,13800.00,0.00,13800.00
"Dues and Subscriptions",,,,,,,,,,,,,""
,"Bill","24-01-2024","0190408130000005337",,"Kenya Association of Manufacturers","2024 Subscriptions","Expense","Dues and Subscriptions",,"Accounts Payable",49376.25,"",49376.25
"Total Dues and Subscriptions",,,,,,,,,,,49376.25,0.00,49376.25
"Reconciliation Discrepancies",,,,,,,,,,,,,""
,"Cheque","15-01-2024","20036336261",,,"WHVAT Rounding","Expense","Reconciliation Discrepancies",,"KCB Bank",11.86,"",11.86
,"General Journal","31-01-2024","22308",,,"Balance Adjustment","Expense","Reconciliation Discrepancies",,"MPESA Account",0.21,"",12.07
,"General Journal","31-01-2024","22345",,,"Balance Adjustment","Expense","Reconciliation Discrepancies",,"KCB Bank","",0.06,12.01
,"Cheque","20-02-2024","20037888498",,,"WHVAT Rounding","Expense","Reconciliation Discrepancies",,"KCB Bank",12.30,"",24.31
,"General Journal","29-02-2024","22629",,,"Balance Adjustment","Expense","Reconciliation Discrepancies",,"MPESA Account","",1.06,23.25
,"General Journal","29-02-2024","22653",,,"Balance Adjustment","Expense","Reconciliation Discrepancies",,"KCB Bank","",0.13,23.12
,"General Journal","29-02-2024","22675",,,"Balance Adjustment","Expense","Reconciliation Discrepancies",,"KCB USD Account","",144.50,-121.38
,"Cheque","18-03-2024","20039223720",,,"WHVAT Rounding","Expense","Reconciliation Discrepancies",,"KCB Bank",24.42,"",-96.96
,"General Journal","31-03-2024","23306",,,"Balance Adjustment","Expense","Reconciliation Discrepancies",,"KCB Bank","",0.43,-97.39
,"Cheque","17-04-2024","20040621927",,,"WHVAT Rounding","Expense","Reconciliation Discrepancies",,"KCB Bank",16.62,"",-80.77
,"General Journal","30-04-2024","23436",,,"Balance Adjustment","Expense","Reconciliation Discrepancies",,"MPESA Account",0.01,"",-80.76
,"General Journal","30-04-2024","23573",,,"Balance Adjustment","Expense","Reconciliation Discrepancies",,"KCB Bank","",0.11,-80.87
,"Cheque","15-05-2024","20041914138",,,"WHVAT Rounding","Expense","Reconciliation Discrepancies",,"KCB Bank",17.07,"",-63.80
,"General Journal","31-05-2024","23817",,,"Balance Adjustment","Expense","Reconciliation Discrepancies",,"MPESA Account","",0.01,-63.81
,"General Journal","31-05-2024","23990",,,"Balance Adjustment","Expense","Reconciliation Discrepancies",,"KCB Bank",0.15,"",-63.66
,"Cheque","18-06-2024","20043446914",,,"WHVAT Rounding","Expense","Reconciliation Discrepancies",,"KCB Bank",14.12,"",-49.54
,"General Journal","30-06-2024","24368",,,"Balance Adjustment","Expense","Reconciliation Discrepancies",,"MPESA Account","",0.03,-49.57
,"General Journal","30-06-2024","24438",,,"Balance Adjustment","Expense","Reconciliation Discrepancies",,"KCB Bank",0.14,"",-49.43
,"Cheque","16-07-2024","20044835184",,,"WHVAT Rounding","Expense","Reconciliation Discrepancies",,"KCB Bank",16.21,"",-33.22
,"General Journal","31-07-2024","24611",,,"Balance Adjustment","Expense","Reconciliation Discrepancies",,"MPESA Account","",0.08,-33.30
,"General Journal","31-07-2024","24678",,,"Balance Adjustment","Expense","Reconciliation Discrepancies",,"KCB Bank","",0.01,-33.31
,"Cheque","15-08-2024","20046224352",,,"WHVAT Rounding","Expense","Reconciliation Discrepancies",,"KCB Bank",21.32,"",-11.99
,"General Journal","31-08-2024","24935",,,"Balance Adjustment","Expense","Reconciliation Discrepancies",,"MPESA Account","",0.30,-12.29
,"General Journal","31-08-2024","24996",,,"Balance Adjustment","Expense","Reconciliation Discrepancies",,"KCB Bank",0.13,"",-12.16
,"Cheque","17-09-2024","20047904421",,,"WHVAT Rounding","Expense","Reconciliation Discrepancies",,"KCB Bank",14.68,"",2.52
,"General Journal","30-09-2024","25350",,,"Balance Adjustment","Expense","Reconciliation Discrepancies",,"MPESA Account","",0.01,2.51
,"General Journal","30-09-2024","25444",,,"Balance Adjustment","Expense","Reconciliation Discrepancies",,"KCB Bank","",0.12,2.39
,"Cheque","15-10-2024","20049264542",,,"WHVAT Rounding","Expense","Reconciliation Discrepancies",,"KCB Bank",11.81,"",14.20
,"General Journal","31-10-2024","26042",,,"Balance Adjustment","Expense","Reconciliation Discrepancies",,"KCB Bank","",0.08,14.12
,"Cheque","15-11-2024","20050892960",,,"WHVAT Rounding","Expense","Reconciliation Discrepancies",,"KCB Bank",16.95,"",31.07
,"General Journal","30-11-2024","26123",,,"Balance Adjustment","Expense","Reconciliation Discrepancies",,"MPESA Account","",2.32,28.75
,"General Journal","30-11-2024","26606",,,"Balance Adjustment","Expense","Reconciliation Discrepancies",,"KCB Bank","",0.49,28.26
,"Cheque","17-12-2024","20052636265",,,"WHVAT Rounding","Expense","Reconciliation Discrepancies",,"KCB Bank",21.64,"",49.90
,"General Journal","31-12-2024","26452",,,"Balance Adjustment","Expense","Reconciliation Discrepancies",,"MPESA Account","",0.80,49.10
,"General Journal","31-12-2024","26648",,,"Balance Adjustment","Expense","Reconciliation Discrepancies",,"KCB Bank","",0.89,48.21
"Total Reconciliation Discrepancies",,,,,,,,,,,199.64,151.43,48.21
"Security Services",,,,,,,,,,,,,""
,"Bill","02-01-2024","WX3008598",,"Wells Fargo Limited","Radio Alarm Rent - February 2024","Expense","Security Services",,"Accounts Payable",8000.00,"",8000.00
,"Bill","01-02-2024","0190407520000021904",,"Wells Fargo Limited","Radio Alarm Rent - March 2024","Expense","Security Services",,"Accounts Payable",8000.00,"",16000.00
,"Bill","01-03-2024","0190407520000023314",,"Wells Fargo Limited","Radio Alarm Rent - April 2024","Expense","Security Services",,"Accounts Payable",8000.00,"",24000.00
,"Bill","26-03-2024","581",,"DualTech Security Services","Burglar Alarm System Service","Expense","Security Services",,"Accounts Payable",2000.00,"",26000.00
,"Bill","02-04-2024","0190407520000024642",,"Wells Fargo Limited","Radio Alarm Rent - May 2024","Expense","Security Services",,"Accounts Payable",8000.00,"",34000.00
,"Bill","02-05-2024","0190407520000025876",,"Wells Fargo Limited","Radio Alarm Rent - June 2024","Expense","Security Services",,"Accounts Payable",8000.00,"",42000.00
,"Cheque","23-05-2024","P2052",,,"security personnel tip","Expense","Security Services",,"MPESA Account",200.00,"",42200.00
,"Bill","03-06-2024","0190407520000027313",,"Wells Fargo Limited","Radio Alarm Rent - July 2024","Expense","Security Services",,"Accounts Payable",8000.00,"",50200.00
,"Bill","01-07-2024","0190407520000028636",,"Wells Fargo Limited","Radio Alarm Rent - August 2024","Expense","Security Services",,"Accounts Payable",8000.00,"",58200.00
,"Bill","03-07-2024","592",,"DualTech Security Services","Burglar Alarm System Service","Expense","Security Services",,"Accounts Payable",2000.00,"",60200.00
,"Cheque","23-07-2024","P2171",,,"security personnel tip","Expense","Security Services",,"MPESA Account",200.00,"",60400.00
,"Bill","01-08-2024","0190407520000029989",,"Wells Fargo Limited","Radio Alarm Rent - September 2024","Expense","Security Services",,"Accounts Payable",8000.00,"",68400.00
,"Cheque","31-08-2024","56",,"Maasai Market","Security personnel accessories","Expense","Security Services",,"Cash Account",2600.00,"",71000.00
,"Bill","09-09-2024","0190407520000031373",,"Wells Fargo Limited","Radio Alarm Rent - October 2024","Expense","Security Services",,"Accounts Payable",8000.00,"",79000.00
,"Bill","13-09-2024","0190407520000031513",,"Wells Fargo Limited","Rapid response Lukenya deposit","Expense","Security Services",,"Accounts Payable",9860.00,"",88860.00
,"Bill","13-09-2024","0190407520000031514",,"Wells Fargo Limited","Lukenya Radio Alarm system installation","Expense","Security Services",,"Accounts Payable",15000.00,"",103860.00
,"Bill","01-10-2024","0190407520000032817",,"Wells Fargo Limited","-MULTIPLE-","Expense","Security Services",,"Accounts Payable",16500.00,"",120360.00
,"Bill","01-10-2024","0190407520000032818",,"Wells Fargo Limited","Lukenya Radio Alarm Rent - October 2024","Expense","Security Services",,"Accounts Payable",8500.00,"",128860.00
,"Bill","11-10-2024","505",,"DualTech Security Services","Burglar Alarm System Service","Expense","Security Services",,"Accounts Payable",2000.00,"",130860.00
,"Bill","01-11-2024","0190407520000034083",,"Wells Fargo Limited","-MULTIPLE-","Expense","Security Services",,"Accounts Payable",16500.00,"",147360.00
,"Cheque","22-11-2024","P2424",,,"security personnel tip","Expense","Security Services",,"MPESA Account",150.00,"",147510.00
,"Bill","27-11-2024","0171720370000000429",,"Beam Security Company Limited","Security guarding for November 2024","Expense","Security Services",,"Accounts Payable",24000.00,"",171510.00
,"Bill","01-12-2024","0190407520000035754",,"Wells Fargo Limited","Lukenya Radio Alarm Rent - January 2024","Expense","Security Services",,"Accounts Payable",8500.00,"",180010.00
,"Bill","29-12-2024","0171720370000000462",,"Beam Security Company Limited","Security guarding for December 2024","Expense","Security Services",,"Accounts Payable",30000.00,"",210010.00
"Total Security Services",,,,,,,,,,,210010.00,0.00,210010.00
"Bank Service Charges",,,,,,,,,,,,,""
,"Cheque","31-01-2024",,,,"Service Charge","Expense","Bank Service Charges",,"MPESA Account",3158.00,"",3158.00
,"Cheque","31-01-2024",,,,"Service Charge","Expense","Bank Service Charges",,"KCB Bank",4528.25,"",7686.25
,"Cheque","29-02-2024",,,,"Service Charge","Expense","Bank Service Charges",,"MPESA Account",2938.36,"",10624.61
,"Cheque","29-02-2024",,,,"Service Charge","Expense","Bank Service Charges",,"KCB Bank",9264.90,"",19889.51
,"Cheque","29-02-2024",,,,"Service Charge","Expense","Bank Service Charges",,"KCB USD Account",2261.43,"",22150.94
,"Cheque","01-03-2024","SC12OU8JBU",,,"MPESA charge","Expense","Bank Service Charges",,"MPESA Account",20.00,"",22170.94
,"Cheque","31-03-2024",,,,"Service Charge","Expense","Bank Service Charges",,"MPESA Account",3938.00,"",26108.94
,"Cheque","31-03-2024",,,,"Service Charge","Expense","Bank Service Charges",,"KCB Bank",13133.90,"",39242.84
,"Cheque","19-04-2024","SDJ8PNURTY",,,"MPESA charge","Expense","Bank Service Charges",,"MPESA Account",68.00,"",39310.84
,"Cheque","30-04-2024",,,,"Service Charge","Expense","Bank Service Charges",,"MPESA Account",4738.43,"",44049.27
,"Cheque","30-04-2024",,,,"Service Charge","Expense","Bank Service Charges",,"KCB Bank",11152.40,"",55201.67
,"Cheque","31-05-2024",,,,"Service Charge","Expense","Bank Service Charges",,"MPESA Account",5504.16,"",60705.83
,"Cheque","31-05-2024",,,,"Service Charge","Expense","Bank Service Charges",,"KCB Bank",8889.65,"",69595.48
,"Cheque","31-05-2024",,,,"Service Charge","Expense","Bank Service Charges",,"KCB USD Account",4875.43,"",74470.91
,"Cheque","10-06-2024","SFA01NGASM",,,"MPESA charge","Expense","Bank Service Charges",,"MPESA Account",103.00,"",74573.91
,"Cheque","30-06-2024",,,,"Service Charge","Expense","Bank Service Charges",,"MPESA Account",4972.00,"",79545.91
,"Cheque","30-06-2024",,,,"Service Charge","Expense","Bank Service Charges",,"KCB Bank",9795.25,"",89341.16
,"Cheque","30-06-2024",,,,"Service Charge","Expense","Bank Service Charges",,"KCB USD Account",2283.09,"",91624.25
,"Cheque","15-07-2024","SGF8QX1BLQ",,,"MPESA charge","Expense","Bank Service Charges",,"MPESA Account",27.00,"",91651.25
,"Cheque","19-07-2024","SGJ15KGBT",,,"MPESA charge","Expense","Bank Service Charges",,"MPESA Account",6.00,"",91657.25
,"Cheque","22-07-2024","SGM6H2ORWE",,,"MPESA charge","Expense","Bank Service Charges",,"MPESA Account",101.00,"",91758.25
,"Cheque","31-07-2024",,,,"Service Charge","Expense","Bank Service Charges",,"MPESA Account",4542.38,"",96300.63
,"Cheque","31-07-2024",,,,"Service Charge","Expense","Bank Service Charges",,"KCB Bank",30528.25,"",126828.88
,"Cheque","31-07-2024",,,,"Service Charge","Expense","Bank Service Charges",,"KCB USD Account",1087.80,"",127916.68
,"Cheque","31-08-2024",,,,"Service Charge","Expense","Bank Service Charges",,"MPESA Account",5652.10,"",133568.78
,"Cheque","31-08-2024",,,,"Service Charge","Expense","Bank Service Charges",,"KCB Bank",8958.75,"",142527.53
,"Cheque","03-09-2024","SI31AY5ICH",,,"MPESA charge","Expense","Bank Service Charges",,"MPESA Account",36.00,"",142563.53
,"Cheque","30-09-2024",,,,"Service Charge","Expense","Bank Service Charges",,"MPESA Account",4800.47,"",147364.00
,"Cheque","30-09-2024",,,,"Service Charge","Expense","Bank Service Charges",,"KCB Bank",4833.00,"",152197.00
,"Cheque","28-10-2024","SJS9OHSBW7",,,"MPESA charge","Expense","Bank Service Charges",,"MPESA Account",33.00,"",152230.00
,"Cheque","31-10-2024",,,,"Service Charge","Expense","Bank Service Charges",,"MPESA Account",4629.13,"",156859.13
,"Cheque","31-10-2024",,,,"Service Charge","Expense","Bank Service Charges",,"KCB Bank",14578.20,"",171437.33
,"Cheque","22-11-2024","SKM1O727K1",,,"MPESA charge","Expense","Bank Service Charges",,"MPESA Account",10.00,"",171447.33
,"Cheque","30-11-2024",,,,"Service Charge","Expense","Bank Service Charges",,"MPESA Account",4971.72,"",176419.05
,"Cheque","30-11-2024",,,,"Service Charge","Expense","Bank Service Charges",,"KCB Bank",9414.20,"",185833.25
,"Cheque","31-12-2024",,,,"Service Charge","Expense","Bank Service Charges",,"MPESA Account",7247.70,"",193080.95
,"Cheque","31-12-2024",,,,"Service Charge","Expense","Bank Service Charges",,"KCB Bank",13381.30,"",206462.25
"Total Bank Service Charges",,,,,,,,,,,206462.25,0.00,206462.25
"Business Licenses and Permits",,,,,,,,,,,,,""
"OSH",,,,,,,,,,,,,""
,"Cheque","25-07-2024","SGP8S7JQMG",,"DOSHS","DOSH Registration Certificate","Expense","OSH",,"MPESA Account",5050.00,"",5050.00
"Total OSH",,,,,,,,,,,5050.00,0.00,5050.00
"Business Licenses and Permits - Other",,,,,,,,,,,,,""
,"Bill","16-08-2024","0040092800000014490",,"Kenya Bureau of Standards","Standardization mark renewals","Expense","Business Licenses and Permits",,"Accounts Payable",15043.10,"",15043.10
,"Bill","16-08-2024","0040092800000014488",,"Kenya Bureau of Standards","Standardization mark renewals","Expense","Business Licenses and Permits",,"Accounts Payable",15043.10,"",30086.20
,"Bill","19-09-2024",,,"Kenya Bureau of Standards","Standardization mark renewals","Expense","Business Licenses and Permits",,"Accounts Payable",15043.10,"",45129.30
,"Bill","09-10-2024",,,"Kenya Bureau of Standards","Standardization mark renewals","Expense","Business Licenses and Permits",,"Accounts Payable",15043.10,"",60172.40
,"Bill","18-10-2024",,,"Kenya Bureau of Standards","Standardization mark renewals","Expense","Business Licenses and Permits",,"Accounts Payable",15043.10,"",75215.50
"Total Business Licenses and Permits - Other",,,,,,,,,,,75215.50,0.00,75215.50
"Total Business Licenses and Permits",,,,,,,,,,,80265.50,0.00,80265.50
"Employee Incentive",,,,,,,,,,,,,""
,"Bill","01-01-2024","INV410721",,"ICPAK","ICPAK Subscription 2024 Dominic","Expense","Employee Incentive",,"Accounts Payable",3200.00,"",3200.00
,"Cheque","17-01-2024","P1797",,,"team incentive","Expense","Employee Incentive",,"MPESA Account",1000.00,"",4200.00
,"Cheque","02-02-2024","P1828",,,"Employee incentive","Expense","Employee Incentive",,"MPESA Account",3120.00,"",7320.00
,"Cheque","02-02-2024","P1829",,,"Employee incentive","Expense","Employee Incentive",,"MPESA Account",1070.00,"",8390.00
,"Cheque","13-02-2024","P1841",,,"Employee incentive Employee of the month","Expense","Employee Incentive",,"MPESA Account",2030.00,"",10420.00
,"Cheque","04-03-2024","P1881",,,"Employee incentive Employee of the month","Expense","Employee Incentive",,"MPESA Account",2030.00,"",12450.00
,"Cheque","06-03-2024","P1882",,,"Employee incentive","Expense","Employee Incentive",,"MPESA Account",1560.00,"",14010.00
,"Bill","01-04-2024","0020110290000003524",,"Panari Investments Limited","-MULTIPLE-","Expense","Employee Incentive",,"Accounts Payable",153485.23,"",167495.23
,"Cheque","02-04-2024","P1935",,,"Employee incentive Employee of the month","Expense","Employee Incentive",,"MPESA Account",3500.00,"",170995.23
,"Cheque","03-04-2024","P1940",,,"Savings Incentive","Expense","Employee Incentive",,"MPESA Account",5000.00,"",175995.23
,"Cheque","17-04-2024","P1972",,,"Vim Team Incentive","Expense","Employee Incentive",,"MPESA Account",19500.00,"",195495.23
,"Cheque","17-04-2024","887294",,"Strathmore University Business School","School Fees","Expense","Employee Incentive",,"KCB Bank",379475.00,"",574970.23
,"Cheque","18-04-2024","886532",,"Strathmore University Business School","School Fees","Expense","Employee Incentive",,"Cash Account",200000.00,"",774970.23
,"Cheque","18-04-2024","886551",,"Strathmore University Business School","School Fees","Expense","Employee Incentive",,"Cash Account",200000.00,"",974970.23
,"Cheque","06-05-2024","P2003",,,"Employee incentive Employee of the month","Expense","Employee Incentive",,"MPESA Account",2000.00,"",976970.23
,"Cheque","07-05-2024","P2007",,,"Vim Team Incentive","Expense","Employee Incentive",,"MPESA Account",21000.00,"",997970.23
,"Bill","14-05-2024","1090564610000053657",,"Bata Shoe Kenya PLC","Shoes","Expense","Employee Incentive",,"Accounts Payable",3619.31,"",1001589.54
,"Cheque","04-06-2024","P2076",,,"Employee incentive Employee of the month","Expense","Employee Incentive",,"MPESA Account",2000.00,"",1003589.54
,"Cheque","28-06-2024","P2121",,,"Vim Team Incentive","Expense","Employee Incentive",,"MPESA Account",21750.00,"",1025339.54
,"Cheque","01-07-2024","P2123",,,"Employee incentive Employee of the month","Expense","Employee Incentive",,"MPESA Account",2000.00,"",1027339.54
,"Cheque","08-08-2024","P2195",,,"Employee incentive Employee of the month","Expense","Employee Incentive",,"MPESA Account",2000.00,"",1029339.54
,"Cheque","30-08-2024","P2250",,,"Vim Team Incentive","Expense","Employee Incentive",,"MPESA Account",20250.00,"",1049589.54
,"Cheque","03-09-2024","P2266",,,"Vim Team Incentive Vincent","Expense","Employee Incentive",,"MPESA Account",750.00,"",1050339.54
,"Cheque","03-09-2024","P2267",,,"Employee incentive Employee of the month","Expense","Employee Incentive",,"MPESA Account",2000.00,"",1052339.54
,"Cheque","30-09-2024","P2312",,,"Employee incentive Employee of the month","Expense","Employee Incentive",,"MPESA Account",2000.00,"",1054339.54
,"Cheque","07-10-2024","P2336",,,"Sales Team Incentive Maurine and Rhoda","Expense","Employee Incentive",,"MPESA Account",3500.00,"",1057839.54
,"Cheque","04-11-2024","P2373",,,"Employee incentive Employee of the month","Expense","Employee Incentive",,"MPESA Account",2000.00,"",1059839.54
,"Cheque","03-12-2024","P2441",,,"Employee incentive Employee of the month","Expense","Employee Incentive",,"MPESA Account",2030.00,"",1061869.54
,"Cheque","04-12-2024","P2444",,,"Vim Team Incentive","Expense","Employee Incentive",,"MPESA Account",21750.00,"",1083619.54
,"Bill","06-12-2024","3897",,"Nkasiri Adventure Park","Team building at Nkasiri","Expense","Employee Incentive",,"Accounts Payable",144400.00,"",1228019.54
,"Cheque","06-12-2024","P2457",,,"Employee transport to Nkasiri","Expense","Employee Incentive",,"MPESA Account",8000.00,"",1236019.54
,"Cheque","06-12-2024","P2458",,,"Employee transport to Nkasiri","Expense","Employee Incentive",,"MPESA Account",13000.00,"",1249019.54
,"Cheque","08-12-2024","P2461",,,"blow moulding 2 teams incentive","Expense","Employee Incentive",,"MPESA Account",9000.00,"",1258019.54
,"Bill","21-12-2024","0040798670001582581",,"Naivas Ltd","Bulk voucher","Expense","Employee Incentive",,"Accounts Payable",323000.00,"",1581019.54
"Total Employee Incentive",,,,,,,,,,,1581019.54,0.00,1581019.54
"Employee Welfare",,,,,,,,,,,,,""
,"Cheque","23-02-2024","P1866",,,"Brian sickness support","Expense","Employee Welfare",,"MPESA Account",7900.00,"",7900.00
,"Bill","06-05-2024","231015",,"Wageindicator Foundation","WageIndicator Living Wage Database","Expense","Employee Welfare",,"Accounts Payable - USD",51920.30,"",59820.30
,"Cheque","27-06-2024","P2117",,,"Martin Ngugi bereavement support","Expense","Employee Welfare",,"MPESA Account",18100.00,"",77920.30
,"Cheque","27-06-2024","P2118",,,"Burial transport facilitation for company reps","Expense","Employee Welfare",,"MPESA Account",1400.00,"",79320.30
,"Cheque","22-10-2024","BL-FH-11437",,"Nairobi City County","Beatrice Food Handlers Certificate","Expense","Employee Welfare",,"MPESA Account",1000.00,"",80320.30
,"Cheque","22-10-2024","P2367",,,"Beatrice fare and medical examination fee for food handlers cert","Expense","Employee Welfare",,"MPESA Account",2150.00,"",82470.30
,"Cheque","23-10-2024","P2355",,,"Christine Ndinda bereavement support","Expense","Employee Welfare",,"MPESA Account",18800.00,"",101270.30
,"Cheque","24-10-2024","P2361",,,"Sylvester Musembi fare to Makueni for burial","Expense","Employee Welfare",,"MPESA Account",2000.00,"",103270.30
,"Cheque","28-10-2024","P2362",,,"Sylvester Musembi fare to Makueni for burial","Expense","Employee Welfare",,"MPESA Account",2000.00,"",105270.30
"Total Employee Welfare",,,,,,,,,,,105270.30,0.00,105270.30
"Insurance Expense",,,,,,,,,,,,,""
"Fire, Burglary, and WIBA",,,,,,,,,,,,,""
,"General Journal","04-01-2024","21860",,,"Fire, Burglary, and WIBA","Expense","Fire, Burglary, and WIBA",,"Prepaid Expenses",24026.42,"",24026.42
,"General Journal","04-02-2024","22240",,,"Fire, Burglary, and WIBA","Expense","Fire, Burglary, and WIBA",,"Prepaid Expenses",24026.42,"",48052.84
,"General Journal","04-03-2024","22604",,,"Fire, Burglary, and WIBA","Expense","Fire, Burglary, and WIBA",,"Prepaid Expenses",24026.42,"",72079.26
,"General Journal","04-04-2024","22998",,,"Fire, Burglary, and WIBA","Expense","Fire, Burglary, and WIBA",,"Prepaid Expenses",24026.42,"",96105.68
,"General Journal","04-05-2024","23389",,,"Fire, Burglary, and WIBA","Expense","Fire, Burglary, and WIBA",,"Prepaid Expenses",24026.42,"",120132.10
,"General Journal","09-05-2024","23549",,,"Fire, Burglary, Employer Liability and WIBA","Expense","Fire, Burglary, and WIBA",,"Prepaid Expenses",20735.58,"",140867.68
,"General Journal","09-06-2024","23847",,,"Fire, Burglary, Employer Liability and WIBA","Expense","Fire, Burglary, and WIBA",,"Prepaid Expenses",20735.58,"",161603.26
,"General Journal","09-07-2024","24223",,,"Fire, Burglary, Employer Liability and WIBA","Expense","Fire, Burglary, and WIBA",,"Prepaid Expenses",20735.58,"",182338.84
,"General Journal","09-08-2024","24634",,,"Fire, Burglary, Employer Liability and WIBA","Expense","Fire, Burglary, and WIBA",,"Prepaid Expenses",20735.58,"",203074.42
,"General Journal","09-09-2024","25008",,,"Fire, Burglary, Employer Liability and WIBA","Expense","Fire, Burglary, and WIBA",,"Prepaid Expenses",20735.58,"",223810.00
,"General Journal","09-10-2024","25450",,,"Fire, Burglary, Employer Liability and WIBA","Expense","Fire, Burglary, and WIBA",,"Prepaid Expenses",20735.58,"",244545.58
,"General Journal","09-11-2024","25821",,,"Fire, Burglary, Employer Liability and WIBA","Expense","Fire, Burglary, and WIBA",,"Prepaid Expenses",20735.58,"",265281.16
,"General Journal","09-12-2024","26186",,,"Fire, Burglary, Employer Liability and WIBA","Expense","Fire, Burglary, and WIBA",,"Prepaid Expenses",20735.58,"",286016.74
"Total Fire, Burglary, and WIBA",,,,,,,,,,,286016.74,0.00,286016.74
"Motor Vehicle Insurance",,,,,,,,,,,,,""
,"General Journal","04-01-2024","21863",,,"Motor Vehicle 2 Insurance","Expense","Motor Vehicle Insurance",,"Prepaid Expenses",3733.42,"",3733.42
,"General Journal","27-01-2024","22163","*",,"Motor Vehicle 4 Insurance","Expense","Motor Vehicle Insurance",,"Prepaid Expenses",11568.75,"",15302.17
,"General Journal","04-02-2024","22246",,,"Motor Vehicle 2 Insurance","Expense","Motor Vehicle Insurance",,"Prepaid Expenses",3733.42,"",19035.59
,"General Journal","20-02-2024","23773",,,"Motor Vehicle 4 Insurance","Expense","Motor Vehicle Insurance",,"Prepaid Expenses",11568.75,"",30604.34
,"General Journal","04-03-2024","22612",,,"Motor Vehicle 2 Insurance","Expense","Motor Vehicle Insurance",,"Prepaid Expenses",3733.42,"",34337.76
,"General Journal","20-03-2024","23781",,,"Motor Vehicle 4 Insurance","Expense","Motor Vehicle Insurance",,"Prepaid Expenses",11568.75,"",45906.51
,"General Journal","25-03-2024","23774",,,"Motor Vehicle 2 Insurance","Expense","Motor Vehicle Insurance",,"Prepaid Expenses",3766.92,"",49673.43
,"General Journal","20-04-2024","23782",,,"Motor Vehicle 4 Insurance","Expense","Motor Vehicle Insurance",,"Prepaid Expenses",11568.75,"",61242.18
,"General Journal","25-04-2024","23779",,,"Motor Vehicle 2 Insurance","Expense","Motor Vehicle Insurance",,"Prepaid Expenses",3766.92,"",65009.10
,"General Journal","20-05-2024","23783",,,"Motor Vehicle 4 Insurance","Expense","Motor Vehicle Insurance",,"Prepaid Expenses",11568.75,"",76577.85
,"General Journal","25-05-2024","23780",,,"Motor Vehicle 2 Insurance","Expense","Motor Vehicle Insurance",,"Prepaid Expenses",3766.92,"",80344.77
,"General Journal","20-06-2024","24014",,,"Motor Vehicle 4 Insurance","Expense","Motor Vehicle Insurance",,"Prepaid Expenses",11568.75,"",91913.52
,"General Journal","24-06-2024","24351",,,"Bajaj Boxer BM150 UG Insurance","Expense","Motor Vehicle Insurance",,"Prepaid Expenses",647.83,"",92561.35
,"General Journal","25-06-2024","24082",,,"Motor Vehicle 2 Insurance","Expense","Motor Vehicle Insurance",,"Prepaid Expenses",3766.92,"",96328.27
,"General Journal","20-07-2024","24380",,,"Motor Vehicle 4 Insurance","Expense","Motor Vehicle Insurance",,"Prepaid Expenses",11568.75,"",107897.02
,"General Journal","24-07-2024","24432",,,"Bajaj Boxer BM150 UG Insurance","Expense","Motor Vehicle Insurance",,"Prepaid Expenses",647.83,"",108544.85
,"General Journal","25-07-2024","24462",,,"Motor Vehicle 2 Insurance","Expense","Motor Vehicle Insurance",,"Prepaid Expenses",3766.92,"",112311.77
,"General Journal","20-08-2024","24799",,,"Motor Vehicle 4 Insurance","Expense","Motor Vehicle Insurance",,"Prepaid Expenses",11568.75,"",123880.52
,"General Journal","24-08-2024","24848",,,"Bajaj Boxer BM150 UG Insurance","Expense","Motor Vehicle Insurance",,"Prepaid Expenses",647.83,"",124528.35
,"General Journal","25-08-2024","24867",,,"Motor Vehicle 2 Insurance","Expense","Motor Vehicle Insurance",,"Prepaid Expenses",3766.92,"",128295.27
,"General Journal","20-09-2024","25228",,,"Motor Vehicle 4 Insurance","Expense","Motor Vehicle Insurance",,"Prepaid Expenses",11568.75,"",139864.02
,"General Journal","24-09-2024","25278",,,"Bajaj Boxer BM150 UG Insurance","Expense","Motor Vehicle Insurance",,"Prepaid Expenses",647.83,"",140511.85
,"General Journal","25-09-2024","25293",,,"Motor Vehicle 2 Insurance","Expense","Motor Vehicle Insurance",,"Prepaid Expenses",3766.92,"",144278.77
,"General Journal","20-10-2024","25621",,,"Motor Vehicle 4 Insurance","Expense","Motor Vehicle Insurance",,"Prepaid Expenses",11568.75,"",155847.52
,"General Journal","24-10-2024","25651",,,"Bajaj Boxer BM150 UG Insurance","Expense","Motor Vehicle Insurance",,"Prepaid Expenses",647.83,"",156495.35
,"General Journal","25-10-2024","25667",,,"Motor Vehicle 2 Insurance","Expense","Motor Vehicle Insurance",,"Prepaid Expenses",3766.92,"",160262.27
,"General Journal","20-11-2024","25958",,,"Motor Vehicle 4 Insurance","Expense","Motor Vehicle Insurance",,"Prepaid Expenses",11568.75,"",171831.02
,"General Journal","24-11-2024","26006",,,"Bajaj Boxer BM150 UG Insurance","Expense","Motor Vehicle Insurance",,"Prepaid Expenses",647.83,"",172478.85
,"General Journal","25-11-2024","26019",,,"Motor Vehicle 2 Insurance","Expense","Motor Vehicle Insurance",,"Prepaid Expenses",3766.92,"",176245.77
,"General Journal","20-12-2024","26319",,,"Motor Vehicle 4 Insurance","Expense","Motor Vehicle Insurance",,"Prepaid Expenses",11568.75,"",187814.52
,"General Journal","24-12-2024","26368",,,"Bajaj Boxer BM150 UG Insurance","Expense","Motor Vehicle Insurance",,"Prepaid Expenses",647.83,"",188462.35
,"General Journal","25-12-2024","26425",,,"Motor Vehicle 2 Insurance","Expense","Motor Vehicle Insurance",,"Prepaid Expenses",3766.92,"",192229.27
"Total Motor Vehicle Insurance",,,,,,,,,,,192229.27,0.00,192229.27
"Total Insurance Expense",,,,,,,,,,,478246.01,0.00,478246.01
"Meals and Entertainment",,,,,,,,,,,,,""
,"Cheque","02-01-2024","02012024",,,"bread","Expense","Meals and Entertainment",,"MPESA Account",325.00,"",325.00
,"Bill","04-01-2024","0412401040111220119",,"Quick Mart Limited","Milk","Expense","Meals and Entertainment",,"Accounts Payable",6720.00,"",7045.00
,"Cheque","06-01-2024","P1777",,,"bread","Expense","Meals and Entertainment",,"MPESA Account",325.00,"",7370.00
,"Cheque","09-01-2024","209",,"Al-Aksa Wholesalers","Sugar","Expense","Meals and Entertainment",,"MPESA Account",8100.00,"",15470.00
,"Cheque","09-01-2024","317",,"Sangonett Merchants","Staff snacks","Expense","Meals and Entertainment",,"MPESA Account",6350.00,"",21820.00
,"Cheque","13-01-2024","P1787",,,"bread","Expense","Meals and Entertainment",,"MPESA Account",455.00,"",22275.00
,"Cheque","15-01-2024","SO-15012440",,"Mbuzi Munch","Meal","Expense","Meals and Entertainment",,"Cash Account",500.00,"",22775.00
,"Cheque","17-01-2024","318",,"Sangonett Merchants","Staff snacks","Expense","Meals and Entertainment",,"MPESA Account",7110.00,"",29885.00
,"Cheque","19-01-2024","830",,"VCS Restaurant","Lunch","Expense","Meals and Entertainment",,"MPESA Account",2640.00,"",32525.00
,"Cheque","19-01-2024","831",,"VCS Restaurant","Lunch","Expense","Meals and Entertainment",,"MPESA Account",220.00,"",32745.00
,"Cheque","19-01-2024","27518",,"Mainspring Ventures Ltd","lunch","Expense","Meals and Entertainment",,"MPESA Account",200.00,"",32945.00
,"Bill","19-01-2024","041240119021282005",,"Quick Mart Limited","Milk","Expense","Meals and Entertainment",,"Accounts Payable",7320.00,"",40265.00
,"Bill","19-01-2024","0090968850000068024",,"Flavor Town Cafe Kenya Ltd","-MULTIPLE-","Expense","Meals and Entertainment",,"Accounts Payable",2550.00,"",42815.00
,"Bill","19-01-2024","0040805450000297975",,"Naivas Ltd","meals","Expense","Meals and Entertainment",,"Accounts Payable",343.10,"",43158.10
,"Cheque","20-01-2024","P1799",,,"bread","Expense","Meals and Entertainment",,"MPESA Account",450.00,"",43608.10
,"Cheque","22-01-2024","220124",,,"Bread","Expense","Meals and Entertainment",,"MPESA Account",65.00,"",43673.10
,"Cheque","24-01-2024","240124",,,"bread","Expense","Meals and Entertainment",,"MPESA Account",130.00,"",43803.10
,"Cheque","24-01-2024","319",,"Sangonett Merchants","Staff snacks","Expense","Meals and Entertainment",,"MPESA Account",7180.00,"",50983.10
,"Cheque","26-01-2024","P1816",,,"bread","Expense","Meals and Entertainment",,"MPESA Account",130.00,"",51113.10
,"Cheque","27-01-2024","270124",,,"bread","Expense","Meals and Entertainment",,"MPESA Account",320.00,"",51433.10
,"Cheque","27-01-2024","P1811",,,"bread","Expense","Meals and Entertainment",,"MPESA Account",325.00,"",51758.10
,"Cheque","29-01-2024","290124",,,"bread","Expense","Meals and Entertainment",,"MPESA Account",130.00,"",51888.10
,"Cheque","29-01-2024","29012024",,,"bread","Expense","Meals and Entertainment",,"MPESA Account",65.00,"",51953.10
,"Cheque","30-01-2024","P1819",,,"bread","Expense","Meals and Entertainment",,"MPESA Account",65.00,"",52018.10
,"Cheque","31-01-2024","310124",,,"bread","Expense","Meals and Entertainment",,"MPESA Account",65.00,"",52083.10
,"Cheque","31-01-2024","322",,"Sangonett Merchants","Staff snacks","Expense","Meals and Entertainment",,"MPESA Account",5470.00,"",57553.10
,"Cheque","01-02-2024","P1822",,,"bread","Expense","Meals and Entertainment",,"MPESA Account",130.00,"",57683.10
,"Bill","02-02-2024","0412402020213080032",,"Quick Mart Limited","Milk","Expense","Meals and Entertainment",,"Accounts Payable",7160.00,"",64843.10
,"Cheque","02-02-2024","020224",,,"bread","Expense","Meals and Entertainment",,"MPESA Account",130.00,"",64973.10
,"Cheque","02-02-2024","02022024",,,"bread","Expense","Meals and Entertainment",,"MPESA Account",65.00,"",65038.10
,"Cheque","03-02-2024","030224",,,"bread","Expense","Meals and Entertainment",,"MPESA Account",325.00,"",65363.10
,"Cheque","04-02-2024","040224",,,"bread","Expense","Meals and Entertainment",,"MPESA Account",125.00,"",65488.10
,"Cheque","04-02-2024","04022024",,,"bread","Expense","Meals and Entertainment",,"MPESA Account",100.00,"",65588.10
,"Cheque","05-02-2024","050224",,,"bread","Expense","Meals and Entertainment",,"MPESA Account",65.00,"",65653.10
,"Cheque","05-02-2024","P1824",,,"bread","Expense","Meals and Entertainment",,"MPESA Account",130.00,"",65783.10
,"Cheque","06-02-2024","060224",,,"bread","Expense","Meals and Entertainment",,"MPESA Account",130.00,"",65913.10
,"Cheque","08-02-2024","323",,"Sangonett Merchants","Staff snacks","Expense","Meals and Entertainment",,"MPESA Account",5800.00,"",71713.10
,"Cheque","09-02-2024","090224",,,"bread","Expense","Meals and Entertainment",,"MPESA Account",130.00,"",71843.10
,"Cheque","10-02-2024","100224",,,"bread","Expense","Meals and Entertainment",,"MPESA Account",340.00,"",72183.10
,"Cheque","11-02-2024","P1832",,,"bread","Expense","Meals and Entertainment",,"MPESA Account",260.00,"",72443.10
,"Cheque","12-02-2024","6439",,"Frant Matt Wholesalers","50kg Sugar","Expense","Meals and Entertainment",,"MPESA Account",7200.00,"",79643.10
,"Cheque","12-02-2024","P1838",,,"bread","Expense","Meals and Entertainment",,"MPESA Account",490.00,"",80133.10
,"Cheque","13-02-2024","130224",,,"bread","Expense","Meals and Entertainment",,"MPESA Account",65.00,"",80198.10
,"Cheque","13-02-2024","2475",,"VCS Restaurant","Lunch","Expense","Meals and Entertainment",,"MPESA Account",420.00,"",80618.10
,"Cheque","14-02-2024","0015",,"County Wholesalers","tea leaves","Expense","Meals and Entertainment",,"MPESA Account",480.00,"",81098.10
,"Cheque","14-02-2024","P1846",,,"bread","Expense","Meals and Entertainment",,"MPESA Account",260.00,"",81358.10
,"Cheque","15-02-2024","150224",,,"bread","Expense","Meals and Entertainment",,"MPESA Account",130.00,"",81488.10
,"Cheque","16-02-2024","0038",,"County Wholesalers","bread","Expense","Meals and Entertainment",,"MPESA Account",520.00,"",82008.10
,"Cheque","16-02-2024","2716",,"VCS Restaurant","Lunch","Expense","Meals and Entertainment",,"MPESA Account",3280.00,"",85288.10
,"Cheque","19-02-2024","326",,"Sangonett Merchants","Staff snacks","Expense","Meals and Entertainment",,"MPESA Account",7110.00,"",92398.10
,"Bill","19-02-2024","0040805450000340783",,"Naivas Ltd","Milk","Expense","Meals and Entertainment",,"Accounts Payable",6600.00,"",98998.10
,"Cheque","19-02-2024","190224",,,"bread","Expense","Meals and Entertainment",,"MPESA Account",195.00,"",99193.10
,"Cheque","19-02-2024","1902241",,,"bread","Expense","Meals and Entertainment",,"MPESA Account",130.00,"",99323.10
,"Cheque","20-02-2024","200224",,,"bread","Expense","Meals and Entertainment",,"MPESA Account",65.00,"",99388.10
,"Cheque","21-02-2024","210224",,"County Wholesalers","bread","Expense","Meals and Entertainment",,"MPESA Account",260.00,"",99648.10
,"Cheque","23-02-2024","230224",,,"bread","Expense","Meals and Entertainment",,"MPESA Account",520.00,"",100168.10
,"Cheque","26-02-2024","260224",,,"bread","Expense","Meals and Entertainment",,"MPESA Account",260.00,"",100428.10
,"Cheque","27-02-2024","3411",,"VCS Restaurant","Lunch","Expense","Meals and Entertainment",,"MPESA Account",470.00,"",100898.10
,"Cheque","28-02-2024","P1874",,,"bread","Expense","Meals and Entertainment",,"MPESA Account",130.00,"",101028.10
,"Cheque","29-02-2024","0026",,"County Wholesalers","bread","Expense","Meals and Entertainment",,"MPESA Account",260.00,"",101288.10
,"Cheque","29-02-2024","327",,"Sangonett Merchants","Staff snacks","Expense","Meals and Entertainment",,"MPESA Account",8550.00,"",109838.10
,"Cheque","02-03-2024","0044",,"County Wholesalers","bread","Expense","Meals and Entertainment",,"MPESA Account",390.00,"",110228.10
,"Cheque","04-03-2024","040324",,,"bread","Expense","Meals and Entertainment",,"MPESA Account",260.00,"",110488.10
,"Cheque","06-03-2024","0038",,"County Wholesalers","bread","Expense","Meals and Entertainment",,"MPESA Account",260.00,"",110748.10
,"Bill","06-03-2024","0110395040000598650",,"Quick Mart Limited","Milk and tea leaves","Expense","Meals and Entertainment",,"Accounts Payable",7154.48,"",117902.58
,"Cheque","08-03-2024","328",,"Sangonett Merchants","Staff snacks","Expense","Meals and Entertainment",,"MPESA Account",6440.00,"",124342.58
,"Cheque","08-03-2024","080324",,,"bread","Expense","Meals and Entertainment",,"MPESA Account",455.00,"",124797.58
,"Cheque","11-03-2024","0042",,"County Wholesalers","bread","Expense","Meals and Entertainment",,"MPESA Account",280.00,"",125077.58
,"Cheque","11-03-2024","RSL-4199",,"VCS Restaurant","Lunch","Expense","Meals and Entertainment",,"MPESA Account",450.00,"",125527.58
,"Cheque","11-03-2024","RSL-4200",,"VCS Restaurant","Lunch","Expense","Meals and Entertainment",,"MPESA Account",20.00,"",125547.58
,"Cheque","13-03-2024","P1890",,,"bread","Expense","Meals and Entertainment",,"MPESA Account",260.00,"",125807.58
,"Cheque","15-03-2024","150324",,,"bread","Expense","Meals and Entertainment",,"MPESA Account",520.00,"",126327.58
,"Cheque","15-03-2024","4519",,"VCS Restaurant","Lunch","Expense","Meals and Entertainment",,"MPESA Account",2490.00,"",128817.58
,"Cheque","15-03-2024","331",,"Sangonett Merchants","Staff snacks","Expense","Meals and Entertainment",,"MPESA Account",5800.00,"",134617.58
,"Cheque","18-03-2024","0023",,"County Wholesalers","bread","Expense","Meals and Entertainment",,"MPESA Account",65.00,"",134682.58
,"Cheque","18-03-2024","130324",,,"bread","Expense","Meals and Entertainment",,"MPESA Account",320.00,"",135002.58
,"Cheque","20-03-2024","20032024",,,"bread","Expense","Meals and Entertainment",,"MPESA Account",390.00,"",135392.58
,"Cheque","22-03-2024","22032024",,,"bread","Expense","Meals and Entertainment",,"MPESA Account",130.00,"",135522.58
,"Cheque","22-03-2024","332",,"Sangonett Merchants","Staff snacks","Expense","Meals and Entertainment",,"MPESA Account",5770.00,"",141292.58
,"Cheque","23-03-2024","0012",,"County Wholesalers","bread","Expense","Meals and Entertainment",,"MPESA Account",65.00,"",141357.58
,"Cheque","23-03-2024","P1912",,,"bread","Expense","Meals and Entertainment",,"MPESA Account",585.00,"",141942.58
,"Bill","25-03-2024","0040806220000278813",,"Quick Mart Limited","Bread","Expense","Meals and Entertainment",,"Accounts Payable",455.00,"",142397.58
,"Bill","25-03-2024","0040806220000278779",,"Quick Mart Limited","-MULTIPLE-","Expense","Meals and Entertainment",,"Accounts Payable",7154.48,"",149552.06
,"Cheque","26-03-2024","P1920",,,"bread","Expense","Meals and Entertainment",,"MPESA Account",30.00,"",149582.06
,"Cheque","27-03-2024","RSL-5192",,"VCS Restaurant","Lunch","Expense","Meals and Entertainment",,"MPESA Account",270.00,"",149852.06
,"Cheque","27-03-2024","27032024",,,"bread","Expense","Meals and Entertainment",,"MPESA Account",325.00,"",150177.06
,"Bill","28-03-2024","0040806220000300167",,"Quick Mart Limited","Bread","Expense","Meals and Entertainment",,"Accounts Payable",650.00,"",150827.06
,"Cheque","28-03-2024","334",,"Sangonett Merchants","Staff snacks","Expense","Meals and Entertainment",,"MPESA Account",4800.00,"",155627.06
,"Cheque","02-04-2024","02042024",,,"bread","Expense","Meals and Entertainment",,"MPESA Account",260.00,"",155887.06
,"Cheque","03-04-2024","0039",,"County Wholesalers","bread","Expense","Meals and Entertainment",,"MPESA Account",130.00,"",156017.06
,"Cheque","05-04-2024","05042024",,,"bread","Expense","Meals and Entertainment",,"MPESA Account",195.00,"",156212.06
,"Cheque","05-04-2024","04042024",,,"bread","Expense","Meals and Entertainment",,"MPESA Account",325.00,"",156537.06
,"Cheque","05-04-2024","336",,"Sangonett Merchants","Staff snacks","Expense","Meals and Entertainment",,"MPESA Account",4520.00,"",161057.06
,"Cheque","08-04-2024","0037057",,"Tawakal Store Mareba","Sugar","Expense","Meals and Entertainment",,"MPESA Account",6150.00,"",167207.06
,"Cheque","08-04-2024","226",,"Al-Aksa Wholesalers","bread","Expense","Meals and Entertainment",,"MPESA Account",325.00,"",167532.06
,"Cheque","09-04-2024","SD99O8DZOF",,,"bread","Expense","Meals and Entertainment",,"MPESA Account",130.00,"",167662.06
,"Cheque","10-04-2024","P1961",,,"bread","Expense","Meals and Entertainment",,"MPESA Account",195.00,"",167857.06
,"Cheque","11-04-2024","11042024",,,"bread","Expense","Meals and Entertainment",,"MPESA Account",390.00,"",168247.06
,"Cheque","11-04-2024","RSL-5942",,"VCS Restaurant","Lunch","Expense","Meals and Entertainment",,"MPESA Account",1100.00,"",169347.06
,"Cheque","12-04-2024","RSL-6039",,"VCS Restaurant","Lunch","Expense","Meals and Entertainment",,"MPESA Account",3630.00,"",172977.06
,"Cheque","12-04-2024","338",,"Sangonett Merchants","Staff snacks","Expense","Meals and Entertainment",,"MPESA Account",4200.00,"",177177.06
,"Cheque","12-04-2024","RSL-6058",,"VCS Restaurant","Lunch","Expense","Meals and Entertainment",,"Cash Account",100.00,"",177277.06
,"Cheque","13-04-2024","0028",,"County Wholesalers","bread","Expense","Meals and Entertainment",,"MPESA Account",195.00,"",177472.06
,"Cheque","15-04-2024","15042024",,,"bread","Expense","Meals and Entertainment",,"MPESA Account",390.00,"",177862.06
,"Cheque","15-04-2024","RSL-6120",,"VCS Restaurant","Lunch","Expense","Meals and Entertainment",,"MPESA Account",2150.00,"",180012.06
,"Cheque","16-04-2024","RSL-6232",,"VCS Restaurant","Lunch","Expense","Meals and Entertainment",,"MPESA Account",2250.00,"",182262.06
,"Bill","16-04-2024","0040805450000402313",,"Naivas Ltd","Milk","Expense","Meals and Entertainment",,"Accounts Payable",6600.00,"",188862.06
,"Cheque","17-04-2024","RSL-6323",,"VCS Restaurant","Lunch","Expense","Meals and Entertainment",,"MPESA Account",2250.00,"",191112.06
,"Cheque","17-04-2024","0025",,"County Wholesalers","tea leaves","Expense","Meals and Entertainment",,"MPESA Account",480.00,"",191592.06
,"Cheque","17-04-2024","17042024",,,"bread","Expense","Meals and Entertainment",,"MPESA Account",325.00,"",191917.06
,"Cheque","18-04-2024","RSL-6406",,"VCS Restaurant","Lunch","Expense","Meals and Entertainment",,"MPESA Account",2250.00,"",194167.06
,"Cheque","18-04-2024","34034",,"Mainspring Ventures Ltd","bread","Expense","Meals and Entertainment",,"MPESA Account",130.00,"",194297.06
,"Cheque","19-04-2024","339",,"Sangonett Merchants","Staff snacks","Expense","Meals and Entertainment",,"MPESA Account",5750.00,"",200047.06
,"Bill","19-04-2024","0040804700001056517",,"Quick Mart Limited","Bread","Expense","Meals and Entertainment",,"Accounts Payable",325.00,"",200372.06
,"Cheque","19-04-2024","RSL-6491",,"VCS Restaurant","Lunch","Expense","Meals and Entertainment",,"MPESA Account",2890.00,"",203262.06
,"Cheque","19-04-2024","61945898",,"Mainspring Ventures Ltd","lunch","Expense","Meals and Entertainment",,"MPESA Account",70.00,"",203332.06
,"Cheque","22-04-2024","0075",,"County Wholesalers","bread","Expense","Meals and Entertainment",,"MPESA Account",65.00,"",203397.06
,"Cheque","22-04-2024","220424",,,"bread","Expense","Meals and Entertainment",,"MPESA Account",260.00,"",203657.06
,"Bill","24-04-2024","0040093550000871100",,"Naivas Ltd","drinking water and sponge","Expense","Meals and Entertainment",,"Accounts Payable",872.41,"",204529.47
,"Cheque","24-04-2024","0124",,"County Wholesalers","bread","Expense","Meals and Entertainment",,"MPESA Account",215.00,"",204744.47
,"Cheque","24-04-2024","240424",,,"bread","Expense","Meals and Entertainment",,"MPESA Account",195.00,"",204939.47
,"Cheque","25-04-2024","210324",,,"bread","Expense","Meals and Entertainment",,"MPESA Account",130.00,"",205069.47
,"Cheque","26-04-2024","340",,"Sangonett Merchants","Staff snacks","Expense","Meals and Entertainment",,"MPESA Account",5650.00,"",210719.47
,"Cheque","26-04-2024","0098",,"County Wholesalers","bread","Expense","Meals and Entertainment",,"MPESA Account",325.00,"",211044.47
,"Cheque","29-04-2024","290424",,,"bread","Expense","Meals and Entertainment",,"MPESA Account",390.00,"",211434.47
,"Cheque","02-05-2024","020524",,,"bread","Expense","Meals and Entertainment",,"MPESA Account",325.00,"",211759.47
,"Cheque","04-05-2024","0022",,"County Wholesalers","bread","Expense","Meals and Entertainment",,"MPESA Account",390.00,"",212149.47
,"Bill","06-05-2024","0040804700001257675",,"Quick Mart Limited","Milk, bread, and tea leaves","Expense","Meals and Entertainment",,"Accounts Payable",8093.28,"",220242.75
,"Cheque","07-05-2024","341",,"Sangonett Merchants","Staff snacks","Expense","Meals and Entertainment",,"MPESA Account",6780.00,"",227022.75
,"Cheque","07-05-2024","070524",,,"bread","Expense","Meals and Entertainment",,"MPESA Account",130.00,"",227152.75
,"Cheque","08-05-2024","080524",,,"bread","Expense","Meals and Entertainment",,"MPESA Account",260.00,"",227412.75
,"Cheque","10-05-2024","100524",,,"bread","Expense","Meals and Entertainment",,"MPESA Account",1430.00,"",228842.75
,"Cheque","12-05-2024","P2024",,,"bread","Expense","Meals and Entertainment",,"MPESA Account",65.00,"",228907.75
,"Cheque","13-05-2024","130524",,,"bread","Expense","Meals and Entertainment",,"MPESA Account",390.00,"",229297.75
,"Cheque","13-05-2024","RSL-7957",,"VCS Restaurant","Lunch","Expense","Meals and Entertainment",,"MPESA Account",540.00,"",229837.75
,"Cheque","15-05-2024","345",,"Sangonett Merchants","Staff snacks","Expense","Meals and Entertainment",,"MPESA Account",5650.00,"",235487.75
,"Cheque","15-05-2024","P2031",,,"bread","Expense","Meals and Entertainment",,"MPESA Account",390.00,"",235877.75
,"Cheque","17-05-2024","P2037",,,"bread","Expense","Meals and Entertainment",,"MPESA Account",390.00,"",236267.75
,"Cheque","17-05-2024","RSL-8338",,"VCS Restaurant","Lunch","Expense","Meals and Entertainment",,"MPESA Account",2420.00,"",238687.75
,"Cheque","17-05-2024","35214",,"Mainspring Ventures Ltd","lunch","Expense","Meals and Entertainment",,"MPESA Account",200.00,"",238887.75
,"Bill","20-05-2024","0040093550000993337",,"Naivas Ltd","drinking water and Machine wash","Expense","Meals and Entertainment",,"Accounts Payable",3583.62,"",242471.37
,"Cheque","20-05-2024","P2042",,,"bread","Expense","Meals and Entertainment",,"MPESA Account",390.00,"",242861.37
,"Cheque","21-05-2024","210524",,,"bread","Expense","Meals and Entertainment",,"MPESA Account",195.00,"",243056.37
,"Cheque","22-05-2024","220524",,,"bread","Expense","Meals and Entertainment",,"MPESA Account",325.00,"",243381.37
,"Bill","22-05-2024","0110687270000001231",,"Bedmarc Caterers Ltd","Lunch","Expense","Meals and Entertainment",,"Accounts Payable",310.34,"",243691.71
,"Bill","24-05-2024","0110159290001003070",,"Quick Mart Limited","Milk and bread","Expense","Meals and Entertainment",,"Accounts Payable",7710.00,"",251401.71
,"Cheque","24-05-2024","348",,"Sangonett Merchants","Staff snacks","Expense","Meals and Entertainment",,"MPESA Account",7640.00,"",259041.71
,"Cheque","27-05-2024","270524",,,"bread","Expense","Meals and Entertainment",,"MPESA Account",390.00,"",259431.71
,"Cheque","29-05-2024","290524",,,"bread","Expense","Meals and Entertainment",,"MPESA Account",325.00,"",259756.71
,"Cheque","30-05-2024","300524",,,"bread","Expense","Meals and Entertainment",,"MPESA Account",260.00,"",260016.71
,"Cheque","31-05-2024","349",,"Sangonett Merchants","Staff snacks","Expense","Meals and Entertainment",,"MPESA Account",5890.00,"",265906.71
,"Cheque","31-05-2024",,,"Carrefour","Water","Expense","Meals and Entertainment",,"Cash Account",1458.00,"",267364.71
,"Cheque","01-06-2024","SF161YMGEO",,,"bread","Expense","Meals and Entertainment",,"MPESA Account",195.00,"",267559.71
,"Bill","02-06-2024","0020098990000028734",,"Nairobi Java House Ltd","meal","Expense","Meals and Entertainment",,"Accounts Payable",8644.03,"",276203.74
,"Cheque","03-06-2024","P2073",,,"bread","Expense","Meals and Entertainment",,"MPESA Account",390.00,"",276593.74
,"Cheque","04-06-2024","0025",,"County Wholesalers","tea leaves","Expense","Meals and Entertainment",,"MPESA Account",480.00,"",277073.74
,"Cheque","05-06-2024","SF52GZQ8MU",,,"bread","Expense","Meals and Entertainment",,"MPESA Account",325.00,"",277398.74
,"Cheque","06-06-2024","351",,"Sangonett Merchants","Staff snacks","Expense","Meals and Entertainment",,"MPESA Account",5350.00,"",282748.74
,"Cheque","07-06-2024","P2092",,,"bread","Expense","Meals and Entertainment",,"MPESA Account",325.00,"",283073.74
,"Cheque","10-06-2024","SFA911OU2L",,,"bread","Expense","Meals and Entertainment",,"MPESA Account",390.00,"",283463.74
,"Cheque","12-06-2024","SFC1842J8F",,,"bread","Expense","Meals and Entertainment",,"MPESA Account",325.00,"",283788.74
,"Bill","12-06-2024","0110159290001032688",,"Quick Mart Limited","Milk","Expense","Meals and Entertainment",,"Accounts Payable",7320.00,"",291108.74
,"Cheque","12-06-2024","SFC28ODH96",,"County Wholesalers","tea leaves","Expense","Meals and Entertainment",,"MPESA Account",480.00,"",291588.74
,"Cheque","14-06-2024","352",,"Sangonett Merchants","Staff snacks","Expense","Meals and Entertainment",,"MPESA Account",5840.00,"",297428.74
,"Cheque","14-06-2024","10513",,"VCS Restaurant","Lunch","Expense","Meals and Entertainment",,"MPESA Account",2720.00,"",300148.74
,"Cheque","14-06-2024","61845555",,"Mainspring Ventures Ltd","lunch","Expense","Meals and Entertainment",,"MPESA Account",200.00,"",300348.74
,"Cheque","14-06-2024","SFE8HQ99A2",,,"bread","Expense","Meals and Entertainment",,"MPESA Account",390.00,"",300738.74
,"Cheque","16-06-2024","SFG7OPA63J",,,"bread","Expense","Meals and Entertainment",,"MPESA Account",130.00,"",300868.74
,"Bill","16-06-2024","0021994570000009171",,"Asmara Entertainment Limited","meals","Expense","Meals and Entertainment",,"Accounts Payable",5211.87,"",306080.61
,"Cheque","18-06-2024","SFI8WJ21T0",,,"bread","Expense","Meals and Entertainment",,"MPESA Account",130.00,"",306210.61
,"Bill","19-06-2024","0040798680000427953",,"Naivas Ltd","drinking water","Expense","Meals and Entertainment",,"Accounts Payable",1241.38,"",307451.99
,"Bill","19-06-2024","0110159290001043546",,"Quick Mart Limited","Bread","Expense","Meals and Entertainment",,"Accounts Payable",260.00,"",307711.99
,"Cheque","21-06-2024","353",,"Sangonett Merchants","Staff snacks","Expense","Meals and Entertainment",,"MPESA Account",4640.00,"",312351.99
,"Cheque","21-06-2024","0039",,"County Wholesalers","bread","Expense","Meals and Entertainment",,"MPESA Account",195.00,"",312546.99
,"Cheque","21-06-2024","SFL76BU7UD",,,"bread","Expense","Meals and Entertainment",,"MPESA Account",195.00,"",312741.99
,"Cheque","22-06-2024","SFM8BZSLQM",,,"bread","Expense","Meals and Entertainment",,"MPESA Account",120.00,"",312861.99
,"Bill","23-06-2024","0090968860000202125",,"Flavor Town Cafe Kenya Ltd","-MULTIPLE-","Expense","Meals and Entertainment",,"Accounts Payable",5532.20,"",318394.19
,"Cheque","24-06-2024","SFO8H0S3HI",,,"bread","Expense","Meals and Entertainment",,"MPESA Account",390.00,"",318784.19
,"Cheque","26-06-2024","SFQ2NIJ6M4",,,"bread","Expense","Meals and Entertainment",,"MPESA Account",325.00,"",319109.19
,"Cheque","28-06-2024","355",,"Sangonett Merchants","Staff snacks","Expense","Meals and Entertainment",,"MPESA Account",4340.00,"",323449.19
,"Cheque","28-06-2024","SFS8WGO3YY",,,"bread","Expense","Meals and Entertainment",,"MPESA Account",325.00,"",323774.19
,"Bill","28-06-2024","0020098470000270580",,"Nairobi Java House Ltd","meal","Expense","Meals and Entertainment",,"Accounts Payable",1063.22,"",324837.41
,"Cheque","30-06-2024","21554",,"Pabiro's Cofee & Snack Shop","Breakfast","Expense","Meals and Entertainment",,"Cash Account",530.00,"",325367.41
,"Cheque","01-07-2024","SG14722846",,,"bread","Expense","Meals and Entertainment",,"MPESA Account",390.00,"",325757.41
,"Cheque","02-07-2024","0037774",,"Tawakal Store Mareba","Sugar","Expense","Meals and Entertainment",,"MPESA Account",6350.00,"",332107.41
,"Bill","02-07-2024","0110159290001063891",,"Quick Mart Limited","Milk","Expense","Meals and Entertainment",,"Accounts Payable",6720.00,"",338827.41
,"Bill","03-07-2024","0020099690000045831",,"Panafric Hotels Ltd","-MULTIPLE-","Expense","Meals and Entertainment",,"Accounts Payable",9110.48,"",347937.89
,"Cheque","05-07-2024","SG58OKZXDS",,,"bread","Expense","Meals and Entertainment",,"MPESA Account",325.00,"",348262.89
,"Cheque","05-07-2024","P2137",,,"bread","Expense","Meals and Entertainment",,"MPESA Account",130.00,"",348392.89
,"Bill","05-07-2024","0020102050000132830",,"Simbisa Brands (K) Limited","meal","Expense","Meals and Entertainment",,"VAT Payable",1050.84,"",349443.73
,"Cheque","08-07-2024","356",,"Sangonett Merchants","Staff snacks","Expense","Meals and Entertainment",,"MPESA Account",6150.00,"",355593.73
,"Cheque","08-07-2024","SG84XW7R1Y",,,"bread","Expense","Meals and Entertainment",,"MPESA Account",390.00,"",355983.73
,"Cheque","08-07-2024","P2141",,,"bread","Expense","Meals and Entertainment",,"MPESA Account",325.00,"",356308.73
,"Cheque","10-07-2024","SGA06RTTYK",,,"bread","Expense","Meals and Entertainment",,"MPESA Account",325.00,"",356633.73
,"Cheque","12-07-2024","RSL-12318",,"VCS Restaurant","Lunch","Expense","Meals and Entertainment",,"MPESA Account",1950.00,"",358583.73
,"Cheque","12-07-2024","61847799",,"Mainspring Ventures Ltd","lunch","Expense","Meals and Entertainment",,"MPESA Account",200.00,"",358783.73
,"Bill","12-07-2024","0090968860000238200",,"Flavor Town Cafe Kenya Ltd","-MULTIPLE-","Expense","Meals and Entertainment",,"Accounts Payable",1460.85,"",360244.58
,"Cheque","13-07-2024","P2154",,,"bread","Expense","Meals and Entertainment",,"MPESA Account",260.00,"",360504.58
,"Cheque","15-07-2024","357",,"Sangonett Merchants","Staff snacks","Expense","Meals and Entertainment",,"MPESA Account",5950.00,"",366454.58
,"Cheque","15-07-2024","SGG0THGP26",,,"bread","Expense","Meals and Entertainment",,"MPESA Account",390.00,"",366844.58
,"Cheque","17-07-2024","SGH7XYN9E9",,,"bread","Expense","Meals and Entertainment",,"MPESA Account",195.00,"",367039.58
,"Cheque","17-07-2024","0051",,"County Wholesalers","Tea leaves and bread","Expense","Meals and Entertainment",,"Cash Account",545.00,"",367584.58
,"Cheque","18-07-2024","P2158",,,"bread","Expense","Meals and Entertainment",,"MPESA Account",140.00,"",367724.58
,"Cheque","19-07-2024","359",,"Sangonett Merchants","Staff snacks","Expense","Meals and Entertainment",,"MPESA Account",4520.00,"",372244.58
,"Cheque","19-07-2024","P2159",,,"bread","Expense","Meals and Entertainment",,"MPESA Account",455.00,"",372699.58
,"Cheque","22-07-2024","SGM5GCN4VJ",,,"bread","Expense","Meals and Entertainment",,"MPESA Account",390.00,"",373089.58
,"Cheque","24-07-2024","SGO2NQPAC6",,,"bread","Expense","Meals and Entertainment",,"MPESA Account",325.00,"",373414.58
,"Bill","24-07-2024","0122-04100430249",,"Naivas Ltd","drinking water and Milk","Expense","Meals and Entertainment",,"Accounts Payable",4181.38,"",377595.96
,"Bill","24-07-2024","0122-01100267637",,"Naivas Ltd","Milk","Expense","Meals and Entertainment",,"Accounts Payable",2940.00,"",380535.96
,"Cheque","26-07-2024","SGQ4VM1IIO",,,"bread","Expense","Meals and Entertainment",,"MPESA Account",585.00,"",381120.96
,"Cheque","26-07-2024","363",,"Sangonett Merchants","Staff snacks","Expense","Meals and Entertainment",,"MPESA Account",5800.00,"",386920.96
,"Cheque","28-07-2024","SGS63YUN8S",,,"bread","Expense","Meals and Entertainment",,"MPESA Account",260.00,"",387180.96
,"Cheque","29-07-2024","SGT79C85CV",,,"bread","Expense","Meals and Entertainment",,"MPESA Account",325.00,"",387505.96
,"Cheque","02-08-2024","SH25PAEPHT",,,"bread","Expense","Meals and Entertainment",,"MPESA Account",325.00,"",387830.96
,"Cheque","02-08-2024","P2189",,,"bread","Expense","Meals and Entertainment",,"MPESA Account",260.00,"",388090.96
,"Cheque","02-08-2024","367",,"Sangonett Merchants","Staff snacks","Expense","Meals and Entertainment",,"MPESA Account",5880.00,"",393970.96
,"Cheque","05-08-2024","SH778QIZV9",,,"bread","Expense","Meals and Entertainment",,"MPESA Account",325.00,"",394295.96
,"Cheque","06-08-2024","0028",,"County Wholesalers","Tea leaves","Expense","Meals and Entertainment",,"MPESA Account",480.00,"",394775.96
,"Cheque","07-08-2024","SH738QRBFL",,,"bread","Expense","Meals and Entertainment",,"MPESA Account",260.00,"",395035.96
,"Cheque","09-08-2024","368",,"Sangonett Merchants","Staff snacks","Expense","Meals and Entertainment",,"MPESA Account",5620.00,"",400655.96
,"Cheque","09-08-2024","SH95IJXX43",,,"bread","Expense","Meals and Entertainment",,"MPESA Account",455.00,"",401110.96
,"Cheque","13-08-2024","SHD5VV1DX1",,,"bread","Expense","Meals and Entertainment",,"MPESA Account",260.00,"",401370.96
,"Bill","13-08-2024","0040798680000436243",,"Naivas Ltd","milk","Expense","Meals and Entertainment",,"Accounts Payable",7320.00,"",408690.96
,"Cheque","14-08-2024","SHE82O7CFI",,,"bread","Expense","Meals and Entertainment",,"MPESA Account",260.00,"",408950.96
,"Cheque","16-08-2024","369",,"Sangonett Merchants","Staff snacks","Expense","Meals and Entertainment",,"MPESA Account",5500.00,"",414450.96
,"Cheque","16-08-2024","14766",,"VCS Restaurant","Lunch","Expense","Meals and Entertainment",,"MPESA Account",2620.00,"",417070.96
,"Cheque","16-08-2024","SHG6B7KVGQ",,,"bread","Expense","Meals and Entertainment",,"MPESA Account",240.00,"",417310.96
,"Cheque","18-08-2024","SHI8GFEKN0",,,"bread","Expense","Meals and Entertainment",,"MPESA Account",260.00,"",417570.96
,"Cheque","19-08-2024","SHJ9K71925",,,"bread","Expense","Meals and Entertainment",,"MPESA Account",325.00,"",417895.96
,"Cheque","20-08-2024","RSL-14936",,"VCS Restaurant","Lunch","Expense","Meals and Entertainment",,"MPESA Account",740.00,"",418635.96
,"Cheque","21-08-2024","SHL1RSGVSB",,,"bread","Expense","Meals and Entertainment",,"MPESA Account",260.00,"",418895.96
,"Cheque","22-08-2024","P2231",,,"bread","Expense","Meals and Entertainment",,"MPESA Account",65.00,"",418960.96
,"Cheque","23-08-2024","SHN8Z9LT3Q",,,"bread","Expense","Meals and Entertainment",,"MPESA Account",390.00,"",419350.96
,"Cheque","23-08-2024","RSL-15306",,"VCS Restaurant","Lunch","Expense","Meals and Entertainment",,"MPESA Account",470.00,"",419820.96
,"Bill","23-08-2024","0090968860000324118",,"Flavor Town Cafe Kenya Ltd","-MULTIPLE-","Expense","Meals and Entertainment",,"Accounts Payable",3379.83,"",423200.79
,"Cheque","24-08-2024","372",,"Sangonett Merchants","Staff snacks","Expense","Meals and Entertainment",,"MPESA Account",6220.00,"",429420.79
,"Cheque","25-08-2024","P2235",,,"bread","Expense","Meals and Entertainment",,"MPESA Account",190.00,"",429610.79
,"Cheque","26-08-2024","SHQ3C11YF5",,,"bread","Expense","Meals and Entertainment",,"MPESA Account",325.00,"",429935.79
,"Cheque","28-08-2024","P2242",,,"bread","Expense","Meals and Entertainment",,"MPESA Account",280.00,"",430215.79
,"Cheque","30-08-2024","374",,"Sangonett Merchants","Staff snacks","Expense","Meals and Entertainment",,"MPESA Account",6100.00,"",436315.79
,"Bill","30-08-2024","0110159290001156263",,"Quick Mart Limited","Milk","Expense","Meals and Entertainment",,"Accounts Payable",6600.00,"",442915.79
,"Cheque","30-08-2024","SHU2SR96L6",,,"bread","Expense","Meals and Entertainment",,"MPESA Account",325.00,"",443240.79
,"Cheque","01-09-2024","P2253",,,"bread","Expense","Meals and Entertainment",,"MPESA Account",195.00,"",443435.79
,"Cheque","02-09-2024","0036",,"County Wholesalers","tea leaves","Expense","Meals and Entertainment",,"MPESA Account",480.00,"",443915.79
,"Cheque","02-09-2024","SI235IDEWV",,,"bread","Expense","Meals and Entertainment",,"MPESA Account",325.00,"",444240.79
,"Bill","02-09-2024","0020102300000156575",,"Simbisa Brands (K) Limited","meal","Expense","Meals and Entertainment",,"VAT Payable",501.36,"",444742.15
,"Cheque","04-09-2024","SI40DE1IFO",,,"bread","Expense","Meals and Entertainment",,"MPESA Account",260.00,"",445002.15
,"Cheque","05-09-2024","SI51K6HATJ",,,"bread","Expense","Meals and Entertainment",,"MPESA Account",130.00,"",445132.15
,"Cheque","06-09-2024","376",,"Sangonett Merchants","Staff snacks","Expense","Meals and Entertainment",,"MPESA Account",5350.00,"",450482.15
,"Cheque","06-09-2024","SI66NPWECK",,,"bread","Expense","Meals and Entertainment",,"MPESA Account",325.00,"",450807.15
,"Bill","06-09-2024","0091659960000009066",,"Ocean Star Restaurant Limited","Meal","Expense","Meals and Entertainment",,"Accounts Payable",198.81,"",451005.96
,"Cheque","06-09-2024","P2274",,,"Lunch","Expense","Meals and Entertainment",,"MPESA Account",750.00,"",451755.96
,"Cheque","08-09-2024","SI89W3ULJ9",,,"bread","Expense","Meals and Entertainment",,"MPESA Account",120.00,"",451875.96
,"Cheque","09-09-2024","SI95XPIR0H",,,"bread","Expense","Meals and Entertainment",,"MPESA Account",325.00,"",452200.96
,"Cheque","09-09-2024","RSL-16460",,"VCS Restaurant","Lunch","Expense","Meals and Entertainment",,"MPESA Account",60.00,"",452260.96
,"Cheque","09-09-2024","RSL-16459",,"VCS Restaurant","Lunch","Expense","Meals and Entertainment",,"MPESA Account",690.00,"",452950.96
,"Cheque","11-09-2024","SIC3BSDGVJ",,,"bread","Expense","Meals and Entertainment",,"MPESA Account",260.00,"",453210.96
,"Cheque","12-09-2024","0038397",,"Tawakal Store Mareba","Sugar","Expense","Meals and Entertainment",,"MPESA Account",5800.00,"",459010.96
,"Bill","12-09-2024","01101592900014830067",,"Quick Mart Limited","Milk","Expense","Meals and Entertainment",,"Accounts Payable",7320.00,"",466330.96
,"Cheque","13-09-2024","SID8F3NW8C",,,"bread","Expense","Meals and Entertainment",,"MPESA Account",520.00,"",466850.96
,"Cheque","13-09-2024","379",,"Sangonett Merchants","Staff snacks","Expense","Meals and Entertainment",,"MPESA Account",6180.00,"",473030.96
,"Cheque","13-09-2024","RSL-16810",,"VCS Restaurant","Lunch","Expense","Meals and Entertainment",,"MPESA Account",3010.00,"",476040.96
,"Cheque","13-09-2024","61841735",,"Mainspring Ventures Ltd","lunch","Expense","Meals and Entertainment",,"MPESA Account",200.00,"",476240.96
,"Cheque","15-09-2024","SIF2P6H5Q8",,,"bread","Expense","Meals and Entertainment",,"MPESA Account",195.00,"",476435.96
,"Cheque","16-09-2024","SIG3R4OOEZ",,,"bread","Expense","Meals and Entertainment",,"MPESA Account",325.00,"",476760.96
,"Cheque","17-09-2024","SIH0V743DW",,,"bread","Expense","Meals and Entertainment",,"MPESA Account",195.00,"",476955.96
,"Cheque","18-09-2024","SII5Z6QSVJ",,,"bread","Expense","Meals and Entertainment",,"MPESA Account",260.00,"",477215.96
,"Cheque","20-09-2024","SIK78M4SRX",,,"bread","Expense","Meals and Entertainment",,"MPESA Account",585.00,"",477800.96
,"Bill","21-09-2024","0020099070000242437",,"Nairobi Java House Ltd","meal","Expense","Meals and Entertainment",,"Accounts Payable",1192.89,"",478993.85
,"Cheque","22-09-2024","P2304",,,"bread","Expense","Meals and Entertainment",,"MPESA Account",195.00,"",479188.85
,"Cheque","23-09-2024","381",,"Sangonett Merchants","Staff snacks","Expense","Meals and Entertainment",,"MPESA Account",5620.00,"",484808.85
,"Cheque","23-09-2024","SIN8JX0Z0Q",,,"bread","Expense","Meals and Entertainment",,"MPESA Account",325.00,"",485133.85
,"Cheque","24-09-2024","0061",,"County Wholesalers","bread","Expense","Meals and Entertainment",,"MPESA Account",260.00,"",485393.85
,"Cheque","25-09-2024","SIP9RTW0A1",,,"bread","Expense","Meals and Entertainment",,"MPESA Account",260.00,"",485653.85
,"Cheque","26-09-2024","SIQ3VF2AU5",,"County Wholesalers","tea leaves","Expense","Meals and Entertainment",,"MPESA Account",480.00,"",486133.85
,"Bill","26-09-2024","0090968860000408806",,"Flavor Town Cafe Kenya Ltd","-MULTIPLE-","Expense","Meals and Entertainment",,"Accounts Payable",2463.56,"",488597.41
,"Cheque","27-09-2024","RSL-17895",,"VCS Restaurant","Lunch","Expense","Meals and Entertainment",,"MPESA Account",740.00,"",489337.41
,"Cheque","27-09-2024","0052",,"County Wholesalers","bread","Expense","Meals and Entertainment",,"MPESA Account",520.00,"",489857.41
,"Cheque","27-09-2024","SIR8ZFIGF4",,,"bread","Expense","Meals and Entertainment",,"MPESA Account",195.00,"",490052.41
,"Cheque","27-09-2024","383",,"Sangonett Merchants","Staff snacks","Expense","Meals and Entertainment",,"MPESA Account",4780.00,"",494832.41
,"Cheque","01-10-2024","SJ15JGMB43",,,"bread","Expense","Meals and Entertainment",,"MPESA Account",325.00,"",495157.41
,"Cheque","02-10-2024","SJ26LFW5I0",,,"bread","Expense","Meals and Entertainment",,"MPESA Account",260.00,"",495417.41
,"Cheque","02-10-2024","SJ21LEKHQN",,,"bread","Expense","Meals and Entertainment",,"MPESA Account",260.00,"",495677.41
,"Bill","02-10-2024","0110159290001253176",,"Quick Mart Limited","Milk","Expense","Meals and Entertainment",,"Accounts Payable",6600.00,"",502277.41
,"Bill","04-10-2024","0040798680000479425",,"Naivas Ltd","drinking water","Expense","Meals and Entertainment",,"Accounts Payable",620.29,"",502897.70
,"Cheque","04-10-2024","385",,"Sangonett Merchants","Staff snacks","Expense","Meals and Entertainment",,"MPESA Account",5410.00,"",508307.70
,"Cheque","05-10-2024","P2334",,,"bread","Expense","Meals and Entertainment",,"MPESA Account",325.00,"",508632.70
,"Cheque","07-10-2024","SJ747ORJ2K",,,"bread","Expense","Meals and Entertainment",,"MPESA Account",325.00,"",508957.70
,"Cheque","09-10-2024","SJ91GAGYJ1",,,"bread","Expense","Meals and Entertainment",,"MPESA Account",260.00,"",509217.70
,"Cheque","11-10-2024","SJB5ON8QCH",,,"bread","Expense","Meals and Entertainment",,"MPESA Account",520.00,"",509737.70
,"Cheque","14-10-2024","SJE81QL6T0",,,"bread","Expense","Meals and Entertainment",,"MPESA Account",325.00,"",510062.70
,"Cheque","15-10-2024","387",,"Sangonett Merchants","Staff snacks","Expense","Meals and Entertainment",,"MPESA Account",7020.00,"",517082.70
,"Cheque","15-10-2024","31842666",,"Mainspring Ventures Ltd","lunch","Expense","Meals and Entertainment",,"MPESA Account",700.00,"",517782.70
,"Cheque","16-10-2024","SJG79F03AZ",,,"bread","Expense","Meals and Entertainment",,"MPESA Account",260.00,"",518042.70
,"Cheque","16-10-2024","RSL-19290",,"VCS Restaurant","Lunch","Expense","Meals and Entertainment",,"MPESA Account",640.00,"",518682.70
,"Cheque","17-10-2024","P2346",,,"bread","Expense","Meals and Entertainment",,"MPESA Account",130.00,"",518812.70
,"Cheque","18-10-2024","SJI2JH48S6",,,"bread","Expense","Meals and Entertainment",,"MPESA Account",390.00,"",519202.70
,"Cheque","19-10-2024","P2350",,,"bread","Expense","Meals and Entertainment",,"MPESA Account",260.00,"",519462.70
,"Bill","23-10-2024","0040798680000502429",,"Naivas Ltd","milk, serviettes and tea leaves","Expense","Meals and Entertainment",,"Accounts Payable",8659.66,"",528122.36
,"Cheque","23-10-2024","389",,"Sangonett Merchants","Staff snacks","Expense","Meals and Entertainment",,"MPESA Account",5560.00,"",533682.36
,"Cheque","23-10-2024","SJN9489N23",,,"bread","Expense","Meals and Entertainment",,"MPESA Account",260.00,"",533942.36
,"Cheque","24-10-2024","SJO78UY5E1",,,"bread","Expense","Meals and Entertainment",,"MPESA Account",260.00,"",534202.36
,"Cheque","25-10-2024","RSL-19929",,"VCS Restaurant","Lunch","Expense","Meals and Entertainment",,"MPESA Account",2960.00,"",537162.36
,"Cheque","25-10-2024","RSL-19933",,"VCS Restaurant","Lunch","Expense","Meals and Entertainment",,"MPESA Account",40.00,"",537202.36
,"Cheque","25-10-2024","RSL-19932",,"VCS Restaurant","Lunch","Expense","Meals and Entertainment",,"MPESA Account",740.00,"",537942.36
,"Cheque","25-10-2024","0136",,"County Wholesalers","bread","Expense","Meals and Entertainment",,"MPESA Account",455.00,"",538397.36
,"Cheque","25-10-2024","61946451",,"Mainspring Ventures Ltd","lunch","Expense","Meals and Entertainment",,"MPESA Account",200.00,"",538597.36
,"Bill","27-10-2024","0020098710000160144",,"OLE-SERENI","End of year party","Expense","Meals and Entertainment",,"Accounts Payable",10401.83,"",548999.19
,"Bill","27-10-2024","0020098710000160069",,"OLE-SERENI","End of year party","Expense","Meals and Entertainment",,"Accounts Payable",7756.30,"",556755.49
,"Cheque","28-10-2024","SJS3NUWSFF",,,"bread","Expense","Meals and Entertainment",,"MPESA Account",325.00,"",557080.49
,"Bill","29-10-2024","0020109110000059940",,"OLE-SERENI","End of year party","Expense","Meals and Entertainment",,"Accounts Payable",417847.28,"",974927.77
,"Bill","30-10-2024","0020098750000149140",,"CARNIVORE RESTAURANT","End of year party","Expense","Meals and Entertainment",,"Accounts Payable",259875.00,"",1234802.77
,"Bill","30-10-2024","0020098750000149141",,"CARNIVORE RESTAURANT","End of year party","Expense","Meals and Entertainment",,"Accounts Payable",89206.77,"",1324009.54
,"Cheque","31-10-2024","390",,"Sangonett Merchants","Staff snacks","Expense","Meals and Entertainment",,"MPESA Account",7200.00,"",1331209.54
,"Cheque","01-11-2024","0037",,"County Wholesalers","bread","Expense","Meals and Entertainment",,"MPESA Account",195.00,"",1331404.54
,"Cheque","01-11-2024","P2369",,,"bread","Expense","Meals and Entertainment",,"MPESA Account",195.00,"",1331599.54
,"Cheque","02-11-2024","P2372",,,"bread","Expense","Meals and Entertainment",,"MPESA Account",195.00,"",1331794.54
,"Bill","02-11-2024","0040034640000020424",,"Magic Peak Limited","Lunch","Expense","Meals and Entertainment",,"VAT Payable",4482.75,"",1336277.29
,"Cheque","04-11-2024","SK46IWGUWI",,,"bread","Expense","Meals and Entertainment",,"MPESA Account",325.00,"",1336602.29
,"Cheque","05-11-2024","395",,"Sangonett Merchants","Staff snacks","Expense","Meals and Entertainment",,"MPESA Account",5560.00,"",1342162.29
,"Cheque","06-11-2024","SK65SIE2KN",,,"bread","Expense","Meals and Entertainment",,"MPESA Account",260.00,"",1342422.29
,"Cheque","06-11-2024","RSL-20784",,"VCS Restaurant","Lunch","Expense","Meals and Entertainment",,"Cash Account",300.00,"",1342722.29
,"Cheque","07-11-2024","SK78YD5U06",,,"bread","Expense","Meals and Entertainment",,"MPESA Account",195.00,"",1342917.29
,"Cheque","08-11-2024","42495",,"Mainspring Ventures Ltd","breakfast","Expense","Meals and Entertainment",,"MPESA Account",320.00,"",1343237.29
,"Cheque","08-11-2024","RSL-21005",,"VCS Restaurant","Lunch","Expense","Meals and Entertainment",,"MPESA Account",890.00,"",1344127.29
,"Cheque","08-11-2024","395",,"Sangonett Merchants","Staff snacks","Expense","Meals and Entertainment",,"MPESA Account",340.00,"",1344467.29
,"Bill","08-11-2024","0040798680000522934",,"Naivas Ltd","drinking water","Expense","Meals and Entertainment",,"Accounts Payable",2461.83,"",1346929.12
,"Bill","09-11-2024","0190984030000238350",,"Pronto Catering Ltd","Lunch","Expense","Meals and Entertainment",,"Accounts Payable",1849.83,"",1348778.95
,"Bill","12-11-2024","0040798680000527944",,"Naivas Ltd","milk","Expense","Meals and Entertainment",,"Accounts Payable",7320.00,"",1356098.95
,"Cheque","12-11-2024","SKC7HYXWLP",,,"bread","Expense","Meals and Entertainment",,"MPESA Account",390.00,"",1356488.95
,"Cheque","14-11-2024","0056",,"County Wholesalers","bread","Expense","Meals and Entertainment",,"MPESA Account",390.00,"",1356878.95
,"Cheque","14-11-2024","P2405",,,"bread","Expense","Meals and Entertainment",,"MPESA Account",130.00,"",1357008.95
,"Cheque","15-11-2024","394",,"Sangonett Merchants","Staff snacks","Expense","Meals and Entertainment",,"MPESA Account",6160.00,"",1363168.95
,"Cheque","15-11-2024","RSL-21555",,"VCS Restaurant","Lunch","Expense","Meals and Entertainment",,"MPESA Account",2550.00,"",1365718.95
,"Cheque","15-11-2024","RSL-21577",,"VCS Restaurant","Lunch","Expense","Meals and Entertainment",,"MPESA Account",320.00,"",1366038.95
,"Cheque","15-11-2024","61843650",,"Mainspring Ventures Ltd","lunch","Expense","Meals and Entertainment",,"MPESA Account",200.00,"",1366238.95
,"Cheque","17-11-2024","P2413",,,"bread","Expense","Meals and Entertainment",,"MPESA Account",195.00,"",1366433.95
,"Cheque","18-11-2024","SKI78BMUWT",,,"bread","Expense","Meals and Entertainment",,"MPESA Account",325.00,"",1366758.95
,"Cheque","20-11-2024","SKK5GFGQM5",,,"bread","Expense","Meals and Entertainment",,"MPESA Account",260.00,"",1367018.95
,"Bill","20-11-2024","0090968860000540606",,"Flavor Town Cafe Kenya Ltd","-MULTIPLE-","Expense","Meals and Entertainment",,"Accounts Payable",1166.95,"",1368185.90
,"Bill","21-11-2024","0090968860000540604",,"Flavor Town Cafe Kenya Ltd","-MULTIPLE-","Expense","Meals and Entertainment",,"Accounts Payable",5393.90,"",1373579.80
,"Cheque","22-11-2024","396",,"Sangonett Merchants","Staff snacks","Expense","Meals and Entertainment",,"MPESA Account",5980.00,"",1379559.80
,"Cheque","22-11-2024","SKM8RBNA16",,,"bread","Expense","Meals and Entertainment",,"MPESA Account",130.00,"",1379689.80
,"Cheque","23-11-2024","SKN3VHLI1Z",,,"bread","Expense","Meals and Entertainment",,"MPESA Account",325.00,"",1380014.80
,"Bill","24-11-2024","0090968860000550050",,"Flavor Town Cafe Kenya Ltd","lunch","Expense","Meals and Entertainment",,"Accounts Payable",5288.14,"",1385302.94
,"Cheque","27-11-2024","SKR5BOZZCD",,,"bread","Expense","Meals and Entertainment",,"MPESA Account",325.00,"",1385627.94
,"Cheque","27-11-2024","P2432",,,"bread","Expense","Meals and Entertainment",,"MPESA Account",195.00,"",1385822.94
,"Cheque","28-11-2024","SKS8H88Q8Q",,,"bread","Expense","Meals and Entertainment",,"MPESA Account",195.00,"",1386017.94
,"Bill","29-11-2024","0040798680000548895",,"Naivas Ltd","milk","Expense","Meals and Entertainment",,"Accounts Payable",7980.00,"",1393997.94
,"Bill","30-11-2024","0040563920001417915",,"Naivas Ltd","bread","Expense","Meals and Entertainment",,"Accounts Payable",1194.83,"",1395192.77
,"Cheque","02-12-2024","0039114",,"Tawakal Store Mareba","Sugar","Expense","Meals and Entertainment",,"MPESA Account",6800.00,"",1401992.77
,"Cheque","02-12-2024","SL381DA2UM",,,"bread","Expense","Meals and Entertainment",,"MPESA Account",325.00,"",1402317.77
,"Cheque","04-12-2024","SL4773B1BJ",,,"bread","Expense","Meals and Entertainment",,"MPESA Account",325.00,"",1402642.77
,"Bill","05-12-2024","0020098140000038586",,"FIFTEEN ROOFTOP LIMITED","Lunch","Expense","Meals and Entertainment",,"Accounts Payable",4105.93,"",1406748.70
,"Bill","06-12-2024","0021994570000014709",,"Asmara Entertainment Limited","meals","Expense","Meals and Entertainment",,"Accounts Payable",31724.14,"",1438472.84
,"Cheque","07-12-2024","SL71JEJG6R",,,"bread","Expense","Meals and Entertainment",,"MPESA Account",260.00,"",1438732.84
,"Cheque","08-12-2024","397",,"Sangonett Merchants","Staff snacks","Expense","Meals and Entertainment",,"MPESA Account",10110.00,"",1448842.84
,"Cheque","08-12-2024","P2462",,,"bread","Expense","Meals and Entertainment",,"MPESA Account",195.00,"",1449037.84
,"Cheque","09-12-2024","SL96SYNS5I",,,"bread","Expense","Meals and Entertainment",,"MPESA Account",325.00,"",1449362.84
,"Cheque","11-12-2024","SLC06NKD8K",,,"bread","Expense","Meals and Entertainment",,"MPESA Account",260.00,"",1449622.84
,"Cheque","12-12-2024","P2466",,,"bread","Expense","Meals and Entertainment",,"MPESA Account",195.00,"",1449817.84
,"Cheque","13-12-2024","SLD8D9NRE2",,,"bread","Expense","Meals and Entertainment",,"MPESA Account",130.00,"",1449947.84
,"Cheque","14-12-2024","SLE1HTHGK7",,,"bread","Expense","Meals and Entertainment",,"MPESA Account",130.00,"",1450077.84
,"Cheque","15-12-2024","P2471",,,"bread","Expense","Meals and Entertainment",,"MPESA Account",140.00,"",1450217.84
,"Cheque","16-12-2024","SLG9NFI5OJ",,,"bread","Expense","Meals and Entertainment",,"MPESA Account",325.00,"",1450542.84
,"Cheque","17-12-2024","400",,"Sangonett Merchants","Staff snacks","Expense","Meals and Entertainment",,"MPESA Account",7140.00,"",1457682.84
,"Cheque","18-12-2024","SLI0YBIZAM",,,"bread","Expense","Meals and Entertainment",,"MPESA Account",195.00,"",1457877.84
,"Cheque","20-12-2024","RSL-24079",,"VCS Restaurant","Lunch","Expense","Meals and Entertainment",,"MPESA Account",2670.00,"",1460547.84
,"Bill","20-12-2024","0110159290001372418",,"Quick Mart Limited","Milk and Tea Leaves","Expense","Meals and Entertainment",,"Accounts Payable",7088.97,"",1467636.81
,"Cheque","22-12-2024","P2496",,,"bread","Expense","Meals and Entertainment",,"MPESA Account",390.00,"",1468026.81
,"Cheque","23-12-2024","SLN5KLF0SV",,,"bread","Expense","Meals and Entertainment",,"MPESA Account",260.00,"",1468286.81
,"Cheque","28-12-2024","SLS14LL3NJ",,,"bread","Expense","Meals and Entertainment",,"MPESA Account",130.00,"",1468416.81
,"Cheque","30-12-2024","P2506",,,"bread","Expense","Meals and Entertainment",,"MPESA Account",195.00,"",1468611.81
"Total Meals and Entertainment",,,,,,,,,,,1468611.81,0.00,1468611.81
"Office Expense",,,,,,,,,,,,,""
"Cleaning",,,,,,,,,,,,,""
,"Bill","02-01-2024","0090972520000441553",,"Kassmatt Supermarkets Ltd","cleaning tools","Expense","Cleaning",,"Accounts Payable",948.28,"",948.28
,"Bill","04-01-2024","0090972520000443984",,"Kassmatt Supermarkets Ltd","cleaning tools","Expense","Cleaning",,"Accounts Payable",400.86,"",1349.14
,"Cheque","16-01-2024","072",,"Cecilia Muthoni","Cotton rags","Expense","Cleaning",,"MPESA Account",1500.00,"",2849.14
,"Bill","16-02-2024","0040074710000008560",,"Soilex Prosolve Ltd","Plastic Squeegee and handle","Expense","Cleaning",,"Accounts Payable",2360.00,"",5209.14
,"Cheque","01-03-2024","140",,"Loima Enterprises","4 mops @ 250 & 5 brooms @ 30","Expense","Cleaning",,"MPESA Account",1150.00,"",6359.14
,"Bill","15-03-2024","0040074710000009110",,"Soilex Prosolve Ltd","Plastic Squeegee and handle and jumbo mops","Expense","Cleaning",,"Accounts Payable",4140.00,"",10499.14
,"Cheque","03-04-2024","P1942",,,"Unclogging sewage line","Expense","Cleaning",,"MPESA Account",1000.00,"",11499.14
,"Cheque","16-04-2024","P1989",,,"Drainage unclogging","Expense","Cleaning",,"MPESA Account",1200.00,"",12699.14
,"Cheque","24-04-2024","P1983",,,"Drainage unclogging","Expense","Cleaning",,"MPESA Account",3000.00,"",15699.14
,"Cheque","25-04-2024","065",,"County Wholesalers","4 big mops","Expense","Cleaning",,"MPESA Account",1400.00,"",17099.14
,"Cheque","25-04-2024","P1984",,,"11pcs squeegee rubber reinstallation","Expense","Cleaning",,"MPESA Account",1100.00,"",18199.14
,"Cheque","26-04-2024","SDP198YEY7",,"Apex Hardware and General Store","2 toilet brushes","Expense","Cleaning",,"MPESA Account",400.00,"",18599.14
,"Cheque","29-04-2024","P1991",,,"Drainage unclogging","Expense","Cleaning",,"MPESA Account",600.00,"",19199.14
,"Cheque","04-05-2024","P2002",,,"Drainage unclogging","Expense","Cleaning",,"MPESA Account",600.00,"",19799.14
,"Cheque","17-05-2024","847",,"JA-GI -WELL METAL-WORKS","Metallic Mop buckets","Expense","Cleaning",,"MPESA Account",5500.00,"",25299.14
,"Cheque","20-05-2024","P2041",,,"Drainage unclogging","Expense","Cleaning",,"MPESA Account",400.00,"",25699.14
,"Cheque","23-05-2024","1464",,"Ngigi Merchants","Mops","Expense","Cleaning",,"MPESA Account",600.00,"",26299.14
,"Cheque","10-07-2024","2865",,"Loima Enterprises","2 mops @ 250","Expense","Cleaning",,"MPESA Account",500.00,"",26799.14
,"Cheque","18-07-2024","P2163",,,"Unclogging sewage line","Expense","Cleaning",,"MPESA Account",1000.00,"",27799.14
,"Cheque","01-08-2024","1122",,"Vumbi Trading Company","12pcs Soft brush @ 200 and 12pcs Hard brush @ 200","Expense","Cleaning",,"MPESA Account",4800.00,"",32599.14
,"Cheque","14-08-2024","P2218",,,"Unclogging sewage line","Expense","Cleaning",,"MPESA Account",3500.00,"",36099.14
,"Bill","21-08-2024","KRACU0100052819/1162",,"Bluemart Prodcuts East Africa Ltd","Wellnax drain opener granules 70G*48Pcs","Expense","Cleaning",,"Accounts Payable",473.69,"",36572.83
,"Cheque","27-08-2024","P2239",,,"kitchen towels","Expense","Cleaning",,"MPESA Account",100.00,"",36672.83
,"Bill","19-09-2024","0040129490000021503",,"Saigul Distributors Ltd","mops","Expense","Cleaning",,"Accounts Payable",172.41,"",36845.24
,"Bill","24-09-2024","0040266580000033081",,"Saigul Distributors Ltd","mops","Expense","Cleaning",,"Accounts Payable",603.45,"",37448.69
,"Cheque","11-10-2024","P2342",,,"Cotton rags","Expense","Cleaning",,"MPESA Account",1300.00,"",38748.69
,"Bill","18-10-2024","0040266580000034254",,"Saigul Distributors Ltd","mops","Expense","Cleaning",,"Accounts Payable",1724.14,"",40472.83
,"Bill","28-10-2024","0171364970000001490",,"Kenpoly Manufacturers Limited","Dustbins and laundry buckets","Expense","Cleaning",,"Accounts Payable",6723.28,"",47196.11
,"Cheque","15-11-2024","P2408",,,"Unclogging sewage line","Expense","Cleaning",,"MPESA Account",3000.00,"",50196.11
,"Cheque","15-11-2024","P2409",,,"Unclogging storm water drain line","Expense","Cleaning",,"MPESA Account",650.00,"",50846.11
,"Cheque","22-11-2024","P2425",,,"Unclogging storm water drain line","Expense","Cleaning",,"MPESA Account",4500.00,"",55346.11
,"Cheque","23-12-2024","P2494",,,"brooms","Expense","Cleaning",,"MPESA Account",180.00,"",55526.11
"Total Cleaning",,,,,,,,,,,55526.11,0.00,55526.11
"Consumables",,,,,,,,,,,,,""
,"Cheque","08-01-2024","SA83F8QV99",,,"shoe polish and brushes","Expense","Consumables",,"MPESA Account",9750.00,"",9750.00
,"Bill","16-01-2024","0110395040000557162",,"Quick Mart Limited","Serviettes and drinking water","Expense","Consumables",,"Accounts Payable",3124.14,"",12874.14
,"Cheque","17-01-2024","P1817",,,"gas burner","Expense","Consumables",,"MPESA Account",600.00,"",13474.14
,"Cheque","22-01-2024","220124",,,"match boxes","Expense","Consumables",,"MPESA Account",50.00,"",13524.14
,"Bill","24-01-2024","0110605050001104544",,"Rubis Energy Kenya PLC","Table salt","Expense","Consumables",,"Accounts Payable",43.10,"",13567.24
,"Bill","30-01-2024","0110395040000577182",,"Quick Mart Limited","handwash","Expense","Consumables",,"Accounts Payable",142.24,"",13709.48
,"Bill","06-02-2024","0040804700000611098",,"Quick Mart Limited","Ushindi paste","Expense","Consumables",,"Accounts Payable",331.90,"",14041.38
,"Cheque","12-02-2024","6439",,"Frant Matt Wholesalers","serviettes","Expense","Consumables",,"MPESA Account",320.00,"",14361.38
,"Cheque","20-02-2024","0016",,"County Wholesalers","serviettes","Expense","Consumables",,"MPESA Account",1000.00,"",15361.38
,"Bill","20-02-2024","321060-100",,"Raage Mart Ltd","items","Expense","Consumables",,"Accounts Payable",2800.00,"",18161.38
,"Cheque","26-02-2024","SBQ78RFAWF",,"Pamoja Limited","Carrier bags - 50pc @ KES 2.6 and 150pc @ KES 3.8","Expense","Consumables",,"MPESA Account",700.00,"",18861.38
,"Bill","28-02-2024","713780",,"Kassmatt Supermarkets Ltd","items","Expense","Consumables",,"Accounts Payable",840.52,"",19701.90
,"Cheque","06-03-2024","285",,"Kmart Enterprises","500pcs security seals","Expense","Consumables",,"MPESA Account",7000.00,"",26701.90
,"Cheque","13-03-2024","2181717",,"Fyndit Technologies Ltd","kitchen blends","Expense","Consumables",,"Cash Account",11150.00,"",37851.90
,"Cheque","15-03-2024","0010",,"County Wholesalers","serviettes","Expense","Consumables",,"MPESA Account",1000.00,"",38851.90
,"Bill","24-03-2024","0040130560000019958",,"Levs Trading Company Limited","items","Expense","Consumables",,"Accounts Payable",172.41,"",39024.31
,"Bill","24-03-2024","0040130560000019948",,"Levs Trading Company Limited","items","Expense","Consumables",,"Accounts Payable",1137.93,"",40162.24
,"Cheque","08-04-2024","0038",,"County Wholesalers","serviettes","Expense","Consumables",,"MPESA Account",1000.00,"",41162.24
,"Cheque","10-04-2024","091",,"Equator MM Traders","Shoe polish 9 dozens","Expense","Consumables",,"MPESA Account",8550.00,"",49712.24
,"Bill","16-04-2024","0090184000000030668",,"Rushab Petroleum Ltd","LPG","Expense","Consumables",,"Accounts Payable",1490.00,"",51202.24
,"Cheque","25-04-2024","25042024",,,"2 litres jugs","Expense","Consumables",,"MPESA Account",220.00,"",51422.24
,"Bill","01-05-2024","796838",,"Kassmatt Supermarkets Ltd","items","Expense","Consumables",,"Accounts Payable",1450.00,"",52872.24
,"Cheque","03-05-2024","0221",,"County Wholesalers","serviettes","Expense","Consumables",,"MPESA Account",1000.00,"",53872.24
,"Cheque","03-05-2024","804",,"Kmart Enterprises","500pcs security seals","Expense","Consumables",,"MPESA Account",7000.00,"",60872.24
,"Cheque","20-05-2024","0109",,"County Wholesalers","serviettes","Expense","Consumables",,"MPESA Account",1000.00,"",61872.24
,"Bill","22-05-2024","0090184000000031370",,"Rushab Petroleum Ltd","LPG","Expense","Consumables",,"Accounts Payable",1490.00,"",63362.24
,"Cheque","19-06-2024","0031",,"County Wholesalers","serviettes","Expense","Consumables",,"MPESA Account",1000.00,"",64362.24
,"Cheque","26-06-2024","0023",,"County Wholesalers","sponge","Expense","Consumables",,"MPESA Account",150.00,"",64512.24
,"Bill","03-07-2024","00408069600000038010",,"Yessmart Supermarket","toilet cleaner","Expense","Consumables",,"Accounts Payable",450.00,"",64962.24
,"Bill","04-07-2024","1600951",,"Kwiksave Links Agencies Limited","Foodcolour","Expense","Consumables",,"Accounts Payable",25.00,"",64987.24
,"Cheque","05-07-2024","1341",,"Kmart Enterprises","500pcs security seals","Expense","Consumables",,"MPESA Account",7000.00,"",71987.24
,"Bill","16-07-2024","0090184000000032182",,"Rushab Petroleum Ltd","LPG","Expense","Consumables",,"Accounts Payable",1490.00,"",73477.24
,"Cheque","17-07-2024","0051",,"County Wholesalers","serviettes","Expense","Consumables",,"Cash Account",1000.00,"",74477.24
,"Cheque","06-08-2024","0028",,"County Wholesalers","serviettes","Expense","Consumables",,"MPESA Account",1000.00,"",75477.24
,"Cheque","22-08-2024","0048",,"County Wholesalers","serviettes and scouring pads","Expense","Consumables",,"MPESA Account",1210.00,"",76687.24
,"Cheque","04-09-2024","0026",,"County Wholesalers","match boxes","Expense","Consumables",,"MPESA Account",45.00,"",76732.24
,"Bill","05-09-2024","0090184000000033023",,"Rushab Petroleum Ltd","LPG","Expense","Consumables",,"Accounts Payable",1490.00,"",78222.24
,"Bill","05-09-2024","0040286510000047529",,"Shell Auto Solution Limited","LPG","Expense","Consumables",,"Accounts Payable",2844.83,"",81067.07
,"Cheque","12-09-2024","0037",,"County Wholesalers","serviettes","Expense","Consumables",,"MPESA Account",1000.00,"",82067.07
,"Bill","22-09-2024","0172170090000067249",,"Myhome Superstore Limited","Canteen and office consumables","Expense","Consumables",,"Accounts Payable",9224.14,"",91291.21
,"Bill","27-09-2024","0172172780000009288",,"Myhome Superstore Limited","Canteen and office consumables","Expense","Consumables",,"Accounts Payable",5793.10,"",97084.31
,"Cheque","30-09-2024","1694",,"Kmart Enterprises","500pcs security seals","Expense","Consumables",,"MPESA Account",7000.00,"",104084.31
,"Cheque","30-09-2024","054",,"Namanga Hardware & Tools","4 Tripple A and 4 Double A batteries","Expense","Consumables",,"MPESA Account",280.00,"",104364.31
,"Cheque","02-10-2024","0046",,"County Wholesalers","serviettes","Expense","Consumables",,"MPESA Account",1100.00,"",105464.31
,"Bill","06-10-2024","1821798680000007783",,"Bizaza Holdings Limited","Items","Expense","Consumables",,"Accounts Payable",3448.28,"",108912.59
,"Cheque","16-10-2024","1272",,"BC Ventures Enterprises","Shoe polish 9 dozens","Expense","Consumables",,"MPESA Account",8550.00,"",117462.59
,"Bill","22-10-2024","0172172790000011993",,"Myhome Superstore Limited","Canteen and office consumables","Expense","Consumables",,"Accounts Payable",5612.07,"",123074.66
,"Bill","28-10-2024","0110162890000192700",,"Carrefour","items","Expense","Consumables",,"Accounts Payable",9078.92,"",132153.58
,"Cheque","04-11-2024","SK46IWIW4C",,,"2pcs super glue","Expense","Consumables",,"MPESA Account",100.00,"",132253.58
,"Bill","06-11-2024","0172178450000000015",,"African Cotton Industries Limited","Serviettes","Expense","Consumables",,"Accounts Payable",6120.69,"",138374.27
,"Bill","09-11-2024","0172178450000000131",,"African Cotton Industries Limited","Serviettes","Expense","Consumables",,"Accounts Payable",3534.48,"",141908.75
,"Bill","13-11-2024","0110163510000084877",,"Carrefour","items","Expense","Consumables",,"Accounts Payable",9729.73,"",151638.48
,"Bill","19-11-2024","0110163540000443360",,"Carrefour","items","Expense","Consumables",,"Accounts Payable",1437.07,"",153075.55
,"Bill","04-12-2024","0040798680000555771",,"Naivas Ltd","serviettes, scouring pad and bi-carbonate soda","Expense","Consumables",,"Accounts Payable",985.34,"",154060.89
,"Cheque","04-12-2024","2221",,"Kmart Enterprises","500pcs security seals","Expense","Consumables",,"MPESA Account",7000.00,"",161060.89
,"Bill","18-12-2024","0040755830000080000",,"Fuelchoice Limited","LPG","Expense","Consumables",,"Accounts Payable",3100.00,"",164160.89
,"Bill","19-12-2024","0110162860000213269",,"Carrefour","items","Expense","Consumables",,"Accounts Payable",14730.35,"",178891.24
,"Bill","22-12-2024","0172172790000015046",,"Myhome Superstore Limited","Canteen and office consumables","Expense","Consumables",,"Accounts Payable",10258.62,"",189149.86
,"Bill","29-12-2024","0110162850000072184",,"Carrefour","items","Expense","Consumables",,"Accounts Payable",2024.13,"",191173.99
"Total Consumables",,,,,,,,,,,191173.99,0.00,191173.99
"Software",,,,,,,,,,,,,""
,"Bill","19-01-2024","NHTHJKMBVYN4",,"Microsoft Corp","Microsoft Office 365 annual subscription license 1","Expense","Software",,"Accounts Payable",14038.92,"",14038.92
,"Bill","29-05-2024","SINV-0120",,"UNTOHR","HR software upgrade","Expense","Software",,"Accounts Payable",70000.00,"",84038.92
,"Bill","06-06-2024","VA01-06062024",,"Value Africa Ltd","ESET Antivirus License","Expense","Software",,"Accounts Payable",22547.00,"",106585.92
,"Bill","07-06-2024","NHT8W8JDXCGY",,"Google Commerce Limited","Cloud Storage Subscription","Expense","Software",,"Accounts Payable",13500.00,"",120085.92
,"Bill","30-06-2024","89",,"Applify Hosting Limited","Elite hosting Subscription","Expense","Software",,"Accounts Payable",10480.00,"",130565.92
,"Bill","11-10-2024","6386428590150347196",,"Microsoft Corp","Microsoft Office 365 annual subscription license 1","Expense","Software",,"Accounts Payable",14038.92,"",144604.84
,"Bill","07-11-2024","6386658436066344269",,"Microsoft Corp","Microsoft Office 365 annual subscription license 1","Expense","Software",,"Accounts Payable",14038.92,"",158643.76
"Total Software",,,,,,,,,,,158643.76,0.00,158643.76
"Stationery",,,,,,,,,,,,,""
,"Cheque","25-01-2024","2399",,"Option Digital Printing Centre","Printing of receipt books","Expense","Stationery",,"MPESA Account",3000.00,"",3000.00
,"Bill","30-01-2024","0040243060000002090",,"Print Parts Ltd","-MULTIPLE-","Expense","Stationery",,"Accounts Payable",5470.00,"",8470.00
,"Bill","06-02-2024","0190434300000014307",,"Dolphin Stationers Limited","Laminating Pouches","Expense","Stationery",,"Accounts Payable",1077.59,"",9547.59
,"Bill","28-02-2024","0040243060000002254",,"Print Parts Ltd","-MULTIPLE-","Expense","Stationery",,"Accounts Payable",16600.00,"",26147.59
,"Bill","04-03-2024","0040243060000002281",,"Print Parts Ltd","-MULTIPLE-","Expense","Stationery",,"Accounts Payable",16400.00,"",42547.59
,"Cheque","26-03-2024","260324",,,"ruler","Expense","Stationery",,"Cash Account",30.00,"",42577.59
,"Bill","28-03-2024","0040243060000002416",,"Print Parts Ltd","-MULTIPLE-","Expense","Stationery",,"Accounts Payable",9620.00,"",52197.59
,"Bill","03-04-2024","2529",,"Option Digital Printing Centre","Printing of receipt books","Expense","Stationery",,"Accounts Payable",8750.00,"",60947.59
,"Bill","08-05-2024","1-2405083",,"Zeitun's Kitchen","Photocopy","Expense","Stationery",,"Accounts Payable",130.00,"",61077.59
,"Bill","29-08-2024","0040243060000003188",,"Print Parts Ltd","-MULTIPLE-","Expense","Stationery",,"Accounts Payable",4350.00,"",65427.59
,"Bill","27-09-2024","0040243060000003345",,"Print Parts Ltd","Permanent Marker","Expense","Stationery",,"Accounts Payable",1200.00,"",66627.59
,"Bill","29-10-2024","0040243060000003486",,"Print Parts Ltd","-MULTIPLE-","Expense","Stationery",,"Accounts Payable",6850.00,"",73477.59
,"Bill","05-11-2024","0190434300000023805",,"Dolphin Stationers Limited","Laminating Pouches","Expense","Stationery",,"Accounts Payable",1077.59,"",74555.18
,"Bill","09-11-2024","0020097070000184310",,"Text Book Centre Ltd","Exercise books 96pgs","Expense","Stationery",,"Accounts Payable",1681.03,"",76236.21
"Total Stationery",,,,,,,,,,,76236.21,0.00,76236.21
"Office Expense - Other",,,,,,,,,,,,,""
,"Bill","01-06-2024","0310489940000122261",,"Heykal Investments Limited","LPG","Expense","Office Expense",,"Accounts Payable",3300.00,"",3300.00
,"Cheque","21-06-2024","606f8500201",,"Carrefour","Office items","Expense","Office Expense",,"Cash Account",666.38,"",3966.38
,"Cheque","26-06-2024","12220310008",,"Naivas Ltd","Office Stationery","Expense","Office Expense",,"Cash Account",2030.34,"",5996.72
,"Bill","27-06-2024","0040073270000103976",,"Davis & Shirtliff Ltd","Service Water filters","Expense","Office Expense",,"Accounts Payable",8295.69,"",14292.41
,"Bill","26-08-2024","0040073280000146338",,"Davis & Shirtliff Ltd","Service Water filters","Expense","Office Expense",,"Accounts Payable",10207.76,"",24500.17
"Total Office Expense - Other",,,,,,,,,,,24500.17,0.00,24500.17
"Total Office Expense",,,,,,,,,,,506080.24,0.00,506080.24
"Postage and Delivery",,,,,,,,,,,,,""
"Gunia",,,,,,,,,,,,,""
,"Bill","10-06-2024","0430205790000015861",,"Supreme Packaging Llp","Plain Clear Woven Bags 90cm x 160cm","Expense","Gunia",,"Accounts Payable",46222.00,"",46222.00
,"Bill","11-09-2024","0430205790000018838",,"Supreme Packaging Llp","Plain Clear Woven Bags 90cm x 160cm","Expense","Gunia",,"Accounts Payable",52668.25,"",98890.25
"Total Gunia",,,,,,,,,,,98890.25,0.00,98890.25
"Postage and Delivery - Other",,,,,,,,,,,,,""
,"Cheque","03-01-2024","P1772",,,"Ibrahim deliveries","Expense","Postage and Delivery",,"MPESA Account",100.00,"",100.00
,"Cheque","05-01-2024","P1774",,,"Ibrahim deliveries","Expense","Postage and Delivery",,"MPESA Account",850.00,"",950.00
,"Cheque","05-01-2024","P1775",,,"Ibrahim deliveries","Expense","Postage and Delivery",,"MPESA Account",200.00,"",1150.00
,"Cheque","09-01-2024","P1778",,,"Ibrahim deliveries","Expense","Postage and Delivery",,"MPESA Account",300.00,"",1450.00
,"Cheque","11-01-2024","P1783",,,"Ibrahim deliveries","Expense","Postage and Delivery",,"MPESA Account",400.00,"",1850.00
,"Cheque","12-01-2024","P1786",,,"Ibrahim deliveries","Expense","Postage and Delivery",,"MPESA Account",800.00,"",2650.00
,"Cheque","14-01-2024","P1788",,,"Ibrahim deliveries","Expense","Postage and Delivery",,"MPESA Account",200.00,"",2850.00
,"Cheque","16-01-2024","P1796",,,"Ibrahim deliveries","Expense","Postage and Delivery",,"MPESA Account",450.00,"",3300.00
,"Cheque","18-01-2024","P1798",,,"Delivery of TVs","Expense","Postage and Delivery",,"MPESA Account",2500.00,"",5800.00
,"Cheque","20-01-2024","P1800",,,"Ibrahim deliveries","Expense","Postage and Delivery",,"MPESA Account",500.00,"",6300.00
,"Cheque","22-01-2024","P1804",,,"Ibrahim deliveries","Expense","Postage and Delivery",,"MPESA Account",300.00,"",6600.00
,"Cheque","22-01-2024","P1814",,,"Deliveries","Expense","Postage and Delivery",,"MPESA Account",200.00,"",6800.00
,"Cheque","23-01-2024","P1806",,,"Ibrahim deliveries","Expense","Postage and Delivery",,"MPESA Account",200.00,"",7000.00
,"Cheque","24-01-2024","P1807",,,"Ibrahim deliveries","Expense","Postage and Delivery",,"MPESA Account",550.00,"",7550.00
,"Cheque","25-01-2024","P1808",,,"Ibrahim deliveries","Expense","Postage and Delivery",,"MPESA Account",300.00,"",7850.00
,"Cheque","26-01-2024","P1809",,,"Ibrahim deliveries","Expense","Postage and Delivery",,"MPESA Account",500.00,"",8350.00
,"Cheque","30-01-2024","P1813",,,"Ibrahim deliveries","Expense","Postage and Delivery",,"MPESA Account",200.00,"",8550.00
,"Cheque","31-01-2024","P1815",,,"Ibrahim deliveries","Expense","Postage and Delivery",,"MPESA Account",200.00,"",8750.00
,"Cheque","31-01-2024","P1820",,,"Deliveries","Expense","Postage and Delivery",,"MPESA Account",1000.00,"",9750.00
,"Cheque","02-02-2024","P1823",,,"Ibrahim deliveries","Expense","Postage and Delivery",,"MPESA Account",150.00,"",9900.00
,"Cheque","06-02-2024","P1825",,,"Ibrahim deliveries","Expense","Postage and Delivery",,"MPESA Account",350.00,"",10250.00
,"Cheque","07-02-2024","P1826",,,"Spares deliveries","Expense","Postage and Delivery",,"MPESA Account",100.00,"",10350.00
,"Cheque","08-02-2024","P1830",,,"Ibrahim deliveries","Expense","Postage and Delivery",,"MPESA Account",150.00,"",10500.00
,"Cheque","13-02-2024","P1843",,,"Ibrahim deliveries","Expense","Postage and Delivery",,"MPESA Account",150.00,"",10650.00
,"Cheque","16-02-2024","P1851",,,"Ibrahim deliveries","Expense","Postage and Delivery",,"MPESA Account",650.00,"",11300.00
,"Cheque","21-02-2024","198",,"Julie Cube Movers","Delivery of diesel","Expense","Postage and Delivery",,"MPESA Account",500.00,"",11800.00
,"Cheque","22-02-2024","P1862",,,"Ibrahim deliveries","Expense","Postage and Delivery",,"MPESA Account",200.00,"",12000.00
,"Cheque","22-02-2024","P1863",,,"Ibrahim deliveries","Expense","Postage and Delivery",,"MPESA Account",150.00,"",12150.00
,"Cheque","26-02-2024","P1867",,,"Ibrahim deliveries","Expense","Postage and Delivery",,"MPESA Account",50.00,"",12200.00
,"Cheque","26-02-2024","P1870",,,"delivery of metal tube and plate from Central Auto","Expense","Postage and Delivery",,"MPESA Account",700.00,"",12900.00
,"Cheque","27-02-2024","P1871",,,"Ibrahim deliveries","Expense","Postage and Delivery",,"MPESA Account",950.00,"",13850.00
,"Cheque","29-02-2024","P1875",,,"Ibrahim deliveries","Expense","Postage and Delivery",,"MPESA Account",250.00,"",14100.00
,"Cheque","07-03-2024","P1883",,,"Ibrahim deliveries","Expense","Postage and Delivery",,"MPESA Account",1200.00,"",15300.00
,"Cheque","08-03-2024","P1887",,,"Ibrahim deliveries","Expense","Postage and Delivery",,"MPESA Account",800.00,"",16100.00
,"Cheque","12-03-2024","P1889",,,"Ibrahim deliveries","Expense","Postage and Delivery",,"MPESA Account",250.00,"",16350.00
,"Cheque","13-03-2024","P1933",,,"Ibrahim deliveries","Expense","Postage and Delivery",,"MPESA Account",50.00,"",16400.00
,"Cheque","15-03-2024","P1893",,,"Ibrahim deliveries","Expense","Postage and Delivery",,"MPESA Account",1020.00,"",17420.00
,"Cheque","15-03-2024","P1894",,,"Ibrahim deliveries","Expense","Postage and Delivery",,"MPESA Account",30.00,"",17450.00
,"Cheque","18-03-2024","P1896",,,"Ibrahim deliveries","Expense","Postage and Delivery",,"MPESA Account",650.00,"",18100.00
,"Cheque","21-03-2024","P1903",,,"Ibrahim deliveries","Expense","Postage and Delivery",,"MPESA Account",1400.00,"",19500.00
,"Cheque","21-03-2024","P1904",,,"Spares deliveries","Expense","Postage and Delivery",,"MPESA Account",50.00,"",19550.00
,"Cheque","23-03-2024","P1911",,,"Ibrahim deliveries","Expense","Postage and Delivery",,"MPESA Account",1100.00,"",20650.00
,"Cheque","25-03-2024","P1918",,,"Ibrahim deliveries","Expense","Postage and Delivery",,"MPESA Account",950.00,"",21600.00
,"Cheque","26-03-2024","P1921",,,"Ibrahim deliveries","Expense","Postage and Delivery",,"MPESA Account",250.00,"",21850.00
,"Cheque","27-03-2024","P1923",,,"Ibrahim deliveries","Expense","Postage and Delivery",,"MPESA Account",450.00,"",22300.00
,"Cheque","29-03-2024","P1926",,,"Ibrahim deliveries","Expense","Postage and Delivery",,"MPESA Account",650.00,"",22950.00
,"Cheque","03-04-2024","P1941",,,"Ibrahim deliveries","Expense","Postage and Delivery",,"MPESA Account",350.00,"",23300.00
,"Cheque","04-04-2024","P1943",,,"Ibrahim deliveries","Expense","Postage and Delivery",,"MPESA Account",600.00,"",23900.00
,"Cheque","05-04-2024","P1947",,,"Ibrahim deliveries","Expense","Postage and Delivery",,"MPESA Account",700.00,"",24600.00
,"Cheque","08-04-2024","P1957",,,"Delivery of ladder","Expense","Postage and Delivery",,"MPESA Account",300.00,"",24900.00
,"Cheque","08-04-2024","P1958",,,"Ibrahim deliveries","Expense","Postage and Delivery",,"MPESA Account",600.00,"",25500.00
,"Cheque","09-04-2024","P1960",,,"Ibrahim deliveries","Expense","Postage and Delivery",,"MPESA Account",400.00,"",25900.00
,"Cheque","11-04-2024","P1963",,,"Ibrahim deliveries","Expense","Postage and Delivery",,"MPESA Account",750.00,"",26650.00
,"Cheque","16-04-2024","P1970",,,"Ibrahim deliveries","Expense","Postage and Delivery",,"MPESA Account",50.00,"",26700.00
,"Cheque","16-04-2024","P1971",,,"Ibrahim deliveries","Expense","Postage and Delivery",,"MPESA Account",200.00,"",26900.00
,"Cheque","19-04-2024","P1975",,,"Ibrahim deliveries","Expense","Postage and Delivery",,"MPESA Account",2750.00,"",29650.00
,"Cheque","19-04-2024","P1976",,,"Ibrahim deliveries","Expense","Postage and Delivery",,"MPESA Account",350.00,"",30000.00
,"Cheque","20-04-2024","P1977",,,"Ibrahim deliveries","Expense","Postage and Delivery",,"MPESA Account",950.00,"",30950.00
,"Cheque","22-04-2024","P1979",,,"Ibrahim deliveries","Expense","Postage and Delivery",,"MPESA Account",400.00,"",31350.00
,"Cheque","24-04-2024","P1982",,,"Ibrahim deliveries","Expense","Postage and Delivery",,"MPESA Account",700.00,"",32050.00
,"Cheque","25-04-2024","P1985",,,"Ibrahim deliveries","Expense","Postage and Delivery",,"MPESA Account",900.00,"",32950.00
,"Cheque","29-04-2024","P1990",,,"Ibrahim deliveries","Expense","Postage and Delivery",,"MPESA Account",300.00,"",33250.00
,"Cheque","30-04-2024","P1993",,,"Ibrahim deliveries","Expense","Postage and Delivery",,"MPESA Account",400.00,"",33650.00
,"Cheque","03-05-2024","P2000",,,"Ibrahim deliveries","Expense","Postage and Delivery",,"MPESA Account",1150.00,"",34800.00
,"Cheque","07-05-2024","P2009",,,"Ibrahim deliveries","Expense","Postage and Delivery",,"MPESA Account",700.00,"",35500.00
,"Cheque","09-05-2024","P2020",,,"Item deliveries","Expense","Postage and Delivery",,"MPESA Account",400.00,"",35900.00
,"Cheque","10-05-2024","P2021",,,"Caleb deliveries","Expense","Postage and Delivery",,"MPESA Account",650.00,"",36550.00
,"Cheque","15-05-2024","P2030",,,"Ibrahim deliveries","Expense","Postage and Delivery",,"MPESA Account",250.00,"",36800.00
,"Cheque","17-05-2024","P2039",,,"deliveries","Expense","Postage and Delivery",,"MPESA Account",300.00,"",37100.00
,"Cheque","20-05-2024","P2043",,,"Ibrahim deliveries","Expense","Postage and Delivery",,"MPESA Account",450.00,"",37550.00
,"Cheque","21-05-2024","P2044",,,"Ibrahim deliveries","Expense","Postage and Delivery",,"MPESA Account",200.00,"",37750.00
,"Cheque","22-05-2024","P2047",,,"Ibrahim deliveries","Expense","Postage and Delivery",,"MPESA Account",400.00,"",38150.00
,"Cheque","24-05-2024","P2053",,,"Ibrahim deliveries","Expense","Postage and Delivery",,"MPESA Account",800.00,"",38950.00
,"Cheque","25-05-2024","P2055",,,"Caleb deliveries","Expense","Postage and Delivery",,"MPESA Account",400.00,"",39350.00
,"Cheque","25-05-2024","P2056",,,"Ibrahim deliveries","Expense","Postage and Delivery",,"MPESA Account",600.00,"",39950.00
,"Cheque","28-05-2024","P2064",,,"Ibrahim deliveries","Expense","Postage and Delivery",,"MPESA Account",700.00,"",40650.00
,"Cheque","30-05-2024","P2070",,,"Ibrahim deliveries","Expense","Postage and Delivery",,"MPESA Account",850.00,"",41500.00
,"Cheque","04-06-2024","P2077",,,"Ibrahim deliveries","Expense","Postage and Delivery",,"MPESA Account",400.00,"",41900.00
,"Cheque","05-06-2024","P2087",,,"Ibrahim deliveries","Expense","Postage and Delivery",,"MPESA Account",250.00,"",42150.00
,"Cheque","06-06-2024","P2088",,,"Ibrahim deliveries","Expense","Postage and Delivery",,"MPESA Account",700.00,"",42850.00
,"Cheque","07-06-2024","P2091",,,"Ibrahim deliveries","Expense","Postage and Delivery",,"MPESA Account",550.00,"",43400.00
,"Cheque","10-06-2024","P2097",,,"Ibrahim deliveries","Expense","Postage and Delivery",,"MPESA Account",400.00,"",43800.00
,"Cheque","11-06-2024","P2098",,,"Ibrahim deliveries","Expense","Postage and Delivery",,"MPESA Account",200.00,"",44000.00
,"Cheque","12-06-2024","P2100",,,"David Osiri Delivery of parts","Expense","Postage and Delivery",,"MPESA Account",50.00,"",44050.00
,"Cheque","13-06-2024","P2101",,,"Ibrahim deliveries","Expense","Postage and Delivery",,"MPESA Account",950.00,"",45000.00
,"Cheque","13-06-2024","P2102",,,"Ibrahim deliveries","Expense","Postage and Delivery",,"MPESA Account",400.00,"",45400.00
,"Cheque","14-06-2024","P2105",,,"Ibrahim deliveries","Expense","Postage and Delivery",,"MPESA Account",100.00,"",45500.00
,"Cheque","19-06-2024","P2107",,,"Ibrahim deliveries","Expense","Postage and Delivery",,"MPESA Account",200.00,"",45700.00
,"Cheque","21-06-2024","P2109",,,"Ibrahim deliveries","Expense","Postage and Delivery",,"MPESA Account",2000.00,"",47700.00
,"Cheque","21-06-2024","P2110",,,"Ibrahim deliveries","Expense","Postage and Delivery",,"MPESA Account",700.00,"",48400.00
,"Cheque","24-06-2024","P2113",,,"Ibrahim deliveries","Expense","Postage and Delivery",,"MPESA Account",450.00,"",48850.00
,"Cheque","26-06-2024","P2116",,,"Paul delivery of Zelia","Expense","Postage and Delivery",,"MPESA Account",400.00,"",49250.00
,"Cheque","28-06-2024","P2119",,,"Ibrahim deliveries","Expense","Postage and Delivery",,"MPESA Account",500.00,"",49750.00
,"Cheque","29-06-2024","P2122",,,"George transport to Machakos to deliver Zelia","Expense","Postage and Delivery",,"MPESA Account",3000.00,"",52750.00
,"Cheque","02-07-2024","P2124",,,"Ibrahim deliveries","Expense","Postage and Delivery",,"MPESA Account",1050.00,"",53800.00
,"Cheque","05-07-2024","P2139",,,"Ibrahim deliveries","Expense","Postage and Delivery",,"MPESA Account",1400.00,"",55200.00
,"Cheque","05-07-2024","P2138",,,"raw materials delivery","Expense","Postage and Delivery",,"MPESA Account",200.00,"",55400.00
,"Cheque","05-07-2024","P2136",,,"Ibrahim deliveries","Expense","Postage and Delivery",,"MPESA Account",1400.00,"",56800.00
,"Cheque","08-07-2024","P2143",,,"Ibrahim deliveries","Expense","Postage and Delivery",,"MPESA Account",300.00,"",57100.00
,"Cheque","09-07-2024","P2144",,,"Caleb deliveries","Expense","Postage and Delivery",,"MPESA Account",457.00,"",57557.00
,"Cheque","09-07-2024","P2145",,,"Ibrahim deliveries","Expense","Postage and Delivery",,"MPESA Account",200.00,"",57757.00
,"Cheque","09-07-2024","P2146",,,"Caleb deliveries","Expense","Postage and Delivery",,"MPESA Account",350.00,"",58107.00
,"Cheque","10-07-2024","P2149",,,"Ibrahim deliveries","Expense","Postage and Delivery",,"MPESA Account",700.00,"",58807.00
,"Cheque","12-07-2024","P2153",,,"Ibrahim deliveries","Expense","Postage and Delivery",,"MPESA Account",650.00,"",59457.00
,"Cheque","18-07-2024","P2162",,,"Ibrahim deliveries","Expense","Postage and Delivery",,"Cash Account",1050.00,"",60507.00
,"Cheque","22-07-2024","P2168",,,"Delivery of Plumping accessories Mulei","Expense","Postage and Delivery",,"MPESA Account",200.00,"",60707.00
,"Cheque","22-07-2024","P2170",,,"Chege Delivery of diesel","Expense","Postage and Delivery",,"MPESA Account",500.00,"",61207.00
,"Cheque","24-07-2024","P2173",,,"Felix Sachita delivery of stickers","Expense","Postage and Delivery",,"MPESA Account",400.00,"",61607.00
,"Cheque","24-07-2024","P2174",,,"Ibrahim deliveries","Expense","Postage and Delivery",,"MPESA Account",500.00,"",62107.00
,"Cheque","26-07-2024","P2176",,,"Ibrahim deliveries","Expense","Postage and Delivery",,"MPESA Account",1750.00,"",63857.00
,"Cheque","27-07-2024","P2179",,,"George transport to Machakos to deliver Zelia","Expense","Postage and Delivery",,"MPESA Account",3000.00,"",66857.00
,"Cheque","29-07-2024","P2181",,,"Ibrahim deliveries","Expense","Postage and Delivery",,"MPESA Account",600.00,"",67457.00
,"Cheque","01-08-2024","P2186",,,"Ibrahim deliveries","Expense","Postage and Delivery",,"MPESA Account",550.00,"",68007.00
,"Cheque","02-08-2024","P2188",,,"Ibrahim deliveries","Expense","Postage and Delivery",,"MPESA Account",350.00,"",68357.00
,"Cheque","07-08-2024","P2193",,,"Ibrahim deliveries","Expense","Postage and Delivery",,"MPESA Account",1500.00,"",69857.00
,"Cheque","13-08-2024","P2215",,,"Ibrahim deliveries","Expense","Postage and Delivery",,"MPESA Account",600.00,"",70457.00
,"Cheque","16-08-2024","P2220",,,"Ibrahim deliveries","Expense","Postage and Delivery",,"MPESA Account",500.00,"",70957.00
,"Cheque","16-08-2024","P2221",,,"Ibrahim deliveries","Expense","Postage and Delivery",,"MPESA Account",500.00,"",71457.00
,"Cheque","19-08-2024","P2223",,,"Ibrahim deliveries","Expense","Postage and Delivery",,"MPESA Account",800.00,"",72257.00
,"Cheque","20-08-2024","P2225",,,"delivery of Carbomer","Expense","Postage and Delivery",,"MPESA Account",300.00,"",72557.00
,"Cheque","22-08-2024","P2228",,,"Ibrahim deliveries","Expense","Postage and Delivery",,"MPESA Account",1900.00,"",74457.00
,"Cheque","22-08-2024","P2230",,,"delivery of Pressure control","Expense","Postage and Delivery",,"MPESA Account",400.00,"",74857.00
,"Cheque","23-08-2024","P2233",,,"Ibrahim deliveries","Expense","Postage and Delivery",,"MPESA Account",650.00,"",75507.00
,"Cheque","26-08-2024","P2237",,,"Ibrahim deliveries","Expense","Postage and Delivery",,"MPESA Account",250.00,"",75757.00
,"Cheque","27-08-2024","P2240",,,"Tarpaulin delivery","Expense","Postage and Delivery",,"MPESA Account",300.00,"",76057.00
,"Cheque","28-08-2024","P2241",,,"Titus delivery of Items","Expense","Postage and Delivery",,"MPESA Account",1200.00,"",77257.00
,"Cheque","28-08-2024","P2243",,,"Ibrahim deliveries","Expense","Postage and Delivery",,"MPESA Account",400.00,"",77657.00
,"Cheque","30-08-2024","P2247",,,"Ibrahim deliveries","Expense","Postage and Delivery",,"MPESA Account",500.00,"",78157.00
,"Cheque","03-09-2024","P2255",,,"Ibrahim deliveries","Expense","Postage and Delivery",,"MPESA Account",1150.00,"",79307.00
,"Cheque","04-09-2024","P2269",,,"Ibrahim deliveries","Expense","Postage and Delivery",,"MPESA Account",250.00,"",79557.00
,"Cheque","09-09-2024","P2275",,,"George transport to Machakos to deliver Zelia","Expense","Postage and Delivery",,"MPESA Account",3053.00,"",82610.00
,"Cheque","09-09-2024","P2279",,,"Ibrahim deliveries","Expense","Postage and Delivery",,"MPESA Account",150.00,"",82760.00
,"Cheque","10-09-2024","P2283",,,"Ibrahim deliveries","Expense","Postage and Delivery",,"MPESA Account",500.00,"",83260.00
,"Cheque","10-09-2024","P2284",,,"Chege delivery of Chuma","Expense","Postage and Delivery",,"MPESA Account",3200.00,"",86460.00
,"Cheque","11-09-2024","P2285",,,"Ibrahim deliveries","Expense","Postage and Delivery",,"MPESA Account",550.00,"",87010.00
,"Cheque","11-09-2024","P2286",,,"Chege Delivery of diesel","Expense","Postage and Delivery",,"MPESA Account",500.00,"",87510.00
,"Cheque","12-09-2024","P2287",,,"Ibrahim deliveries","Expense","Postage and Delivery",,"MPESA Account",1000.00,"",88510.00
,"Cheque","13-09-2024","P2289",,,"Ibrahim deliveries","Expense","Postage and Delivery",,"MPESA Account",850.00,"",89360.00
,"Cheque","16-09-2024","P2292",,,"Ibrahim deliveries","Expense","Postage and Delivery",,"MPESA Account",50.00,"",89410.00
,"Bill","18-09-2024","0040229260000030799",,"Chania Travellers SACCO Society Ltd","Parcel delivery to Thika","Expense","Postage and Delivery",,"Accounts Payable",129.31,"",89539.31
,"Cheque","18-09-2024","P2297",,,"Ibrahim deliveries","Expense","Postage and Delivery",,"MPESA Account",700.00,"",90239.31
,"Cheque","18-09-2024","P2296",,"Kejalyn Enterprise","Jacob deliveries","Expense","Postage and Delivery",,"MPESA Account",800.00,"",91039.31
,"Cheque","19-09-2024","P2299",,"Kejalyn Enterprise","Jacob deliveries","Expense","Postage and Delivery",,"MPESA Account",700.00,"",91739.31
,"Cheque","19-09-2024","P2302",,,"Ibrahim deliveries","Expense","Postage and Delivery",,"MPESA Account",350.00,"",92089.31
,"Cheque","19-09-2024","P2298",,,"Chege delivery of Chuma","Expense","Postage and Delivery",,"MPESA Account",3700.00,"",95789.31
,"Cheque","20-09-2024","P2303",,,"Ibrahim deliveries","Expense","Postage and Delivery",,"MPESA Account",250.00,"",96039.31
,"Cheque","23-09-2024","P2306",,,"Ibrahim deliveries","Expense","Postage and Delivery",,"MPESA Account",500.00,"",96539.31
,"Cheque","24-09-2024","P2308",,,"Ibrahim deliveries","Expense","Postage and Delivery",,"MPESA Account",200.00,"",96739.31
,"Cheque","25-09-2024","P2309",,,"Ibrahim deliveries","Expense","Postage and Delivery",,"MPESA Account",50.00,"",96789.31
,"Cheque","27-09-2024","P2311",,,"Ibrahim deliveries","Expense","Postage and Delivery",,"MPESA Account",400.00,"",97189.31
,"Cheque","30-09-2024","P2314",,,"Ibrahim deliveries","Expense","Postage and Delivery",,"MPESA Account",700.00,"",97889.31
,"Cheque","01-10-2024","P2316",,,"Square tube transport","Expense","Postage and Delivery",,"MPESA Account",60.00,"",97949.31
,"Cheque","01-10-2024","P2319",,,"Ibrahim deliveries","Expense","Postage and Delivery",,"MPESA Account",350.00,"",98299.31
,"Cheque","02-10-2024","P2330",,,"Ibrahim deliveries","Expense","Postage and Delivery",,"MPESA Account",700.00,"",98999.31
,"Bill","02-10-2024","KRACU0300001554-7627",,"Easycoach Kenya Limited","parcel","Expense","Postage and Delivery",,"Accounts Payable",2284.48,"",101283.79
,"Cheque","04-10-2024","P2331",,,"Delivery of outer samples","Expense","Postage and Delivery",,"MPESA Account",400.00,"",101683.79
,"Cheque","04-10-2024","P2332",,,"Ibrahim deliveries","Expense","Postage and Delivery",,"MPESA Account",300.00,"",101983.79
,"Cheque","07-10-2024","P2337",,,"Ibrahim deliveries","Expense","Postage and Delivery",,"MPESA Account",250.00,"",102233.79
,"Cheque","09-10-2024","P2338",,,"Ibrahim deliveries","Expense","Postage and Delivery",,"MPESA Account",500.00,"",102733.79
,"Cheque","11-10-2024","P2339",,,"Ibrahim deliveries","Expense","Postage and Delivery",,"MPESA Account",700.00,"",103433.79
,"Cheque","11-10-2024","P2341",,,"Chege delivery of Chuma","Expense","Postage and Delivery",,"MPESA Account",3700.00,"",107133.79
,"Cheque","17-10-2024","P2347",,,"Ibrahim deliveries","Expense","Postage and Delivery",,"MPESA Account",100.00,"",107233.79
,"Cheque","18-10-2024","P2348",,,"Ibrahim deliveries","Expense","Postage and Delivery",,"MPESA Account",600.00,"",107833.79
,"Cheque","22-10-2024","P2353",,,"Ibrahim deliveries","Expense","Postage and Delivery",,"MPESA Account",300.00,"",108133.79
,"Cheque","23-10-2024","P2356",,,"Ibrahim deliveries","Expense","Postage and Delivery",,"MPESA Account",750.00,"",108883.79
,"Cheque","24-10-2024","P2357",,,"Ibrahim deliveries","Expense","Postage and Delivery",,"MPESA Account",100.00,"",108983.79
,"Cheque","24-10-2024","P2359",,,"Ibrahim deliveries","Expense","Postage and Delivery",,"MPESA Account",1000.00,"",109983.79
,"Cheque","28-10-2024","P2365",,,"Ibrahim deliveries","Expense","Postage and Delivery",,"MPESA Account",1250.00,"",111233.79
,"Cheque","30-10-2024","P2368",,,"Ibrahim deliveries","Expense","Postage and Delivery",,"MPESA Account",250.00,"",111483.79
,"Cheque","05-11-2024","P2384",,,"Ibrahim deliveries","Expense","Postage and Delivery",,"MPESA Account",600.00,"",112083.79
,"Cheque","05-11-2024","P2385",,,"Silas delivery of spare parts","Expense","Postage and Delivery",,"MPESA Account",300.00,"",112383.79
,"Cheque","06-11-2024","P2390",,,"Ibrahim deliveries","Expense","Postage and Delivery",,"MPESA Account",250.00,"",112633.79
,"Cheque","07-11-2024","P2392",,,"Ibrahim deliveries","Expense","Postage and Delivery",,"MPESA Account",800.00,"",113433.79
,"Cheque","09-11-2024","P2394",,,"Ibrahim deliveries","Expense","Postage and Delivery",,"MPESA Account",550.00,"",113983.79
,"Cheque","09-11-2024","P2395",,,"Caleb deliveries","Expense","Postage and Delivery",,"MPESA Account",400.00,"",114383.79
,"Cheque","11-11-2024","P2397",,,"Caleb deliveries","Expense","Postage and Delivery",,"MPESA Account",350.00,"",114733.79
,"Cheque","12-11-2024","P2400",,,"Ibrahim deliveries","Expense","Postage and Delivery",,"MPESA Account",250.00,"",114983.79
,"Cheque","13-11-2024","P2403",,,"Caleb deliveries","Expense","Postage and Delivery",,"MPESA Account",650.00,"",115633.79
,"Cheque","13-11-2024","P2404",,,"Titus deliveries","Expense","Postage and Delivery",,"MPESA Account",300.00,"",115933.79
,"Cheque","15-11-2024","P2411",,,"Ibrahim deliveries","Expense","Postage and Delivery",,"MPESA Account",600.00,"",116533.79
,"Cheque","18-11-2024","P2415",,,"Caleb deliveries","Expense","Postage and Delivery",,"MPESA Account",350.00,"",116883.79
,"Cheque","18-11-2024","P2416",,,"Ibrahim deliveries","Expense","Postage and Delivery",,"MPESA Account",200.00,"",117083.79
,"Cheque","19-11-2024","P2419",,,"Caleb deliveries","Expense","Postage and Delivery",,"MPESA Account",650.00,"",117733.79
,"Cheque","21-11-2024","P2420",,,"Ibrahim deliveries","Expense","Postage and Delivery",,"MPESA Account",900.00,"",118633.79
,"Cheque","22-11-2024","P2422",,,"Chege Delivery of diesel","Expense","Postage and Delivery",,"MPESA Account",500.00,"",119133.79
,"Cheque","22-11-2024","P2423",,,"Ibrahim deliveries","Expense","Postage and Delivery",,"MPESA Account",1050.00,"",120183.79
,"Cheque","23-11-2024","P2426",,,"Caleb deliveries","Expense","Postage and Delivery",,"MPESA Account",400.00,"",120583.79
,"Cheque","25-11-2024","P2427",,,"Ibrahim deliveries","Expense","Postage and Delivery",,"MPESA Account",250.00,"",120833.79
,"Cheque","26-11-2024","P2430",,,"Benson delivery of Chuma","Expense","Postage and Delivery",,"MPESA Account",5000.00,"",125833.79
,"Cheque","28-11-2024","P2433",,,"Caleb deliveries","Expense","Postage and Delivery",,"MPESA Account",250.00,"",126083.79
,"Cheque","29-11-2024","P2434",,,"Caleb deliveries","Expense","Postage and Delivery",,"MPESA Account",400.00,"",126483.79
,"Cheque","30-11-2024","P2437",,,"Ibrahim deliveries","Expense","Postage and Delivery",,"MPESA Account",200.00,"",126683.79
,"Cheque","02-12-2024","P2440",,,"Ibrahim deliveries","Expense","Postage and Delivery",,"MPESA Account",500.00,"",127183.79
,"Cheque","03-12-2024","P2455",,,"Ibrahim deliveries","Expense","Postage and Delivery",,"MPESA Account",550.00,"",127733.79
,"Cheque","04-12-2024","P2456",,,"Ibrahim deliveries","Expense","Postage and Delivery",,"MPESA Account",750.00,"",128483.79
,"Cheque","09-12-2024","P2498",,,"Ibrahim deliveries","Expense","Postage and Delivery",,"MPESA Account",50.00,"",128533.79
,"Cheque","11-12-2024","P2465",,,"Ibrahim deliveries","Expense","Postage and Delivery",,"MPESA Account",250.00,"",128783.79
,"Cheque","13-12-2024","P2467",,,"Transport of metal sheets for bending","Expense","Postage and Delivery",,"MPESA Account",800.00,"",129583.79
,"Cheque","13-12-2024","P2470",,,"Ibrahim deliveries","Expense","Postage and Delivery",,"MPESA Account",400.00,"",129983.79
,"Cheque","16-12-2024","P2473",,,"Ena coach sending parcel to Kisumu","Expense","Postage and Delivery",,"MPESA Account",600.00,"",130583.79
,"Cheque","16-12-2024","P2474",,,"Caleb deliveries","Expense","Postage and Delivery",,"MPESA Account",350.00,"",130933.79
,"Cheque","16-12-2024","P2476",,,"Ibrahim deliveries","Expense","Postage and Delivery",,"MPESA Account",250.00,"",131183.79
,"Cheque","17-12-2024","P2478",,,"Caleb deliveries","Expense","Postage and Delivery",,"MPESA Account",250.00,"",131433.79
,"Cheque","18-12-2024","P2480",,,"Nguyo Delivery of diesel","Expense","Postage and Delivery",,"MPESA Account",500.00,"",131933.79
,"Cheque","18-12-2024","P2481",,,"Caleb deliveries","Expense","Postage and Delivery",,"MPESA Account",250.00,"",132183.79
,"Cheque","18-12-2024","P2482",,,"Ibrahim deliveries","Expense","Postage and Delivery",,"MPESA Account",400.00,"",132583.79
,"Cheque","19-12-2024","P2487",,,"Ibrahim deliveries","Expense","Postage and Delivery",,"MPESA Account",1000.00,"",133583.79
,"Cheque","20-12-2024","P2490",,,"Mburu delivery of Chuma","Expense","Postage and Delivery",,"MPESA Account",6500.00,"",140083.79
,"Cheque","21-12-2024","P2492",,,"Caleb deliveries","Expense","Postage and Delivery",,"MPESA Account",650.00,"",140733.79
,"Cheque","21-12-2024","P2493",,,"Ibrahim deliveries","Expense","Postage and Delivery",,"MPESA Account",1100.00,"",141833.79
,"Cheque","23-12-2024","P2495",,,"Ibrahim deliveries","Expense","Postage and Delivery",,"MPESA Account",50.00,"",141883.79
"Total Postage and Delivery - Other",,,,,,,,,,,141883.79,0.00,141883.79
"Total Postage and Delivery",,,,,,,,,,,240774.04,0.00,240774.04
"Professional Fees",,,,,,,,,,,,,""
"Audit Expenses",,,,,,,,,,,,,""
,"Bill","20-05-2024","0040572960000000051",,"Jacob & Associates","Audit Fees","Expense","Audit Expenses",,"Accounts Payable",220000.00,"",220000.00
"Total Audit Expenses",,,,,,,,,,,220000.00,0.00,220000.00
"Total Professional Fees",,,,,,,,,,,220000.00,0.00,220000.00
"Training",,,,,,,,,,,,,""
,"Cheque","19-02-2024","1300-4",,"Ignite Minds Afrika Ltd","Be Unstoppable Personal development program","Expense","Training",,"Cash Account",107000.00,"",107000.00
"Total Training",,,,,,,,,,,107000.00,0.00,107000.00
"Travelling and Entertainment",,,,,,,,,,,,,""
,"Cheque","03-01-2024","KE1124-24",,"Bolt Taxi","Trip Fee","Expense","Travelling and Entertainment",,"Cash Account",470.00,"",470.00
,"Cheque","10-01-2024","P1781",,,"Vincent fare reimbursement","Expense","Travelling and Entertainment",,"MPESA Account",600.00,"",1070.00
,"Cheque","19-01-2024","0190124",,"Uber Taxi","Trip Fee","Expense","Travelling and Entertainment",,"MPESA Account",390.00,"",1460.00
,"Cheque","19-01-2024","A26EDE27-0E",,"Little Cab","trip fee","Expense","Travelling and Entertainment",,"MPESA Account",810.00,"",2270.00
,"Cheque","19-01-2024","KE1124-276",,"Bolt Taxi","Trip Fee","Expense","Travelling and Entertainment",,"MPESA Account",870.00,"",3140.00
,"Cheque","19-01-2024","KE1124-73",,"Bolt Taxi","Trip Fee","Expense","Travelling and Entertainment",,"Cash Account",350.00,"",3490.00
,"Cheque","20-01-2024","KE1124-114",,"Bolt Taxi","Trip Fee","Expense","Travelling and Entertainment",,"Cash Account",520.00,"",4010.00
,"Cheque","22-01-2024","KE1124-170",,"Bolt Taxi","Trip Fee","Expense","Travelling and Entertainment",,"MPESA Account",460.00,"",4470.00
,"Cheque","22-01-2024","P1801",,,"Allan fare reimbursement","Expense","Travelling and Entertainment",,"MPESA Account",300.00,"",4770.00
,"Cheque","24-01-2024","KE1124-279",,"Bolt Taxi","Trip Fee","Expense","Travelling and Entertainment",,"MPESA Account",510.00,"",5280.00
,"Cheque","24-01-2024","KE1124-153",,"Bolt Taxi","Trip Fee","Expense","Travelling and Entertainment",,"MPESA Account",510.00,"",5790.00
,"Cheque","26-01-2024","26012024",,"Uber Taxi","Trip Fee","Expense","Travelling and Entertainment",,"MPESA Account",550.00,"",6340.00
,"Cheque","26-01-2024","KE1124-223",,"Bolt Taxi","Trip Fee","Expense","Travelling and Entertainment",,"MPESA Account",730.00,"",7070.00
,"Cheque","26-01-2024","KE1124-256",,"Bolt Taxi","Trip Fee","Expense","Travelling and Entertainment",,"Cash Account",350.00,"",7420.00
,"Cheque","27-01-2024","KE1124-148",,"Bolt Taxi","Trip Fee","Expense","Travelling and Entertainment",,"Cash Account",450.00,"",7870.00
,"Cheque","30-01-2024","KE1124-119",,"Bolt Taxi","Trip Fee","Expense","Travelling and Entertainment",,"MPESA Account",500.00,"",8370.00
,"Cheque","30-01-2024","KE1124-139",,"Bolt Taxi","Trip Fee","Expense","Travelling and Entertainment",,"MPESA Account",510.00,"",8880.00
,"Cheque","31-01-2024","31012024",,"Uber Taxi","Trip Fee","Expense","Travelling and Entertainment",,"MPESA Account",570.00,"",9450.00
,"Cheque","09-02-2024","09022024",,"Bolt Taxi","Trip Fee","Expense","Travelling and Entertainment",,"MPESA Account",910.00,"",10360.00
,"Cheque","09-02-2024","KE1124-507",,"Bolt Taxi","Trip Fee","Expense","Travelling and Entertainment",,"MPESA Account",600.00,"",10960.00
,"Cheque","09-02-2024","KE1124-16",,"Bolt Taxi","Trip Fee","Expense","Travelling and Entertainment",,"MPESA Account",490.00,"",11450.00
,"Cheque","09-02-2024","KE1124-290",,"Bolt Taxi","Trip Fee","Expense","Travelling and Entertainment",,"MPESA Account",250.00,"",11700.00
,"Cheque","12-02-2024","P1833",,,"Vincent fare reimbursement","Expense","Travelling and Entertainment",,"MPESA Account",350.00,"",12050.00
,"Cheque","13-02-2024","P1842",,,"Reuben fare reimbursement","Expense","Travelling and Entertainment",,"MPESA Account",300.00,"",12350.00
,"Cheque","14-02-2024","P1847",,,"Vincent fare reimbursement","Expense","Travelling and Entertainment",,"MPESA Account",300.00,"",12650.00
,"Cheque","15-02-2024","KE1124-519",,"Bolt Taxi","Trip Fee","Expense","Travelling and Entertainment",,"MPESA Account",470.00,"",13120.00
,"Cheque","15-02-2024","P1849",,,"Reuben fare reimbursement","Expense","Travelling and Entertainment",,"MPESA Account",300.00,"",13420.00
,"Cheque","16-02-2024","P1852",,,"Vincent fare reimbursement","Expense","Travelling and Entertainment",,"MPESA Account",200.00,"",13620.00
,"Cheque","19-02-2024","KE1124-487",,"Bolt Taxi","Trip Fee","Expense","Travelling and Entertainment",,"Cash Account",570.00,"",14190.00
,"Cheque","21-02-2024","P1858",,,"Vincent fare reimbursement","Expense","Travelling and Entertainment",,"MPESA Account",300.00,"",14490.00
,"Cheque","23-02-2024","KE1124-54",,"Bolt Taxi","Trip Fee","Expense","Travelling and Entertainment",,"MPESA Account",460.00,"",14950.00
,"Cheque","23-02-2024","KE1124-830",,"Bolt Taxi","Trip Fee","Expense","Travelling and Entertainment",,"MPESA Account",480.00,"",15430.00
,"Cheque","23-02-2024","23022024",,"Uber Taxi","Trip Fee","Expense","Travelling and Entertainment",,"MPESA Account",570.00,"",16000.00
,"Cheque","28-02-2024","P1872",,,"Reuben fare reimbursement","Expense","Travelling and Entertainment",,"MPESA Account",300.00,"",16300.00
,"Cheque","29-02-2024","KE1124-137",,"Bolt Taxi","Trip Fee","Expense","Travelling and Entertainment",,"MPESA Account",540.00,"",16840.00
,"Cheque","29-02-2024","KE1124-180",,"Bolt Taxi","Trip Fee","Expense","Travelling and Entertainment",,"MPESA Account",490.00,"",17330.00
,"Cheque","29-02-2024","290224",,"Uber Taxi","Trip Fee","Expense","Travelling and Entertainment",,"MPESA Account",480.00,"",17810.00
,"Cheque","01-03-2024","KE1124-349",,"Bolt Taxi","Trip Fee","Expense","Travelling and Entertainment",,"MPESA Account",690.00,"",18500.00
,"Cheque","04-03-2024","KE1124-496",,"Bolt Taxi","Trip Fee","Expense","Travelling and Entertainment",,"MPESA Account",350.00,"",18850.00
,"Cheque","04-03-2024","KE1124-464",,"Bolt Taxi","Trip Fee","Expense","Travelling and Entertainment",,"MPESA Account",730.00,"",19580.00
,"Cheque","04-03-2024","92D4DCF5-CE",,"Little Cab","trip fee","Expense","Travelling and Entertainment",,"MPESA Account",820.00,"",20400.00
,"Cheque","05-03-2024","KE1124-493",,"Bolt Taxi","Trip Fee","Expense","Travelling and Entertainment",,"MPESA Account",630.00,"",21030.00
,"Cheque","05-03-2024","050324",,"Uber Taxi","Trip Fee","Expense","Travelling and Entertainment",,"MPESA Account",1020.00,"",22050.00
,"Cheque","06-03-2024","06032024",,"Uber Taxi","Trip Fee","Expense","Travelling and Entertainment",,"MPESA Account",550.00,"",22600.00
,"Cheque","07-03-2024","P1885",,,"Reuben fare reimbursement","Expense","Travelling and Entertainment",,"MPESA Account",100.00,"",22700.00
,"Cheque","08-03-2024","08032024",,"Uber Taxi","Trip Fee","Expense","Travelling and Entertainment",,"MPESA Account",1080.00,"",23780.00
,"Cheque","08-03-2024","008032024",,"Uber Taxi","Trip Fee","Expense","Travelling and Entertainment",,"MPESA Account",460.00,"",24240.00
,"Cheque","13-03-2024","13032024",,"Uber Taxi","Trip Fee","Expense","Travelling and Entertainment",,"MPESA Account",490.00,"",24730.00
,"Cheque","14-03-2024","P1892",,,"Vincent fare reimbursement","Expense","Travelling and Entertainment",,"MPESA Account",300.00,"",25030.00
,"Cheque","20-03-2024","KE1124-385",,"Bolt Taxi","Trip Fee","Expense","Travelling and Entertainment",,"MPESA Account",300.00,"",25330.00
,"Cheque","20-03-2024","020032024",,"Uber Taxi","Trip Fee","Expense","Travelling and Entertainment",,"MPESA Account",260.00,"",25590.00
,"Cheque","21-03-2024","P1898",,,"Reuben fare reimbursement","Expense","Travelling and Entertainment",,"MPESA Account",100.00,"",25690.00
,"Cheque","21-03-2024","P1908",,,"Reuben fare reimbursement","Expense","Travelling and Entertainment",,"MPESA Account",300.00,"",25990.00
,"Cheque","22-03-2024","KE1124-604",,"Bolt Taxi","Trip Fee","Expense","Travelling and Entertainment",,"MPESA Account",630.00,"",26620.00
,"Cheque","22-03-2024","KE1124-395",,"Bolt Taxi","Trip Fee","Expense","Travelling and Entertainment",,"MPESA Account",340.00,"",26960.00
,"Cheque","22-03-2024","KE1124-316",,"Bolt Taxi","Trip Fee","Expense","Travelling and Entertainment",,"MPESA Account",500.00,"",27460.00
,"Cheque","22-03-2024","KE1124-419",,"Bolt Taxi","Trip Fee","Expense","Travelling and Entertainment",,"MPESA Account",470.00,"",27930.00
,"Cheque","22-03-2024","P1934",,,"Ndambuki fare reimbursement","Expense","Travelling and Entertainment",,"MPESA Account",200.00,"",28130.00
,"Cheque","25-03-2024","25032024",,"Uber Taxi","Trip Fee","Expense","Travelling and Entertainment",,"MPESA Account",990.00,"",29120.00
,"Cheque","25-03-2024","P1917",,,"Erick Omondi fare reimbursement","Expense","Travelling and Entertainment",,"MPESA Account",100.00,"",29220.00
,"Cheque","25-03-2024","KE1124-1056",,"Bolt Taxi","Trip Fee","Expense","Travelling and Entertainment",,"MPESA Account",290.00,"",29510.00
,"Cheque","26-03-2024","26032024",,"Uber Taxi","Trip Fee","Expense","Travelling and Entertainment",,"MPESA Account",410.00,"",29920.00
,"Cheque","26-03-2024","P1922",,,"Reuben fare reimbursement","Expense","Travelling and Entertainment",,"MPESA Account",100.00,"",30020.00
,"Cheque","27-03-2024","027032024",,"Uber Taxi","Trip Fee","Expense","Travelling and Entertainment",,"MPESA Account",460.00,"",30480.00
,"Cheque","28-03-2024","P1924",,,"Reuben fare reimbursement","Expense","Travelling and Entertainment",,"MPESA Account",150.00,"",30630.00
,"Cheque","02-04-2024","P1937",,,"Reuben fare reimbursement","Expense","Travelling and Entertainment",,"MPESA Account",100.00,"",30730.00
,"Cheque","05-04-2024","005042024",,"Uber Taxi","Trip Fee","Expense","Travelling and Entertainment",,"MPESA Account",1010.00,"",31740.00
,"Cheque","05-04-2024","B4D11D17-12",,"Little Cab","trip fee","Expense","Travelling and Entertainment",,"MPESA Account",760.00,"",32500.00
,"Cheque","08-04-2024","KE1124-133",,"Bolt Taxi","Trip Fee","Expense","Travelling and Entertainment",,"MPESA Account",700.00,"",33200.00
,"Cheque","08-04-2024","KE1124-81",,"Bolt Taxi","Trip Fee","Expense","Travelling and Entertainment",,"MPESA Account",490.00,"",33690.00
,"Cheque","08-04-2024","KE1124-1043",,"Bolt Taxi","Trip Fee","Expense","Travelling and Entertainment",,"MPESA Account",610.00,"",34300.00
,"Cheque","08-04-2024","KE1124-199",,"Bolt Taxi","Trip Fee","Expense","Travelling and Entertainment",,"MPESA Account",1030.00,"",35330.00
,"Cheque","08-04-2024","2B665B55-E0",,"Little Cab","trip fee","Expense","Travelling and Entertainment",,"MPESA Account",700.00,"",36030.00
,"Cheque","11-04-2024","011042024",,"Uber Taxi","Trip Fee","Expense","Travelling and Entertainment",,"MPESA Account",470.00,"",36500.00
,"Cheque","11-04-2024","KE1124-809",,"Bolt Taxi","Trip Fee","Expense","Travelling and Entertainment",,"MPESA Account",520.00,"",37020.00
,"Cheque","11-04-2024","P1964",,,"Reuben fare reimbursement","Expense","Travelling and Entertainment",,"MPESA Account",100.00,"",37120.00
,"Cheque","11-04-2024","P1965",,,"Vincent fare reimbursement","Expense","Travelling and Entertainment",,"MPESA Account",300.00,"",37420.00
,"Cheque","12-04-2024","P1966",,,"Reuben fare reimbursement","Expense","Travelling and Entertainment",,"MPESA Account",250.00,"",37670.00
,"Cheque","16-04-2024","016042024",,"Uber Taxi","Trip Fee","Expense","Travelling and Entertainment",,"MPESA Account",600.00,"",38270.00
,"Cheque","18-04-2024","KE1124-1133",,"Bolt Taxi","Trip Fee","Expense","Travelling and Entertainment",,"MPESA Account",650.00,"",38920.00
,"Cheque","19-04-2024","019042024",,"Uber Taxi","Trip Fee","Expense","Travelling and Entertainment",,"MPESA Account",510.00,"",39430.00
,"Cheque","19-04-2024","KE1124-729",,"Bolt Taxi","Trip Fee","Expense","Travelling and Entertainment",,"MPESA Account",540.00,"",39970.00
,"Cheque","22-04-2024","P1978",,,"Reuben fare reimbursement","Expense","Travelling and Entertainment",,"MPESA Account",300.00,"",40270.00
,"Cheque","25-04-2024","KE1124-1317",,"Bolt Taxi","Trip Fee","Expense","Travelling and Entertainment",,"MPESA Account",490.00,"",40760.00
,"Cheque","26-04-2024","P1987",,,"Reuben fare reimbursement","Expense","Travelling and Entertainment",,"MPESA Account",250.00,"",41010.00
,"Cheque","27-04-2024","027042024",,"Uber Taxi","Trip Fee","Expense","Travelling and Entertainment",,"MPESA Account",500.00,"",41510.00
,"Cheque","29-04-2024","KE1124-588",,"Bolt Taxi","Trip Fee","Expense","Travelling and Entertainment",,"MPESA Account",500.00,"",42010.00
,"Cheque","29-04-2024","29042024",,"Uber Taxi","Trip Fee","Expense","Travelling and Entertainment",,"MPESA Account",490.00,"",42500.00
,"Cheque","29-04-2024","KE1124-611",,"Bolt Taxi","Trip Fee","Expense","Travelling and Entertainment",,"MPESA Account",680.00,"",43180.00
,"Cheque","29-04-2024","KE1124-161",,"Bolt Taxi","Trip Fee","Expense","Travelling and Entertainment",,"MPESA Account",730.00,"",43910.00
,"Cheque","29-04-2024","KE1124-87",,"Bolt Taxi","Trip Fee","Expense","Travelling and Entertainment",,"MPESA Account",500.00,"",44410.00
,"Cheque","02-05-2024","P1998",,,"Reuben fare reimbursement","Expense","Travelling and Entertainment",,"MPESA Account",400.00,"",44810.00
,"Cheque","04-05-2024","P2001",,,"Reuben fare reimbursement","Expense","Travelling and Entertainment",,"MPESA Account",500.00,"",45310.00
,"Cheque","06-05-2024","KE1124-1293",,"Bolt Taxi","Trip Fee","Expense","Travelling and Entertainment",,"MPESA Account",510.00,"",45820.00
,"Cheque","06-05-2024","P2004",,,"Vincent fare reimbursement","Expense","Travelling and Entertainment",,"MPESA Account",300.00,"",46120.00
,"Cheque","08-05-2024","P1988",,,"Erick, Samson, Douglas, & Evans fare reimbursement","Expense","Travelling and Entertainment",,"MPESA Account",400.00,"",46520.00
,"Cheque","09-05-2024","09052024",,"Uber Taxi","Trip Fee","Expense","Travelling and Entertainment",,"MPESA Account",260.00,"",46780.00
,"Cheque","09-05-2024","090524",,"Uber Taxi","Trip Fee","Expense","Travelling and Entertainment",,"MPESA Account",390.00,"",47170.00
,"Cheque","09-05-2024","P2019",,,"Korir fare reimbursement","Expense","Travelling and Entertainment",,"MPESA Account",200.00,"",47370.00
,"Cheque","13-05-2024","KE1124-108",,"Bolt Taxi","Trip Fee","Expense","Travelling and Entertainment",,"MPESA Account",410.00,"",47780.00
,"Cheque","14-05-2024","14052024",,"Uber Taxi","Trip Fee","Expense","Travelling and Entertainment",,"MPESA Account",420.00,"",48200.00
,"Cheque","16-05-2024","P2035",,,"Reuben fare reimbursement","Expense","Travelling and Entertainment",,"MPESA Account",350.00,"",48550.00
,"Cheque","16-05-2024","16052024",,"Uber Taxi","Trip Fee","Expense","Travelling and Entertainment",,"MPESA Account",150.00,"",48700.00
,"Cheque","17-05-2024","P2038",,,"Reuben fare reimbursement","Expense","Travelling and Entertainment",,"MPESA Account",400.00,"",49100.00
,"Cheque","17-05-2024","17524",,"Uber Taxi","Trip Fee","Expense","Travelling and Entertainment",,"MPESA Account",560.00,"",49660.00
,"Bill","20-05-2024","3284",,"Nigeria High Commission","admin fee","Expense","Travelling and Entertainment",,"Accounts Payable",2500.00,"",52160.00
,"Cheque","22-05-2024","P2048",,,"Reuben fare reimbursement","Expense","Travelling and Entertainment",,"MPESA Account",300.00,"",52460.00
,"Cheque","23-05-2024","KE1124-949",,"Bolt Taxi","Trip Fee","Expense","Travelling and Entertainment",,"MPESA Account",490.00,"",52950.00
,"Cheque","23-05-2024","23052024",,"Uber Taxi","Trip Fee","Expense","Travelling and Entertainment",,"MPESA Account",910.00,"",53860.00
,"Cheque","23-05-2024","KE1124-785",,"Bolt Taxi","Trip Fee","Expense","Travelling and Entertainment",,"MPESA Account",380.00,"",54240.00
,"Cheque","23-05-2024","KE1124-203",,"Bolt Taxi","Trip Fee","Expense","Travelling and Entertainment",,"MPESA Account",470.00,"",54710.00
,"Cheque","23-05-2024","P2051",,,"Reuben fare reimbursement","Expense","Travelling and Entertainment",,"MPESA Account",200.00,"",54910.00
,"Cheque","24-05-2024","KE1124-767",,"Bolt Taxi","Trip Fee","Expense","Travelling and Entertainment",,"MPESA Account",990.00,"",55900.00
,"Cheque","24-05-2024","KE1124-964",,"Bolt Taxi","Trip Fee","Expense","Travelling and Entertainment",,"MPESA Account",1900.00,"",57800.00
,"Cheque","24-05-2024","KE1124-315",,"Bolt Taxi","Trip Fee","Expense","Travelling and Entertainment",,"MPESA Account",250.00,"",58050.00
,"Cheque","27-05-2024","P2061",,,"Reuben fare reimbursement","Expense","Travelling and Entertainment",,"MPESA Account",100.00,"",58150.00
,"Cheque","29-05-2024","29052024",,"Uber Taxi","Trip Fee","Expense","Travelling and Entertainment",,"MPESA Account",450.00,"",58600.00
,"Cheque","30-05-2024","30052024",,"Uber Taxi","Trip Fee","Expense","Travelling and Entertainment",,"MPESA Account",570.00,"",59170.00
,"Cheque","31-05-2024","31052024",,"Uber Taxi","Trip Fee","Expense","Travelling and Entertainment",,"MPESA Account",780.00,"",59950.00
,"Cheque","03-06-2024","P2075",,,"Reuben fare reimbursement","Expense","Travelling and Entertainment",,"MPESA Account",300.00,"",60250.00
,"Cheque","05-06-2024","05062024",,"Uber Taxi","Trip Fee","Expense","Travelling and Entertainment",,"MPESA Account",540.00,"",60790.00
,"Cheque","07-06-2024","P2090",,,"Vincent fare reimbursement","Expense","Travelling and Entertainment",,"MPESA Account",700.00,"",61490.00
,"Cheque","10-06-2024","P2096",,,"Reuben fare reimbursement","Expense","Travelling and Entertainment",,"MPESA Account",200.00,"",61690.00
,"Cheque","10-06-2024","KE1124-228",,"Bolt Taxi","Trip Fee","Expense","Travelling and Entertainment",,"Cash Account",220.00,"",61910.00
,"Cheque","14-06-2024","14062024",,"Uber Taxi","Trip Fee","Expense","Travelling and Entertainment",,"MPESA Account",390.00,"",62300.00
,"Cheque","19-06-2024","KE1124-719",,"Bolt Taxi","Trip Fee","Expense","Travelling and Entertainment",,"MPESA Account",540.00,"",62840.00
,"Cheque","24-06-2024","KE1124-812",,"Bolt Taxi","Trip Fee","Expense","Travelling and Entertainment",,"MPESA Account",590.00,"",63430.00
,"Cheque","01-07-2024","01072024",,"Uber Taxi","Trip Fee","Expense","Travelling and Entertainment",,"MPESA Account",580.00,"",64010.00
,"Cheque","05-07-2024","05072024",,"Uber Taxi","Trip Fee","Expense","Travelling and Entertainment",,"MPESA Account",310.00,"",64320.00
,"Cheque","05-07-2024","KE1124-995",,"Bolt Taxi","Trip Fee","Expense","Travelling and Entertainment",,"Cash Account",890.00,"",65210.00
,"Bill","07-07-2024","070724010135",,"Middle East Supermarket","drinking water","Expense","Travelling and Entertainment",,"Accounts Payable - UGX",175.34,"",65385.34
,"Bill","09-07-2024","NT09072024010100102",,"Master Supermarket Ltd","drinking water and cleaning detergent","Expense","Travelling and Entertainment",,"Accounts Payable - UGX",549.38,"",65934.72
,"Bill","09-07-2024","4011",,"Canary Hotel","Hotel Charges","Expense","Travelling and Entertainment",,"Accounts Payable - UGX",56945.13,"",122879.85
,"Cheque","10-07-2024","UG1124-28",,"Bolt Uganda","trip fee","Expense","Travelling and Entertainment",,"Cash Account",448.28,"",123328.13
,"Cheque","11-07-2024","UG1124-42",,"Bolt Uganda","trip fee","Expense","Travelling and Entertainment",,"Cash Account",482.76,"",123810.89
,"Cheque","12-07-2024","12072024",,"Uber Taxi","Trip Fee","Expense","Travelling and Entertainment",,"MPESA Account",550.00,"",124360.89
,"Cheque","12-07-2024","P2152",,,"Reuben fare reimbursement","Expense","Travelling and Entertainment",,"MPESA Account",300.00,"",124660.89
,"Cheque","12-07-2024","1272024",,"Uber Taxi","Trip Fee","Expense","Travelling and Entertainment",,"MPESA Account",520.00,"",125180.89
,"Cheque","13-07-2024","13072024",,"Uber Taxi","Trip Fee","Expense","Travelling and Entertainment",,"MPESA Account",490.00,"",125670.89
,"Cheque","17-07-2024","KE1124-1257",,"Bolt Taxi","Trip Fee","Expense","Travelling and Entertainment",,"MPESA Account",300.00,"",125970.89
,"Cheque","17-07-2024","P2157",,,"Reuben fare reimbursement","Expense","Travelling and Entertainment",,"MPESA Account",200.00,"",126170.89
,"Cheque","17-07-2024","KE1124-771",,"Bolt Taxi","Trip Fee","Expense","Travelling and Entertainment",,"MPESA Account",370.00,"",126540.89
,"Cheque","19-07-2024","19072024",,"Uber Taxi","Trip Fee","Expense","Travelling and Entertainment",,"MPESA Account",330.00,"",126870.89
,"Cheque","19-07-2024","1972024",,"Uber Taxi","Trip Fee","Expense","Travelling and Entertainment",,"MPESA Account",540.00,"",127410.89
,"Cheque","22-07-2024","P2165",,,"Reuben fare reimbursement","Expense","Travelling and Entertainment",,"MPESA Account",300.00,"",127710.89
,"Cheque","24-07-2024","P2172",,,"Reuben fare reimbursement","Expense","Travelling and Entertainment",,"MPESA Account",300.00,"",128010.89
,"Cheque","30-07-2024","30072024",,"Uber Taxi","Trip Fee","Expense","Travelling and Entertainment",,"MPESA Account",490.00,"",128500.89
,"Cheque","01-08-2024","P2187",,,"Denis, Douglas, Peter, and Erick fare reimbursement","Expense","Travelling and Entertainment",,"MPESA Account",400.00,"",128900.89
,"Cheque","05-08-2024","05082024",,"Uber Taxi","Trip Fee","Expense","Travelling and Entertainment",,"MPESA Account",540.00,"",129440.89
,"Cheque","09-08-2024","KE1124-1584",,"Bolt Taxi","Trip Fee","Expense","Travelling and Entertainment",,"MPESA Account",490.00,"",129930.89
,"Cheque","16-08-2024","16082024",,"Uber Taxi","Trip Fee","Expense","Travelling and Entertainment",,"MPESA Account",280.00,"",130210.89
,"Cheque","16-08-2024","160824",,"Uber Taxi","Trip Fee","Expense","Travelling and Entertainment",,"MPESA Account",580.00,"",130790.89
,"Cheque","21-08-2024","KE1124-4135",,"Bolt Taxi","Trip Fee","Expense","Travelling and Entertainment",,"MPESA Account",310.00,"",131100.89
,"Cheque","23-08-2024","KE1124-547",,"Bolt Taxi","Trip Fee","Expense","Travelling and Entertainment",,"MPESA Account",740.00,"",131840.89
,"Cheque","26-08-2024","KE1124-55",,"Bolt Taxi","Trip Fee","Expense","Travelling and Entertainment",,"MPESA Account",540.00,"",132380.89
,"Cheque","27-08-2024","27082024",,"Uber Taxi","Trip Fee","Expense","Travelling and Entertainment",,"MPESA Account",420.00,"",132800.89
,"Cheque","27-08-2024","KE1124-522",,"Bolt Taxi","Trip Fee","Expense","Travelling and Entertainment",,"MPESA Account",550.00,"",133350.89
,"Cheque","28-08-2024","KE1124-765",,"Bolt Taxi","Trip Fee","Expense","Travelling and Entertainment",,"Cash Account",420.00,"",133770.89
,"Cheque","02-09-2024","02092024",,"Uber Taxi","Trip Fee","Expense","Travelling and Entertainment",,"MPESA Account",420.00,"",134190.89
,"Cheque","05-09-2024","KE1124-125",,"Bolt Taxi","Trip Fee","Expense","Travelling and Entertainment",,"MPESA Account",540.00,"",134730.89
,"Cheque","05-09-2024","KE1124-8",,"Bolt Taxi","Trip Fee","Expense","Travelling and Entertainment",,"MPESA Account",290.00,"",135020.89
,"Cheque","06-09-2024","06092024",,"Uber Taxi","Trip Fee","Expense","Travelling and Entertainment",,"MPESA Account",640.00,"",135660.89
,"Cheque","06-09-2024","6092024",,"Uber Taxi","Trip Fee","Expense","Travelling and Entertainment",,"MPESA Account",660.00,"",136320.89
,"Cheque","11-09-2024","KE1124-159",,"Bolt Taxi","Trip Fee","Expense","Travelling and Entertainment",,"MPESA Account",560.00,"",136880.89
,"Cheque","12-09-2024","P2288",,,"Douglas, Fredrick, and Erick fare reimbursement","Expense","Travelling and Entertainment",,"MPESA Account",300.00,"",137180.89
,"Cheque","23-09-2024","KE1124-185",,"Bolt Taxi","Trip Fee","Expense","Travelling and Entertainment",,"MPESA Account",550.00,"",137730.89
,"Cheque","11-10-2024","P2343",,,"Vincent fare reimbursement","Expense","Travelling and Entertainment",,"MPESA Account",596.00,"",138326.89
,"Cheque","16-10-2024","P2345",,,"Vincent fare reimbursement","Expense","Travelling and Entertainment",,"MPESA Account",300.00,"",138626.89
,"Cheque","18-10-2024","18102024",,"Uber Taxi","Trip Fee","Expense","Travelling and Entertainment",,"MPESA Account",490.00,"",139116.89
,"Cheque","18-10-2024","018102024",,"Uber Taxi","Trip Fee","Expense","Travelling and Entertainment",,"MPESA Account",1140.00,"",140256.89
,"Cheque","25-10-2024","P2363",,,"Denis fare reimbursement","Expense","Travelling and Entertainment",,"MPESA Account",200.00,"",140456.89
,"Cheque","25-10-2024","25102024",,"Uber Taxi","Trip Fee","Expense","Travelling and Entertainment",,"MPESA Account",500.00,"",140956.89
,"Cheque","29-10-2024","29102024",,"Uber Taxi","Trip Fee","Expense","Travelling and Entertainment",,"MPESA Account",400.00,"",141356.89
,"Cheque","29-10-2024","029102024",,"Uber Taxi","Trip Fee","Expense","Travelling and Entertainment",,"MPESA Account",430.00,"",141786.89
,"Cheque","29-10-2024","0029102024",,"Uber Taxi","Trip Fee","Expense","Travelling and Entertainment",,"MPESA Account",610.00,"",142396.89
,"Cheque","08-11-2024","KE1124-755",,"Bolt Taxi","Trip Fee","Expense","Travelling and Entertainment",,"MPESA Account",580.00,"",142976.89
,"Cheque","08-11-2024","KE1124-553",,"Bolt Taxi","Trip Fee","Expense","Travelling and Entertainment",,"Cash Account",480.00,"",143456.89
,"Cheque","11-11-2024","KE1124-1101",,"Bolt Taxi","Trip Fee","Expense","Travelling and Entertainment",,"MPESA Account",600.00,"",144056.89
,"Cheque","11-11-2024","11112024",,"Uber Taxi","Trip Fee","Expense","Travelling and Entertainment",,"MPESA Account",350.00,"",144406.89
,"Cheque","12-11-2024","P2401",,,"Trip to Lukenya","Expense","Travelling and Entertainment",,"MPESA Account",2000.00,"",146406.89
,"Cheque","14-11-2024","P2407",,,"Fredrick, Evans, Brian, Douglas, and Edwin fare reimbursement","Expense","Travelling and Entertainment",,"MPESA Account",500.00,"",146906.89
,"Cheque","15-11-2024","15112024",,"Uber Taxi","Trip Fee","Expense","Travelling and Entertainment",,"MPESA Account",630.00,"",147536.89
,"Cheque","15-11-2024","KE1124-687",,"Bolt Taxi","Trip Fee","Expense","Travelling and Entertainment",,"MPESA Account",480.00,"",148016.89
,"Cheque","19-11-2024","19112024",,"Uber Taxi","Trip Fee","Expense","Travelling and Entertainment",,"MPESA Account",450.00,"",148466.89
,"Cheque","20-11-2024","KE1124-2700",,"Bolt Taxi","Trip Fee","Expense","Travelling and Entertainment",,"MPESA Account",510.00,"",148976.89
,"Cheque","20-11-2024","KE1124-12",,"Bolt Taxi","Trip Fee","Expense","Travelling and Entertainment",,"MPESA Account",290.00,"",149266.89
,"Cheque","21-11-2024","KE1124-378",,"Bolt Taxi","Trip Fee","Expense","Travelling and Entertainment",,"MPESA Account",450.00,"",149716.89
,"Cheque","21-11-2024","21112024",,"Uber Taxi","Trip Fee","Expense","Travelling and Entertainment",,"MPESA Account",260.00,"",149976.89
,"Cheque","21-11-2024","KE1124-2919",,"Bolt Taxi","Trip Fee","Expense","Travelling and Entertainment",,"Cash Account",220.00,"",150196.89
,"Cheque","22-11-2024","22112024",,"Uber Taxi","Trip Fee","Expense","Travelling and Entertainment",,"MPESA Account",420.00,"",150616.89
,"Cheque","22-11-2024","KE1124-13",,"Bolt Taxi","Trip Fee","Expense","Travelling and Entertainment",,"MPESA Account",540.00,"",151156.89
,"Cheque","22-11-2024","KE1124-574",,"Bolt Taxi","Trip Fee","Expense","Travelling and Entertainment",,"MPESA Account",350.00,"",151506.89
,"Cheque","23-11-2024","23112024",,"Uber Taxi","Trip Fee","Expense","Travelling and Entertainment",,"MPESA Account",330.00,"",151836.89
,"Cheque","23-11-2024","231124",,"Uber Taxi","Trip Fee","Expense","Travelling and Entertainment",,"MPESA Account",730.00,"",152566.89
,"Cheque","25-11-2024","KE1124-522",,"Bolt Taxi","Trip Fee","Expense","Travelling and Entertainment",,"MPESA Account",220.00,"",152786.89
,"Cheque","29-11-2024","KE1124-824",,"Bolt Taxi","Trip Fee","Expense","Travelling and Entertainment",,"Cash Account",670.00,"",153456.89
,"Cheque","29-11-2024","DD5EAE68-D2",,"Little Cab","trip fee","Expense","Travelling and Entertainment",,"MPESA Account",720.00,"",154176.89
,"Cheque","29-11-2024","P2435",,,"trip fee","Expense","Travelling and Entertainment",,"MPESA Account",150.00,"",154326.89
,"Cheque","30-11-2024","30112024",,"Uber Taxi","Trip Fee","Expense","Travelling and Entertainment",,"MPESA Account",380.00,"",154706.89
,"Cheque","03-12-2024","29112024",,"Uber Taxi","Trip Fee","Expense","Travelling and Entertainment",,"MPESA Account",590.00,"",155296.89
,"Cheque","03-12-2024","02122024",,"Uber Taxi","Trip Fee","Expense","Travelling and Entertainment",,"MPESA Account",500.00,"",155796.89
,"Cheque","03-12-2024","021224",,"Uber Taxi","Trip Fee","Expense","Travelling and Entertainment",,"MPESA Account",920.00,"",156716.89
,"Cheque","04-12-2024","04122024",,"Uber Taxi","Trip Fee","Expense","Travelling and Entertainment",,"MPESA Account",580.00,"",157296.89
,"Cheque","04-12-2024","041224",,"Uber Taxi","Trip Fee","Expense","Travelling and Entertainment",,"MPESA Account",390.00,"",157686.89
,"Cheque","05-12-2024","P2454",,,"Trip to Nkasiri park","Expense","Travelling and Entertainment",,"MPESA Account",2181.00,"",159867.89
,"Bill","06-12-2024","0040214930000005786",,"Caribbean Food Court","Meal","Expense","Travelling and Entertainment",,"Accounts Payable",8017.24,"",167885.13
,"Cheque","06-12-2024","P2459",,,"Drinks","Expense","Travelling and Entertainment",,"MPESA Account",19080.00,"",186965.13
,"Cheque","07-12-2024","07122024",,"Uber Taxi","Trip Fee","Expense","Travelling and Entertainment",,"MPESA Account",410.00,"",187375.13
,"Cheque","07-12-2024","P2460",,,"Fare reimbursement from end year party","Expense","Travelling and Entertainment",,"MPESA Account",1900.00,"",189275.13
,"Cheque","07-12-2024","071224",,"Uber Taxi","Trip Fee","Expense","Travelling and Entertainment",,"MPESA Account",240.00,"",189515.13
,"Bill","12-12-2024","0020001450000032995",,"THE GREAT RIFT VALLEY LODGE PLC","Entertainment","Expense","Travelling and Entertainment",,"Accounts Payable",245706.49,"",435221.62
,"Cheque","13-12-2024","KE1124-853",,"Bolt Taxi","Trip Fee","Expense","Travelling and Entertainment",,"Cash Account",220.00,"",435441.62
,"Cheque","16-12-2024","P2477",,,"Evans, Brian, Douglas, Peter and Wilson fare reimbursement","Expense","Travelling and Entertainment",,"MPESA Account",500.00,"",435941.62
,"Cheque","16-12-2024","16122024",,"Uber Taxi","Trip Fee","Expense","Travelling and Entertainment",,"MPESA Account",480.00,"",436421.62
,"Cheque","17-12-2024","17122024",,"Uber Taxi","Trip Fee","Expense","Travelling and Entertainment",,"MPESA Account",310.00,"",436731.62
,"Cheque","17-12-2024","171224",,"Uber Taxi","Trip Fee","Expense","Travelling and Entertainment",,"MPESA Account",220.00,"",436951.62
,"Cheque","17-12-2024","KE1124-167",,"Bolt Taxi","Trip Fee","Expense","Travelling and Entertainment",,"MPESA Account",360.00,"",437311.62
,"Cheque","17-12-2024","KE1124-1167",,"Bolt Taxi","Trip Fee","Expense","Travelling and Entertainment",,"MPESA Account",420.00,"",437731.62
,"Cheque","19-12-2024","KE1124-2014",,"Bolt Taxi","Trip Fee","Expense","Travelling and Entertainment",,"MPESA Account",340.00,"",438071.62
,"Cheque","19-12-2024","KE1124-899",,"Bolt Taxi","Trip Fee","Expense","Travelling and Entertainment",,"MPESA Account",420.00,"",438491.62
,"Cheque","20-12-2024","KE1124-1515",,"Bolt Taxi","Trip Fee","Expense","Travelling and Entertainment",,"MPESA Account",250.00,"",438741.62
,"Cheque","20-12-2024","KE1124-3562",,"Bolt Taxi","Trip Fee","Expense","Travelling and Entertainment",,"MPESA Account",1270.00,"",440011.62
,"Cheque","21-12-2024","8ADA0A50-6B",,"Little Cab","trip fee","Expense","Travelling and Entertainment",,"MPESA Account",660.00,"",440671.62
,"Bill","22-12-2024","0040349030000001511",,"ENTIM SIDAI RETREAT LIMITED","retreat","Expense","Travelling and Entertainment",,"Accounts Payable",18189.66,"",458861.28
,"Cheque","23-12-2024","KE1124-1948",,"Bolt Taxi","Trip Fee","Expense","Travelling and Entertainment",,"MPESA Account",420.00,"",459281.28
,"Cheque","23-12-2024","KE1124-321",,"Bolt Taxi","Trip Fee","Expense","Travelling and Entertainment",,"MPESA Account",460.00,"",459741.28
,"Cheque","23-12-2024","KE1124-2454",,"Bolt Taxi","Trip Fee","Expense","Travelling and Entertainment",,"MPESA Account",340.00,"",460081.28
"Total Travelling and Entertainment",,,,,,,,,,,460081.28,0.00,460081.28
"Vehicle Expense",,,,,,,,,,,,,""
"Fuel & Oil",,,,,,,,,,,,,""
,"Bill","08-01-2024","0020105540000123782",,"Geoviwa Investments","Fuel","Expense","Fuel & Oil",,"Accounts Payable",12758.62,"",12758.62
,"Bill","11-01-2024","0310489940000112/01",,"Heykal Investments Limited","Fuel","Expense","Fuel & Oil",,"Accounts Payable",6465.52,"",19224.14
,"Bill","27-01-2024","0020105650000036703",,"Santinar Investment","Fuel","Expense","Fuel & Oil",,"Accounts Payable",6175.86,"",25400.00
,"Bill","06-02-2024","0040226660000061466",,"Dovecote Company Limited","Motorcycle fuel","Expense","Fuel & Oil",,"Accounts Payable",2155.17,"",27555.17
,"Bill","09-02-2024","0020105950000072602",,"Baraka Four Enterprises","Fuel","Expense","Fuel & Oil",,"Accounts Payable",9741.38,"",37296.55
,"Bill","10-02-2024","0041417130000006350",,"Insignia Group Limited","Fuel","Expense","Fuel & Oil",,"Accounts Payable",7181.03,"",44477.58
,"Bill","12-02-2024","1822183880000008373",,"Century Petroleum Dealers Limited","Fuel","Expense","Fuel & Oil",,"Accounts Payable",6379.31,"",50856.89
,"Bill","21-02-2024","0040892310000022540",,"Cabon Petroleum Limited","Fuel","Expense","Fuel & Oil",,"Accounts Payable",6405.17,"",57262.06
,"Bill","27-02-2024","1822183880000010222",,"Century Petroleum Dealers Limited","Fuel","Expense","Fuel & Oil",,"Accounts Payable",6551.72,"",63813.78
,"Bill","29-02-2024","1822183880000010387",,"Century Petroleum Dealers Limited","Fuel","Expense","Fuel & Oil",,"Accounts Payable",11135.34,"",74949.12
,"Bill","13-03-2024","1822183880000012056",,"Century Petroleum Dealers Limited","Fuel","Expense","Fuel & Oil",,"Accounts Payable",10344.83,"",85293.95
,"Bill","14-03-2024","0020105950000128362",,"Baraka Four Enterprises","Fuel","Expense","Fuel & Oil",,"Accounts Payable",5131.03,"",90424.98
,"Bill","28-03-2024","1822183880000014086",,"Century Petroleum Dealers Limited","Fuel","Expense","Fuel & Oil",,"Accounts Payable",6179.31,"",96604.29
,"Bill","28-03-2024","1822183880000014085",,"Century Petroleum Dealers Limited","Fuel","Expense","Fuel & Oil",,"Accounts Payable",6179.31,"",102783.60
,"Bill","29-03-2024","0022002390000001028",,"Thukamis Enterprises","Fuel","Expense","Fuel & Oil",,"Accounts Payable",9892.24,"",112675.84
,"Bill","09-04-2024","0040226660000070751",,"Dovecote Company Limited","Motorcycle fuel","Expense","Fuel & Oil",,"Accounts Payable",1986.21,"",114662.05
,"Bill","11-04-2024","1822183880000015615",,"Century Petroleum Dealers Limited","Fuel","Expense","Fuel & Oil",,"Accounts Payable",11864.66,"",126526.71
,"Bill","09-05-2024","0021995460000145426",,"Chapavel Investments","Fuel","Expense","Fuel & Oil",,"Accounts Payable",6276.78,"",132803.49
,"Bill","19-05-2024","1822183880000019945",,"Century Petroleum Dealers Limited","Fuel","Expense","Fuel & Oil",,"Accounts Payable",10907.76,"",143711.25
,"Bill","22-05-2024","0020105950000238504",,"Baraka Four Enterprises","Fuel","Expense","Fuel & Oil",,"Accounts Payable",2155.17,"",145866.42
,"Bill","27-05-2024","0040226660000077381",,"Dovecote Company Limited","Motorcycle fuel","Expense","Fuel & Oil",,"Accounts Payable",2185.34,"",148051.76
,"Bill","27-05-2024","0170522690000031236",,"Freenally Investments Limited","Fuel","Expense","Fuel & Oil",,"Accounts Payable",2758.62,"",150810.38
,"Bill","28-05-2024","0020105950000246956",,"Baraka Four Enterprises","Fuel","Expense","Fuel & Oil",,"Accounts Payable",5561.21,"",156371.59
,"Bill","13-06-2024","0020105950000273527",,"Baraka Four Enterprises","Fuel","Expense","Fuel & Oil",,"Accounts Payable",5858.62,"",162230.21
,"Bill","15-06-2024","0020105890000172142",,"Zasha Investments","Fuel","Expense","Fuel & Oil",,"Accounts Payable",10693.10,"",172923.31
,"Bill","28-06-2024","0040133220000040125",,"6M Lubrication and Energy Solutions Ltd","fuel","Expense","Fuel & Oil",,"Accounts Payable",5801.72,"",178725.03
,"Bill","05-07-2024","0020105950000307450",,"Baraka Four Enterprises","Fuel","Expense","Fuel & Oil",,"Accounts Payable",9995.03,"",188720.06
,"Bill","23-07-2024","1822183880000027164",,"Century Petroleum Dealers Limited","Fuel","Expense","Fuel & Oil",,"Accounts Payable",5401.72,"",194121.78
,"Bill","24-07-2024","0190170910000015464",,"RYASAS INVESTMENTS LIMITED","Fuel","Expense","Fuel & Oil",,"Accounts Payable",6102.59,"",200224.37
,"Bill","28-07-2024","0170522690000034745",,"Freenally Investments Limited","Fuel","Expense","Fuel & Oil",,"Accounts Payable",2758.62,"",202982.99
,"Bill","31-07-2024","0020105950000347524",,"Baraka Four Enterprises","Fuel","Expense","Fuel & Oil",,"Accounts Payable",10646.59,"",213629.58
,"Bill","08-08-2024","0020105950000360739",,"Baraka Four Enterprises","Fuel","Expense","Fuel & Oil",,"Accounts Payable",5654.53,"",219284.11
,"Bill","09-08-2024","1822183880000028964",,"Century Petroleum Dealers Limited","Fuel","Expense","Fuel & Oil",,"Accounts Payable",10396.55,"",229680.66
,"Bill","20-08-2024","0040226660000088449",,"Dovecote Company Limited","Motorcycle fuel","Expense","Fuel & Oil",,"Accounts Payable",1896.55,"",231577.21
,"Bill","20-08-2024","1822183880000030104",,"Century Petroleum Dealers Limited","Fuel","Expense","Fuel & Oil",,"Accounts Payable",10777.59,"",242354.80
,"Bill","27-08-2024","0020105950000390264",,"Baraka Four Enterprises","Fuel","Expense","Fuel & Oil",,"Accounts Payable",5914.97,"",248269.77
,"Bill","29-08-2024","1822183880000030193",,"Century Petroleum Dealers Limited","Fuel","Expense","Fuel & Oil",,"Accounts Payable",11120.69,"",259390.46
,"Bill","06-09-2024","0040418170000035469",,"Luqman Petroleum Limited","fuel","Expense","Fuel & Oil",,"Accounts Payable",3017.24,"",262407.70
,"Bill","09-09-2024","1822183880000032205",,"Century Petroleum Dealers Limited","Fuel","Expense","Fuel & Oil",,"Accounts Payable",5955.17,"",268362.87
,"Bill","09-09-2024","0040418170000035628",,"Luqman Petroleum Limited","fuel","Expense","Fuel & Oil",,"Accounts Payable",1379.31,"",269742.18
,"Bill","12-09-2024","0020105950000416414",,"Baraka Four Enterprises","Fuel","Expense","Fuel & Oil",,"Accounts Payable",9343.33,"",279085.51
,"Bill","16-09-2024","0040418170000036026",,"Luqman Petroleum Limited","fuel","Expense","Fuel & Oil",,"Accounts Payable",1724.14,"",280809.65
,"Bill","24-09-2024","0040897150000058651",,"Crosspoint Asset Managers Ltd","Fuel","Expense","Fuel & Oil",,"Accounts Payable",2758.62,"",283568.27
,"Bill","25-09-2024","0020105950000436732",,"Baraka Four Enterprises","Fuel","Expense","Fuel & Oil",,"Accounts Payable",5259.01,"",288827.28
,"Bill","26-09-2024","0040226660000093717",,"Dovecote Company Limited","Motorcycle fuel","Expense","Fuel & Oil",,"Accounts Payable",1953.45,"",290780.73
,"Bill","02-10-2024","0040226660000094470",,"Dovecote Company Limited","Fuel","Expense","Fuel & Oil",,"Accounts Payable",8266.38,"",299047.11
,"Bill","02-10-2024","0040418170000036956",,"Luqman Petroleum Limited","fuel","Expense","Fuel & Oil",,"Accounts Payable",732.76,"",299779.87
,"Bill","03-10-2024","0040418170000037007",,"Luqman Petroleum Limited","fuel","Expense","Fuel & Oil",,"Accounts Payable",2372.41,"",302152.28
,"Bill","03-10-2024","0040418170000037006",,"Luqman Petroleum Limited","fuel","Expense","Fuel & Oil",,"Accounts Payable",1293.10,"",303445.38
,"Bill","07-10-2024","0310489990000026189",,"Pristine Energy Ltd","Fuel","Expense","Fuel & Oil",,"Accounts Payable",5826.72,"",309272.10
,"Bill","10-10-2024","1822183880000035590",,"Century Petroleum Dealers Limited","Fuel","Expense","Fuel & Oil",,"Accounts Payable",12741.38,"",322013.48
,"Bill","14-10-2024","1822183880000035888",,"Century Petroleum Dealers Limited","Fuel","Expense","Fuel & Oil",,"Accounts Payable",5077.59,"",327091.07
,"Bill","22-10-2024","0171957880000000597",,"Century Petroleum Dealers Limited","Fuel","Expense","Fuel & Oil",,"Accounts Payable",10948.28,"",338039.35
,"Bill","22-10-2024","0040418170000037931",,"Luqman Petroleum Limited","fuel","Expense","Fuel & Oil",,"Accounts Payable",2586.21,"",340625.56
,"Bill","26-10-2024","1822183880000036575",,"Century Petroleum Dealers Limited","Fuel","Expense","Fuel & Oil",,"Accounts Payable",5646.55,"",346272.11
,"Bill","03-11-2024","0020105740000088641",,"Pewan Investments","Fuel","Expense","Fuel & Oil",,"Accounts Payable",11120.69,"",357392.80
,"Bill","08-11-2024","0020105950000504404",,"Baraka Four Enterprises","Fuel","Expense","Fuel & Oil",,"Accounts Payable",5569.02,"",362961.82
,"Bill","12-11-2024","0040226660000099390",,"Dovecote Company Limited","Fuel","Expense","Fuel & Oil",,"Accounts Payable",1293.10,"",364254.92
,"Bill","12-11-2024","0040418170000039063",,"Luqman Petroleum Limited","fuel","Expense","Fuel & Oil",,"Accounts Payable",1724.14,"",365979.06
,"Bill","14-11-2024","0020105950000513446",,"Baraka Four Enterprises","Fuel","Expense","Fuel & Oil",,"Accounts Payable",10080.00,"",376059.06
,"Bill","20-11-2024","0040418170000039473",,"Luqman Petroleum Limited","fuel","Expense","Fuel & Oil",,"Accounts Payable",2620.69,"",378679.75
,"Bill","22-11-2024","0041029290000121356",,"Nixomb Limited","Fuel","Expense","Fuel & Oil",,"Accounts Payable",1724.14,"",380403.89
,"Bill","22-11-2024","0040226660000100777",,"Dovecote Company Limited","Motorcycle fuel","Expense","Fuel & Oil",,"Accounts Payable",1896.55,"",382300.44
,"Bill","23-11-2024","0040418170000039641",,"Luqman Petroleum Limited","fuel","Expense","Fuel & Oil",,"Accounts Payable",1724.14,"",384024.58
,"Bill","24-11-2024","0020105950000529095",,"Baraka Four Enterprises","Fuel","Expense","Fuel & Oil",,"Accounts Payable",5604.83,"",389629.41
,"Bill","28-11-2024","0040418170000039838",,"Luqman Petroleum Limited","fuel","Expense","Fuel & Oil",,"Accounts Payable",1724.14,"",391353.55
,"Bill","30-11-2024","0020105950000531963",,"Baraka Four Enterprises","Fuel","Expense","Fuel & Oil",,"Accounts Payable",5517.64,"",396871.19
,"Bill","03-12-2024","0040418170000040061",,"Luqman Petroleum Limited","fuel","Expense","Fuel & Oil",,"Accounts Payable",2844.83,"",399716.02
,"Bill","05-12-2024","0040226660000102466",,"Dovecote Company Limited","Fuel","Expense","Fuel & Oil",,"Accounts Payable",1120.69,"",400836.71
,"Bill","05-12-2024","0170957230000007644",,"Dreamliner Energies Ltd","Fuel","Expense","Fuel & Oil",,"Accounts Payable",862.07,"",401698.78
,"Bill","07-12-2024","0171957880000004836",,"Century Petroleum Dealers Limited","Fuel","Expense","Fuel & Oil",,"Accounts Payable",10086.21,"",411784.99
,"Bill","12-12-2024","KRACU0100066787/337",,"Energy Brand Ltd","fuel","Expense","Fuel & Oil",,"Accounts Payable",689.66,"",412474.65
,"Bill","13-12-2024","0040418170000040543",,"Luqman Petroleum Limited","fuel","Expense","Fuel & Oil",,"Accounts Payable",2844.83,"",415319.48
,"Bill","13-12-2024","0040418170000040556",,"Luqman Petroleum Limited","fuel","Expense","Fuel & Oil",,"Accounts Payable",2844.83,"",418164.31
,"Bill","14-12-2024","0020105950000552522",,"Baraka Four Enterprises","Fuel","Expense","Fuel & Oil",,"Accounts Payable",5544.11,"",423708.42
,"Bill","18-12-2024","0020105950000557765",,"Baraka Four Enterprises","Fuel","Expense","Fuel & Oil",,"Accounts Payable",1491.38,"",425199.80
,"Bill","19-12-2024","0171957880000006072",,"Century Petroleum Dealers Limited","Fuel","Expense","Fuel & Oil",,"Accounts Payable",8189.66,"",433389.46
,"Bill","19-12-2024","0171957880000006113",,"Century Petroleum Dealers Limited","Fuel","Expense","Fuel & Oil",,"Accounts Payable",10381.90,"",443771.36
,"Bill","20-12-2024","0040343630000035061",,"Oilhub Limited","fuel","Expense","Fuel & Oil",,"Accounts Payable",758.62,"",444529.98
,"Bill","21-12-2024","0040418170000040935",,"Luqman Petroleum Limited","fuel","Expense","Fuel & Oil",,"Accounts Payable",1293.10,"",445823.08
"Total Fuel & Oil",,,,,,,,,,,445823.08,0.00,445823.08
"Servicing/Repairs",,,,,,,,,,,,,""
,"Bill","16-01-2024","0040349850000000142",,"Sure Drive Car Solution","Vehicle parts","Expense","Servicing/Repairs",,"Accounts Payable",11206.90,"",11206.90
,"Bill","27-01-2024","0040552400000000199",,"Johag Enterprises Ltd","motorcycle servicing","Expense","Servicing/Repairs",,"Accounts Payable",925.86,"",12132.76
,"Bill","05-02-2024","0040073190000161529",,"Impala Downtown Limited","parts","Expense","Servicing/Repairs",,"Accounts Payable",5603.45,"",17736.21
,"Bill","07-03-2024","0190276370000172403",,"Car and General Trading Limited","Forklift Service","Expense","Servicing/Repairs",,"Accounts Payable",16661.28,"",34397.49
,"Bill","13-03-2024","0040073190000175749",,"Impala Downtown Limited","inlet manifold","Expense","Servicing/Repairs",,"Accounts Payable",22500.00,"",56897.49
,"Cheque","10-04-2024","8968",,"Aliko Motors Ltd","Motorcycle servicing","Expense","Servicing/Repairs",,"MPESA Account",850.00,"",57747.49
,"Bill","28-04-2024","0020064350000040991",,"Veew Distributors Limited","Lubricants","Expense","Servicing/Repairs",,"Accounts Payable",2844.83,"",60592.32
,"Cheque","18-06-2024","649",,"Motor Vehicle Auto Spares Services","Auto parts","Expense","Servicing/Repairs",,"Cash Account",3000.00,"",63592.32
,"Bill","27-06-2024","0020113070000020545",,"AutoExpress Limited","vehicle servicing","Expense","Servicing/Repairs",,"Accounts Payable",5775.86,"",69368.18
,"Cheque","02-07-2024","1323",,"Vermwa Auto Spare & Accessories","Wiper","Expense","Servicing/Repairs",,"Cash Account",3000.00,"",72368.18
,"Bill","08-08-2024","0170920020000013916",,"Bajaj East Africa Limited","motorcycle servicing","Expense","Servicing/Repairs",,"Accounts Payable",1465.52,"",73833.70
,"Bill","09-08-2024","0190276370000231183",,"Car and General Trading Limited","Forklift Service","Expense","Servicing/Repairs",,"Accounts Payable",15760.75,"",89594.45
,"Bill","09-08-2024","0190276370000231183",,"Car and General Trading Limited","Forklift Service","Expense","Servicing/Repairs",,"Accounts Payable","",0.47,89593.98
,"Bill","20-09-2024","0041169670000000066",,"Bawinjo Supplies Centre","Vehicle repairs","Expense","Servicing/Repairs",,"Accounts Payable",15500.00,"",105093.98
,"Bill","02-12-2024","0020113070000038779",,"AutoExpress Limited","vehicle servicing","Expense","Servicing/Repairs",,"Accounts Payable",3534.48,"",108628.46
,"Bill","03-12-2024","0040083530000138506",,"Impala Auto Spares Ltd","Vehicle repair","Expense","Servicing/Repairs",,"Accounts Payable",2672.41,"",111300.87
,"Bill","03-12-2024","0040073190000282011",,"Impala Downtown Limited","service","Expense","Servicing/Repairs",,"Accounts Payable",12068.97,"",123369.84
,"Bill","12-12-2024","0170920020000016492",,"Bajaj East Africa Limited","motorcycle servicing","Expense","Servicing/Repairs",,"Accounts Payable",905.17,"",124275.01
"Total Servicing/Repairs",,,,,,,,,,,124275.48,0.47,124275.01
"Vehicle Expense - Other",,,,,,,,,,,,,""
,"Cheque","22-05-2024","P2045",,,"Parking expense","Expense","Vehicle Expense",,"MPESA Account",500.00,"",500.00
"Total Vehicle Expense - Other",,,,,,,,,,,500.00,0.00,500.00
"Total Vehicle Expense",,,,,,,,,,,570598.56,0.47,570598.09
"Total Factory Overheads",,,,,,,,,,,6298970.14,15178.48,6283791.66
"Payroll Expenses",,,,,,,,,,,,,""
"Hsing Levy Company Contribution",,,,,,,,,,,,,""
,"General Journal","30-04-2024","23581",,,"Apr 2024 Hsing Levy Contribution","Expense","Hsing Levy Company Contribution",,"Housing Levy",16085.56,"",16085.56
,"General Journal","31-05-2024","24001",,,"May 2024 Hsing Levy Contribution","Expense","Hsing Levy Company Contribution",,"Housing Levy",16494.69,"",32580.25
,"General Journal","30-06-2024","24448",,,"Jun 2024 Hsing Levy Contribution","Expense","Hsing Levy Company Contribution",,"Housing Levy",15718.50,"",48298.75
,"General Journal","31-07-2024","24608",,,"Jul 2024 Hsing Levy Contribution","Expense","Hsing Levy Company Contribution",,"Housing Levy",16215.41,"",64514.16
,"General Journal","31-08-2024","25065",,,"Aug 2024 Hsing Levy Contribution","Expense","Hsing Levy Company Contribution",,"Housing Levy",15474.74,"",79988.90
,"General Journal","30-09-2024","25438",,,"Sep 2024 Hsing Levy Contribution","Expense","Hsing Levy Company Contribution",,"Housing Levy",15660.74,"",95649.64
,"General Journal","31-10-2024","26034",,,"Oct 2024 Hsing Levy Contribution","Expense","Hsing Levy Company Contribution",,"Housing Levy",15376.72,"",111026.36
,"General Journal","30-11-2024","26595",,,"Nov 2024 Hsing Levy Contribution","Expense","Hsing Levy Company Contribution",,"Housing Levy",15897.71,"",126924.07
,"General Journal","31-12-2024","26655",,,"Dec 2024 Hsing Levy Contribution","Expense","Hsing Levy Company Contribution",,"Housing Levy",15960.74,"",142884.81
"Total Hsing Levy Company Contribution",,,,,,,,,,,142884.81,0.00,142884.81
"NITA Company Contribution",,,,,,,,,,,,,""
,"General Journal","31-01-2024","22408",,,"Jan 2024 NITA Contribution","Expense","NITA Company Contribution",,"NITA",2300.00,"",2300.00
,"General Journal","29-02-2024","23192",,,"Feb 2024 NITA Contribution","Expense","NITA Company Contribution",,"NITA",2250.00,"",4550.00
,"General Journal","31-03-2024","23193",,,"Mar 2024 NITA Contribution","Expense","NITA Company Contribution",,"NITA",2200.00,"",6750.00
,"General Journal","30-04-2024","23574",,,"Apr 2024 NITA Contribution","Expense","NITA Company Contribution",,"NITA",2150.00,"",8900.00
,"General Journal","31-05-2024","23998",,,"May 2024 NITA Contribution","Expense","NITA Company Contribution",,"NITA",2150.00,"",11050.00
,"General Journal","30-06-2024","24449",,,"Jun 2024 NITA Contribution","Expense","NITA Company Contribution",,"NITA",2150.00,"",13200.00
,"General Journal","31-07-2024","24606",,,"Jul 2024 NITA Contribution","Expense","NITA Company Contribution",,"NITA",2150.00,"",15350.00
,"General Journal","31-08-2024","25060",,,"Aug 2024 NITA Contribution","Expense","NITA Company Contribution",,"NITA",2100.00,"",17450.00
,"General Journal","30-09-2024","25437",,,"Sep 2024 NITA Contribution","Expense","NITA Company Contribution",,"NITA",2050.00,"",19500.00
,"General Journal","31-10-2024","26032",,,"Oct 2024 NITA Contribution","Expense","NITA Company Contribution",,"NITA",2050.00,"",21550.00
,"General Journal","30-11-2024","26596",,,"Nov 2024 NITA Contribution","Expense","NITA Company Contribution",,"NITA",1950.00,"",23500.00
,"General Journal","31-12-2024","26652",,,"Dec 2024 NITA Contribution","Expense","NITA Company Contribution",,"NITA",1850.00,"",25350.00
"Total NITA Company Contribution",,,,,,,,,,,25350.00,0.00,25350.00
"NSSF Company Contribution",,,,,,,,,,,,,""
,"General Journal","31-01-2024","22404",,,"Jan 2024 NSSF Contribution","Expense","NSSF Company Contribution",,"NSSF",46148.00,"",46148.00
,"General Journal","29-02-2024","23194",,,"Feb 2024 NSSF Contribution","Expense","NSSF Company Contribution",,"NSSF",60669.00,"",106817.00
,"General Journal","31-03-2024","23195",,,"Mar 2024 NSSF Contribution","Expense","NSSF Company Contribution",,"NSSF",62259.00,"",169076.00
,"General Journal","30-04-2024","23577",,,"Apr 2024 NSSF Contribution","Expense","NSSF Company Contribution",,"NSSF",60431.00,"",229507.00
,"General Journal","31-05-2024","23994",,,"May 2024 NSSF Contribution","Expense","NSSF Company Contribution",,"NSSF",62070.00,"",291577.00
,"General Journal","30-06-2024","24444",,,"Jun 2024 NSSF Contribution","Expense","NSSF Company Contribution",,"NSSF",58857.00,"",350434.00
,"General Journal","31-07-2024","24607",,,"Jul 2024 NSSF Contribution","Expense","NSSF Company Contribution",,"NSSF",61038.00,"",411472.00
,"General Journal","31-08-2024","25058",,,"Aug 2024 NSSF Contribution","Expense","NSSF Company Contribution",,"NSSF",58073.00,"",469545.00
,"General Journal","30-09-2024","25439",,,"Sep 2024 NSSF Contribution","Expense","NSSF Company Contribution",,"NSSF",57965.00,"",527510.00
,"General Journal","31-10-2024","26037",,,"Oct 2024 NSSF Contribution","Expense","NSSF Company Contribution",,"NSSF",57494.00,"",585004.00
,"General Journal","30-11-2024","26599",,,"Nov 2024 NSSF Contribution","Expense","NSSF Company Contribution",,"NSSF",59082.00,"",644086.00
,"General Journal","31-12-2024","26656",,,"Dec 2024 NSSF Contribution","Expense","NSSF Company Contribution",,"NSSF",58902.00,"",702988.00
"Total NSSF Company Contribution",,,,,,,,,,,702988.00,0.00,702988.00
"Salaries",,,,,,,,,,,,,""
,"General Journal","31-01-2024","22399",,,"Jan 2024 Salaries","Expense","Salaries",,"-SPLIT-",955025.43,"",955025.43
,"General Journal","29-02-2024","22654",,,"Feb 2024 Salaries","Expense","Salaries",,"-SPLIT-",966390.85,"",1921416.28
,"General Journal","31-03-2024","23190",,,"Mar 2024 Salaries","Expense","Salaries",,"-SPLIT-",973090.23,"",2894506.51
,"General Journal","30-04-2024","23492",,,"Apr 2024 Salaries","Expense","Salaries",,"-SPLIT-",985602.05,"",3880108.56
,"General Journal","31-05-2024","23775",,,"May 2024 Salaries","Expense","Salaries",,"-SPLIT-",987462.61,"",4867571.17
,"General Journal","30-06-2024","24428",,,"Jun 2024 Salaries","Expense","Salaries",,"-SPLIT-",954547.57,"",5822118.74
,"General Journal","31-07-2024","24604",,,"Jul 2024 Salaries","Expense","Salaries",,"-SPLIT-",952629.45,"",6774748.19
,"General Journal","31-08-2024","24993",,,"Aug 2024 Salaries","Expense","Salaries",,"-SPLIT-",921607.71,"",7696355.90
,"General Journal","30-09-2024","25435",,,"Sep 2024 Salaries","Expense","Salaries",,"-SPLIT-",941946.58,"",8638302.48
,"General Journal","31-10-2024","26030",,,"Oct 2024 Salaries","Expense","Salaries",,"-SPLIT-",933142.40,"",9571444.88
,"General Journal","30-11-2024","26557",,,"Nov 2024 Salaries","Expense","Salaries",,"-SPLIT-",946753.74,"",10518198.62
,"General Journal","31-12-2024","26562",,,"Dec 2024 Salaries","Expense","Salaries",,"-SPLIT-",981121.80,"",11499320.42
"Total Salaries",,,,,,,,,,,11499320.42,0.00,11499320.42
"Total Payroll Expenses",,,,,,,,,,,12370543.23,0.00,12370543.23
"Rent",,,,,,,,,,,,,""
,"Bill","03-01-2024","0040306860000000156",,"Bigoh Properties LLP","GD 1 January 2024 Rent","Expense","Rent",,"Accounts Payable",283874.26,"",283874.26
,"Bill","03-01-2024","0040306860000000157",,"Bigoh Properties LLP","GD 2 January 2024 Rent","Expense","Rent",,"Accounts Payable",301409.63,"",585283.89
,"Cheque","04-01-2024","4366",,"Just Real Estates Ltd","Rent January 2024","Expense","Rent",,"Cash Account",117128.00,"",702411.89
,"Bill","24-01-2024","MO/056/ATB/2004",,"Otieno Omuga and Company","GD2 Lease Renewal legal fees","Expense","Rent",,"Accounts Payable",75000.00,"",777411.89
,"Bill","01-02-2024","0040306860000000164",,"Bigoh Properties LLP","GD 1 February 2024 Rent","Expense","Rent",,"Accounts Payable",283874.26,"",1061286.15
,"Bill","01-02-2024","0040306860000000165",,"Bigoh Properties LLP","GD 2 February 2024 Rent","Expense","Rent",,"Accounts Payable",284000.00,"",1345286.15
,"Cheque","04-02-2024","4409",,"Just Real Estates Ltd","Rent February 2024","Expense","Rent",,"Cash Account",117128.00,"",1462414.15
,"Bill","16-02-2024","C4W6BU2RLS",,"Otieno Omuga and Company","Stamp Duty for lease","Expense","Rent",,"Accounts Payable",18620.00,"",1481034.15
,"Bill","01-03-2024","0040306860000000174",,"Bigoh Properties LLP","GD 1 March 2024 Rent","Expense","Rent",,"Accounts Payable",283874.26,"",1764908.41
,"Bill","01-03-2024","0040306860000000175",,"Bigoh Properties LLP","GD 2 March 2024 Rent","Expense","Rent",,"Accounts Payable",284000.00,"",2048908.41
,"Cheque","04-03-2024","4452",,"Just Real Estates Ltd","Rent March 2024","Expense","Rent",,"Cash Account",117128.00,"",2166036.41
,"Bill","02-04-2024","0040306860000000184",,"Bigoh Properties LLP","GD 1 April 2024 Rent","Expense","Rent",,"Accounts Payable",283874.26,"",2449910.67
,"Bill","02-04-2024","0040306860000000185",,"Bigoh Properties LLP","GD 2 April 2024 Rent","Expense","Rent",,"Accounts Payable",284000.00,"",2733910.67
,"Cheque","04-04-2024","4495",,"Just Real Estates Ltd","Rent April 2024","Expense","Rent",,"Cash Account",117128.00,"",2851038.67
,"Bill","02-05-2024","0040306860000000192",,"Bigoh Properties LLP","GD 1 May 2024 Rent","Expense","Rent",,"Accounts Payable",295874.00,"",3146912.67
,"Bill","02-05-2024","0040306860000000193",,"Bigoh Properties LLP","GD 2 May 2024 Rent","Expense","Rent",,"Accounts Payable",284000.00,"",3430912.67
,"Cheque","04-05-2024","4538",,"Just Real Estates Ltd","Rent May 2024","Expense","Rent",,"Cash Account",117128.00,"",3548040.67
,"Bill","03-06-2024","0040306860000000199",,"Bigoh Properties LLP","GD 1 June 2024 Rent","Expense","Rent",,"Accounts Payable",295874.00,"",3843914.67
,"Bill","03-06-2024","0040306860000000200",,"Bigoh Properties LLP","GD 2 June 2024 Rent","Expense","Rent",,"Accounts Payable",284000.00,"",4127914.67
,"Bill","01-07-2024","0040306860000000210",,"Bigoh Properties LLP","GD 1 July 2024 Rent","Expense","Rent",,"Accounts Payable",295874.00,"",4423788.67
,"Bill","01-07-2024","0040306860000000211",,"Bigoh Properties LLP","GD 2 July 2024 Rent","Expense","Rent",,"Accounts Payable",284000.00,"",4707788.67
,"Bill","01-08-2024","0040306860000000222",,"Bigoh Properties LLP","GD 1 August 2024 Rent","Expense","Rent",,"Accounts Payable",295874.00,"",5003662.67
,"Bill","01-08-2024","0040306860000000223",,"Bigoh Properties LLP","GD 2 August 2024 Rent","Expense","Rent",,"Accounts Payable",284000.00,"",5287662.67
,"Bill","02-09-2024","0040306860000000232",,"Bigoh Properties LLP","GD 1 September 2024 Rent","Expense","Rent",,"Accounts Payable",295874.00,"",5583536.67
,"Bill","02-09-2024","0040306860000000233",,"Bigoh Properties LLP","GD 2 September 2024 Rent","Expense","Rent",,"Accounts Payable",284000.00,"",5867536.67
,"Bill","01-10-2024","0040306860000000240",,"Bigoh Properties LLP","GD 1 October 2024 Rent","Expense","Rent",,"Accounts Payable",295874.00,"",6163410.67
,"Bill","01-10-2024","0040306860000000241",,"Bigoh Properties LLP","GD 2 October 2024 Rent","Expense","Rent",,"Accounts Payable",284000.00,"",6447410.67
,"Bill","04-11-2024","0040306860000000250",,"Bigoh Properties LLP","GD 1 November 2024 Rent","Expense","Rent",,"Accounts Payable",295874.00,"",6743284.67
,"Bill","04-11-2024","0040306860000000251",,"Bigoh Properties LLP","GD 2 November 2024 Rent","Expense","Rent",,"Accounts Payable",284000.00,"",7027284.67
,"Bill","02-12-2024","0040306860000000261",,"Bigoh Properties LLP","GD 1 December 2024 Rent","Expense","Rent",,"Accounts Payable",295874.00,"",7323158.67
,"Bill","02-12-2024","0040306860000000262",,"Bigoh Properties LLP","GD 2 December 2024 Rent","Expense","Rent",,"Accounts Payable",284000.00,"",7607158.67
"Total Rent",,,,,,,,,,,7607158.67,0.00,7607158.67
"Repairs and Maintenance",,,,,,,,,,,,,""
"Leasehold Improvements",,,,,,,,,,,,,""
,"Cheque","05-01-2024","21474",,"Ivory General Merchants Limited","Repairs","Expense","Leasehold Improvements",,"Cash Account",1637.93,"",1637.93
,"Bill","26-02-2024","0110393730000074655",,"Central Auto & Hardware Ltd","SHS 20X20X1.5MM & MS PLATE 8X4X1.5MM","Expense","Leasehold Improvements",,"Accounts Payable",6508.62,"",8146.55
,"Cheque","04-03-2024","537",,"Fairdell General Supplies","terrazzo floor repair materials","Expense","Leasehold Improvements",,"Cash Account",17800.00,"",25946.55
,"Bill","14-03-2024","0040758170000002713",,"Soham Limited","PVC tiles","Expense","Leasehold Improvements",,"Accounts Payable",1637.93,"",27584.48
,"Cheque","25-03-2024","P1930",,,"Offloading sand","Expense","Leasehold Improvements",,"MPESA Account",200.00,"",27784.48
,"Bill","28-03-2024","0041414510000000142",,"Wakmasters Enterprises Tena Shop","Floor repairs items","Expense","Leasehold Improvements",,"Accounts Payable",9956.90,"",37741.38
,"Bill","28-03-2024","0040091820000042654",,"Nasib Industrial Product","Paints","Expense","Leasehold Improvements",,"Accounts Payable",9052.05,"",46793.43
,"Bill","28-03-2024","0040091820000042664",,"Nasib Industrial Product","Paints","Expense","Leasehold Improvements",,"Accounts Payable",3189.77,"",49983.20
,"Cheque","28-03-2024","P1929",,,"Delivery of floor repairs materials","Expense","Leasehold Improvements",,"MPESA Account",1000.00,"",50983.20
,"Cheque","29-03-2024","643",,"Ngigi Merchants","cement","Expense","Leasehold Improvements",,"MPESA Account",2550.00,"",53533.20
,"Cheque","02-04-2024","P1945",,,"Floor repair works","Expense","Leasehold Improvements",,"Cash Account",27000.00,"",80533.20
,"Cheque","15-05-2024","P2033",,,"3 Buckets ballast","Expense","Leasehold Improvements",,"MPESA Account",600.00,"",81133.20
,"Bill","26-07-2024","0040091820000049896",,"Nasib Industrial Product","Paints","Expense","Leasehold Improvements",,"Accounts Payable",2413.88,"",83547.08
,"Bill","19-10-2024","0040091820000055418",,"Nasib Industrial Product","Paints","Expense","Leasehold Improvements",,"Accounts Payable",9181.37,"",92728.45
"Total Leasehold Improvements",,,,,,,,,,,92728.45,0.00,92728.45
"Materials",,,,,,,,,,,,,""
,"Cheque","02-01-2024","IG15065",,"Kifaru Enterprises Ltd Gikomba","Materials","Expense","Materials",,"Cash Account",2456.89,"",2456.89
,"Cheque","02-01-2024","1524",,"Cana Junior Glassmart & Hardware","materials","Expense","Materials",,"Cash Account",40000.00,"",42456.89
,"Bill","02-01-2024","0110151760000012482",,"Dcosta Hardware Ltd","repair items","Expense","Materials",,"Accounts Payable",20258.62,"",62715.51
,"Cheque","02-01-2024","4214",,"Super Jambo Hardware Traders","Items","Expense","Materials",,"Cash Account",2758.62,"",65474.13
,"Bill","05-01-2024","0171381340000001277",,"Ngumi Bay Enterprises","plumbing items","Expense","Materials",,"Accounts Payable",625.00,"",66099.13
,"Bill","05-01-2024","0171381340000001276",,"Ngumi Bay Enterprises","plumbing items","Expense","Materials",,"Accounts Payable",1172.41,"",67271.54
,"Cheque","08-01-2024","357",,"Fairdell General Supplies","Cutting Disks","Expense","Materials",,"Cash Account",1500.00,"",68771.54
,"Bill","10-01-2024","0041028240000000531",,"Original Expresso Paints Limited","repair paints","Expense","Materials",,"Accounts Payable",194000.00,"",262771.54
,"Bill","10-01-2024","0041028240000000533",,"Original Expresso Paints Limited","repair paints","Expense","Materials",,"Accounts Payable",99396.55,"",362168.09
,"Bill","10-01-2024","0040073260000073431",,"Davis & Shirtliff Ltd","filters","Expense","Materials",,"Accounts Payable",6239.66,"",368407.75
,"Cheque","11-01-2024","154135",,"Sealbelt Enterprises Ltd","Vee belt","Expense","Materials",,"MPESA Account",758.62,"",369166.37
,"Bill","13-01-2024","0040247290000005742",,"Daviply Hardware Limited","repair items","Expense","Materials",,"Accounts Payable",7629.31,"",376795.68
,"Cheque","15-01-2024","20323",,"Farmal General Merchants Ltd","2x2 Cypress","Expense","Materials",,"Cash Account",1000.00,"",377795.68
,"Cheque","17-01-2024","3024",,"Walkside Hardware","Mixing area Repair items","Expense","Materials",,"Cash Account",71215.00,"",449010.68
,"Cheque","19-01-2024","190124",,"Apex Hardware Store","Plumbing accessories","Expense","Materials",,"MPESA Account",660.00,"",449670.68
,"Cheque","19-01-2024","3081",,"POWRIGHT SUPPLIES","repairs items","Expense","Materials",,"MPESA Account",70.00,"",449740.68
,"Cheque","19-01-2024","3080",,"POWRIGHT SUPPLIES","repairs items","Expense","Materials",,"MPESA Account",200.00,"",449940.68
,"Cheque","22-01-2024","606",,"Walkside Hardware","Mixing area Repair items","Expense","Materials",,"Cash Account",13530.00,"",463470.68
,"Cheque","23-01-2024","154633",,"Sealbelt Enterprises Ltd","Chain","Expense","Materials",,"MPESA Account",6293.10,"",469763.78
,"Cheque","23-01-2024","649",,"Walkside Hardware","Mixing area Repair items","Expense","Materials",,"Cash Account",5890.00,"",475653.78
,"Cheque","24-01-2024","195899",,"Roadside Hay & Animal Feeds","Feeder","Expense","Materials",,"Cash Account",1500.00,"",477153.78
,"Bill","24-01-2024","0170946760000005698",,"Central Aberdare Timber & Cement Ltd","BRC A66","Expense","Materials",,"Accounts Payable",9482.76,"",486636.54
,"Cheque","25-01-2024","2894",,"Maasai Curio & Furniture","Ellys& Mocar 1 Set","Expense","Materials",,"Cash Account",35000.00,"",521636.54
,"Bill","25-01-2024","0110151760000012955",,"Dcosta Hardware Ltd","repair items","Expense","Materials",,"Accounts Payable",20258.62,"",541895.16
,"Bill","25-01-2024","0110151760000012956",,"Dcosta Hardware Ltd","repair items","Expense","Materials",,"Accounts Payable",21258.62,"",563153.78
,"Bill","26-01-2024","0110151760000012973",,"Dcosta Hardware Ltd","repair items","Expense","Materials",,"Accounts Payable",5000.00,"",568153.78
,"Bill","30-01-2024","0040345290000001462",,"Fairdell General Supplies","repair items","Expense","Materials",,"Accounts Payable",431.03,"",568584.81
,"Cheque","31-01-2024","829",,"Ngigi Merchants","Angleline 2x2x5mm","Expense","Materials",,"MPESA Account",3100.00,"",571684.81
,"Cheque","31-01-2024","195900",,"Focus Hardware Supplies","Plumbing Accessories","Expense","Materials",,"Cash Account",1180.00,"",572864.81
,"Cheque","01-02-2024","2895",,"Dreamscom Timber & Hardware","Scarfing","Expense","Materials",,"Cash Account",450.00,"",573314.81
,"Cheque","01-02-2024","2896",,"Kensew Hardware Store","Lipping & repir items","Expense","Materials",,"Cash Account",2120.00,"",575434.81
,"Cheque","03-02-2024","195901",,"Focus Hardware Supplies","Electrical Accessories","Expense","Materials",,"Cash Account",1310.00,"",576744.81
,"Bill","03-02-2024","0041432110000002246",,"Parkrose Plumbing & Hardware Limited","Plumbing items","Expense","Materials",,"Accounts Payable",3336.21,"",580081.02
,"Bill","05-02-2024","0040075790000003874",,"Dbass Auto Limited","Items","Expense","Materials",,"Accounts Payable",79310.34,"",659391.36
,"Bill","06-02-2024","0041432110000002268",,"Parkrose Plumbing & Hardware Limited","Plumbing items","Expense","Materials",,"Accounts Payable",629.31,"",660020.67
,"Bill","06-02-2024","0041432110000002269",,"Parkrose Plumbing & Hardware Limited","Plumbing items","Expense","Materials",,"Accounts Payable",629.31,"",660649.98
,"Cheque","13-02-2024","1127",,"Markrane Hardware","cement","Expense","Materials",,"MPESA Account",800.00,"",661449.98
,"Cheque","19-02-2024","3131",,"POWRIGHT SUPPLIES","repairs items","Expense","Materials",,"MPESA Account",90.00,"",661539.98
,"Bill","20-02-2024","0040247290000006366",,"Daviply Hardware Limited","repair items","Expense","Materials",,"Accounts Payable",4922.41,"",666462.39
,"Cheque","21-02-2024","5098406",,"Powerstar Supermarket","items","Expense","Materials",,"Cash Account",990.00,"",667452.39
,"Cheque","29-02-2024","380",,"Ngigi Merchants","Square tube 20x20x1.5","Expense","Materials",,"MPESA Account",900.00,"",668352.39
,"Bill","01-03-2024","0171519300000001208",,"RICHADO ELECTRICAL AGENCIES LIMITED","Materials","Expense","Materials",,"Accounts Payable",12100.00,"",680452.39
,"Cheque","03-03-2024","183",,"Coverhut Enterprises","paint roller","Expense","Materials",,"Cash Account",300.00,"",680752.39
,"Bill","04-03-2024","0041432110000002558",,"Parkrose Plumbing & Hardware Limited","Plumbing items","Expense","Materials",,"Accounts Payable",603.45,"",681355.84
,"Cheque","05-03-2024","552",,"Fairdell General Supplies","Red oxide","Expense","Materials",,"Cash Account",600.00,"",681955.84
,"Cheque","21-03-2024","954",,"Ngigi Merchants","Angleline 40x40x3mm","Expense","Materials",,"MPESA Account",3700.00,"",685655.84
,"Cheque","22-03-2024","199591",,"Roadside Hay & Animal Feeds","items","Expense","Materials",,"Cash Account",550.00,"",686205.84
,"Cheque","23-03-2024","199633",,"Roadside Hay & Animal Feeds","items","Expense","Materials",,"Cash Account",1450.00,"",687655.84
,"Cheque","27-03-2024","3163",,"POWRIGHT SUPPLIES","repairs items","Expense","Materials",,"MPESA Account",650.00,"",688305.84
,"Bill","28-03-2024","0110151760000014235",,"Dcosta Hardware Ltd","Cross Couple","Expense","Materials",,"Accounts Payable",6241.38,"",694547.22
,"Cheque","28-03-2024","SO-28032443",,"Parkrose Plumbing & Hardware Limited","Repair Items","Expense","Materials",,"Cash Account",500.00,"",695047.22
,"Bill","02-05-2024","0090772520000005583",,"Nasa Products Limited","Sheet Cork 3.0mm","Expense","Materials",,"Accounts Payable",2241.38,"",697288.60
,"Cheque","04-05-2024","235380",,"Focus Hardware Supplies","Plumbing accessories","Expense","Materials",,"Cash Account",5580.00,"",702868.60
,"Cheque","20-05-2024","78340",,"Sifa Njema Stores","Hinges","Expense","Materials",,"Cash Account",4800.00,"",707668.60
,"Cheque","29-05-2024","29052446288",,"Parkrose Plumbing & Hardware Limited","Adhesive","Expense","Materials",,"Cash Account",680.00,"",708348.60
,"Cheque","29-05-2024","18080",,"Don Hardware & Fabricators","Glue","Expense","Materials",,"Cash Account",1500.00,"",709848.60
,"Cheque","30-05-2024","30052446354",,"Parkrose Plumbing & Hardware Limited","white spirit and clear varnish","Expense","Materials",,"Cash Account",1200.00,"",711048.60
,"Bill","10-06-2024","0040893280000020314",,"Ayany General Hardware Limited","repairs items","Expense","Materials",,"Accounts Payable",603.45,"",711652.05
,"Bill","14-06-2024","0041432110000003304",,"Parkrose Plumbing & Hardware Limited","Plumbing items","Expense","Materials",,"Accounts Payable",646.55,"",712298.60
,"Bill","15-06-2024","1821919410000008527",,"P.J Genesis Chuma Limited","Materials","Expense","Materials",,"Accounts Payable",26896.55,"",739195.15
,"Bill","20-07-2024","SO-20072448944",,"Parkrose Plumbing & Hardware Limited","Plumbing items","Expense","Materials",,"Accounts Payable",1500.00,"",740695.15
,"Cheque","22-07-2024","209077",,"Roadside Hay & Animal Feeds","items","Expense","Materials",,"Cash Account",1950.00,"",742645.15
,"Bill","07-08-2024","0171726470000000461",,"Saro Hardware","plumping materials","Expense","Materials",,"Accounts Payable",2301.72,"",744946.87
,"Cheque","09-08-2024","1463",,"Patson General Suppliers","Plumbing materials","Expense","Materials",,"MPESA Account",2850.00,"",747796.87
,"Cheque","20-08-2024","2252",,"Etihad Water Ways","Plumbing accessories","Expense","Materials",,"MPESA Account",1850.00,"",749646.87
,"Bill","31-08-2024","0190484170000002350",,"NG'USTIC GENERAL HARDWARE LIMITED","materials","Expense","Materials",,"VAT Payable",4827.59,"",754474.46
,"Bill","18-11-2024","0041432110000004623",,"Parkrose Plumbing & Hardware Limited","Plumbing items","Expense","Materials",,"Accounts Payable",3836.21,"",758310.67
"Total Materials",,,,,,,,,,,758310.67,0.00,758310.67
"Consumables",,,,,,,,,,,,,""
,"Bill","03-01-2024","0040075020000008405",,"Ultratech Building Solution Ltd","clear silicone","Expense","Consumables",,"Accounts Payable",350.00,"",350.00
,"Cheque","05-01-2024","977",,"Ngigi Merchants","plumbing consumables","Expense","Consumables",,"MPESA Account",750.00,"",1100.00
,"Cheque","09-01-2024","990",,"Ngigi Merchants","plumbing consumables","Expense","Consumables",,"MPESA Account",600.00,"",1700.00
,"Cheque","12-01-2024","2104",,"Bidii Hardware and Electronics","rawl bolts","Expense","Consumables",,"MPESA Account",100.00,"",1800.00
,"Cheque","12-01-2024","1025",,"Ngigi Merchants","welding rods","Expense","Consumables",,"MPESA Account",1400.00,"",3200.00
,"Bill","13-01-2024","0090967430000067409",,"ASL Limited","items","Expense","Consumables",,"Accounts Payable",6228.45,"",9428.45
,"Cheque","15-01-2024","SO-15012439",,"Parkrose Plumbing & Hardware Limited","Repair Items","Expense","Consumables",,"Cash Account",790.00,"",10218.45
,"Cheque","18-01-2024","1091",,"Ngigi Merchants","items","Expense","Consumables",,"MPESA Account",1800.00,"",12018.45
,"Cheque","19-01-2024","19012024",,"Standard Hardware & Tools","repairs consumables","Expense","Consumables",,"MPESA Account",1050.00,"",13068.45
,"Cheque","19-01-2024","4250",,"Samliz Hardware","nails and hammer","Expense","Consumables",,"MPESA Account",660.00,"",13728.45
,"Cheque","22-01-2024","473",,"Daniel Steels Engineering","SS rods","Expense","Consumables",,"MPESA Account",3500.00,"",17228.45
,"Bill","25-01-2024","0010197310000038276",,"Nabico Enterprices Ltd","Contactor","Expense","Consumables",,"Accounts Payable",8000.00,"",25228.45
,"Bill","26-01-2024","0171764230000025191",,"Sealbelt Enterprises Ltd","Chain link","Expense","Consumables",,"Accounts Payable",129.31,"",25357.76
,"Bill","30-01-2024","0171764230000025476",,"Sealbelt Enterprises Ltd","Chain link","Expense","Consumables",,"Accounts Payable",51.72,"",25409.48
,"Bill","31-01-2024","0110608420000006937",,"Galaxy Fasteners & Supplies Ltd","Allen Hex Socket Cap Screws and washers","Expense","Consumables",,"Accounts Payable",431.03,"",25840.51
,"Cheque","31-01-2024","391",,"Richado Electrical Agencies","Electrical consumables","Expense","Consumables",,"MPESA Account",13650.00,"",39490.51
,"Bill","06-02-2024","0190169980000009310",,"New Baku Kenya Ltd","double tape","Expense","Consumables",,"Accounts Payable",172.41,"",39662.92
,"Bill","06-02-2024","0110161990000553942",,"New Muthokinju Hardware Ltd","Paints","Expense","Consumables",,"Accounts Payable",40991.38,"",80654.30
,"Bill","07-02-2024","0010197310000039508",,"Nabico Enterprices Ltd","Fuse","Expense","Consumables",,"Accounts Payable",300.00,"",80954.30
,"Cheque","11-02-2024","467",,"Union Hardware","bolts","Expense","Consumables",,"Cash Account",1500.00,"",82454.30
,"Bill","14-02-2024","0110161990000563801",,"New Muthokinju Hardware Ltd","Paints","Expense","Consumables",,"Accounts Payable",1810.34,"",84264.64
,"Cheque","19-02-2024","190224",,"Apex Hardware and Electricals","rubber","Expense","Consumables",,"Cash Account",50.00,"",84314.64
,"Cheque","21-02-2024","6857",,"Four WM Enterprises","covers","Expense","Consumables",,"Cash Account",210.00,"",84524.64
,"Bill","27-02-2024","0171764230000027714",,"Sealbelt Enterprises Ltd","Chain link","Expense","Consumables",,"Accounts Payable",387.93,"",84912.57
,"Cheque","27-02-2024","SBR1AV787X",,"Standard Hardware and General Store","double chain","Expense","Consumables",,"MPESA Account",600.00,"",85512.57
,"Bill","29-02-2024","0311139760000027643",,"Quatre Global Holdings Limited","items","Expense","Consumables",,"Accounts Payable",1724.14,"",87236.71
,"Cheque","08-03-2024","514",,"Ngigi Merchants","consumables","Expense","Consumables",,"MPESA Account",3750.00,"",90986.71
,"Bill","15-03-2024","0190169980000010021",,"New Baku Kenya Ltd","double tape","Expense","Consumables",,"Accounts Payable",344.83,"",91331.54
,"Cheque","15-03-2024","1369",,"Ngigi Merchants","consumables","Expense","Consumables",,"MPESA Account",7000.00,"",98331.54
,"Bill","18-03-2024","0110608420000007707",,"Galaxy Fasteners & Supplies Ltd","Allen Hex Socket Cap Screws and washers","Expense","Consumables",,"Accounts Payable",431.03,"",98762.57
,"Bill","18-03-2024","0090543830000019648",,"General Plastics Limited","LINO171239","Expense","Consumables",,"Accounts Payable",0.00,"",98762.57
,"Bill","19-03-2024","0010197310000043484",,"Nabico Enterprices Ltd","Rawl bolts and metric PG Gland","Expense","Consumables",,"Accounts Payable",450.00,"",99212.57
,"Bill","19-03-2024","0090973960000008440",,"ASL Limited","items","Expense","Consumables",,"Accounts Payable",862.07,"",100074.64
,"Cheque","20-03-2024","941",,"Ngigi Merchants","Union GI 1/2in","Expense","Consumables",,"Cash Account",70.00,"",100144.64
,"Bill","21-03-2024","0010197310000043770",,"Nabico Enterprices Ltd","fuses 6AMPS 10*38MM and fuse carrier and 1M rail","Expense","Consumables",,"Accounts Payable",1138.50,"",101283.14
,"Cheque","22-03-2024","972",,"Ngigi Merchants","hose clips","Expense","Consumables",,"MPESA Account",400.00,"",101683.14
,"Bill","22-03-2024","0110608420000007792",,"Galaxy Fasteners & Supplies Ltd","-MULTIPLE-","Expense","Consumables",,"Accounts Payable",207.17,"",101890.31
,"Bill","23-03-2024","0110608420000007807",,"Galaxy Fasteners & Supplies Ltd","Allen Hex Socket Cap Screws and washers","Expense","Consumables",,"Accounts Payable",387.93,"",102278.24
,"Bill","05-04-2024","0171764230000030538",,"Sealbelt Enterprises Ltd","Coupling L 095/090","Expense","Consumables",,"Accounts Payable",1206.90,"",103485.14
,"Bill","05-04-2024","0110608420000007982",,"Galaxy Fasteners & Supplies Ltd","Allen Hex Socket Cap Screws and washers","Expense","Consumables",,"Accounts Payable",422.41,"",103907.55
,"Bill","09-04-2024","0171764230000030710",,"Sealbelt Enterprises Ltd","Vee belt A 47 B/FR/DAY","Expense","Consumables",,"Accounts Payable",5190.25,"",109097.80
,"Cheque","11-04-2024","1840",,"Ngigi Merchants","items","Expense","Consumables",,"MPESA Account",450.00,"",109547.80
,"Bill","11-04-2024","0110608420000008051",,"Galaxy Fasteners & Supplies Ltd","Allen Hex Socket Cap Screws and washers","Expense","Consumables",,"Accounts Payable",1681.03,"",111228.83
,"Bill","11-04-2024","0010197310000045287",,"Nabico Enterprices Ltd","fuses 6AMPS 10*38MM","Expense","Consumables",,"Accounts Payable",500.00,"",111728.83
,"Bill","11-04-2024","0110611000000000742",,"UNIPRO LIMITED","-MULTIPLE-","Expense","Consumables",,"Accounts Payable",9000.00,"",120728.83
,"Cheque","18-04-2024","752",,"Mobi Care Phone","Drycleaner fluid and glue","Expense","Consumables",,"MPESA Account",1000.00,"",121728.83
,"Bill","23-04-2024","0110608420000008261",,"Galaxy Fasteners & Supplies Ltd","Allen Hex Socket Cap Screws and washers","Expense","Consumables",,"Accounts Payable",387.93,"",122116.76
,"Bill","23-04-2024","0171764230000031669",,"Sealbelt Enterprises Ltd","Vee belt A 47 B/FR/DAY","Expense","Consumables",,"Accounts Payable",1551.72,"",123668.48
,"Bill","29-04-2024","0040226660000073818",,"Dovecote Company Limited","Engine oil","Expense","Consumables",,"Accounts Payable",2284.48,"",125952.96
,"Bill","02-05-2024","0010197310000047131",,"Nabico Enterprices Ltd","13AMP Top plug and Emergency push button","Expense","Consumables",,"Accounts Payable",1576.00,"",127528.96
,"Cheque","02-05-2024","1205",,"Ngigi Merchants","ball valve","Expense","Consumables",,"MPESA Account",750.00,"",128278.96
,"Bill","07-05-2024","0171764230000032584",,"Sealbelt Enterprises Ltd","Vee belt A 47 B/FR/DAY","Expense","Consumables",,"Accounts Payable",482.76,"",128761.72
,"Cheque","09-05-2024","1283",,"Ngigi Merchants","SS welding rods and grinding disk","Expense","Consumables",,"MPESA Account",4200.00,"",132961.72
,"Cheque","10-05-2024","1314",,"Ngigi Merchants","Door bolt, Door hinges and nails","Expense","Consumables",,"MPESA Account",410.00,"",133371.72
,"Bill","11-05-2024","0171764230000032858",,"Sealbelt Enterprises Ltd","Bearing 6207 ZZ SKF and Oil seals 33x32x7 NAK","Expense","Consumables",,"Accounts Payable",3663.79,"",137035.51
,"Bill","17-05-2024","0171764230000033268",,"Sealbelt Enterprises Ltd","Vee Belt 13A 0915","Expense","Consumables",,"Accounts Payable",1379.31,"",138414.82
,"Bill","21-05-2024","0010197310000048664",,"Nabico Enterprices Ltd","LEDtube 1200MM 16W","Expense","Consumables",,"Accounts Payable",2500.00,"",140914.82
,"Cheque","23-05-2024","4910",,"Samliz Hardware","Battery Acid","Expense","Consumables",,"MPESA Account",100.00,"",141014.82
,"Cheque","24-05-2024","1478",,"Ngigi Merchants","bolts","Expense","Consumables",,"MPESA Account",80.00,"",141094.82
,"Bill","25-05-2024","0171764230000033845",,"Sealbelt Enterprises Ltd","Coupling L100NR SKF","Expense","Consumables",,"Accounts Payable",982.76,"",142077.58
,"Cheque","25-05-2024","18081",,"Pointer Hardware Stores","Floor repairs materials","Expense","Consumables",,"Cash Account",6400.00,"",148477.58
,"Bill","28-05-2024","0040908910000000464",,"Tram Technical Services Ltd","switch","Expense","Consumables",,"Accounts Payable",86.21,"",148563.79
,"Bill","28-05-2024","0040226660000077452",,"Dovecote Company Limited","Kerosene","Expense","Consumables",,"Accounts Payable",711.21,"",149275.00
,"Cheque","04-06-2024","1612",,"Ngigi Merchants","ball valves and hosepipe","Expense","Consumables",,"MPESA Account",2800.00,"",152075.00
,"Bill","06-06-2024","0010197310000050245",,"Nabico Enterprices Ltd","LEDtube 1200MM 16W","Expense","Consumables",,"Accounts Payable",825.00,"",152900.00
,"Bill","08-06-2024","0171764230000034849",,"Sealbelt Enterprises Ltd","Wiper seal 25 x 33 x 5/8","Expense","Consumables",,"Accounts Payable",2586.21,"",155486.21
,"Cheque","10-06-2024","1724",,"Ngigi Merchants","ball valves","Expense","Consumables",,"MPESA Account",650.00,"",156136.21
,"Bill","12-06-2024","0110608420000009117",,"Galaxy Fasteners & Supplies Ltd","Allen Hex Head Bolt","Expense","Consumables",,"Accounts Payable",51.72,"",156187.93
,"Bill","12-06-2024","0171764230000035145",,"Sealbelt Enterprises Ltd","O ring 66x4","Expense","Consumables",,"Accounts Payable",387.93,"",156575.86
,"Bill","13-06-2024","0190447770000003678",,"Power Controls Ltd","heavy duty top plug 2pc","Expense","Consumables",,"Accounts Payable",629.31,"",157205.17
,"Cheque","21-06-2024","1460",,"Ngigi Merchants","thinner","Expense","Consumables",,"MPESA Account",1000.00,"",158205.17
,"Bill","27-06-2024","0010197310000052004",,"Nabico Enterprices Ltd","6AMPS Fuse 10mm*38mm","Expense","Consumables",,"Accounts Payable",500.00,"",158705.17
,"Bill","02-07-2024","0010186870000021318",,"Sona Shoppe Limited","Batteries","Expense","Consumables",,"Accounts Payable",431.03,"",159136.20
,"Bill","15-07-2024","0110608420000009586",,"Galaxy Fasteners & Supplies Ltd","Allen Hex Socket Cap Screws and washers","Expense","Consumables",,"Accounts Payable",448.28,"",159584.48
,"Bill","22-07-2024","0171764230000037864",,"Sealbelt Enterprises Ltd","Vee Belt SPZ 937","Expense","Consumables",,"Accounts Payable",758.62,"",160343.10
,"Bill","24-07-2024","0171510090000004550",,"KAGS TRADING COMPANY LIMITED","plumbing union","Expense","Consumables",,"Accounts Payable",215.52,"",160558.62
,"Cheque","25-07-2024","SGP3S0TM7H",,,"bolts","Expense","Consumables",,"MPESA Account",40.00,"",160598.62
,"Cheque","26-07-2024","2893",,"Daniel Steels Engineering","7M Chain and 350 SS plate","Expense","Consumables",,"MPESA Account",4750.00,"",165348.62
,"Bill","26-07-2024","0110640380000025045",,"Gulf Timber & Hardware Supplies Ltd","Steel nails","Expense","Consumables",,"Accounts Payable",517.24,"",165865.86
,"Bill","31-07-2024","0171764230000038544",,"Sealbelt Enterprises Ltd","Chain link 12B2 CL","Expense","Consumables",,"Accounts Payable",258.62,"",166124.48
,"Bill","31-07-2024","0171764230000038587",,"Sealbelt Enterprises Ltd","Bearings","Expense","Consumables",,"Accounts Payable",8663.79,"",174788.27
,"Bill","06-08-2024","0171764230000039007",,"Sealbelt Enterprises Ltd","Bearings","Expense","Consumables",,"Accounts Payable",13965.60,"",188753.87
,"Bill","07-08-2024","0040226660000086896",,"Dovecote Company Limited","Engine oil","Expense","Consumables",,"Accounts Payable",2318.97,"",191072.84
,"Cheque","07-08-2024","5648",,"Union Hardware","Welding rods","Expense","Consumables",,"MPESA Account",1100.00,"",192172.84
,"Cheque","15-08-2024","780",,"Josma Enterprises","50pcs SS rods","Expense","Consumables",,"MPESA Account",4000.00,"",196172.84
,"Bill","19-08-2024","0171764230000039830",,"Sealbelt Enterprises Ltd","Vee Belt B 71 B/FR/DAY","Expense","Consumables",,"Accounts Payable",2586.21,"",198759.05
,"Cheque","20-08-2024","2625",,"Ngigi Merchants","SS 680 welding rods","Expense","Consumables",,"MPESA Account",3000.00,"",201759.05
,"Bill","28-08-2024","0171510090000004874",,"KAGS TRADING COMPANY LIMITED","plumbing union","Expense","Consumables",,"Accounts Payable",387.93,"",202146.98
,"Bill","02-09-2024","0110608420000010379",,"Galaxy Fasteners & Supplies Ltd","Allen Hex Socket Cap Screws and washers","Expense","Consumables",,"Accounts Payable",275.86,"",202422.84
,"Bill","09-09-2024","0040226660000091452",,"Dovecote Company Limited","LPG gas regulator","Expense","Consumables",,"Accounts Payable",732.76,"",203155.60
,"Cheque","11-09-2024","487",,"Richado Electrical Agencies","2pcs MC cutout","Expense","Consumables",,"Cash Account",6000.00,"",209155.60
,"Bill","17-09-2024","0010197310000059934",,"Nabico Enterprices Ltd","Emergence push button and other buttons","Expense","Consumables",,"Accounts Payable",1255.20,"",210410.80
,"Bill","30-09-2024","0010197310000061113",,"Nabico Enterprices Ltd","6AMPS Fuse 10mm*38mm","Expense","Consumables",,"Accounts Payable",518.00,"",210928.80
,"Bill","30-09-2024","0010197310000061118",,"Nabico Enterprices Ltd","LED Tube 16W 4FT Double ended","Expense","Consumables",,"Accounts Payable",5500.00,"",216428.80
,"Bill","03-10-2024","0190172250000016493",,"Nipsur Hardware Limited","SPRAY PAINT","Expense","Consumables",,"Accounts Payable",3051.72,"",219480.52
,"Bill","07-10-2024","0040226660000094945",,"Dovecote Company Limited","Diesel","Expense","Consumables",,"Accounts Payable",739.66,"",220220.18
,"Bill","08-10-2024","0040018760000002588",,"Mlolongo Central Hardware","Ropes","Expense","Consumables",,"Accounts Payable",862.07,"",221082.25
,"Bill","08-10-2024","KRACU0100059966/1375",,"Maercury Hardware Store Limited","Manila 5pcs","Expense","Consumables",,"Accounts Payable",301.72,"",221383.97
,"Bill","15-10-2024","0110608420000011091",,"Galaxy Fasteners & Supplies Ltd","Allen Hex Socket Cap Screws and washers","Expense","Consumables",,"Accounts Payable",146.55,"",221530.52
,"Bill","23-10-2024","0171764230000044665",,"Sealbelt Enterprises Ltd","Bearings 6204 2RS SKF","Expense","Consumables",,"Accounts Payable",11586.21,"",233116.73
,"Bill","24-10-2024","0110608420000011215",,"Galaxy Fasteners & Supplies Ltd","Allen Hex Socket Cap Screws and washers","Expense","Consumables",,"Accounts Payable",431.03,"",233547.76
,"Cheque","28-10-2024","SJS1NUMQEB",,"Standard Hardware and General Store","standard thinner","Expense","Consumables",,"MPESA Account",1000.00,"",234547.76
,"Cheque","05-11-2024","3138",,"Ngigi Merchants","plumbing repairs","Expense","Consumables",,"MPESA Account",850.00,"",235397.76
,"Bill","11-11-2024","0045",,"Matrix Water Ltd","UPVC pipe 3/4"" 1M, 3 elbows 2/4"", socket 3/4"", male A 3/4"", Glue 118MI","Expense","Consumables",,"Accounts Payable",930.00,"",236327.76
,"Bill","20-11-2024","0171764230000046694",,"Sealbelt Enterprises Ltd","Chain link 10B2 CL","Expense","Consumables",,"Accounts Payable",137.93,"",236465.69
,"Bill","20-11-2024","0171764230000046693",,"Sealbelt Enterprises Ltd","Chain link 10B2 CL and Chain PT-CH 10B2","Expense","Consumables",,"Accounts Payable",2982.76,"",239448.45
,"Bill","21-11-2024","0171764230000046700",,"Sealbelt Enterprises Ltd","Chain link 10B2 CL and Chain PT-CH 10B2","Expense","Consumables",,"Accounts Payable",3793.10,"",243241.55
,"Bill","21-11-2024","0171764230000046701",,"Sealbelt Enterprises Ltd","Chain link 10B2 CL","Expense","Consumables",,"Accounts Payable",646.55,"",243888.10
,"Bill","22-11-2024","0171764230000046830",,"Sealbelt Enterprises Ltd","Taper Pulley PT-TP 180-2 SPE and Taper Bush PT-TBM 2517-38","Expense","Consumables",,"Accounts Payable",8965.52,"",252853.62
,"Bill","23-11-2024","0171764230000046896",,"Sealbelt Enterprises Ltd","Taper Pulley PT-TP 180-2 SPE and Taper Bush PT-TBM 2517-38","Expense","Consumables",,"Accounts Payable",8965.52,"",261819.14
,"Bill","25-11-2024","0040226660000101041",,"Dovecote Company Limited","Diesel","Expense","Consumables",,"Accounts Payable",724.14,"",262543.28
,"Cheque","03-12-2024","03122024",,,"Soldering wire & Soldering gun","Expense","Consumables",,"MPESA Account",1200.00,"",263743.28
,"Bill","19-12-2024","0010186870000026303",,"Sona Shoppe Limited","Item","Expense","Consumables",,"Accounts Payable",474.14,"",264217.42
,"Bill","21-12-2024","0010197310000068731",,"Nabico Enterprices Ltd","Contactors and other items","Expense","Consumables",,"Accounts Payable",29453.75,"",293671.17
,"Bill","23-12-2024","0010197310000068827",,"Nabico Enterprices Ltd","Contactors and other items","Expense","Consumables",,"Accounts Payable",5529.75,"",299200.92
,"Credit","23-12-2024","0010197310000068816",,"Nabico Enterprices Ltd","Returned Contactors and other items","Expense","Consumables",,"Accounts Payable","",1175.00,298025.92
,"Cheque","24-12-2024","4274",,"Ngigi Merchants","parts","Expense","Consumables",,"MPESA Account",800.00,"",298825.92
,"Cheque","24-12-2024","1375",,"Destiny Hardware & Electronics","bush","Expense","Consumables",,"MPESA Account",130.00,"",298955.92
"Total Consumables",,,,,,,,,,,300130.92,1175.00,298955.92
"Spares and Tools",,,,,,,,,,,,,""
,"Cheque","02-01-2024","000533",,"Vee Wire Kenya Ltd","Tools","Expense","Spares and Tools",,"Cash Account",948.28,"",948.28
,"Cheque","03-01-2024","03012024",,"Standard Hardware Store","bolts","Expense","Spares and Tools",,"Cash Account",3480.00,"",4428.28
,"Bill","03-01-2024","0190174920000045392",,"Powermax General Electrical Merchants Ltd","LED Bulkhead","Expense","Spares and Tools",,"Accounts Payable",2327.59,"",6755.87
,"Cheque","08-01-2024","CS/019231",,"Kenya Hydraulics LTD","Hydro hose pipes","Expense","Spares and Tools",,"MPESA Account",2879.20,"",9635.07
,"Cheque","12-01-2024","1388",,"Hybrid Electricals","Cables & Contactor","Expense","Spares and Tools",,"Cash Account",5830.00,"",15465.07
,"Bill","15-01-2024","0110185500000014180",,"Hydromatics Ltd","proximity sensor","Expense","Spares and Tools",,"Accounts Payable",13980.00,"",29445.07
,"Cheque","23-01-2024","1475",,"Hybrid Electricals","Electricals & Contactor","Expense","Spares and Tools",,"Cash Account",16990.00,"",46435.07
,"Cheque","30-01-2024","611",,"Hybrid Electricals","Electricals & Contactor","Expense","Spares and Tools",,"Cash Account",10390.00,"",56825.07
,"Cheque","30-01-2024","612",,"Hybrid Electricals","Cables & Contactor","Expense","Spares and Tools",,"Cash Account",3150.00,"",59975.07
,"Cheque","01-02-2024","631",,"Hybrid Electricals","Cables & Electricals","Expense","Spares and Tools",,"Cash Account",7620.00,"",67595.07
,"Bill","09-02-2024","0020096880000040533",,"Oil Seals And Bearing Centre Limited","6002 2RS C3 Timken","Expense","Spares and Tools",,"Accounts Payable",1310.40,"",68905.47
,"Bill","09-02-2024","0040120720000008949",,"Allwin Packaging International Ltd","steam tunnel spares","Expense","Spares and Tools",,"Accounts Payable",4800.00,"",73705.47
,"Bill","19-02-2024","0190447770000002984",,"Power Controls Ltd","Capacitor","Expense","Spares and Tools",,"Accounts Payable",745.69,"",74451.16
,"Cheque","01-03-2024","5414",,"Engineering Systems","2 Magnetic contactor","Expense","Spares and Tools",,"Cash Account",6000.00,"",80451.16
,"Bill","05-03-2024","0110185500000015721",,"Hydromatics Ltd","silencer festo","Expense","Spares and Tools",,"Accounts Payable",5580.00,"",86031.16
,"Bill","05-03-2024","0020111240000012004",,"Kenya Hydraulics LTD","Janatics male connector","Expense","Spares and Tools",,"Accounts Payable",4807.76,"",90838.92
,"Bill","15-03-2024","AT/016/23-24",,"Asiafric Trading FZE","-MULTIPLE-","Expense","Spares and Tools",,"Accounts Payable - USD",1199205.50,"",1290044.42
,"Bill","18-03-2024","0020111240000012252",,"Kenya Hydraulics LTD","air silencer","Expense","Spares and Tools",,"Accounts Payable",1439.66,"",1291484.08
,"Bill","22-03-2024","0040268870000001262",,"Delon Enterprises Limited","Crane button control switch","Expense","Spares and Tools",,"Accounts Payable",7500.00,"",1298984.08
,"Cheque","22-03-2024","2612",,"Tasmania Hardware & Tools","Scrappers","Expense","Spares and Tools",,"MPESA Account",500.00,"",1299484.08
,"Bill","22-03-2024","0040075340000070770",,"Swissport Kenya Limited","Airport Handling & Storage Charges","Expense","Spares and Tools",,"Accounts Payable",6064.80,"",1305548.88
,"Bill","22-03-2024","0040075340000070795",,"Swissport Kenya Limited","Airport Handling & Storage Charges","Expense","Spares and Tools",,"Accounts Payable",13087.20,"",1318636.08
,"Bill","23-03-2024","0020111240000012364",,"Kenya Hydraulics LTD","Janatics male connectors","Expense","Spares and Tools",,"Accounts Payable",4807.76,"",1323443.84
,"Bill","23-03-2024","24NBOIM403279335",,"Tax Agency (Sales Taxes)","Railway Levy, MSS Levy & IDF Fees","Expense","Spares and Tools",,"Accounts Payable",41202.74,"",1364646.58
,"Cheque","26-03-2024","1004",,"Kefas Plumbing Hardware","1inch ball corks, male adapters and thread seal","Expense","Spares and Tools",,"Cash Account",2320.00,"",1366966.58
,"Bill","27-03-2024","0110185500000016317",,"Hydromatics Ltd","Meter and sensors","Expense","Spares and Tools",,"Accounts Payable",51980.00,"",1418946.58
,"Bill","02-04-2024","0020111240000012473",,"Kenya Hydraulics LTD","HYD hose 4SH, sleeve and BSP FST","Expense","Spares and Tools",,"Accounts Payable",6396.55,"",1425343.13
,"Bill","04-04-2024","0040792500000127544",,"Marksy Electricals Ltd.","electrical parts","Expense","Spares and Tools",,"Accounts Payable",2155.17,"",1427498.30
,"Bill","11-04-2024","S240407KEN01A",,"Adatouch Company Limited","4 touch screen for AMT10615","Expense","Spares and Tools",,"Accounts Payable - USD",10617.72,"",1438116.02
,"Bill","11-04-2024","24NBOIMC04297465",,"Tax Agency (Sales Taxes)","Import Duty, Railway Levy, MSS Levy & IDF Fees","Expense","Spares and Tools",,"Accounts Payable",2715.00,"",1440831.02
,"Bill","30-04-2024","0040120720000010099",,"Allwin Packaging International Ltd","steam tunnel spares, magnetic level sensor","Expense","Spares and Tools",,"Accounts Payable",28350.00,"",1469181.02
,"Bill","02-05-2024","0190447630000008270",,"Skylife Kenya Ltd","compressor fan","Expense","Spares and Tools",,"Accounts Payable",862.07,"",1470043.09
,"Bill","02-05-2024","0040912860000000508",,"Petmark Electrical Sales","100VA Transformer","Expense","Spares and Tools",,"Accounts Payable",4000.00,"",1474043.09
,"Bill","02-05-2024","0190169220000025314",,"New Shakah Electricals Ltd","electrical tools and parts","Expense","Spares and Tools",,"Accounts Payable",10008.62,"",1484051.71
,"Cheque","07-05-2024","3203",,"POWRIGHT SUPPLIES","PPR Union","Expense","Spares and Tools",,"MPESA Account",80.00,"",1484131.71
,"Cheque","08-05-2024","3205",,"POWRIGHT SUPPLIES","Socket, Plug, and nipple","Expense","Spares and Tools",,"MPESA Account",155.00,"",1484286.71
,"Cheque","09-05-2024","91512024",,"Hillary Shah","pressure control switch","Expense","Spares and Tools",,"MPESA Account",4500.00,"",1488786.71
,"Cheque","13-05-2024","3229",,"POWRIGHT SUPPLIES","PPR 32mm","Expense","Spares and Tools",,"MPESA Account",60.00,"",1488846.71
,"Cheque","13-05-2024","1113",,"Kefas Plumbing Hardware","1inch Union, 1inch Tee, and 1inch Socket","Expense","Spares and Tools",,"MPESA Account",510.00,"",1489356.71
,"Cheque","14-05-2024","1452024",,"Economy Hardware and General Stores","Handsaw","Expense","Spares and Tools",,"MPESA Account",300.00,"",1489656.71
,"Cheque","15-05-2024","1552024",,"Economy Hardware and General Stores","Handsaw","Expense","Spares and Tools",,"MPESA Account",300.00,"",1489956.71
,"Cheque","17-05-2024","17052024",,"Standard Hardware and Electricals","1Pc Spanner 46","Expense","Spares and Tools",,"MPESA Account",1000.00,"",1490956.71
,"Cheque","17-05-2024","1752024",,"Apex Hardware and Electricals","1Pc Spanner 46","Expense","Spares and Tools",,"MPESA Account",1000.00,"",1491956.71
,"Bill","22-05-2024","0040425430000001273",,"Refrigeration Components Limited","Ebmpapst Fan Motor 36/10W","Expense","Spares and Tools",,"Accounts Payable",6000.00,"",1497956.71
,"Bill","22-05-2024","0090973920000008250",,"ASL Limited","Solar water heating system replacement pump 0.5HP PKM 60","Expense","Spares and Tools",,"Accounts Payable",7327.59,"",1505284.30
,"Bill","23-05-2024","0020111240000013353",,"Kenya Hydraulics LTD","Silencer","Expense","Spares and Tools",,"Accounts Payable",1012.93,"",1506297.23
,"Cheque","23-05-2024","20716",,"Quails Bearing and Chains","0.75Kw motor replacement","Expense","Spares and Tools",,"Cash Account",50000.00,"",1556297.23
,"Bill","28-05-2024","0110393730000092293",,"Central Auto & Hardware Ltd","Weld Mesh 8x4x8g","Expense","Spares and Tools",,"Accounts Payable",1379.31,"",1557676.54
,"Bill","31-05-2024","0190439850000030304",,"Tradecon Downtown Ltd","Allen cap 16x70","Expense","Spares and Tools",,"Accounts Payable",379.31,"",1558055.85
,"Bill","05-06-2024","0040120720000010642",,"Allwin Packaging International Ltd","teflon belt 5pc @ 450 and nylon belt 2pc @ 675","Expense","Spares and Tools",,"Accounts Payable",3600.00,"",1561655.85
,"Cheque","13-06-2024","629",,"Standard Electricals","Overload 4-6A","Expense","Spares and Tools",,"Cash Account",3000.00,"",1564655.85
,"Bill","05-07-2024","0170947490000001114",,"Kate Pneumatics Solutions","Festo Double Solenoid Valve","Expense","Spares and Tools",,"Accounts Payable",18000.00,"",1582655.85
,"Bill","10-07-2024","1347",,"Waruwa Company Limited","Metal plate","Expense","Spares and Tools",,"Accounts Payable",525.00,"",1583180.85
,"Cheque","12-07-2024","1942",,"Ngigi Merchants","padlocks","Expense","Spares and Tools",,"MPESA Account",900.00,"",1584080.85
,"Bill","19-07-2024","0170537680000001246",,"Geocomp Systems Ltd","Blow moulding hose pipe","Expense","Spares and Tools",,"Accounts Payable",2500.00,"",1586580.85
,"Cheque","22-07-2024","1355",,"Kefas Plumbing Hardware","Plumbing materials","Expense","Spares and Tools",,"MPESA Account",4540.00,"",1591120.85
,"Cheque","22-07-2024","22072024",,"Economy Hardware and General Stores","plumbing accessories","Expense","Spares and Tools",,"Cash Account",16700.00,"",1607820.85
,"Cheque","24-07-2024","268",,"K.K. Tents","hoist bag repairs","Expense","Spares and Tools",,"MPESA Account",700.00,"",1608520.85
,"Cheque","24-07-2024","24072024",,"Ambex Hardware Store","3 thread tape","Expense","Spares and Tools",,"MPESA Account",90.00,"",1608610.85
,"Cheque","25-07-2024","1298",,"Kefas Plumbing Hardware","Plumbing materials","Expense","Spares and Tools",,"MPESA Account",480.00,"",1609090.85
,"Cheque","26-07-2024","4034",,"Dominion Kitchen Ware Enterprise","Bosch tools","Expense","Spares and Tools",,"MPESA Account",7800.00,"",1616890.85
,"Cheque","29-07-2024","034",,"Electrical & Rewinders","Motor fan","Expense","Spares and Tools",,"Cash Account",700.00,"",1617590.85
,"Bill","31-07-2024","0040120720000011494",,"Allwin Packaging International Ltd","teflon belt","Expense","Spares and Tools",,"Accounts Payable",1800.00,"",1619390.85
,"Bill","02-08-2024","0020111240000014547",,"Kenya Hydraulics LTD","Janatics male connectors","Expense","Spares and Tools",,"Accounts Payable",9616.00,"",1629006.85
,"Cheque","14-08-2024","307",,"Jua Kali Kamukunji Hardware","Square tube @120","Expense","Spares and Tools",,"MPESA Account",300.00,"",1629306.85
,"Bill","16-08-2024","0190439850000033817",,"Tradecon Downtown Ltd","Screw, Compression Spring, and Allen bottom","Expense","Spares and Tools",,"Accounts Payable",517.24,"",1629824.09
,"Bill","21-08-2024","0040120720000011837",,"Allwin Packaging International Ltd","teflon belt 6pcs @ 450","Expense","Spares and Tools",,"Accounts Payable",2700.00,"",1632524.09
,"Cheque","22-08-2024","764",,"Hillary Shah","pressure control switch","Expense","Spares and Tools",,"MPESA Account",4300.00,"",1636824.09
,"Bill","28-08-2024","0040219110000001800",,"Wescham Enterprises Limited","plumping parts","Expense","Spares and Tools",,"Accounts Payable",94.83,"",1636918.92
,"Bill","30-08-2024","0170537680000001363",,"Geocomp Systems Ltd","Blow moulding pneumatic silencer","Expense","Spares and Tools",,"Accounts Payable",1500.00,"",1638418.92
,"Bill","31-08-2024","KRACU0100028436/134",,"Kisii Drom Electronics","Solar light and solar system","Expense","Spares and Tools",,"VAT Payable",30910.00,"",1669328.92
,"Cheque","03-09-2024","03092024",,"Jumbo Hardware and General Stores","Roundfile","Expense","Spares and Tools",,"MPESA Account",250.00,"",1669578.92
,"Bill","05-09-2024","KRACU0100028436/146",,"Kisii Drom Electronics","Solar light and solar system","Expense","Spares and Tools",,"VAT Payable",39000.00,"",1708578.92
,"Bill","05-09-2024","KRACU0100028436/152",,"Kisii Drom Electronics","Solar light and solar system","Expense","Spares and Tools",,"VAT Payable",45000.00,"",1753578.92
,"Bill","05-09-2024","KRACU0100028436/151",,"Kisii Drom Electronics","Solar light and solar system","Expense","Spares and Tools",,"VAT Payable",30000.00,"",1783578.92
,"Credit","05-09-2024","KRACU0100028436/153",,"Kisii Drom Electronics","Solar light and solar system","Expense","Spares and Tools",,"VAT Payable","",27200.00,1756378.92
,"Cheque","10-09-2024","10924",,"Imperial Hardware and General Stores","2 spades","Expense","Spares and Tools",,"MPESA Account",1200.00,"",1757578.92
,"Bill","13-09-2024","0190439870000026144",,"Tradecon Downtown Ltd","Allen cap bolt","Expense","Spares and Tools",,"Accounts Payable",301.72,"",1757880.64
,"Bill","14-09-2024","KRACU0100028436/212",,"Kisii Drom Electronics","Solar light and solar system","Expense","Spares and Tools",,"VAT Payable",30000.00,"",1787880.64
,"Bill","14-09-2024","KRACU0100028436/219",,"Kisii Drom Electronics","Solar light and solar system","Expense","Spares and Tools",,"VAT Payable",34200.00,"",1822080.64
,"Bill","17-09-2024","KRACU0100028436/223",,"Kisii Drom Electronics","Solar light and solar system","Expense","Spares and Tools",,"VAT Payable",10000.00,"",1832080.64
,"Bill","19-09-2024","0040120720000012294",,"Allwin Packaging International Ltd","temperature control, drive wheel, and spring","Expense","Spares and Tools",,"Accounts Payable",9945.00,"",1842025.64
,"Cheque","30-09-2024","30092024",,"Apex Electrical Sales & Services","Isolator 100A, and Rowl bolt","Expense","Spares and Tools",,"Cash Account",6200.00,"",1848225.64
,"Cheque","30-09-2024","0789",,,"cable","Expense","Spares and Tools",,"Cash Account",13000.00,"",1861225.64
,"Cheque","01-10-2024","0801",,,"cable and controller","Expense","Spares and Tools",,"Cash Account",10700.00,"",1871925.64
,"Bill","01-10-2024","0170528110000062789",,"Ragson Kenya Limited","Spares","Expense","Spares and Tools",,"Accounts Payable",875.00,"",1872800.64
,"Cheque","01-10-2024","4749",,"Jua Kali Kamukunji Hardware","Square tube","Expense","Spares and Tools",,"MPESA Account",200.00,"",1873000.64
,"Bill","03-10-2024","0110397490000070010",,"Elite Tools Limited","Measuring Tape 50M Fibre Glass Stanley","Expense","Spares and Tools",,"Accounts Payable",2547.41,"",1875548.05
,"Bill","11-10-2024","0040120720000012615",,"Allwin Packaging International Ltd","Driven roller for FR900","Expense","Spares and Tools",,"Accounts Payable",1485.00,"",1877033.05
,"Cheque","22-10-2024","054",,"Electrical & Rewinders","Grinder switch","Expense","Spares and Tools",,"MPESA Account",1200.00,"",1878233.05
,"Bill","24-10-2024","0090973960000038267",,"ASL Limited","PVC Telescopic Bottle Trap 1 1/4 H/D Grey","Expense","Spares and Tools",,"Accounts Payable",344.83,"",1878577.88
,"Bill","28-10-2024","0040092180000008660",,"Hydraulic Hoses & Pipe Manufacturers Ltd.","Air quick exhaust valve 1/4inch and 6 x 4mm PU tube blue","Expense","Spares and Tools",,"Accounts Payable",5430.86,"",1884008.74
,"Bill","04-11-2024","0040092180000008740",,"Hydraulic Hoses & Pipe Manufacturers Ltd.","Air quick exhaust valve 1/4inch","Expense","Spares and Tools",,"Accounts Payable",3275.86,"",1887284.60
,"Cheque","05-11-2024","987",,"Kefas Plumbing Hardware","Plumbing materials","Expense","Spares and Tools",,"Cash Account",4290.00,"",1891574.60
,"Bill","13-11-2024","KRACU0100048251/8",,"JALISTEP INTERNATIONAL LIMITED","UV sterilizer 25 watt","Expense","Spares and Tools",,"Accounts Payable",16000.00,"",1907574.60
,"Cheque","15-11-2024","063",,"Electrical & Rewinders","Grinder repairs","Expense","Spares and Tools",,"MPESA Account",2800.00,"",1910374.60
,"Bill","23-11-2024","0170949050000004444",,"Ermac Enterprises","flash ball valve","Expense","Spares and Tools",,"Accounts Payable",344.84,"",1910719.44
,"Cheque","26-11-2024","SKR0AWLIFE",,"Kang Steel Engineering And Supplies Ltd","items","Expense","Spares and Tools",,"MPESA Account",500.00,"",1911219.44
,"Cheque","26-11-2024","1431",,"Pakika Enterprises","items","Expense","Spares and Tools",,"Cash Account",19500.00,"",1930719.44
,"Bill","29-11-2024","KRACU0100028436/491",,"Kisii Drom Electronics","Solar light and solar system","Expense","Spares and Tools",,"VAT Payable",76000.00,"",2006719.44
,"Bill","03-12-2024","KRACU0100028436/497",,"Kisii Drom Electronics","Solar light and solar system","Expense","Spares and Tools",,"VAT Payable",38000.00,"",2044719.44
,"Bill","18-12-2024","0020111240000017179",,"Kenya Hydraulics LTD","Janatics male connectors","Expense","Spares and Tools",,"Accounts Payable",14424.00,"",2059143.44
,"Bill","18-12-2024","KRACU0100028436/530",,"Kisii Drom Electronics","Solar light and solar system","Expense","Spares and Tools",,"VAT Payable",4500.00,"",2063643.44
,"Cheque","18-12-2024","1234",,"Loima Enterprises","saw","Expense","Spares and Tools",,"MPESA Account",900.00,"",2064543.44
,"Cheque","20-12-2024","4059",,"Daniel Steels Engineering","10pcs hacksaw blades","Expense","Spares and Tools",,"MPESA Account",5000.00,"",2069543.44
,"Cheque","23-12-2024","073",,"Electrical & Rewinders","2 pairs carbon brushes","Expense","Spares and Tools",,"MPESA Account",2400.00,"",2071943.44
"Total Spares and Tools",,,,,,,,,,,2099143.44,27200.00,2071943.44
"Labour and Services",,,,,,,,,,,,,""
,"General Journal","04-01-2024","21942",,,"Dec 23 Salaries and Wages Payment","Expense","Labour and Services",,"Net Pay",44000.00,"",44000.00
,"Cheque","05-01-2024","P1776",,,"Fabrication works","Expense","Labour and Services",,"MPESA Account",1650.00,"",45650.00
,"Cheque","10-01-2024","P1782",,,"Fabrication works","Expense","Labour and Services",,"MPESA Account",672.00,"",46322.00
,"Cheque","10-01-2024","P1782",,,"Fabrication works","Expense","Labour and Services",,"Cash Account",978.00,"",47300.00
,"Cheque","11-01-2024","P1784",,,"Fabrication works","Expense","Labour and Services",,"MPESA Account",1650.00,"",48950.00
,"Cheque","12-01-2024","P1785",,,"Fabrication works","Expense","Labour and Services",,"MPESA Account",1650.00,"",50600.00
,"Bill","29-01-2024","KRACU0200000460/18",,"Clarjos Enterprises","Mechanical Engineering Services","Expense","Labour and Services",,"Accounts Payable",23500.00,"",74100.00
,"Bill","30-01-2024","0171525950000000028",,"Airlink Technologies","Servicing water cooled chiller","Expense","Labour and Services",,"Accounts Payable",3500.00,"",77600.00
,"Bill","01-02-2024","KRACU0200000767/20",,"TynWald Fabricators Limited","4mm stainless steel threaded U-bolts","Expense","Labour and Services",,"Accounts Payable",1500.00,"",79100.00
,"Cheque","01-02-2024","P1821",,,"Fabrication works","Expense","Labour and Services",,"MPESA Account",1650.00,"",80750.00
,"General Journal","01-02-2024","22401",,,"Jan 24 Salaries and Wages Payment","Expense","Labour and Services",,"Net Pay",102053.00,"",182803.00
,"Cheque","12-02-2024","P1836",,,"Fabrication works","Expense","Labour and Services",,"MPESA Account",1650.00,"",184453.00
,"Cheque","13-02-2024","P1839",,,"Masonry works","Expense","Labour and Services",,"MPESA Account",2050.00,"",186503.00
,"Cheque","19-02-2024","P1860",,,"Electrical repair jobs hoist and compressor","Expense","Labour and Services",,"Cash Account",26500.00,"",213003.00
,"Cheque","20-02-2024","SBK6NVPMNC",,"Allantony Engineering Systems","Canteen CCTV relocation and production office CCTV monitor setup","Expense","Labour and Services",,"MPESA Account",1800.00,"",214803.00
,"Cheque","21-02-2024","P1861",,,"Plumbing works","Expense","Labour and Services",,"MPESA Account",1500.00,"",216303.00
,"Cheque","23-02-2024","P1869",,,"Fabrication works","Expense","Labour and Services",,"MPESA Account",1650.00,"",217953.00
,"Bill","23-02-2024","KRACU0200000767/24",,"TynWald Fabricators Limited","Machining 16x500mm SS shaft","Expense","Labour and Services",,"Accounts Payable",2300.00,"",220253.00
,"Cheque","29-02-2024","P1876",,,"Fabrication works","Expense","Labour and Services",,"MPESA Account",1650.00,"",221903.00
,"Cheque","01-03-2024","P1878",,,"Fabrication works","Expense","Labour and Services",,"MPESA Account",1650.00,"",223553.00
,"General Journal","01-03-2024","22657",,,"Feb 24 Salaries and Wages Payment","Expense","Labour and Services",,"Net Pay",102053.00,"",325606.00
,"Cheque","04-03-2024","P1879",,,"Electrical repair jobs installation of safety interlocks","Expense","Labour and Services",,"Cash Account",9500.00,"",335106.00
,"Cheque","20-03-2024","P1897",,,"Fabrication works","Expense","Labour and Services",,"MPESA Account",1000.00,"",336106.00
,"Cheque","21-03-2024","P1905",,,"Steve Electrical repairs","Expense","Labour and Services",,"MPESA Account",2000.00,"",338106.00
,"Cheque","21-03-2024","P1907",,,"Fabrication works","Expense","Labour and Services",,"MPESA Account",650.00,"",338756.00
,"Cheque","21-03-2024","P1938",,,"Electrical repairs Hoist and Mixer","Expense","Labour and Services",,"Cash Account",19250.00,"",358006.00
,"Cheque","22-03-2024","P1932",,,"Steve Electrical repairs","Expense","Labour and Services",,"MPESA Account",2500.00,"",360506.00
,"Cheque","23-03-2024","P1913",,,"Fabrication works","Expense","Labour and Services",,"MPESA Account",600.00,"",361106.00
,"Cheque","26-03-2024","P1919",,,"Plumbing works","Expense","Labour and Services",,"MPESA Account",1000.00,"",362106.00
,"General Journal","29-03-2024","23304",,,"Mar 24 Salaries and Wages Payment","Expense","Labour and Services",,"Net Pay",103553.00,"",465659.00
,"Cheque","04-04-2024","P1944",,,"Steve Electrical repairs","Expense","Labour and Services",,"MPESA Account",2500.00,"",468159.00
,"Bill","11-04-2024","0171525950000000032",,"Airlink Technologies","Servicing water cooled chiller","Expense","Labour and Services",,"Accounts Payable",95000.00,"",563159.00
,"Cheque","18-04-2024","P1973",,,"Steve Electrical repairs","Expense","Labour and Services",,"MPESA Account",2500.00,"",565659.00
,"Cheque","18-04-2024","P1974",,,"Felix Electrical repairs","Expense","Labour and Services",,"MPESA Account",2500.00,"",568159.00
,"Cheque","22-04-2024","SDM4XO6ZMO",,"Njenga's Upholstery","hoist chain bag repairs","Expense","Labour and Services",,"MPESA Account",700.00,"",568859.00
,"Bill","22-04-2024","KRACU0200000767/29",,"TynWald Fabricators Limited","coupling boring","Expense","Labour and Services",,"Accounts Payable",7200.00,"",576059.00
,"Cheque","23-04-2024","P1980",,,"Fabrication works","Expense","Labour and Services",,"MPESA Account",1100.00,"",577159.00
,"Cheque","25-04-2024","P1986",,,"Steve Electrical repairs","Expense","Labour and Services",,"MPESA Account",2500.00,"",579659.00
,"Cheque","30-04-2024","P1992",,,"Steve Electrical repairs","Expense","Labour and Services",,"MPESA Account",2500.00,"",582159.00
,"General Journal","30-04-2024","23494",,,"Apr 24 Salaries and Wages Payment","Expense","Labour and Services",,"Net Pay",103553.00,"",685712.00
,"Cheque","02-05-2024","P1997",,,"Felix Electrical repairs","Expense","Labour and Services",,"MPESA Account",1000.00,"",686712.00
,"Cheque","08-05-2024","P2010",,,"Plumbing works","Expense","Labour and Services",,"MPESA Account",700.00,"",687412.00
,"Cheque","10-05-2024","P2022",,,"Fabrication works","Expense","Labour and Services",,"MPESA Account",4950.00,"",692362.00
,"Cheque","12-05-2024","P2023",,,"Fabrication works","Expense","Labour and Services",,"MPESA Account",1650.00,"",694012.00
,"Cheque","13-05-2024","P2025",,,"Plumbing works","Expense","Labour and Services",,"MPESA Account",400.00,"",694412.00
,"Cheque","13-05-2024","P2028",,,"Fabrication works","Expense","Labour and Services",,"MPESA Account",1650.00,"",696062.00
,"Cheque","13-05-2024","P026",,,"Electrical repair & Installation on Auger filler","Expense","Labour and Services",,"Cash Account",19200.00,"",715262.00
,"Bill","14-05-2024","KRACU0200000460/23",,"Clarjos Enterprises","Mechanical Engineering Services","Expense","Labour and Services",,"Accounts Payable",13500.00,"",728762.00
,"Bill","14-05-2024","KRACU0200000460/24",,"Clarjos Enterprises","Mechanical Engineering Services","Expense","Labour and Services",,"Accounts Payable",14900.00,"",743662.00
,"Cheque","14-05-2024","P2029",,,"Fabrication works","Expense","Labour and Services",,"MPESA Account",1650.00,"",745312.00
,"Cheque","15-05-2024","P2034",,,"Fabrication works","Expense","Labour and Services",,"MPESA Account",1650.00,"",746962.00
,"Cheque","16-05-2024","058",,"Compressor Maintenance Services","Compressor repairs","Expense","Labour and Services",,"Cash Account",55000.00,"",801962.00
,"Cheque","16-05-2024","P2036",,,"Steve Electrical repairs","Expense","Labour and Services",,"MPESA Account",2500.00,"",804462.00
,"Cheque","23-05-2024","P2049",,,"Fabrication works","Expense","Labour and Services",,"MPESA Account",1650.00,"",806112.00
,"Cheque","23-05-2024","P2050",,,"Fabrication works","Expense","Labour and Services",,"MPESA Account",1650.00,"",807762.00
,"Cheque","24-05-2024","P2054",,,"Fabrication works","Expense","Labour and Services",,"MPESA Account",1650.00,"",809412.00
,"Cheque","27-05-2024","P2060",,,"Steve Electrical repairs","Expense","Labour and Services",,"MPESA Account",2500.00,"",811912.00
,"Cheque","28-05-2024","P2062",,,"Fabrication works","Expense","Labour and Services",,"MPESA Account",1950.00,"",813862.00
,"Cheque","29-05-2024","P2065",,,"Fabrication works","Expense","Labour and Services",,"MPESA Account",1650.00,"",815512.00
,"General Journal","30-05-2024","23777",,,"May 24 Salaries and Wages Payment","Expense","Labour and Services",,"Net Pay",103553.00,"",919065.00
,"Cheque","30-05-2024","P2069",,,"Fabrication works","Expense","Labour and Services",,"MPESA Account",1650.00,"",920715.00
,"Cheque","31-05-2024","P2071",,,"Fabrication works Solomon","Expense","Labour and Services",,"MPESA Account",420.00,"",921135.00
,"Cheque","06-06-2024","P2089",,,"Felix Electrical repairs","Expense","Labour and Services",,"MPESA Account",2500.00,"",923635.00
,"Cheque","10-06-2024","P2095",,,"Fabrication works","Expense","Labour and Services",,"MPESA Account",1650.00,"",925285.00
,"Bill","12-06-2024","0020111240000013712",,"Kenya Hydraulics LTD","Blow moulding machine 2 cylinder repairs","Expense","Labour and Services",,"Accounts Payable",40877.60,"",966162.60
,"Bill","13-06-2024","KRACU0200000767/36",,"TynWald Fabricators Limited","shaft machining","Expense","Labour and Services",,"Accounts Payable",6100.00,"",972262.60
,"Cheque","13-06-2024","P2104",,,"Steve Electrical repairs","Expense","Labour and Services",,"MPESA Account",2500.00,"",974762.60
,"Cheque","17-06-2024","062",,"Compressor Maintenance Services","Compressor repairs","Expense","Labour and Services",,"Cash Account",55000.00,"",1029762.60
,"Bill","27-06-2024","229",,"Clarjos Enterprises","Mixer 1 chain repairs","Expense","Labour and Services",,"Accounts Payable",2500.00,"",1032262.60
,"General Journal","29-06-2024","24430",,,"Jun 24 Salaries and Wages Payment","Expense","Labour and Services",,"Net Pay",103553.00,"",1135815.60
,"Bill","04-07-2024","0020111240000014054",,"Kenya Hydraulics LTD","BSP FST, Sleeve R1, & machining","Expense","Labour and Services",,"Accounts Payable",926.40,"",1136742.00
,"Cheque","10-07-2024","P2148",,,"Fabrication works @ 1650 and transportation of parts for machining @ 150","Expense","Labour and Services",,"MPESA Account",1800.00,"",1138542.00
,"Cheque","10-07-2024","P2150",,,"Masonry works Albunus Katuli","Expense","Labour and Services",,"MPESA Account",3500.00,"",1142042.00
,"Bill","11-07-2024","0171738860000000448",,"Kalsi Hydraulic & Engineering Works","Machining works","Expense","Labour and Services",,"Accounts Payable",83500.00,"",1225542.00
,"Cheque","13-07-2024","P2160",,,"Steve Electrical repairs","Expense","Labour and Services",,"Cash Account",2500.00,"",1228042.00
,"Bill","15-07-2024","0171738860000000450",,"Kalsi Hydraulic & Engineering Works","Machining works","Expense","Labour and Services",,"Accounts Payable",9300.00,"",1237342.00
,"Cheque","18-07-2024","P2161",,,"Fabrication works","Expense","Labour and Services",,"Cash Account",3300.00,"",1240642.00
,"Cheque","25-07-2024","P2175",,,"Fabrication works offset KES 235 for byproducts","Expense","Labour and Services",,"MPESA Account",1415.00,"",1242057.00
,"Cheque","26-07-2024","P2177",,,"Fabrication works","Expense","Labour and Services",,"MPESA Account",1650.00,"",1243707.00
,"Bill","30-07-2024","231",,"Clarjos Enterprises","Toilet cleaner machine tank modification","Expense","Labour and Services",,"Accounts Payable",5000.00,"",1248707.00
,"Cheque","31-07-2024","P2182",,,"Steve Electrical repairs","Expense","Labour and Services",,"Cash Account",2000.00,"",1250707.00
,"General Journal","31-07-2024","24677",,,"Jul 24 Salaries and Wages Payment","Expense","Labour and Services",,"Net Pay",103553.00,"",1354260.00
,"Cheque","02-08-2024","P2190",,,"Fabrication works","Expense","Labour and Services",,"MPESA Account",1670.00,"",1355930.00
,"Cheque","06-08-2024","P2192",,,"Fabrication works","Expense","Labour and Services",,"MPESA Account",1525.00,"",1357455.00
,"Cheque","07-08-2024","P2194",,,"Fabrication works","Expense","Labour and Services",,"MPESA Account",1650.00,"",1359105.00
,"Cheque","08-08-2024","P2206",,,"Fabrication works","Expense","Labour and Services",,"MPESA Account",1650.00,"",1360755.00
,"Cheque","09-08-2024","P2209",,,"Fabrication works","Expense","Labour and Services",,"MPESA Account",1650.00,"",1362405.00
,"Cheque","09-08-2024","P2210",,,"Plumbing works","Expense","Labour and Services",,"MPESA Account",1000.00,"",1363405.00
,"Bill","12-08-2024","0171738860000000475",,"Kalsi Hydraulic & Engineering Works","Machining works","Expense","Labour and Services",,"Accounts Payable",8700.00,"",1372105.00
,"Cheque","14-08-2024","P2217",,,"Fabrication works","Expense","Labour and Services",,"MPESA Account",1030.00,"",1373135.00
,"Cheque","15-08-2024","P2219",,,"Fabrication works","Expense","Labour and Services",,"MPESA Account",410.00,"",1373545.00
,"Cheque","20-08-2024","P2226",,,"Plumbing works","Expense","Labour and Services",,"MPESA Account",1200.00,"",1374745.00
,"Bill","26-08-2024","KRACU0200000460/29",,"Clarjos Enterprises","Mechanical Engineering Services","Expense","Labour and Services",,"Accounts Payable",24000.00,"",1398745.00
,"Cheque","28-08-2024","P2244",,,"Romans Plumbing works","Expense","Labour and Services",,"MPESA Account",800.00,"",1399545.00
,"General Journal","30-08-2024","24995",,,"Aug 24 Salaries and Wages Payment","Expense","Labour and Services",,"Net Pay",88341.00,"",1487886.00
,"Bill","02-09-2024","P2254",,"Mutinda Fabrication","Mutinda Fabrication works","Expense","Labour and Services",,"Accounts Payable",1650.00,"",1489536.00
,"Cheque","03-09-2024","P2265",,,"Dominic Oloo maintenance services","Expense","Labour and Services",,"MPESA Account",500.00,"",1490036.00
,"Bill","03-09-2024","P2268",,"Mutinda Fabrication","Mutinda Fabrication works","Expense","Labour and Services",,"Accounts Payable",1650.00,"",1491686.00
,"Cheque","10-09-2024","P2282",,,"Fabrication works","Expense","Labour and Services",,"MPESA Account",1650.00,"",1493336.00
,"Cheque","10-09-2024","P2280",,,"Steve Electrical repairs","Expense","Labour and Services",,"Cash Account",4500.00,"",1497836.00
,"Cheque","14-09-2024","P2290",,,"Fabrication works","Expense","Labour and Services",,"MPESA Account",1000.00,"",1498836.00
,"Cheque","17-09-2024","P2293",,,"Dominic Oloo maintenance services","Expense","Labour and Services",,"MPESA Account",200.00,"",1499036.00
,"Bill","30-09-2024","KRACU0200000460/31",,"Clarjos Enterprises","Mechanical Engineering Services","Expense","Labour and Services",,"Accounts Payable",24000.00,"",1523036.00
,"Cheque","30-09-2024","P2315",,,"Steve Electrical repairs steam tunnel, hot air tunnel","Expense","Labour and Services",,"Cash Account",16200.00,"",1539236.00
,"General Journal","01-10-2024","25445",,,"Sep 24 Salaries and Wages Payment","Expense","Labour and Services",,"Net Pay",88341.00,"",1627577.00
,"Cheque","07-10-2024","496",,"Airlink Technologies","Servicing chiller","Expense","Labour and Services",,"Cash Account",32000.00,"",1659577.00
,"Bill","14-10-2024","0041411100000000376",,"Compressor Maintenance Services","Compressor service","Expense","Labour and Services",,"Accounts Payable",70137.93,"",1729714.93
,"Bill","17-10-2024","0040557580000000560",,"Pearl Electrical Controls Ltd","Generator service","Expense","Labour and Services",,"Accounts Payable",34108.62,"",1763823.55
,"Cheque","19-10-2024","P2351",,,"Fabrication works","Expense","Labour and Services",,"MPESA Account",1650.00,"",1765473.55
,"Cheque","24-10-2024","P2360",,,"Fabrication works Benedict Kyalo","Expense","Labour and Services",,"MPESA Account",1650.00,"",1767123.55
,"General Journal","31-10-2024","26041",,,"Oct 24 Salaries and Wages Payment","Expense","Labour and Services",,"Net Pay",88341.00,"",1855464.55
,"Bill","04-11-2024","KRACU0200000460/33",,"Clarjos Enterprises","Mechanical Engineering Services","Expense","Labour and Services",,"Accounts Payable",30000.00,"",1885464.55
,"Cheque","06-11-2024","P2389",,,"Romans Plumbing works","Expense","Labour and Services",,"MPESA Account",1300.00,"",1886764.55
,"Cheque","07-11-2024","P2391",,,"Steve Electrical repairs","Expense","Labour and Services",,"MPESA Account",4000.00,"",1890764.55
,"Cheque","12-11-2024","P2399",,,"Romans Plumbing works","Expense","Labour and Services",,"MPESA Account",500.00,"",1891264.55
,"Cheque","12-11-2024","P2402",,,"Fabrication works","Expense","Labour and Services",,"MPESA Account",1650.00,"",1892914.55
,"Cheque","14-11-2024","P2406",,,"Fabrication works","Expense","Labour and Services",,"MPESA Account",1650.00,"",1894564.55
,"Cheque","16-11-2024","P2412",,,"Fabrication works","Expense","Labour and Services",,"MPESA Account",1950.00,"",1896514.55
,"General Journal","01-12-2024","26560",,,"Nov 24 Salaries and Wages Payment","Expense","Labour and Services",,"Net Pay",88341.00,"",1984855.55
,"Bill","03-12-2024","KRACU0200000460/39",,"Clarjos Enterprises","Mechanical Engineering Services","Expense","Labour and Services",,"Accounts Payable",23500.00,"",2008355.55
,"Cheque","03-12-2024","P2443",,,"Felix Electrical repairs","Expense","Labour and Services",,"MPESA Account",3800.00,"",2012155.55
,"Cheque","04-12-2024","P2453",,,"Delvis Electrical repairs","Expense","Labour and Services",,"MPESA Account",6000.00,"",2018155.55
,"Cheque","13-12-2024","P2468",,,"Fabrication works","Expense","Labour and Services",,"MPESA Account",1650.00,"",2019805.55
,"Cheque","16-12-2024","P2472",,,"Delvis Electrical repairs","Expense","Labour and Services",,"MPESA Account",2000.00,"",2021805.55
,"Cheque","16-12-2024","P2475",,,"Fabrication works Solomon","Expense","Labour and Services",,"MPESA Account",300.00,"",2022105.55
,"Cheque","17-12-2024","P2479",,,"Fabrication works","Expense","Labour and Services",,"MPESA Account",1650.00,"",2023755.55
,"Cheque","18-12-2024","P2483",,,"Fabrication works","Expense","Labour and Services",,"MPESA Account",1650.00,"",2025405.55
,"Cheque","20-12-2024","P2489",,,"Fabrication works","Expense","Labour and Services",,"MPESA Account",1650.00,"",2027055.55
,"Cheque","23-12-2024","P2500",,,"Fabrication works","Expense","Labour and Services",,"MPESA Account",2650.00,"",2029705.55
,"Cheque","24-12-2024","P2503",,,"Fabrication works","Expense","Labour and Services",,"MPESA Account",2650.00,"",2032355.55
,"General Journal","24-12-2024","26564",,,"Dec 24 Salaries and Wages Payment","Expense","Labour and Services",,"Net Pay",88341.00,"",2120696.55
"Total Labour and Services",,,,,,,,,,,2120696.55,0.00,2120696.55
"ICT repairs and maintenance",,,,,,,,,,,,,""
"Labour and Services",,,,,,,,,,,,,""
,"Cheque","14-03-2024","P1891",,,"Koech computer repairs service","Expense","Labour and Services",,"MPESA Account",2000.00,"",2000.00
,"Bill","20-03-2024","Inv01",,"Stanbest Group EA Limited","Type-C ESD repairs","Expense","Labour and Services",,"Accounts Payable",2500.00,"",4500.00
,"Bill","24-04-2024","501",,"Clarjos Enterprises","Laptop bag repairs","Expense","Labour and Services",,"Accounts Payable",900.00,"",5400.00
,"Bill","25-04-2024","Inv02",,"Stanbest Group EA Limited","Type-C ESD license renewal","Expense","Labour and Services",,"Accounts Payable",11000.00,"",16400.00
,"Bill","04-06-2024","502",,"Clarjos Enterprises","Laptop bag repairs","Expense","Labour and Services",,"Accounts Payable",800.00,"",17200.00
,"Bill","08-10-2024","KRACU0200046943/29",,"Technomax Solutions Limited","Type-C ESD license renewal","Expense","Labour and Services",,"Accounts Payable",11000.00,"",28200.00
"Total Labour and Services",,,,,,,,,,,28200.00,0.00,28200.00
"Spares and Tools",,,,,,,,,,,,,""
,"Bill","24-01-2024","416",,"AtoZ Suppliers Ltd","HDMI to VGA cable","Expense","Spares and Tools",,"Accounts Payable",1500.00,"",1500.00
,"Bill","15-02-2024","0040218310000000260",,"Routine Solutions Ltd","HDMI Extender, coper cat 6 cable,HDMI cable, CCTV camera","Expense","Spares and Tools",,"Accounts Payable",11960.34,"",13460.34
,"Cheque","20-02-2024","183",,"Watom Enterprises","wireless mouse","Expense","Spares and Tools",,"MPESA Account",550.00,"",14010.34
,"Bill","13-03-2024","625",,"AtoZ Suppliers Ltd","Seagate 2TB Internal HDD","Expense","Spares and Tools",,"Accounts Payable",6800.00,"",20810.34
,"Bill","14-03-2024","392",,"AtoZ Suppliers Ltd","two 8GB server RAM","Expense","Spares and Tools",,"Accounts Payable",16000.00,"",36810.34
,"Bill","14-03-2024","391",,"AtoZ Suppliers Ltd","VGA cable","Expense","Spares and Tools",,"Accounts Payable",1500.00,"",38310.34
,"Bill","15-03-2024","631",,"AtoZ Suppliers Ltd","Keyboard","Expense","Spares and Tools",,"Accounts Payable",1300.00,"",39610.34
,"Cheque","10-04-2024","1546",,"Steliam Computers - RNG Plaza","Power flower cable","Expense","Spares and Tools",,"MPESA Account",300.00,"",39910.34
,"Bill","11-04-2024","763",,"AtoZ Suppliers Ltd","MiniPC adapter","Expense","Spares and Tools",,"Accounts Payable",1800.00,"",41710.34
,"Cheque","01-07-2024","SG158PQFJH",,"Ciss Solutions","Printer L6190 replacement maintenance box","Expense","Spares and Tools",,"MPESA Account",5800.00,"",47510.34
,"Bill","30-08-2024","0040562610000001181",,"Flow Controls Ltd","4 Blow moulding pneumatic silencer quarter inch","Expense","Spares and Tools",,"Accounts Payable",6719.83,"",54230.17
,"Bill","20-09-2024","0245",,"AtoZ Suppliers Ltd","2 MiniPC Display port to VGA cable and 1 HDMI to VGA cable","Expense","Spares and Tools",,"Accounts Payable",3000.00,"",57230.17
,"Bill","07-11-2024","902",,"AtoZ Suppliers Ltd","2 MiniPC screens and 1 display port cable","Expense","Spares and Tools",,"Accounts Payable",17700.00,"",74930.17
"Total Spares and Tools",,,,,,,,,,,74930.17,0.00,74930.17
"ICT repairs and maintenance - Other",,,,,,,,,,,,,""
,"Cheque","08-02-2024",,,,"Pop 8 Phones 2pc","Expense","ICT repairs and maintenance",,"Cash Account",26000.00,"",26000.00
"Total ICT repairs and maintenance - Other",,,,,,,,,,,26000.00,0.00,26000.00
"Total ICT repairs and maintenance",,,,,,,,,,,129130.17,0.00,129130.17
"Repairs and Maintenance - Other",,,,,,,,,,,,,""
,"Cheque","06-01-2024","IKAS181795",,"New Muthokinju Hardware Ltd","Crown paint","Expense","Repairs and Maintenance",,"Cash Account",2379.31,"",2379.31
,"Bill","30-01-2024","0110161990000544849",,"New Muthokinju Hardware Ltd","Paints","Expense","Repairs and Maintenance",,"Accounts Payable",39620.69,"",42000.00
,"Cheque","15-02-2024","694",,"Kefas Plumbing Hardware","Plumbing materials","Expense","Repairs and Maintenance",,"MPESA Account",1785.00,"",43785.00
,"Bill","02-10-2024","KRACU0100036336/674",,"Nairobi Power Tools Ltd","Carbon brushes","Expense","Repairs and Maintenance",,"Accounts Payable",1724.14,"",45509.14
"Total Repairs and Maintenance - Other",,,,,,,,,,,45509.14,0.00,45509.14
"Total Repairs and Maintenance",,,,,,,,,,,5545649.34,28375.00,5517274.34
"Safety, Health, Env & Quality",,,,,,,,,,,,,""
"Hygiene services",,,,,,,,,,,,,""
,"Bill","05-02-2024","488",,"Allgood Traders","Pedal bins","Expense","Hygiene services",,"Accounts Payable",500.00,"",500.00
,"Bill","06-05-2024","3292",,"Allgood Traders","Pedal bin and plastic trash can","Expense","Hygiene services",,"Accounts Payable",650.00,"",1150.00
"Total Hygiene services",,,,,,,,,,,1150.00,0.00,1150.00
"Health Services",,,,,,,,,,,,,""
,"Bill","02-10-2024","KRACU0200027267/63",,"Dr. Kowino J.O.","Medical Examination","Expense","Health Services",,"Accounts Payable",44000.00,"",44000.00
"Total Health Services",,,,,,,,,,,44000.00,0.00,44000.00
"Calibration Services",,,,,,,,,,,,,""
,"Bill","16-02-2024","0170931820000000234",,"San-Traco Weighing Services","Service and Calibration of weighing scales","Expense","Calibration Services",,"Accounts Payable",42700.00,"",42700.00
,"Bill","16-04-2024","0170931820000000293",,"San-Traco Weighing Services","Service repairs and adapter","Expense","Calibration Services",,"Accounts Payable",2800.00,"",45500.00
,"Bill","23-07-2024","0170931820000000341",,"San-Traco Weighing Services","Repair and replacement of AGT load cell and leveling feet","Expense","Calibration Services",,"Accounts Payable",10000.00,"",55500.00
,"Bill","09-10-2024","0170931820000000382",,"San-Traco Weighing Services","Repair and replacement of circuit board - T28 and battery replacement","Expense","Calibration Services",,"Accounts Payable",11800.00,"",67300.00
"Total Calibration Services",,,,,,,,,,,67300.00,0.00,67300.00
"Waste Disposal",,,,,,,,,,,,,""
,"Bill","09-02-2024","981",,"Multech Waste Services","Garbage disposal 09-02-2024","Expense","Waste Disposal",,"Accounts Payable",5000.00,"",5000.00
,"Bill","03-04-2024","992",,"Multech Waste Services","Garbage disposal 03-04-2024","Expense","Waste Disposal",,"Accounts Payable",5000.00,"",10000.00
,"Bill","31-05-2024","2107",,"Multech Waste Services","Garbage disposal 31-05-2024","Expense","Waste Disposal",,"Accounts Payable",5000.00,"",15000.00
,"Bill","30-08-2024","2130",,"Multech Waste Services","Garbage disposal 30-06-2024","Expense","Waste Disposal",,"Accounts Payable",5000.00,"",20000.00
,"Bill","24-10-2024","2013",,"Multech Waste Services","Garbage disposal 24-10-2024","Expense","Waste Disposal",,"Accounts Payable",5000.00,"",25000.00
"Total Waste Disposal",,,,,,,,,,,25000.00,0.00,25000.00
"Systems Audit Fees",,,,,,,,,,,,,""
,"Bill","04-10-2024","EHS/20774",,"Greenview Env &  Safety Consultants","Environmental, Fire safety and OSH Audits and reports","Expense","Systems Audit Fees",,"Accounts Payable",60000.00,"",60000.00
,"Bill","29-10-2024","0010194840000007096",,"Bureau Veritas Kenya Limited","ISO 22716 GMP certification","Expense","Systems Audit Fees",,"Accounts Payable",120000.00,"",180000.00
,"Bill","25-11-2024","420",,"Scenic Photo Phactory","GMP Cert 2 frame copies","Expense","Systems Audit Fees",,"Accounts Payable",5000.00,"",185000.00
"Total Systems Audit Fees",,,,,,,,,,,185000.00,0.00,185000.00
"PPE",,,,,,,,,,,,,""
,"Bill","04-01-2024","MCDAV/09/24",,"Sarai Afrique Limited","3-ply Masks","Expense","PPE",,"Accounts Payable",5000.00,"",5000.00
,"Bill","31-01-2024","0170524890000000196",,"Sarai Afrique Limited","-MULTIPLE-","Expense","PPE",,"Accounts Payable",18740.00,"",23740.00
,"Bill","23-02-2024","0041426510000000118",,"Detchy Supplies","Diamond grip glove","Expense","PPE",,"Accounts Payable",12500.00,"",36240.00
,"Bill","07-03-2024","MCDAV/11/24",,"Sarai Afrique Limited","-MULTIPLE-","Expense","PPE",,"Accounts Payable",10000.00,"",46240.00
,"Bill","26-03-2024","KRACU0200000460/22",,"Clarjos Enterprises","-MULTIPLE-","Expense","PPE",,"Accounts Payable",22200.00,"",68440.00
,"Cheque","28-03-2024","SCS9DULHRB",,"Liachilo General Supplies","Welding Gloves","Expense","PPE",,"MPESA Account",4200.00,"",72640.00
,"Cheque","15-04-2024","SDF5AN8KDL",,"Liachilo General Supplies","Diamond grip glove","Expense","PPE",,"MPESA Account",12500.00,"",85140.00
,"Cheque","16-04-2024","SDG1ESVRPB",,"Liachilo General Supplies","Ear muff","Expense","PPE",,"MPESA Account",2200.00,"",87340.00
,"Bill","23-04-2024","0170524890000000390",,"Sarai Afrique Limited","-MULTIPLE-","Expense","PPE",,"Accounts Payable",17300.00,"",104640.00
,"Bill","06-05-2024","5766",,"M & M Shop","Gumboots","Expense","PPE",,"Accounts Payable",4060.00,"",108700.00
,"Cheque","15-05-2024","SEF3BK3DF1",,"Liachilo General Supplies","Nitrile gloves","Expense","PPE",,"MPESA Account",1500.00,"",110200.00
,"Cheque","24-05-2024","SEO0A6K81U",,"Liachilo General Supplies","Diamond grip glove","Expense","PPE",,"MPESA Account",12500.00,"",122700.00
,"Bill","12-06-2024","0170524890000000445",,"Sarai Afrique Limited","-MULTIPLE-","Expense","PPE",,"Accounts Payable",16155.17,"",138855.17
,"Cheque","24-06-2024","SFO1J3POZZ",,"Liachilo General Supplies","Diamond grip glove","Expense","PPE",,"MPESA Account",12500.00,"",151355.17
,"Bill","19-07-2024","0170524890000000554",,"Sarai Afrique Limited","Taiwan dust masks","Expense","PPE",,"Accounts Payable",9000.00,"",160355.17
,"Cheque","26-07-2024","SGQ7WXD3L5",,"Liachilo General Supplies","Diamond grip glove","Expense","PPE",,"MPESA Account",12500.00,"",172855.17
,"Bill","13-08-2024","0170524890000000551",,"Sarai Afrique Limited","-MULTIPLE-","Expense","PPE",,"Accounts Payable",8300.00,"",181155.17
,"Cheque","25-08-2024",,,,"Heat resistant gloves","Expense","PPE",,"MPESA Account",1400.00,"",182555.17
,"Cheque","26-08-2024","SHQ9EQVBAH",,"Liachilo General Supplies","3-ply Masks","Expense","PPE",,"MPESA Account",2450.00,"",185005.17
,"Cheque","27-08-2024","SHS9JO6ROJ",,"Liachilo General Supplies","Diamond grip glove","Expense","PPE",,"MPESA Account",12500.00,"",197505.17
,"Cheque","03-09-2024","2024SSL0105",,"Subanya Supplies Ltd","-MULTIPLE-","Expense","PPE",,"MPESA Account",19500.00,"",217005.17
,"Bill","19-09-2024","KRACU0200000460/30",,"Clarjos Enterprises","Broken overalls","Expense","PPE",,"Accounts Payable",23000.00,"",240005.17
,"Bill","19-09-2024","0010197120000009417",,"Ravs Fashions Ltd","Reflector Jackets","Expense","PPE",,"Accounts Payable",879.31,"",240884.48
,"Bill","27-09-2024","360",,"Clarjos Enterprises","Ladies dust coat","Expense","PPE",,"Accounts Payable",1500.00,"",242384.48
,"Bill","01-10-2024","0040129490000021776",,"Saigul Distributors Ltd","Reflector Jacket","Expense","PPE",,"Accounts Payable",2327.59,"",244712.07
,"Cheque","07-10-2024","2024SSL0142",,"Subanya Supplies Ltd","-MULTIPLE-","Expense","PPE",,"MPESA Account",20900.00,"",265612.07
,"Cheque","08-10-2024","SJ85F1E929",,"Liachilo General Supplies","Diamond grip glove","Expense","PPE",,"MPESA Account",12500.00,"",278112.07
,"Bill","24-10-2024","0040129490000022289",,"Saigul Distributors Ltd","Reflector Jacket","Expense","PPE",,"Accounts Payable",2327.59,"",280439.66
,"Bill","24-10-2024","0040129490000022296",,"Saigul Distributors Ltd","Reflector Jacket","Expense","PPE",,"Accounts Payable",2482.76,"",282922.42
,"Bill","24-10-2024","22690",,"Safety Hub Ltd","Reflective Tetrex Overalls Navy Blue","Expense","PPE",,"Accounts Payable",1200.00,"",284122.42
,"Bill","24-10-2024","22697",,"Safety Hub Ltd","Reflective Tetrex Overalls Navy Blue","Expense","PPE",,"Accounts Payable",1200.00,"",285322.42
,"Bill","28-10-2024","0040129490000022387",,"Saigul Distributors Ltd","Helmet","Expense","PPE",,"Accounts Payable",11422.41,"",296744.83
,"Cheque","28-10-2024","SJS9OHSBW7",,,"Heat resistant gloves","Expense","PPE",,"MPESA Account",1890.00,"",298634.83
,"Cheque","08-11-2024","SK842UL8MQ",,"Liachilo General Supplies","Diamond grip glove","Expense","PPE",,"MPESA Account",12500.00,"",311134.83
,"Cheque","11-11-2024","2024SSL0155",,"Subanya Supplies Ltd","-MULTIPLE-","Expense","PPE",,"MPESA Account",32500.00,"",343634.83
,"Cheque","11-12-2024","SLB14PXTZF",,"Liachilo General Supplies","Diamond grip glove","Expense","PPE",,"MPESA Account",12500.00,"",356134.83
,"Cheque","18-12-2024","1753",,,"Heat resistant gloves","Expense","PPE",,"MPESA Account",2100.00,"",358234.83
"Total PPE",,,,,,,,,,,358234.83,0.00,358234.83
"Safety, Health, Env & Quality - Other",,,,,,,,,,,,,""
,"Bill","15-04-2024","0090967790000000525",,"Unique Packaging (Ke) Limited","Quality Assurance Sticker","Expense","Safety, Health, Env & Quality",,"Accounts Payable",9936.00,"",9936.00
"Total Safety, Health, Env & Quality - Other",,,,,,,,,,,9936.00,0.00,9936.00
"Total Safety, Health, Env & Quality",,,,,,,,,,,690620.83,0.00,690620.83
"Utilities",,,,,,,,,,,,,""
"Mobile",,,,,,,,,,,,,""
,"Bill","01-01-2024","1951682",,"Jamii Telecommunications Limited","15Mbps Faiba Business","Expense","Mobile",,"Accounts Payable",11500.00,"",11500.00
,"Cheque","15-01-2024","P1791",,,"Kangethe airtime","Expense","Mobile",,"MPESA Account",1000.00,"",12500.00
,"Cheque","15-01-2024","P1792",,,"Joan airtime","Expense","Mobile",,"MPESA Account",2000.00,"",14500.00
,"Cheque","15-01-2024","P1793",,,"Uimbia airtime","Expense","Mobile",,"MPESA Account",4000.00,"",18500.00
,"Cheque","15-01-2024","P1794",,,"Christine Mwende airtime","Expense","Mobile",,"MPESA Account",500.00,"",19000.00
,"Cheque","15-01-2024","P1795",,,"Alarm system line SMS subscription","Expense","Mobile",,"MPESA Account",100.00,"",19100.00
,"Credit","27-01-2024","CN5000000001901379",,"Airtel Network Kenya Ltd","Early payment discount","Expense","Mobile",,"Accounts Payable","",540.90,18559.10
,"Bill","01-02-2024","0110162140000099098",,"Jamii Telecommunications Limited","15Mbps Faiba Business","Expense","Mobile",,"Accounts Payable",11500.00,"",30059.10
,"Bill","02-02-2024","0020111660000060371",,"Airtel Network Kenya Ltd","Airtel postpaid subscription","Expense","Mobile",,"Accounts Payable",5167.21,"",35226.31
,"Cheque","07-02-2024","P1827",,,"Kangethe airtime","Expense","Mobile",,"MPESA Account",1000.00,"",36226.31
,"Cheque","14-02-2024","P1850",,,"Maurine Khalifa airtime","Expense","Mobile",,"MPESA Account",500.00,"",36726.31
,"Cheque","19-02-2024","P1856",,,"Christine Mwende airtime","Expense","Mobile",,"MPESA Account",500.00,"",37226.31
,"Cheque","19-02-2024","P1857",,,"SMS subscription","Expense","Mobile",,"MPESA Account",60.00,"",37286.31
,"Credit","29-02-2024","CN500000000",,"Airtel Network Kenya Ltd","Early payment discount","Expense","Mobile",,"Accounts Payable","",545.40,36740.91
,"Bill","01-03-2024","0110162140000105496",,"Jamii Telecommunications Limited","15Mbps Faiba Business","Expense","Mobile",,"Accounts Payable",11500.00,"",48240.91
,"Bill","01-03-2024","0020111660000069451",,"Airtel Network Kenya Ltd","Airtel postpaid subscription","Expense","Mobile",,"Accounts Payable",5167.19,"",53408.10
,"Cheque","07-03-2024","P1884",,,"Kangethe airtime","Expense","Mobile",,"MPESA Account",1000.00,"",54408.10
,"Cheque","07-03-2024","P1886",,,"Christine Mwende airtime","Expense","Mobile",,"MPESA Account",500.00,"",54908.10
,"Cheque","21-03-2024","P1899",,,"Reuben Oloo airtime","Expense","Mobile",,"MPESA Account",1000.00,"",55908.10
,"Cheque","21-03-2024","P1900",,,"Vincent Ouma airtime","Expense","Mobile",,"MPESA Account",1000.00,"",56908.10
,"Cheque","21-03-2024","P1901",,,"Joan airtime","Expense","Mobile",,"MPESA Account",2000.00,"",58908.10
,"Cheque","21-03-2024","P1902",,,"Uimbia airtime","Expense","Mobile",,"MPESA Account",4000.00,"",62908.10
,"Bill","31-03-2024","0020111660000078425",,"Airtel Network Kenya Ltd","Airtel postpaid subscription","Expense","Mobile",,"Accounts Payable",5167.19,"",68075.29
,"Credit","31-03-2024","CN500000000",,"Airtel Network Kenya Ltd","Early payment discount","Expense","Mobile",,"Accounts Payable","",544.80,67530.49
,"Bill","01-04-2024","0110162140000112418",,"Jamii Telecommunications Limited","15Mbps Faiba Business","Expense","Mobile",,"Accounts Payable",11500.00,"",79030.49
,"Cheque","05-04-2024","P1948",,,"Kangethe airtime","Expense","Mobile",,"MPESA Account",1000.00,"",80030.49
,"Cheque","05-04-2024","P1949",,,"Maurine Khalifa airtime","Expense","Mobile",,"MPESA Account",1000.00,"",81030.49
,"Cheque","05-04-2024","P1950",,,"Vincent Ouma airtime","Expense","Mobile",,"MPESA Account",1000.00,"",82030.49
,"Cheque","05-04-2024","P1952",,,"Dominic airtime","Expense","Mobile",,"MPESA Account",1000.00,"",83030.49
,"Cheque","05-04-2024","P1951",,,"Reuben Oloo airtime","Expense","Mobile",,"MPESA Account",1000.00,"",84030.49
,"Cheque","05-04-2024","P1953",,,"Joan airtime","Expense","Mobile",,"MPESA Account",2000.00,"",86030.49
,"Cheque","05-04-2024","P1954",,,"Uimbia airtime","Expense","Mobile",,"MPESA Account",4000.00,"",90030.49
,"Cheque","05-04-2024","P1955",,,"Christine Mwende airtime","Expense","Mobile",,"MPESA Account",500.00,"",90530.49
,"Cheque","05-04-2024","P1956",,,"Alarm system line SMS subscription","Expense","Mobile",,"MPESA Account",100.00,"",90630.49
,"Cheque","15-04-2024","P1969",,,"SMS subscription","Expense","Mobile",,"MPESA Account",20.00,"",90650.49
,"Credit","30-04-2024","CN500000000",,"Airtel Network Kenya Ltd","Early payment discount","Expense","Mobile",,"Accounts Payable","",541.61,90108.88
,"Bill","01-05-2024","0020111660000087733",,"Airtel Network Kenya Ltd","Airtel postpaid subscription","Expense","Mobile",,"Accounts Payable",5167.19,"",95276.07
,"Bill","01-05-2024","0110162140000119354",,"Jamii Telecommunications Limited","15Mbps Faiba Business","Expense","Mobile",,"Accounts Payable",11500.00,"",106776.07
,"Cheque","08-05-2024","P2011",,,"Vincent Ouma airtime","Expense","Mobile",,"MPESA Account",1000.00,"",107776.07
,"Cheque","08-05-2024","P2012",,,"Maurine Khalifa airtime","Expense","Mobile",,"MPESA Account",1000.00,"",108776.07
,"Cheque","08-05-2024","P2013",,,"Reuben Oloo airtime","Expense","Mobile",,"MPESA Account",1000.00,"",109776.07
,"Cheque","08-05-2024","P2014",,,"Dominic airtime","Expense","Mobile",,"MPESA Account",1000.00,"",110776.07
,"Cheque","08-05-2024","P2015",,,"Joan airtime","Expense","Mobile",,"MPESA Account",2000.00,"",112776.07
,"Cheque","08-05-2024","P2016",,,"Uimbia airtime","Expense","Mobile",,"MPESA Account",4000.00,"",116776.07
,"Cheque","08-05-2024","P2017",,,"Christine Mwende airtime","Expense","Mobile",,"MPESA Account",500.00,"",117276.07
,"Cheque","08-05-2024","P2018",,,"Kangethe airtime","Expense","Mobile",,"MPESA Account",1000.00,"",118276.07
,"Cheque","15-05-2024","P2032",,,"SMS subscription","Expense","Mobile",,"MPESA Account",20.00,"",118296.07
,"Credit","31-05-2024","CN500000000",,"Airtel Network Kenya Ltd","Early payment discount","Expense","Mobile",,"Accounts Payable","",545.19,117750.88
,"Bill","01-06-2024","0110162140000126091",,"Jamii Telecommunications Limited","15Mbps Faiba Business","Expense","Mobile",,"Accounts Payable",11500.00,"",129250.88
,"Bill","03-06-2024","0020111660000101360",,"Airtel Network Kenya Ltd","Airtel postpaid subscription","Expense","Mobile",,"Accounts Payable",5167.21,"",134418.09
,"Cheque","05-06-2024","P2078",,,"Vincent Ouma airtime","Expense","Mobile",,"MPESA Account",1000.00,"",135418.09
,"Cheque","05-06-2024","P2079",,,"Reuben Oloo airtime","Expense","Mobile",,"MPESA Account",1000.00,"",136418.09
,"Cheque","05-06-2024","P2080",,,"Maurine Khalifa airtime","Expense","Mobile",,"MPESA Account",1000.00,"",137418.09
,"Cheque","05-06-2024","P2081",,,"Dominic airtime","Expense","Mobile",,"MPESA Account",1000.00,"",138418.09
,"Cheque","05-06-2024","P2082",,,"Uimbia airtime","Expense","Mobile",,"MPESA Account",4000.00,"",142418.09
,"Cheque","05-06-2024","P2083",,,"Christine Mwende airtime","Expense","Mobile",,"MPESA Account",500.00,"",142918.09
,"Cheque","05-06-2024","P2084",,,"Kangethe airtime","Expense","Mobile",,"MPESA Account",1000.00,"",143918.09
,"Cheque","05-06-2024","P2085",,,"Joan airtime","Expense","Mobile",,"MPESA Account",2000.00,"",145918.09
,"Cheque","25-06-2024","P2115",,,"Kangethe airtime","Expense","Mobile",,"MPESA Account",1000.00,"",146918.09
,"Credit","29-06-2024","CN500000000",,"Airtel Network Kenya Ltd","Early payment discount","Expense","Mobile",,"Accounts Payable","",544.80,146373.29
,"Bill","01-07-2024","0110162140000132656",,"Jamii Telecommunications Limited","15Mbps Faiba Business","Expense","Mobile",,"Accounts Payable",11500.00,"",157873.29
,"Bill","01-07-2024","0020111660000106085",,"Airtel Network Kenya Ltd","Airtel postpaid subscription","Expense","Mobile",,"Accounts Payable",5167.21,"",163040.50
,"Cheque","03-07-2024","P2128",,,"Vincent Ouma airtime","Expense","Mobile",,"MPESA Account",1000.00,"",164040.50
,"Cheque","03-07-2024","P2129",,,"Reuben Oloo airtime","Expense","Mobile",,"MPESA Account",1000.00,"",165040.50
,"Cheque","03-07-2024","P2130",,,"Maurine Khalifa airtime","Expense","Mobile",,"MPESA Account",1000.00,"",166040.50
,"Cheque","03-07-2024","P2131",,,"Dominic airtime","Expense","Mobile",,"MPESA Account",1000.00,"",167040.50
,"Cheque","03-07-2024","P2132",,,"Joan airtime","Expense","Mobile",,"MPESA Account",2000.00,"",169040.50
,"Cheque","03-07-2024","P2133",,,"Uimbia airtime","Expense","Mobile",,"MPESA Account",4000.00,"",173040.50
,"Cheque","03-07-2024","P2134",,,"Christine Mwende airtime","Expense","Mobile",,"MPESA Account",500.00,"",173540.50
,"Cheque","03-07-2024","P2135",,,"Alarm system line SMS subscription","Expense","Mobile",,"MPESA Account",100.00,"",173640.50
,"Cheque","10-07-2024","P2147",,,"Safaricom postpaid roaming bundles subscription","Expense","Mobile",,"MPESA Account",2950.00,"",176590.50
,"Credit","31-07-2024","CN500000000",,"Airtel Network Kenya Ltd","Early payment discount","Expense","Mobile",,"Accounts Payable","",544.90,176045.60
,"Bill","01-08-2024","0110162140000138880",,"Jamii Telecommunications Limited","15Mbps Faiba Business","Expense","Mobile",,"Accounts Payable",11500.00,"",187545.60
,"Bill","01-08-2024","0020111960000116329",,"Airtel Network Kenya Ltd","Airtel postpaid subscription","Expense","Mobile",,"Accounts Payable",5167.21,"",192712.81
,"Cheque","08-08-2024","P2196",,,"Vincent Ouma airtime","Expense","Mobile",,"MPESA Account",1000.00,"",193712.81
,"Cheque","08-08-2024","P2197",,,"Maurine Khalifa airtime","Expense","Mobile",,"MPESA Account",1000.00,"",194712.81
,"Cheque","08-08-2024","P2198",,,"Kangethe airtime","Expense","Mobile",,"MPESA Account",1000.00,"",195712.81
,"Cheque","08-08-2024","P2199",,,"Joan airtime","Expense","Mobile",,"MPESA Account",2000.00,"",197712.81
,"Cheque","08-08-2024","P2200",,,"Dominic airtime","Expense","Mobile",,"MPESA Account",1000.00,"",198712.81
,"Cheque","08-08-2024","P2201",,,"Uimbia airtime","Expense","Mobile",,"MPESA Account",4000.00,"",202712.81
,"Cheque","08-08-2024","P2202",,,"Christine Mwende airtime","Expense","Mobile",,"MPESA Account",500.00,"",203212.81
,"Cheque","08-08-2024","P2203",,,"Alarm system line SMS subscription","Expense","Mobile",,"MPESA Account",100.00,"",203312.81
,"Cheque","13-08-2024","P2214",,,"MPESA line airtime","Expense","Mobile",,"MPESA Account",50.00,"",203362.81
,"Bill","01-09-2024","0020111640000125805",,"Airtel Network Kenya Ltd","Airtel postpaid subscription","Expense","Mobile",,"Accounts Payable",5167.21,"",208530.02
,"Bill","02-09-2024","0110162140000145524",,"Jamii Telecommunications Limited","15Mbps Faiba Business","Expense","Mobile",,"Accounts Payable",11500.00,"",220030.02
,"Cheque","03-09-2024","P2256",,,"Vincent Ouma airtime","Expense","Mobile",,"MPESA Account",1000.00,"",221030.02
,"Cheque","03-09-2024","P2257",,,"Maurine Khalifa airtime","Expense","Mobile",,"MPESA Account",1000.00,"",222030.02
,"Cheque","03-09-2024","P2258",,,"Kangethe airtime","Expense","Mobile",,"MPESA Account",1000.00,"",223030.02
,"Cheque","03-09-2024","P2259",,,"Joan airtime","Expense","Mobile",,"MPESA Account",2000.00,"",225030.02
,"Cheque","03-09-2024","P2260",,,"Dominic airtime","Expense","Mobile",,"MPESA Account",1000.00,"",226030.02
,"Cheque","03-09-2024","P2261",,,"Uimbia airtime","Expense","Mobile",,"MPESA Account",4000.00,"",230030.02
,"Cheque","03-09-2024","P2262",,,"Christine Mwende airtime","Expense","Mobile",,"MPESA Account",500.00,"",230530.02
,"Cheque","03-09-2024","P2263",,,"Alarm system line SMS subscription","Expense","Mobile",,"MPESA Account",100.00,"",230630.02
,"Credit","30-09-2024","CN500000000",,"Airtel Network Kenya Ltd","Early payment discount","Expense","Mobile",,"Accounts Payable","",599.45,230030.57
,"Bill","01-10-2024","0110162140000151883",,"Jamii Telecommunications Limited","15Mbps Faiba Business","Expense","Mobile",,"Accounts Payable",11500.00,"",241530.57
,"Bill","01-10-2024","0020111640000135287",,"Airtel Network Kenya Ltd","Airtel postpaid subscription","Expense","Mobile",,"Accounts Payable",5167.21,"",246697.78
,"Cheque","02-10-2024","P2320",,,"Vincent Ouma airtime","Expense","Mobile",,"MPESA Account",1000.00,"",247697.78
,"Cheque","02-10-2024","P2321",,,"Maurine Khalifa airtime","Expense","Mobile",,"MPESA Account",1000.00,"",248697.78
,"Cheque","02-10-2024","P2322",,,"Kangethe airtime","Expense","Mobile",,"MPESA Account",1000.00,"",249697.78
,"Cheque","02-10-2024","P2324",,,"Joan airtime","Expense","Mobile",,"MPESA Account",2000.00,"",251697.78
,"Cheque","02-10-2024","P2325",,,"Dominic airtime","Expense","Mobile",,"MPESA Account",1000.00,"",252697.78
,"Cheque","02-10-2024","P2326",,,"Uimbia airtime","Expense","Mobile",,"MPESA Account",4000.00,"",256697.78
,"Cheque","02-10-2024","P2327",,,"Christine Mwende airtime","Expense","Mobile",,"MPESA Account",500.00,"",257197.78
,"Cheque","02-10-2024","P2328",,,"Crispus Malenge airtime","Expense","Mobile",,"MPESA Account",500.00,"",257697.78
,"Cheque","02-10-2024","P2329",,,"Alarm system line SMS subscription","Expense","Mobile",,"MPESA Account",100.00,"",257797.78
,"Bill","31-10-2024","0110162140000158071",,"Jamii Telecommunications Limited","15Mbps Faiba Business","Expense","Mobile",,"Accounts Payable",11500.00,"",269297.78
,"Bill","01-11-2024","0020111960000144595",,"Airtel Network Kenya Ltd","Airtel postpaid subscription","Expense","Mobile",,"Accounts Payable",5167.21,"",274464.99
,"Cheque","05-11-2024","P2375",,,"Vincent Ouma airtime","Expense","Mobile",,"MPESA Account",1000.00,"",275464.99
,"Cheque","05-11-2024","P2376",,,"Maurine Khalifa airtime","Expense","Mobile",,"MPESA Account",1000.00,"",276464.99
,"Cheque","05-11-2024","P2377",,,"Kangethe airtime","Expense","Mobile",,"MPESA Account",1000.00,"",277464.99
,"Cheque","05-11-2024","P2378",,,"Joan airtime","Expense","Mobile",,"MPESA Account",2000.00,"",279464.99
,"Cheque","05-11-2024","P2379",,,"Dominic airtime","Expense","Mobile",,"MPESA Account",1000.00,"",280464.99
,"Cheque","05-11-2024","P2380",,,"Uimbia airtime","Expense","Mobile",,"MPESA Account",4000.00,"",284464.99
,"Cheque","05-11-2024","P2381",,,"Christine Mwende airtime","Expense","Mobile",,"MPESA Account",500.00,"",284964.99
,"Cheque","05-11-2024","P2382",,,"Crispus Malenge airtime","Expense","Mobile",,"MPESA Account",500.00,"",285464.99
,"Cheque","05-11-2024","P2383",,,"Alarm system line SMS subscription","Expense","Mobile",,"MPESA Account",100.00,"",285564.99
,"Bill","30-11-2024","0020111640000154166",,"Airtel Network Kenya Ltd","Airtel postpaid subscription","Expense","Mobile",,"Accounts Payable",5167.21,"",290732.20
,"Bill","02-12-2024","0110162140000164010",,"Jamii Telecommunications Limited","15Mbps Faiba Business","Expense","Mobile",,"Accounts Payable",11500.00,"",302232.20
,"Cheque","04-12-2024","P2445",,,"Vincent Ouma airtime","Expense","Mobile",,"MPESA Account",1000.00,"",303232.20
,"Cheque","04-12-2024","P2446",,,"Maurine Khalifa airtime","Expense","Mobile",,"MPESA Account",1000.00,"",304232.20
,"Cheque","04-12-2024","P2447",,,"Kangethe airtime","Expense","Mobile",,"MPESA Account",1000.00,"",305232.20
,"Cheque","04-12-2024","P2448",,,"Joan airtime","Expense","Mobile",,"MPESA Account",2000.00,"",307232.20
,"Cheque","04-12-2024","P2449",,,"Dominic airtime","Expense","Mobile",,"MPESA Account",1000.00,"",308232.20
,"Cheque","04-12-2024","P2450",,,"Uimbia airtime","Expense","Mobile",,"MPESA Account",4000.00,"",312232.20
,"Cheque","04-12-2024","P2451",,,"Christine Mwende airtime","Expense","Mobile",,"MPESA Account",500.00,"",312732.20
,"Cheque","04-12-2024","P2452",,,"Crispus Malenge airtime","Expense","Mobile",,"MPESA Account",500.00,"",313232.20
,"Bill","31-12-2024","0020111960000163713",,"Airtel Network Kenya Ltd","Airtel postpaid subscription","Expense","Mobile",,"Accounts Payable",5167.21,"",318399.41
"Total Mobile",,,,,,,,,,,322806.46,4407.05,318399.41
"Water",,,,,,,,,,,,,""
,"Bill","02-01-2024",,,"Nairobi Water and Sewerage Co.","Water bill","Expense","Water",,"Accounts Payable",2864.00,"",2864.00
,"Bill","04-01-2024","BL-009577048",,"Nairobi Water and Sewerage Co.","Water bill","Expense","Water",,"Accounts Payable",5109.00,"",7973.00
,"Bill","05-02-2024","BL-009831174",,"Nairobi Water and Sewerage Co.","Water bill","Expense","Water",,"Accounts Payable",6498.00,"",14471.00
,"Bill","06-03-2024",,,"Nairobi Water and Sewerage Co.","Water bill","Expense","Water",,"Accounts Payable",5355.00,"",19826.00
,"Cheque","25-03-2024","P1927",,,"Water 40 jerrycans","Expense","Water",,"MPESA Account",1200.00,"",21026.00
,"Cheque","26-03-2024","P1928",,,"Water 10 jerrycans","Expense","Water",,"MPESA Account",300.00,"",21326.00
,"Bill","08-04-2024","BL-010380277",,"Nairobi Water and Sewerage Co.","Water bill","Expense","Water",,"Accounts Payable",7057.00,"",28383.00
,"Bill","07-05-2024","BL-010603428",,"Nairobi Water and Sewerage Co.","Water bill","Expense","Water",,"Accounts Payable",2118.00,"",30501.00
,"Bill","05-06-2024","BL-010835791",,"Nairobi Water and Sewerage Co.","Water bill","Expense","Water",,"Accounts Payable",12589.00,"",43090.00
,"Bill","08-07-2024","BL-011141795",,"Nairobi Water and Sewerage Co.","Water bill","Expense","Water",,"Accounts Payable",5109.00,"",48199.00
,"Bill","02-08-2024","BL-011310752",,"Nairobi Water and Sewerage Co.","Water bill","Expense","Water",,"Accounts Payable",6406.00,"",54605.00
,"Cheque","09-08-2024","P2211",,,"Water 40 jerrycans","Expense","Water",,"MPESA Account",1000.00,"",55605.00
,"Cheque","12-08-2024","P2212",,,"Water 20 jerrycans","Expense","Water",,"MPESA Account",500.00,"",56105.00
,"Bill","04-09-2024","BL-011563999",,"Nairobi Water and Sewerage Co.","Water bill","Expense","Water",,"Accounts Payable",6944.00,"",63049.00
,"Bill","04-10-2024","BL-011816016",,"Nairobi Water and Sewerage Co.","Water bill","Expense","Water",,"Accounts Payable",7102.00,"",70151.00
,"Bill","05-11-2024","BL-012049989",,"Nairobi Water and Sewerage Co.","Water bill","Expense","Water",,"Accounts Payable",7724.00,"",77875.00
,"Bill","03-12-2024","BL-012282595",,"Nairobi Water and Sewerage Co.","Water bill","Expense","Water",,"Accounts Payable",6762.00,"",84637.00
"Total Water",,,,,,,,,,,84637.00,0.00,84637.00
"Total Utilities",,,,,,,,,,,407443.46,4407.05,403036.41
"Total Expense",,,,,,,,,,,42323192.05,47960.53,42275231.52
"Net Ordinary Income",,,,,,,,,,,203252395.18,294305254.05,91052858.87
"Other Income/Expense",,,,,,,,,,,,,""
"Other Expense",,,,,,,,,,,,,""
"Exchange Gain or Loss",,,,,,,,,,,,,""
,"Bill Pmt -Cheque","28-03-2024","Cash",,"Adatouch Company Limited","Exchange Gain/Loss","Other Expense","Exchange Gain or Loss",,"Cash Account",1117.13,"",1117.13
,"Bill Pmt -Cheque","18-04-2024","Cash",,"Consolbase Limited","Exchange Gain/Loss","Other Expense","Exchange Gain or Loss",,"Cash Account",1436.81,"",2553.94
,"Bill Pmt -Cheque","06-06-2024","FT24158R18F",,"Givaudan MEA FZE","Exchange Gain/Loss","Other Expense","Exchange Gain or Loss",,"KCB USD Account",227590.27,"",230144.21
"Total Exchange Gain or Loss",,,,,,,,,,,230144.21,0.00,230144.21
"Total Other Expense",,,,,,,,,,,230144.21,0.00,230144.21
"Net Other Income",,,,,,,,,,,230144.21,0.00,-230144.21
"Profit for the Year",,,,,,,,,,,203482539.39,294305254.05,90822714.66
